,Posts,Channel,Views_03/03,Views_03/12,view_delta
0,"Yared Negu - Yegir Esat |ያሬድ ነጉ - የእግር እሳት ከካሜራ በስተጀርባ 2022 by 16 Plus Entertainment 2 weeks ago 13 minutes, 6 seconds 534 views",16 Plus Entertainment,534,643,109
1,"Zebiba Girma - Ayehu Gela - ዘቢባ ግርማ - አየሁ ገላ የሙዚቃ ቪዲዮ ከካሜራ በስተጀርባ  2021 by 16 Plus Entertainment 3 months ago 18 minutes 1,069 views",16 Plus Entertainment,1069,1121,52
2,26 September 2021 by 16 Plus Entertainment 5 months ago 16 seconds 255 views,16 Plus Entertainment,255,260,5
3,"Yared Negu & Millen Hailu-(BIRA-BIRO)የ ያሬድ ነጉ እና የ ሚለን ሀይሉ 'ቢራቢሮ' የሙዚቃ ቪዲዮ ከካሜራ በስተጀርባ ክፍል ሁለት 2021 by 16 Plus Entertainment 7 months ago 11 minutes, 57 seconds 159,257 views",16 Plus Entertainment,159257,159913,656
4,"Ethiopian Music Bisrat Surafel ብስራት ሱራፌል (ትሆን ወይ) የሙዚቃ ቪዲዮ ከካሜራ በስተጀርባ Behind Scenes 2021 by 16 Plus Entertainment 7 months ago 23 minutes 6,543 views",16 Plus Entertainment,6543,6618,75
5,"Yared Negu & Millen Hailu - (BIRA-BIRO)የ ያሬድ ነጉ እና የ ሚለን ሀይሉ 'ቢራቢሮ' የሙዚቃ ቪዲዮ ከካሜራ በስተጀርባ 2021 by 16 Plus Entertainment 8 months ago 16 minutes 354,415 views",16 Plus Entertainment,354415,354947,532
6,ልዩ የበዓል ፕሮግራም ክፍል 1 by 16 Plus Entertainment 1 year ago 19 minutes 597 views,16 Plus Entertainment,597,599,2
7,"Ethiopia: Zebiba Girma (Zim) ዘቢባ ግርማ (ዝም) - New Ethiopian Music 2020(Official Video) by 16 Plus Entertainment 1 year ago 1 minute, 15 seconds 348,514 views",16 Plus Entertainment,348514,350044,1530
8,"ጃኪ ጎሲ | እንዳሞራው  - Jacky Gosee | Ende Amoraw || BEHIND THE SCENES || ምርጥ ከካሜራ ጀርባ ትእይንቶች by 16 Plus Entertainment 2 years ago 12 minutes, 5 seconds 22,298 views",16 Plus Entertainment,22298,22344,46
9,"ወጣት በ 97 | WETAT BE 97 - ከካሜራ ጀርባ ትእይንቶች || ክፍል 2 || 16 Film Production by 16 Plus Entertainment 2 years ago 9 minutes, 16 seconds 12,853 views",16 Plus Entertainment,12853,13098,245
10,"ወጣት በ 97 | WETAT BE 97 - ከካሜራ ጀርባ ትእይንቶች || ክፍል 1 - 16 Film Production by 16 Plus Entertainment 2 years ago 8 minutes, 51 seconds 10,580 views",16 Plus Entertainment,10580,10899,319
11,"ኢትኤል Ethiopian movie trailer - Ethal 2019 - 16 Film Production by 16 Plus Entertainment 2 years ago 2 minutes, 31 seconds 15,495 views",16 Plus Entertainment,15495,15504,9
12,"Behind The Scene Kako Getachew - Aroge Arada 2 - አሮጌ አራዳ 2 music video - 16 Film Production by 16 Plus Entertainment 2 years ago 4 minutes, 5 seconds 15,685 views",16 Plus Entertainment,15685,15767,82
13,"Welcome To 16 Film production official Channel - 16 Film Production by 16 Plus Entertainment 2 years ago 1 minute, 32 seconds 4,860 views",16 Plus Entertainment,4860,4882,22
14,"Asgegnew Ashko Asge /Lade / ላዴ  Music Mideo Behind The Scene - 16 Film Production by 16 Plus Entertainment 2 years ago 4 minutes, 46 seconds 2,737 views",16 Plus Entertainment,2737,2744,7
15,"Bisrat Surafel /Yebet Sira /የቤት ስራ Music clip Behind The Scene - 16 Film Production by 16 Plus Entertainment 2 years ago 2 minutes, 28 seconds 4,348 views",16 Plus Entertainment,4348,4355,7
16,"ያሬድ ነጉ - ያጉቴ - ከካሜራ ጀርባ || Yared Negu - Yagute - Music video Behind The Scene - 16 Film Production by 16 Plus Entertainment 2 years ago 4 minutes, 39 seconds 104,136 views",16 Plus Entertainment,104136,104229,93
17,"😲🔥ታዳሚውን  በጭፈራ ያስደመሙት ሙሽሮች😲🔥 Amazing Ethiopian habesha wedding  አዝናኝ የስርግ ላይ ጭፈራዎች by Adey Entertainment 3 months ago 9 minutes, 21 seconds 676 views",Adey Entertainment,676,700,24
18,"💎Luxury wedding 💎 in Addis Abeba / Tsion & Sirak /አዝናኝ የስርግ ፕሮግራም / ETHIOPIAN  HABESHA WEDDING VIDEO by Adey Entertainment 3 months ago 8 minutes, 16 seconds 7,693 views",Adey Entertainment,7693,8204,511
19,ዝነኛው ሾው/Zenegnaw Show/ Coming Soon by Adey Entertainment 8 months ago 23 seconds 121 views,Adey Entertainment,121,121,0
20,"Amazing Ethiopian habesha wedding  አዝናኝ የስርግ ላይ ጭፈራዎች by Adey Entertainment 11 months ago 59 seconds 6,893 views",Adey Entertainment,6893,6975,82
21,SKALES  - Live Concert in Ethiopia Addis Abeba  WAZEMA Concert  🔥🔥🔥 by Adey Entertainment 1 year ago 26 minutes 443 views,Adey Entertainment,443,446,3
22,"Hewan Gebrewold - Gude Fela | ሄዋን ገብረወልድ | ጉዴፈላ| - New Ethiopian Music 2020 (Official Video) by Adey Entertainment 1 year ago 4 minutes 187,331 views",Adey Entertainment,187331,187794,463
23,"ቤቲ ጂ - / አዲስ አመት /  BETTY G - ""ABEBAYEHOSH"" by Adey Entertainment 1 year ago 5 minutes, 58 seconds 2,018 views",Adey Entertainment,2018,2027,9
24,"አዝናኝ የስርግ ፕሮግራም  እና ጭፈራዎች THE MOST BEAUTIFUL ETHIOPIAN  HABESHA WEDDING VIDEO ""NADIYA AND MIKREAB"" by Adey Entertainment 1 year ago 9 minutes, 42 seconds 230,958 views",Adey Entertainment,230958,232053,1095
25,"ሔኖክ ድንቁ - ለ ሜላት ነብዩ የጋብዛት ዘፈን ""ክፍል 2""  አዝናኝ ቆይታ/ ዝነኛው ሾው/Zenegnaw Show/ Melat Nebeyou & Henok Dinku by Adey Entertainment 1 year ago 11 minutes, 23 seconds 8,867 views",Adey Entertainment,8867,8893,26
26,"በጉጉት ሲጠበቅ የነበረው የ ሜላት ነብዮ ቃለ መጠይቅ እና አስቂኝ  አዝናኝ ጨዋታ Melat Nebeyou & Henok Dinku Zenegnaw Show by Adey Entertainment 1 year ago 13 minutes, 5 seconds 19,757 views",Adey Entertainment,19757,19899,142
27,"ከ አርቲሰት ሜላት ነብዩ ጋር የተደረገ ቃለ መጠየቅ (አዝናኝና አስቂኝ ጨዋታ) ዝነኛው ሾው/ Melat Nebeyou & Henok Dinku Zenegnaw Show by Adey Entertainment 1 year ago 2 minutes, 43 seconds 35,323 views",Adey Entertainment,35323,35513,190
28,"ከ አርቲሰት ሔኖክ ድንቁ ጋር የተደረገ ቃለ መጠየቅ እና  አዝናኝ ቆይታ/ ዝነኛው ሾው/Zenegnaw Show/ Melat Nebeyou & Henok Dinku by Adey Entertainment 1 year ago 10 minutes, 42 seconds 218,100 views",Adey Entertainment,218100,218899,799
29,"Sami Dan - Lebe Sema | ልቤ ስማ - New Ethiopian Music 2019 (Official Video) by Adey Entertainment 2 years ago 6 minutes, 1 second 25,116 views",Adey Entertainment,25116,25296,180
30,"Fikru Yilkal  - Wub Ager Gonder  | ዉብ ሀገር ጎንደር - New Ethiopian Music 2022 by ADMAS MUSIC 5 days ago 6 minutes, 33 seconds 3,889 views",Admas Music,3889,7755,3866
31,"Filmon Fissehaye  - Ajoka  | ኣጆኻ - New Eritrean Music 2022 by ADMAS MUSIC 2 weeks ago 4 minutes, 45 seconds 6,124 views",Admas Music,6124,7298,1174
32,"Nahom Da - Lbona eta Lebam | ልቦና እታ ለባም - New Eritrean Music 2022 by ADMAS MUSIC 2 weeks ago 3 minutes, 59 seconds 13,565 views",Admas Music,13565,15098,1533
33,"Tekhali Gebrehiwet - Kxbeyeki Eye | ክጽበየኪ እየ - New Eritrean Music 2022 by ADMAS MUSIC 3 weeks ago 5 minutes, 58 seconds 11,422 views",Admas Music,11422,12086,664
34,"Hussein Basheqir - Beker Sham | በክር ሻም  ብ ሑሴን ባሸቂር - New Eritrean Music 2022 by ADMAS MUSIC 1 month ago 5 minutes, 40 seconds 13,992 views",Admas Music,13992,14536,544
35,"Fishale Mujo - Bahli Ade'boy | ባህሊ ዓደ'ቦይ - New Eritrean Music 2022 by ADMAS MUSIC 1 month ago 3 minutes, 37 seconds 10,220 views",Admas Music,10220,10405,185
36,"SDET - ስደት by Berhane Teweldemedhin (Wedi Haleka) - New Eritrean Music 2022 by ADMAS MUSIC 1 month ago 5 minutes 516,120 views",Admas Music,516120,541740,25620
37,"SDET (ስደት) by Berhane Wedi Haleka - NEW ERITREAN MUSIC Coming Soon @ADMAS MUSIC by ADMAS MUSIC 1 month ago 2 minutes, 33 seconds 119,234 views",Admas Music,119234,119828,594
38,"Dejen Simon - Haliwiley | ሃልውለይ ብ ደጀን ስምኦን - New Eritrean Music 2022 by ADMAS MUSIC 2 months ago 4 minutes, 21 seconds 197,874 views",Admas Music,197874,204704,6830
39,"Nehmiya Zeray - Chey Chey |  ቸይ ቸይ ብ ነህሚያ ዘርኣይ - New Eritrean Music 2022 by ADMAS MUSIC 2 months ago 4 minutes, 14 seconds 653,189 views",Admas Music,653189,681317,28128
40,"Merhawi Tewelde  - Ab Wegahta | ኣብ ወጋሕታ ብ መርሃዊ ተወልደ - New Eritrean Music 2021 by ADMAS MUSIC 3 months ago 5 minutes, 18 seconds 279,495 views",Admas Music,279495,289639,10144
41,"Biniam Okbagaber (Chapin) - Muley | ሙለይ ብ ቢንያም ዑቕባጋብር (ቻፒን)  - New Eritrean Music 2021 by ADMAS MUSIC 3 months ago 5 minutes, 1 second 154,301 views",Admas Music,154301,156899,2598
42,"Abraham Alem - Shewit Sgem | ሸዊት ስገም ብ ኣብርሃም ኣለም ኣቢ - New Eritrean Music 2021 by ADMAS MUSIC 4 months ago 6 minutes, 21 seconds 2,348,543 views",Admas Music,2348543,2411326,62783
43,"Minasie Haile  - Tsehay | ጽሓይ - New Eritrean Music 2021 by ADMAS MUSIC 4 months ago 5 minutes, 24 seconds 20,183 views",Admas Music,20183,20296,113
44,"Filmon Mahray - Gedamey | ገዳመይ  - New Eritrean Music 2021 by ADMAS MUSIC 4 months ago 5 minutes, 23 seconds 678,182 views",Admas Music,678182,698774,20592
45,"Amanuel Goitom - Fanusey | ፋኑሰይ - New Eritrean Music 2021 (Traditional Guayla) by ADMAS MUSIC 5 months ago 8 minutes, 2 seconds 680,128 views",Admas Music,680128,699675,19547
46,"Kuhlen Ibe - Nyam Nyam | ኛም ኛም - New Eritrean Music 2021 by ADMAS MUSIC 5 months ago 4 minutes, 28 seconds 9,323 views",Admas Music,9323,9411,88
47,"Tsegay Sibhatu - Sidet'yu Bedali | ስደት'ዩ በዳሊ - New Eritrean Music 2021 by ADMAS MUSIC 5 months ago 5 minutes, 45 seconds 155,327 views",Admas Music,155327,159528,4201
48,"Yosief H Michael - Kulu Zemhirela | ኩሉ ዘምሕረላ - New Eritrean Music 2021 by ADMAS MUSIC 5 months ago 5 minutes, 35 seconds 48,056 views",Admas Music,48056,48635,579
49,"Semir Abubeker - Zyaday | ዝያዳይ - New Eritrean Music 2021 by ADMAS MUSIC 6 months ago 4 minutes, 53 seconds 31,350 views",Admas Music,31350,31788,438
50,"Habtom Tekeste - Ajoki | ኣጆኺ - New Eritrean Music 2021 by ADMAS MUSIC 6 months ago 5 minutes, 15 seconds 21,721 views",Admas Music,21721,21812,91
51,"Osam Nurselam - Fenan | فنان - New Ethio Arabic Music by ADMAS MUSIC 6 months ago 3 minutes, 26 seconds 9,431 views",Admas Music,9431,9515,84
52,"Izack Ft Ras Yared - Yemaneshe | የማነሽ - New Ethiopian Music 2021 by ADMAS MUSIC 6 months ago 2 minutes, 58 seconds 8,189 views",Admas Music,8189,8273,84
53,"Daniel Estifanos - Aboy | ኣቦይ - New Eritrean Music 2021 by ADMAS MUSIC 7 months ago 5 minutes, 34 seconds 40,585 views",Admas Music,40585,40750,165
54,"Kifle Berhe - Kohayiney Adey | ቆሓይነይ ዓደይ - New Eritrean Music 2021 by ADMAS MUSIC 7 months ago 8 minutes, 54 seconds 71,367 views",Admas Music,71367,71772,405
55,"Mogos Teklit (Wedi Zager) - Ezi Weledo | እዚ ወለዶ - New Eritrean Music 2021 by ADMAS MUSIC 7 months ago 6 minutes, 14 seconds 19,783 views",Admas Music,19783,19969,186
56,"BIRUK JANE (KIRA) feat BEK - EMEGNIGN | እመኚኝ - New Ethiopian Music 2021 by ADMAS MUSIC 7 months ago 4 minutes, 1 second 47,650 views",Admas Music,47650,50123,2473
57,"Ferow feat Hagos Berhane - Love All - New Eritrean Music 2021 by ADMAS MUSIC 7 months ago 3 minutes, 55 seconds 35,016 views",Admas Music,35016,35104,88
58,"Dawit Kahsay - Haliwiley | ሃልውለይ - Eritrean Music 2021 by ADMAS MUSIC 8 months ago 5 minutes, 16 seconds 10,048 views",Admas Music,10048,10097,49
59,"Kidane Tesefaye - Selamey | ሰላመይ - Ethiopian Music by ADMAS MUSIC 8 months ago 4 minutes, 29 seconds 18,136 views",Admas Music,18136,18215,79
60,"Koang Bol Luak - Gambella Ejuale Tungker Nyaang | Ethiopian Music 2021 by ADMAS MUSIC 8 months ago 5 minutes, 43 seconds 8,134 views",Admas Music,8134,8234,100
61,"Ghebrebirhan Fishaye - Bealti Bar | ብዓል'ቲ ባር - Eritrean Music 2021 by ADMAS MUSIC 8 months ago 4 minutes, 40 seconds 82,299 views",Admas Music,82299,82691,392
62,"Florida Weldu - Nea Temeles | ንዓ ተመለስ - Eritrean Music 2021 by ADMAS MUSIC 8 months ago 5 minutes, 15 seconds 1,496,787 views",Admas Music,1496787,1512329,15542
63,"Yalew Anley (Tyger)  - Fikreaddis | ፍቅራዲስ - New Ethiopian Music 2021 by ADMAS MUSIC 9 months ago 5 minutes, 13 seconds 40,157 views",Admas Music,40157,40229,72
64,"Yalew Anley (Tyger) - Neway | ነዋይ - New Ethiopian Music 2021 by ADMAS MUSIC 9 months ago 6 minutes, 1 second 7,281 views",Admas Music,7281,7330,49
65,"Yalew Anley (Tyger) - Mnew | ምነው - New Ethiopian Music 2021 by ADMAS MUSIC 9 months ago 5 minutes, 19 seconds 7,226 views",Admas Music,7226,7370,144
66,"Yalew Anley (Tyger) - Ay Wubet | አይ ዉበት - New Ethiopian Music 2021 by ADMAS MUSIC 9 months ago 5 minutes, 48 seconds 7,630 views",Admas Music,7630,7687,57
67,"Yalew Anley (Tyger) - Entewawek | እንተዋወቅ - New Ethiopian Music 2021 by ADMAS MUSIC 9 months ago 5 minutes, 44 seconds 11,901 views",Admas Music,11901,12007,106
68,"Yalew Anley (Tyger) - Kalkidan | ቃልኪዳን - New Ethiopian Music 2021 by ADMAS MUSIC 9 months ago 5 minutes, 24 seconds 15,076 views",Admas Music,15076,15265,189
69,"Yalew Anley (Tyger) - Melsegn | መልሰኝ - New Ethiopian Music 2021 by ADMAS MUSIC 9 months ago 7 minutes, 26 seconds 5,504 views",Admas Music,5504,5559,55
70,"Yalew Anley (Tyger) - Mnale | ምናለ - New Ethiopian Music 2021 by ADMAS MUSIC 9 months ago 4 minutes, 2 seconds 5,448 views",Admas Music,5448,5514,66
71,"Yalew Anley (Tyger) - Ewedeshalhu | እወድሻለሁ - New Ethiopian Music 2021 by ADMAS MUSIC 9 months ago 4 minutes, 23 seconds 7,059 views",Admas Music,7059,7116,57
72,"Yalew Anley (Tyger) - Jobiraw | ጆቢራው - New Ethiopian Music 2021 by ADMAS MUSIC 9 months ago 4 minutes, 46 seconds 4,149 views",Admas Music,4149,4171,22
73,"Yalew Anley (Tyger) - Ethio Eritrea | ኢትዮ ኤርትራ - New Ethiopian Music 2021 by ADMAS MUSIC 9 months ago 4 minutes, 4 seconds 6,064 views",Admas Music,6064,6090,26
74,"Yalew Anley (Tyger) - Yene Akalat | የኔ አከላት - New Ethiopian Music 2021 by ADMAS MUSIC 9 months ago 4 minutes, 42 seconds 9,914 views",Admas Music,9914,9995,81
75,"Yalew Anley (Tyger) - Fitawerari | ፊታውራሪ - New Ethiopian Music 2021 by ADMAS MUSIC 9 months ago 5 minutes, 42 seconds 8,539 views",Admas Music,8539,8606,67
76,"Rodas Workiye (Rodiyano) - Hela Hola (Official Video) | Ethiopian Music by ADMAS MUSIC 9 months ago 5 minutes, 41 seconds 18,614 views",Admas Music,18614,18726,112
77,"Tesfalidet Simon - Adiena (Remix) | Eritrean Music by ADMAS MUSIC 9 months ago 4 minutes, 23 seconds 60,331 views",Admas Music,60331,60989,658
78,"Nahom Teshale  - Aytichekiniley (Official Video) | Eritrean Music by ADMAS MUSIC 9 months ago 5 minutes, 57 seconds 22,300 views",Admas Music,22300,22389,89
79,"Mewded Kibru - Dagu (Official Video) | Ethiopian Music by ADMAS MUSIC 9 months ago 5 minutes, 1 second 19,734 views",Admas Music,19734,19941,207
80,"Teame Weldemichael - Kemey Aleki (Official Audio) | Eritrean Music by ADMAS MUSIC 9 months ago 5 minutes, 43 seconds 55,615 views",Admas Music,55615,55838,223
81,"Embeba Shishay - Fanusey (Official Video) | Eritrean Music by ADMAS MUSIC 10 months ago 5 minutes, 7 seconds 86,184 views",Admas Music,86184,86365,181
82,"Merhawi Haile - Kemaki Yelen (Official Video) | Eritrean Music by ADMAS MUSIC 10 months ago 5 minutes, 39 seconds 78,670 views",Admas Music,78670,78913,243
83,"Noh Simon - Kinirakeb Ena (Official Video) | Eritrean Music by ADMAS MUSIC 10 months ago 4 minutes, 43 seconds 14,383 views",Admas Music,14383,14458,75
84,"Getu Tasew - Awawale (Official Video) | Ethiopian Music by ADMAS MUSIC 10 months ago 5 minutes, 42 seconds 7,163 views",Admas Music,7163,7225,62
85,"Tewodros Kassahun - Amert (Official Video) | Ethiopian Music by ADMAS MUSIC 10 months ago 5 minutes, 44 seconds 16,777 views",Admas Music,16777,17102,325
86,"Bereket Hailemichael - Sur Hade Libi (Official Video) | Eritrean Music by ADMAS MUSIC 10 months ago 6 minutes, 30 seconds 109,859 views",Admas Music,109859,109954,95
87,"Hadgu Aradom - Telam (Official Video) | Eritrean Music by ADMAS MUSIC 10 months ago 4 minutes, 19 seconds 13,732 views",Admas Music,13732,13785,53
88,"Mengisteab Gebregergish - Deki Erey (Official Video) | Eritrean Music by ADMAS MUSIC 10 months ago 6 minutes, 28 seconds 163,184 views",Admas Music,163184,163459,275
89,"Temesgen Bazigar - Entay Teazibka (Official Video) | Eritrean Music by ADMAS MUSIC 10 months ago 5 minutes, 38 seconds 282,361 views",Admas Music,282361,282670,309
90,"Merkeb Bonitua - Gujimjim (Official Video) | Tigray Music by ADMAS MUSIC 10 months ago 5 minutes, 31 seconds 1,519,540 views",Admas Music,1519540,1527763,8223
91,"Seare Debesay - Gudam | ጉዳም - New Eritrean Music 2021 by ADMAS MUSIC 11 months ago 5 minutes, 33 seconds 814,261 views",Admas Music,814261,828192,13931
92,"Veronica Solomon - Tesfa Aleni (Official Video) | Eritrean Music by ADMAS MUSIC 11 months ago 5 minutes, 18 seconds 17,838 views",Admas Music,17838,17922,84
93,"Znabu Kiros - Kidikiro (Official Video) | Tigray Music by ADMAS MUSIC 11 months ago 3 minutes, 59 seconds 38,710 views",Admas Music,38710,38787,77
94,"Daniel Gilay - Lbona Fikri (Official Video) | Eritrean Music by ADMAS MUSIC 11 months ago 5 minutes, 5 seconds 27,667 views",Admas Music,27667,27723,56
95,"Berhe Amare - Kihdet (Official Video) | Ethiopian Tigrigna Music by ADMAS MUSIC 1 year ago 5 minutes, 26 seconds 75,360 views",Admas Music,75360,75530,170
96,"Asmerom Abraham - Kidiyo (Official Video) | Eritrean Music by ADMAS MUSIC 1 year ago 5 minutes, 49 seconds 47,375 views",Admas Music,47375,47414,39
97,"Frezer Kenaw (Babi) - Welo Mejen (Official Video) - Ethiopian Music by ADMAS MUSIC 1 year ago 6 minutes, 14 seconds 3,750,629 views",Admas Music,3750629,3864497,113868
98,"Teddy K - Kedamawit (Official Video) | Ethiopian Music by ADMAS MUSIC 1 year ago 4 minutes, 6 seconds 9,625 views",Admas Music,9625,9674,49
99,"Filmon Kesete - Qendey (Official Video) | Eritrean Music by ADMAS MUSIC 1 year ago 5 minutes, 6 seconds 20,572 views",Admas Music,20572,20603,31
100,"Filmon Michael - Nhder (Official Video) | Eritrean Music by ADMAS MUSIC 1 year ago 4 minutes, 28 seconds 10,561 views",Admas Music,10561,10577,16
101,"Buze Man (Buzayehu Kifle) - Anleyayim (Official Video) | Ethiopian Music by ADMAS MUSIC 1 year ago 4 minutes, 8 seconds 175,407 views",Admas Music,175407,176538,1131
102,"Hermon Tesfalidet - Nieruna'yu (Official Video) | Eritrean Music by ADMAS MUSIC 1 year ago 4 minutes, 44 seconds 32,221 views",Admas Music,32221,32273,52
103,"Rezene Teame - Meteazazebi (Official Audio) | Ethiopian Tigrigna Music by ADMAS MUSIC 1 year ago 4 minutes, 30 seconds 61,738 views",Admas Music,61738,61884,146
104,"Samuel Elias - Abelo ti Feqri (Official Video) | Eritrean Music by ADMAS MUSIC 1 year ago 4 minutes, 58 seconds 43,379 views",Admas Music,43379,43438,59
105,"Kaleab Ghebremariam - Afqire (Official Video) | Eritrean Music by ADMAS MUSIC 1 year ago 4 minutes, 9 seconds 23,180 views",Admas Music,23180,23235,55
106,"Thomas Ghebrehiwet - Kidi (Official Video) | Eritrean Music by ADMAS MUSIC 1 year ago 5 minutes, 1 second 97,357 views",Admas Music,97357,97416,59
107,"Alex Kaleab - Lela Agegnew (Official Video) | Ethiopian Music by ADMAS MUSIC 1 year ago 4 minutes, 18 seconds 21,666 views",Admas Music,21666,21721,55
108,"Sem Oqbakader - Tezarebi | ተዛረቢ (Official Video) - Eritrean Music by ADMAS MUSIC 1 year ago 4 minutes, 41 seconds 20,673 views",Admas Music,20673,20706,33
109,"SEWI - Endeza New | እንደዛ ነው (Official Video) - Ethiopian Music by ADMAS MUSIC 1 year ago 4 minutes, 1 second 18,135 views",Admas Music,18135,18195,60
110,"Simon Goitom - Brey | ብረይ (Official Video) - Eritrean Music by ADMAS MUSIC 1 year ago 4 minutes, 46 seconds 26,848 views",Admas Music,26848,26905,57
111,"Rahel Atakilti - Zeyteblechlich Werqi | ዘይተብለጭልጭ ወርቂ (Official Video) - Eritrean Music by ADMAS MUSIC 1 year ago 3 minutes, 52 seconds 36,897 views",Admas Music,36897,36965,68
112,"Awet Habtegergish - Zeytxbitey | ዘይትጽቢተይ (Official Video) - Eritrean Music by ADMAS MUSIC 1 year ago 5 minutes, 8 seconds 23,287 views",Admas Music,23287,23388,101
113,"Abdi Jemal - SIDAAMITI FAAYYA | ሲዳሚቲ ፋያ - Ethiopian Music by ADMAS MUSIC 1 year ago 5 minutes, 40 seconds 43,255 views",Admas Music,43255,44367,1112
114,"Daniel Zewdu - Hunelegn Dehna (Official Video) | Ethiopian Music | ሁኝልኝ ደህና በ ዳንኤል ዘውዱ by ADMAS MUSIC 1 year ago 4 minutes, 43 seconds 76,056 views",Admas Music,76056,77266,1210
115,"Dawit Kesete - Selsela (Official Video) | Eritrean Music by ADMAS MUSIC 1 year ago 4 minutes, 36 seconds 33,904 views",Admas Music,33904,33935,31
116,"Yohanna Ghirmai - Telam Aykonkun (Official Video) | Eritrean Music by ADMAS MUSIC 1 year ago 6 minutes, 10 seconds 73,766 views",Admas Music,73766,73843,77
117,"Welday Measho - Wereki Semie (Official Video) | Eritrean Music by ADMAS MUSIC 1 year ago 5 minutes, 17 seconds 44,738 views",Admas Music,44738,44779,41
118,"Winta Berhane - Amel (Official Video) | Ethiopian Tigrigna Music by ADMAS MUSIC 1 year ago 4 minutes, 27 seconds 1,735,741 views",Admas Music,1735741,1744259,8518
119,"Adam Major - Mesiluwa (Official Video) | Eritrean Music by ADMAS MUSIC 1 year ago 8 minutes, 36 seconds 99,527 views",Admas Music,99527,99619,92
120,"Isaias Beyene - Gizena (Official Video) | Eritrean Music by ADMAS MUSIC 1 year ago 6 minutes, 4 seconds 106,869 views",Admas Music,106869,106896,27
121,"Petros Russom - Welelo (Official Video) | Eritrean Music by ADMAS MUSIC 1 year ago 5 minutes, 40 seconds 45,770 views",Admas Music,45770,45831,61
122,"Filmon Tesfay - Tedebise'ye (Official Video) | Eritrean Music by ADMAS MUSIC 1 year ago 4 minutes, 33 seconds 37,013 views",Admas Music,37013,37063,50
123,"Mekonen Tadis - Welelay (Official Video) | Ethiopian Tigrigna Music by ADMAS MUSIC 1 year ago 5 minutes, 20 seconds 22,625 views",Admas Music,22625,22666,41
124,"Fortuna Yihdego - Muqur Qanza (Official Video) | Eritrean Music by ADMAS MUSIC 1 year ago 4 minutes, 41 seconds 49,498 views",Admas Music,49498,49598,100
125,"Robel Gebrehannes - Met'ayitey (Official Video) | Eritrean Music by ADMAS MUSIC 1 year ago 5 minutes, 49 seconds 153,778 views",Admas Music,153778,153818,40
126,"Tamrat Amare - Zemene 'Tay (Official Video) | Ethiopian Tigrigna Music by ADMAS MUSIC 1 year ago 4 minutes, 5 seconds 35,610 views",Admas Music,35610,35660,50
127,"Bahta Kiros - Nbeyney (Official Video) | Eritrean Music by ADMAS MUSIC 1 year ago 6 minutes, 22 seconds 52,365 views",Admas Music,52365,52410,45
128,"Robel Okbay - Be Lomi Aytemariri (Official Music) | Eritrean Music by ADMAS MUSIC 1 year ago 4 minutes, 36 seconds 79,183 views",Admas Music,79183,79212,29
129,"Biniam Negasi - Nay Edki Rkebi (Official Video) | Eritrean Music by ADMAS MUSIC 1 year ago 4 minutes, 39 seconds 116,521 views",Admas Music,116521,116601,80
130,"Teame Weldemichael - Zihisheni Do Tefiuni (Official Video) | Eritrean Music by ADMAS MUSIC 1 year ago 5 minutes, 19 seconds 391,110 views",Admas Music,391110,391480,370
131,"Ephrem Amare - RORA (Official Video) | Ethiopian Tigrigna Music by ADMAS MUSIC 1 year ago 5 minutes, 15 seconds 9,147,651 views",Admas Music,9147651,9209906,62255
132,"Filmon Solomon - Samru (Official Video) | Eritrean Music by ADMAS MUSIC 1 year ago 5 minutes, 57 seconds 146,814 views",Admas Music,146814,146885,71
133,"Kibrom Tekleweyni - Ati Birey (Official Video) | Ethiopian Tigrigna Music by ADMAS MUSIC 1 year ago 5 minutes, 12 seconds 51,483 views",Admas Music,51483,51525,42
134,"DELYEYA - YONI T TAP x HELTON TEWOLD x ALU WALIKE x ANGAMAN (Official Music Video) by ADMAS MUSIC 1 year ago 3 minutes, 49 seconds 20,615 views",Admas Music,20615,20637,22
135,"Teame Adhanom - Teteasi (Official Video) | Eritrean Music by ADMAS MUSIC 1 year ago 6 minutes, 10 seconds 109,909 views",Admas Music,109909,109964,55
136,"Hanibal Gebrezgi - Tebelatsit (Official Video) | Eritrean Music by ADMAS MUSIC 1 year ago 5 minutes, 23 seconds 17,675 views",Admas Music,17675,17700,25
137,"African Ali - Fyorina (Official Video) | Ethiopian Tigrigna and Afar Music by ADMAS MUSIC 1 year ago 4 minutes, 38 seconds 77,304 views",Admas Music,77304,77596,292
138,"Samuel Negash - Bkidan Kidibes (Official Music) | Eritrean Music by ADMAS MUSIC 1 year ago 5 minutes, 50 seconds 24,843 views",Admas Music,24843,24863,20
139,"Tesfay Beyene - Awideya (Official Video) | Ethiopian Tigrigna Music by ADMAS MUSIC 1 year ago 4 minutes, 21 seconds 21,431 views",Admas Music,21431,21495,64
140,"Asgedom Tewelde - Welfi Gieruley (Official Video) | Eritrean Music by ADMAS MUSIC 1 year ago 5 minutes, 4 seconds 29,231 views",Admas Music,29231,29262,31
141,"Aron Tadesse - Nafikot (Official Video) | Eritrean Music by ADMAS MUSIC 1 year ago 6 minutes, 29 seconds 20,539 views",Admas Music,20539,20566,27
142,"Reshan Gebre - Embebay (Official Video) | Ethiopian Tigrigna Music by ADMAS MUSIC 1 year ago 5 minutes, 41 seconds 25,097 views",Admas Music,25097,25139,42
143,"Merhawi Kibrom - Telimu Aytibelini (Official Video) | Eritrean Music by ADMAS MUSIC 1 year ago 4 minutes, 37 seconds 44,153 views",Admas Music,44153,44214,61
144,"Zerihun Alemayehu - Nafekot feat. Mekdes Teshome - Ethiopian Music by ADMAS MUSIC 1 year ago 5 minutes, 49 seconds 17,112 views",Admas Music,17112,17165,53
145,"Alemtsehay Russom - Enquae Kesebkuka | እንኳዕ ከሰብኩኻ - Eritrean Music by ADMAS MUSIC 1 year ago 5 minutes, 47 seconds 11,874 views",Admas Music,11874,11904,30
146,"Rahel Tsegay - Serihkaley | ሰሪሕካለይ - Ethiopian Tigrigna Music by ADMAS MUSIC 1 year ago 5 minutes, 24 seconds 135,634 views",Admas Music,135634,135728,94
147,"Halewat Hagos - Abay | ዓባይ - Ethiopian Music (Lyrics Video) by ADMAS MUSIC 1 year ago 4 minutes, 32 seconds 26,243 views",Admas Music,26243,26352,109
148,"Fitsum Teklebrhan - Sefleltkhun Yma | ሰፍለልትኹን ይማ - Eritrean Music by ADMAS MUSIC 1 year ago 5 minutes, 27 seconds 30,870 views",Admas Music,30870,30911,41
149,"Daniel Tedros (Ariva) - Ktmelseni'ya | ክትመልሰኒ'ያ - Eritrean Music by ADMAS MUSIC 1 year ago 6 minutes, 13 seconds 76,314 views",Admas Music,76314,76384,70
150,"Komander Kedir - Kuniley | ኩንለይ - Ethiopian Tigrigna Music by ADMAS MUSIC 1 year ago 4 minutes, 33 seconds 45,184 views",Admas Music,45184,45215,31
151,"Fana Abraha - Ahlimeni (Official Video) | Eritrean Music by ADMAS MUSIC 1 year ago 3 minutes, 59 seconds 840,291 views",Admas Music,840291,841597,1306
152,"Kudus Kibreab - Dawine (Official Video) | Eritrean Music by ADMAS MUSIC 1 year ago 6 minutes, 18 seconds 72,426 views",Admas Music,72426,72466,40
153,"DJ Ashu Ethio - Ashikidim - Ethiopian Tigrigna Music by ADMAS MUSIC 1 year ago 3 minutes, 54 seconds 71,613 views",Admas Music,71613,71900,287
154,"Tareken Lencha - Misi Misi - Ethiopian Music by ADMAS MUSIC 1 year ago 4 minutes, 45 seconds 19,759 views",Admas Music,19759,19956,197
155,"Habtom & Temesgen Wanalewa (Official Video) Eritrean Music. by ADMAS MUSIC 1 year ago 3 minutes, 53 seconds 23,449 views",Admas Music,23449,23458,9
156,"Habtom Asmerom Alemey (Official Video) Eritrean Music. by ADMAS MUSIC 1 year ago 4 minutes, 20 seconds 29,641 views",Admas Music,29641,29669,28
157,"Weyni Tekle Cobra (Official Video) Eritrean Music. by ADMAS MUSIC 1 year ago 4 minutes, 49 seconds 89,414 views",Admas Music,89414,89450,36
158,"Rodas Workiye - Yayeshala (Official Video) | Ethiopian Music by ADMAS MUSIC 1 year ago 5 minutes, 4 seconds 56,807 views",Admas Music,56807,56846,39
159,"Znabu Kiros - Halwlna (Official Video) | Ethiopian Music [Tigrigna] by ADMAS MUSIC 1 year ago 4 minutes, 51 seconds 91,097 views",Admas Music,91097,91176,79
160,"Feruz Kesete - Ayney (Official Video) | Eritrean Music by ADMAS MUSIC 1 year ago 5 minutes, 24 seconds 100,925 views",Admas Music,100925,100971,46
161,"Biniam Okbagaber (Chapin) Tizikiriyo'do (Official Video) Eritrean Music by ADMAS MUSIC 1 year ago 5 minutes, 17 seconds 718,587 views",Admas Music,718587,721080,2493
162,"Negassi Merexe (Sasi) Bgezana Maedo (Official Video) Eritrean Music by ADMAS MUSIC 1 year ago 5 minutes, 10 seconds 112,649 views",Admas Music,112649,112678,29
163,"Embeba Shishay - Gombeley (Official Video) | Eritrean Music by ADMAS MUSIC 1 year ago 6 minutes, 5 seconds 83,594 views",Admas Music,83594,83627,33
164,"Hermon Gebrehiwot - Nitsewawer (Official Video) | Eritrean Music by ADMAS MUSIC 1 year ago 5 minutes, 16 seconds 37,158 views",Admas Music,37158,37183,25
165,"Awet Alem (Wedi Alem) - Tederbishe (Official Video) | Eritrean Music by ADMAS MUSIC 1 year ago 5 minutes, 42 seconds 78,280 views",Admas Music,78280,78322,42
166,"Rahwa Gali - Seameni (Official Video) | Ethiopian Music (Tigrigna) by ADMAS MUSIC 1 year ago 4 minutes, 2 seconds 314,707 views",Admas Music,314707,315223,516
167,"Bereket Demewez - Wan'tayle ft. DJ Sami (Official Video) | Ethiopian Tigrigna Hip Hop Music by ADMAS MUSIC 1 year ago 5 minutes, 48 seconds 33,101 views",Admas Music,33101,33234,133
168,"DJ Weni - Aykemaye (Official Video) | Ethiopian Tigrinya Music by ADMAS MUSIC 1 year ago 4 minutes, 22 seconds 50,515 views",Admas Music,50515,50546,31
169,"Nebyat Tesfay - Kem Dilayey (Official Video) | Eritrean Music by ADMAS MUSIC 1 year ago 4 minutes, 23 seconds 267,329 views",Admas Music,267329,267591,262
170,"Gezai Fitwi - Aynatan (Official Video) | Ethiopian Tigrinya Music by ADMAS MUSIC 1 year ago 4 minutes, 57 seconds 446,737 views",Admas Music,446737,448190,1453
171,"Luwam Gebrelibanos - Qanza (Official Video) | Eritrean Music by ADMAS MUSIC 1 year ago 6 minutes, 38 seconds 40,664 views",Admas Music,40664,40702,38
172,"Wedi Nazu - Zan Zan (Official Video) | Eritrean Music by ADMAS MUSIC 1 year ago 5 minutes, 21 seconds 166,152 views",Admas Music,166152,166538,386
173,"Dawit Mantile - Alilalom (Official Video) Ethiopian Tigrinya Music by ADMAS MUSIC 1 year ago 6 minutes, 53 seconds 61,855 views",Admas Music,61855,61918,63
174,"Werkneh Addisu - Mihretka Habena (Lyrics Video) | Ethiopian Tigrigna Music by ADMAS MUSIC 1 year ago 5 minutes, 27 seconds 20,362 views",Admas Music,20362,20376,14
175,"Amanuel Yemane - Ghize (Lyrics Video) feat Shewit Mezgebo | Ethiopian Tigrigna Music by ADMAS MUSIC 1 year ago 5 minutes, 6 seconds 1,753,067 views",Admas Music,1753067,1765811,12744
176,"Ella Man - Rak (Official Video) | Ethiopian Music by ADMAS MUSIC 1 year ago 4 minutes, 1 second 61,778 views",Admas Music,61778,61838,60
177,"Teame Weldemichael - Welel (Official Video) | Eritrean Music by ADMAS MUSIC 1 year ago 4 minutes, 4 seconds 181,472 views",Admas Music,181472,181647,175
178,"Eseyas Okbay - Aytegayeshkun (Official Video) | Eritrean Music by ADMAS MUSIC 1 year ago 4 minutes, 40 seconds 97,442 views",Admas Music,97442,97578,136
179,"Teklit Teame - Beka (Official Video) | Ethiopian Tigrigna Music by ADMAS MUSIC 2 years ago 4 minutes, 6 seconds 40,678 views",Admas Music,40678,40692,14
180,"Afewerki Gebrekidan - Qedawit (Official Video) | Ethiopian Tigrigna Music by ADMAS MUSIC 2 years ago 5 minutes, 15 seconds 64,805 views",Admas Music,64805,64847,42
181,"Felly Nova - Ney Ney Oropop (Official Video) | Ethiopian Music by ADMAS MUSIC 2 years ago 3 minutes, 15 seconds 8,273 views",Admas Music,8273,8287,14
182,"Kuku Antutu - Kondorana Mayda (Official Video) | Eritrean Music (Kunama) by ADMAS MUSIC 2 years ago 6 minutes, 10 seconds 134,910 views",Admas Music,134910,135304,394
183,"Abel Getahun - JABEL (Full Album) | Ethiopian Music by ADMAS MUSIC 2 years ago 1 hour, 2 minutes 9,112 views",Admas Music,9112,9126,14
184,"Mulugeta Gebreselassie - Gibd Maedo (Official Video) - Ethiopian Erob Music by ADMAS MUSIC 2 years ago 6 minutes, 49 seconds 57,995 views",Admas Music,57995,58185,190
185,"Niyat Kidane - Nabey'ye Zebilo (Official Video) | Eritrean Music by ADMAS MUSIC 2 years ago 5 minutes, 40 seconds 136,989 views",Admas Music,136989,137104,115
186,"Yohanna E. - Love On Me (Official Video) | Eritrean Music by ADMAS MUSIC 2 years ago 3 minutes, 16 seconds 120,299 views",Admas Music,120299,120344,45
187,"Meron Mulgeta (Maryo) - Beka Yiakleni (Official Video) | Eritrean Music by ADMAS MUSIC 2 years ago 5 minutes, 7 seconds 55,185 views",Admas Music,55185,55219,34
188,"Yosef Kidane - Shita Rihan (Official Video) | Eritrean Music by ADMAS MUSIC 2 years ago 5 minutes, 16 seconds 43,095 views",Admas Music,43095,43128,33
189,"Betelihem Abraha - Timnitey (Official Video) | Ethiopian Tigrigna Music by ADMAS MUSIC 2 years ago 5 minutes, 10 seconds 31,161 views",Admas Music,31161,31191,30
190,"Meaza Yohannes - Qelbey (Official Video) | Ethiopian Tigrigna Music by ADMAS MUSIC 2 years ago 5 minutes, 34 seconds 127,267 views",Admas Music,127267,127547,280
191,"Alem Gebreanenia - Neger Fikri (Official Video) | Ethiopian Tigrigna Music by ADMAS MUSIC 2 years ago 3 minutes, 30 seconds 60,002 views",Admas Music,60002,60070,68
192,"Yoel Berhane (Ela) - Beli'ba (Official Video) | Eritrean Music by ADMAS MUSIC 2 years ago 3 minutes, 49 seconds 101,588 views",Admas Music,101588,101721,133
193,"Mehari Tekie (Bella) - Tihibeni'la (Official Video) | Eritrean Music by ADMAS MUSIC 2 years ago 5 minutes, 34 seconds 73,754 views",Admas Music,73754,73779,25
194,"Tekle Tesfagergish (Wedi Reqak) - Zikriki (Official Video) | Eritrean Music by ADMAS MUSIC 2 years ago 6 minutes, 45 seconds 44,701 views",Admas Music,44701,44717,16
195,"Abrahaley Kahsay - Men Eki (Official Video) | Eritrean Music by ADMAS MUSIC 2 years ago 5 minutes, 25 seconds 160,024 views",Admas Music,160024,160219,195
196,"Efrem Kinfe - Kef Alewa (Official Video) | Eritrean Music by ADMAS MUSIC 2 years ago 4 minutes, 17 seconds 176,499 views",Admas Music,176499,176558,59
197,"Million MG - Tezarebi (Official Video) | Eritrean Music by ADMAS MUSIC 2 years ago 3 minutes, 40 seconds 19,673 views",Admas Music,19673,19683,10
198,"Esayas Tamrat - Balageru (Official Video) | Ethiopian Music by ADMAS MUSIC 2 years ago 6 minutes, 14 seconds 246,343 views",Admas Music,246343,246744,401
199,"Abraham Tewelde - Mikihti (Official Video) | Eritrean Music by ADMAS MUSIC 2 years ago 5 minutes, 49 seconds 69,882 views",Admas Music,69882,69952,70
200,"Millen Hailu - Aytiwesawes | ኣይትወሳወስ (Official Video) - Eritrean Music by ADMAS MUSIC 2 years ago 4 minutes, 35 seconds 5,148,937 views",Admas Music,5148937,5167756,18819
201,"Temesgen Abraham - Kibur Meninetey (Official Video) | Eritrean Music by ADMAS MUSIC 2 years ago 5 minutes, 9 seconds 62,535 views",Admas Music,62535,62577,42
202,"Alemnesh Yemane - Nisatom (Official Video) | Ethiopian Tigrigna Music by ADMAS MUSIC 2 years ago 5 minutes 253,199 views",Admas Music,253199,253454,255
203,"Mussie Tekle (Tewil) - Awdeamet (Official Video) | Eritrean Music by ADMAS MUSIC 2 years ago 5 minutes, 27 seconds 106,911 views",Admas Music,106911,106999,88
204,"Tesfaye Adugna - Mamarwa (Official Video) | Ethiopian Music by ADMAS MUSIC 2 years ago 5 minutes, 5 seconds 225,639 views",Admas Music,225639,226983,1344
205,"Eseyas Salh (Rasha) - Hewey Ele (Official Video) | Eritrean Music by ADMAS MUSIC 2 years ago 4 minutes, 35 seconds 439,312 views",Admas Music,439312,439959,647
206,"Eden Kesete - Kizirifeka (Official Video) | Eritrean Music by ADMAS MUSIC 2 years ago 5 minutes, 14 seconds 2,653,770 views",Admas Music,2653770,2671491,17721
207,"Mengisteab Gebregergish - Berhan Gezana (Official Video) | Eritrean Music by ADMAS MUSIC 2 years ago 5 minutes, 46 seconds 138,602 views",Admas Music,138602,138729,127
208,"Elham Mohammed - Aytefkirekan'ya (Official Video) | Eritrean Music by ADMAS MUSIC 2 years ago 2 minutes, 59 seconds 591,112 views",Admas Music,591112,592291,1179
209,"Kidane Mussie - Alemey (Official Video) | Eritrean Music by ADMAS MUSIC 2 years ago 4 minutes, 43 seconds 75,310 views",Admas Music,75310,75340,30
210,"Efrem Tesfe - Gobizelki (Official Video) | Eritrean Music by ADMAS MUSIC 2 years ago 6 minutes, 18 seconds 61,161 views",Admas Music,61161,61187,26
211,"Filmon Tesfalem - Tuf Beliyo (Official Video) | Eritrean Music by ADMAS MUSIC 2 years ago 6 minutes, 3 seconds 75,137 views",Admas Music,75137,75153,16
212,"Helen Meles - Meaza (Official Video) | Eritrean Music by ADMAS MUSIC 2 years ago 4 minutes, 30 seconds 2,890,345 views",Admas Music,2890345,2895635,5290
213,"Layne Tadesse - Lovin You (Official Video) | Eritrean Music by ADMAS MUSIC 2 years ago 7 minutes, 38 seconds 40,239 views",Admas Music,40239,40250,11
214,"Mulugeta Weldetinsae - Gual Adey (Official Video) | Eritrean Music by ADMAS MUSIC 2 years ago 6 minutes, 55 seconds 216,176 views",Admas Music,216176,216293,117
215,"Bahta Kiros - Aythazley (Official Video) | Eritrean Music by ADMAS MUSIC 2 years ago 6 minutes, 35 seconds 101,708 views",Admas Music,101708,101736,28
216,"Shewit Mezgebo - Neay Mehasheni (Official Video) | Ethiopian Tigrigna Music by ADMAS MUSIC 2 years ago 4 minutes, 22 seconds 5,460,116 views",Admas Music,5460116,5498522,38406
217,"Fishaye Tesfalem - Nay Fqri Barkot (Official Video) | Eritrean Music by ADMAS MUSIC 2 years ago 4 minutes, 42 seconds 56,731 views",Admas Music,56731,56755,24
218,"Simon Michael - Hasikini (Official Video) | Eritrean Music by ADMAS MUSIC 2 years ago 4 minutes, 7 seconds 37,686 views",Admas Music,37686,37698,12
219,"Saba Andemariam - Ayani (Official Video) | Eritrean Music by ADMAS MUSIC 2 years ago 5 minutes, 14 seconds 2,194,058 views",Admas Music,2194058,2198643,4585
220,"Dawit Tesfatsion - Kemey'le (Official Video) | Eritrean Music by ADMAS MUSIC 2 years ago 5 minutes, 9 seconds 150,803 views",Admas Music,150803,150902,99
221,"Yaru Makaveli X Robel Leul - Kolia Geter (Official Video) | Ethiopian Music by ADMAS MUSIC 2 years ago 4 minutes, 32 seconds 34,421 views",Admas Music,34421,34609,188
222,"Funti - Zenat (Official Video) | Eritrean Music by ADMAS MUSIC 2 years ago 4 minutes, 4 seconds 54,093 views",Admas Music,54093,54123,30
223,"Abraham Haile - Ruteye (Official Video) | Eritrean Music by ADMAS MUSIC 2 years ago 3 minutes, 45 seconds 74,176 views",Admas Music,74176,74208,32
224,"Simon Neguse - Zondoy (Official Video) | Eritrean Music by ADMAS MUSIC 2 years ago 5 minutes, 22 seconds 19,917 views",Admas Music,19917,19926,9
225,"Kibreab Shewit - Ajoki (Official Video) | Eritrean Music by ADMAS MUSIC 2 years ago 4 minutes, 46 seconds 32,611 views",Admas Music,32611,32628,17
226,"Gebreleul Afwerki - Maemiuni'lo (Official Video) | Eritrean Music by ADMAS MUSIC 2 years ago 7 minutes, 3 seconds 334,326 views",Admas Music,334326,334483,157
227,"Tesfu Rezene - Msay Aleki'do (Official Video) | Eritrean Music by ADMAS MUSIC 2 years ago 4 minutes, 32 seconds 32,136 views",Admas Music,32136,32162,26
228,"Zemichael Daniel - Ab Sdet'ye Zeleku (Official Video) | Eritrean Music by ADMAS MUSIC 2 years ago 6 minutes, 49 seconds 39,398 views",Admas Music,39398,39413,15
229,"Temesgen Zegeye - Behilmey Yigbero (Official Video) | Ethiopian Tigrigna Music by ADMAS MUSIC 2 years ago 5 minutes, 15 seconds 55,519 views",Admas Music,55519,55606,87
230,"Ebrahim Bushra - Zeysqoro (Official Video) | Eritrean Music by ADMAS MUSIC 2 years ago 6 minutes, 6 seconds 134,924 views",Admas Music,134924,134986,62
231,"Sennay Hadgu - Ab Mijimarna (Official Video) | Eritrean Music by ADMAS MUSIC 2 years ago 4 minutes, 59 seconds 117,586 views",Admas Music,117586,117648,62
232,"Teddy Hentsa - Muruk Gerkni (Official Audio) | Eritrean Music 2019 by ADMAS MUSIC 2 years ago 4 minutes, 36 seconds 19,050 views",Admas Music,19050,19055,5
233,"Black Note Ethiopia - Hod Yifjew (Official Video) | Ethiopian Music 2019 by ADMAS MUSIC 2 years ago 3 minutes, 34 seconds 13,645 views",Admas Music,13645,13667,22
234,"Daniel Kahase - Yimechiki (Official Video) | Ethiopian Tigrigna Music 2019 by ADMAS MUSIC 2 years ago 4 minutes, 4 seconds 32,210 views",Admas Music,32210,32227,17
235,"Zenawi Hailemariam - Mamaye (Official Video) | Ethiopian Tigrigna Music by ADMAS MUSIC 2 years ago 4 minutes, 1 second 1,686,992 views",Admas Music,1686992,1692064,5072
236,"Salem Welday - Asanabiteni (Official Video) | Eritrean Music by ADMAS MUSIC 2 years ago 5 minutes, 23 seconds 282,348 views",Admas Music,282348,282466,118
237,"Selamawit Kelelom - Siyomay (Official Video) | Ethiopian Tigrigna Music by ADMAS MUSIC 2 years ago 3 minutes, 54 seconds 73,799 views",Admas Music,73799,73857,58
238,"Senait Amine - Mear Afu (Official Video) | Eritrean Music by ADMAS MUSIC 2 years ago 4 minutes, 29 seconds 723,201 views",Admas Music,723201,724364,1163
239,"Filmon Berhane - Zeytmno (Official Video) | Eritrean Music by ADMAS MUSIC 2 years ago 5 minutes, 51 seconds 77,864 views",Admas Music,77864,77909,45
240,"Dawit Gebremichael - Dgul Fiqri (Official Video) | Eritrean Music by ADMAS MUSIC 2 years ago 5 minutes, 16 seconds 59,138 views",Admas Music,59138,59172,34
241,"Mehari Kiros - Geramito (Official Video) | Ethiopian Tigrigna Music by ADMAS MUSIC 2 years ago 5 minutes 65,837 views",Admas Music,65837,65869,32
242,"Eyerusalem Amde - Lela (Official Video) | Ethiopian Tigrigna Music by ADMAS MUSIC 2 years ago 4 minutes, 21 seconds 1,573,328 views",Admas Music,1573328,1577944,4616
243,"Tadesse Mekete - Iteta (Official Video) | Traditional Ethiopian Music by ADMAS MUSIC 2 years ago 4 minutes, 31 seconds 71,900 views",Admas Music,71900,72422,522
244,"Nehmiya Zeray - Gebete (Official Video) | Eritrean Music by ADMAS MUSIC 2 years ago 4 minutes, 50 seconds 2,751,965 views",Admas Music,2751965,2754829,2864
245,"Awet Teklemariam - Bebeynina (Official Video) | Eritrean Music by ADMAS MUSIC 2 years ago 4 minutes, 11 seconds 193,139 views",Admas Music,193139,193248,109
246,"Meron Russom - Lwamey Habni (Official Video) | Eritrean Music by ADMAS MUSIC 2 years ago 6 minutes, 24 seconds 130,584 views",Admas Music,130584,130615,31
247,"Rahel Haile - Endieley (Official Video) | Ethiopian Tigrigna Music by ADMAS MUSIC 2 years ago 3 minutes, 53 seconds 2,891,318 views",Admas Music,2891318,2897200,5882
248,"Abrehet Abdu - Tsiweyuley (Official Video) | Ethiopian Tigrigna Music by ADMAS MUSIC 2 years ago 7 minutes, 4 seconds 822,897 views",Admas Music,822897,825430,2533
249,"Mehari Arefayne (Wedi Keshi) - Debae [Official Video] | Eritrean Music by ADMAS MUSIC 2 years ago 5 minutes, 10 seconds 55,964 views",Admas Music,55964,55988,24
250,"Dina Anteneh - Honelign (Official Video) | Ethiopian Music by ADMAS MUSIC 2 years ago 5 minutes, 42 seconds 948,988 views",Admas Music,948988,952251,3263
251,"Halewat Hagos - Temeles (Official Video) | Ethiopian Music by ADMAS MUSIC 2 years ago 5 minutes, 41 seconds 123,701 views",Admas Music,123701,123872,171
252,"Dejazmach by Samson Getachew (Official Video) | Ethiopian Music by ADMAS MUSIC 2 years ago 5 minutes, 50 seconds 23,136 views",Admas Music,23136,23150,14
253,"HMEYUNI by Mihreteab Habtegabr (Official Video) | Eritrean Music by ADMAS MUSIC 2 years ago 5 minutes, 11 seconds 132,213 views",Admas Music,132213,132292,79
254,"Tambiqa - Zmam (Official Video) | Ethiopian Tigrigna Music by ADMAS MUSIC 2 years ago 4 minutes, 36 seconds 117,382 views",Admas Music,117382,117539,157
255,"Eden Kesete - Ahdege (Official Video) | Eritrean Music by ADMAS MUSIC 2 years ago 4 minutes, 47 seconds 2,314,053 views",Admas Music,2314053,2317705,3652
256,"Robel Haile - Habeney (Official Video) | Eritrean Music by ADMAS MUSIC 2 years ago 5 minutes, 2 seconds 1,081,580 views",Admas Music,1081580,1083337,1757
257,"Mulu Wubet - Shegawa (Official Video) | Traditional Ethiopian Music by ADMAS MUSIC 2 years ago 5 minutes, 19 seconds 660,794 views",Admas Music,660794,663610,2816
258,"MANALE by Solomon & Mengsteab Ft Dimon (Official Video) | Eritrean Music by ADMAS MUSIC 2 years ago 4 minutes, 29 seconds 184,704 views",Admas Music,184704,185253,549
259,"Atakilti Gezahegn - Alilalom (Official Video) | Ethiopian Tigrigna Music by ADMAS MUSIC 2 years ago 5 minutes, 54 seconds 83,448 views",Admas Music,83448,83543,95
260,"Yohana Solomon (Rubi) - Kitkielo (Official Video) | Eritrean Music by ADMAS MUSIC 2 years ago 3 minutes, 56 seconds 432,805 views",Admas Music,432805,433168,363
261,"Dallak - Endewaza (Official Video) | Ethiopian Music by ADMAS MUSIC 2 years ago 3 minutes, 18 seconds 10,472 views",Admas Music,10472,10485,13
262,"Awet Tesfay - Meskel Agame (Official Video) | Ethiopian Tigrigna Music by ADMAS MUSIC 2 years ago 4 minutes, 45 seconds 158,581 views",Admas Music,158581,158905,324
263,"Gebru Fano - Kiela (Official Video) | Ethiopian Tigrigna Music by ADMAS MUSIC 2 years ago 5 minutes, 26 seconds 834,113 views",Admas Music,834113,835881,1768
264,"Teklit Lilay - Des Yibleni'lo (Official Video) | Eritrean Music by ADMAS MUSIC 2 years ago 6 minutes, 25 seconds 144,347 views",Admas Music,144347,144438,91
265,"Tsega Muche - Je t'aime (Dire) (Official Video) | Ethiopian Music by ADMAS MUSIC 2 years ago 5 minutes, 56 seconds 17,614 views",Admas Music,17614,17636,22
266,"Leul Hailu - Libe Alarfim Ale (Official Video) | Ethiopian Music by ADMAS MUSIC 2 years ago 5 minutes, 16 seconds 102,220 views",Admas Music,102220,102668,448
267,"Melake Abraham - Hadasey (Official Video) | Eritrean Music by ADMAS MUSIC 2 years ago 5 minutes, 36 seconds 845,268 views",Admas Music,845268,846399,1131
268,"Dawit Tekie - Gele Giberi (Official Video) | Eritrean Music by ADMAS MUSIC 2 years ago 4 minutes, 51 seconds 31,816 views",Admas Music,31816,31841,25
269,"Solomon Bayre - Tium Zena (Official Audio) | Ethiopian Tigrigna Music by ADMAS MUSIC 2 years ago 5 minutes, 19 seconds 1,289,775 views",Admas Music,1289775,1301333,11558
270,"Efrem Tsegay - Aminey (Official Video) | Eritrean Music by ADMAS MUSIC 2 years ago 5 minutes, 35 seconds 50,075 views",Admas Music,50075,50103,28
271,"Zafu Kiros - Ashenda (Official Video) | Ethiopian Tigrigna Music by ADMAS MUSIC 2 years ago 7 minutes, 7 seconds 837,599 views",Admas Music,837599,839034,1435
272,"Bezawit Tikue - Ashenda (Official Video) | Ethiopian Tigrigna Music by ADMAS MUSIC 2 years ago 5 minutes, 20 seconds 90,327 views",Admas Music,90327,90362,35
273,"Selomon Gashabe ft Bini Faket - Enen Blesh (Official Video) | Ethiopian Music by ADMAS MUSIC 2 years ago 5 minutes, 3 seconds 23,058 views",Admas Music,23058,23136,78
274,"Tiki G - Jilo (Official Video) | Ethiopian Music by ADMAS MUSIC 2 years ago 4 minutes, 40 seconds 25,553 views",Admas Music,25553,25579,26
275,"Minas Belay - Beyniki Mitsi (Official Video) | Eritrean Music by ADMAS MUSIC 2 years ago 5 minutes, 30 seconds 215,351 views",Admas Music,215351,215481,130
276,"Filmon Tesfalem - Modeley (Official Video) | Eritrean Music by ADMAS MUSIC 2 years ago 6 minutes, 4 seconds 85,584 views",Admas Music,85584,85599,15
277,"Zenawi Yehdego - Yigedeni'lo (Official Video) | Eritrean Music by ADMAS MUSIC 2 years ago 6 minutes, 5 seconds 45,293 views",Admas Music,45293,45313,20
278,"Ariam Zemichael - Tegayishkani (Official Video) | Eritrean Music by ADMAS MUSIC 2 years ago 4 minutes, 29 seconds 400,722 views",Admas Music,400722,401760,1038
279,"Tadele Getachew - Nateye (Official Video) | Ethiopian Amharic and Tigrigna Music by ADMAS MUSIC 2 years ago 4 minutes, 52 seconds 350,797 views",Admas Music,350797,351692,895
280,"Kalkidan Alemu - Mechem (Official Video) | Ethiopian Music by ADMAS MUSIC 2 years ago 4 minutes, 49 seconds 39,843 views",Admas Music,39843,39881,38
281,"Haileab Daru - Yigibea (Official Video) | Eritrean Music by ADMAS MUSIC 2 years ago 4 minutes, 54 seconds 125,155 views",Admas Music,125155,125269,114
282,"Ephrem Amare - Atiyo (Official Video) | Ethiopian Tigrigna Music by ADMAS MUSIC 2 years ago 5 minutes, 5 seconds 18,668,485 views",Admas Music,18668485,18738616,70131
283,"Milat Kidane - Nitearek (Official Video) | Ethiopian Tigrigna Music by ADMAS MUSIC 2 years ago 5 minutes, 52 seconds 113,387 views",Admas Music,113387,113447,60
284,"Michael Yemane (Fetat) - Zendo (Official Video) | Eritrean Music by ADMAS MUSIC 2 years ago 4 minutes, 39 seconds 131,229 views",Admas Music,131229,131671,442
285,"Merhawi Nuru - Ketnafiqeni'ki (Official Video) | Eritrean Music by ADMAS MUSIC 2 years ago 6 minutes, 21 seconds 160,168 views",Admas Music,160168,160194,26
286,"Eritrean Music - Mihreteab Beyene - Hiyabey (Official Video) by ADMAS MUSIC 2 years ago 7 minutes, 32 seconds 65,438 views",Admas Music,65438,65451,13
287,"Helen Gidey - Kem Gele (Official Video) | Ethiopian Tigrigna Music by ADMAS MUSIC 2 years ago 5 minutes, 4 seconds 70,666 views",Admas Music,70666,70752,86
288,"Mahlet Abadi - Nea Telo (Official Video) | Ethiopian Tigrigna Music by ADMAS MUSIC 2 years ago 4 minutes, 49 seconds 142,733 views",Admas Music,142733,142764,31
289,"Wube Girma - Nadohe (Official Video) | Ethiopian Music by ADMAS MUSIC 2 years ago 4 minutes, 45 seconds 55,940 views",Admas Music,55940,56442,502
290,"Sabur Abdu feat. Dawit Mengistu - Elilta | Eritrean & Ethiopian Music by ADMAS MUSIC 2 years ago 4 minutes, 54 seconds 284,910 views",Admas Music,284910,285331,421
291,"Daniel Semere - Adey (Official Video) | Eritrean Music by ADMAS MUSIC 2 years ago 6 minutes, 19 seconds 43,737 views",Admas Music,43737,43763,26
292,"Wedi Kokob - Meseley (Official Video) | Ethiopian Tigrigna Music by ADMAS MUSIC 2 years ago 5 minutes, 18 seconds 2,035,001 views",Admas Music,2035001,2041974,6973
293,"Tesfu Abraha feat  Merab Tesfu - Mekoneney (Official Video) | Eritrean Music by ADMAS MUSIC 2 years ago 5 minutes, 18 seconds 25,508 views",Admas Music,25508,25517,9
294,"Dejen Mengsteab - Yiqkre (Official Video) | Eritrean Music by ADMAS MUSIC 2 years ago 5 minutes, 35 seconds 38,577 views",Admas Music,38577,38590,13
295,"Gebrekristos Teklu (Major) - Tigray Adey | Ethiopian Tigrigna Music by ADMAS MUSIC 2 years ago 5 minutes, 53 seconds 73,666 views",Admas Music,73666,73795,129
296,"Efrem Tesfamichael - Milietey (Official Video) | Eritrean Music by ADMAS MUSIC 2 years ago 5 minutes, 58 seconds 20,584 views",Admas Music,20584,20603,19
297,"Samuel Berhe - Tiebit Qetali'yu (Official Audio) | Eritrean Music by ADMAS MUSIC 2 years ago 4 minutes, 14 seconds 13,631 views",Admas Music,13631,13644,13
298,"Mohammed Sirgaga - And Enehun (Official Video) | Ethiopian Music by ADMAS MUSIC 2 years ago 6 minutes, 1 second 87,264 views",Admas Music,87264,87522,258
299,"Hadish Araya - Kewanitey (Official Video) | Eritrean Music by ADMAS MUSIC 2 years ago 5 minutes, 6 seconds 14,370 views",Admas Music,14370,14378,8
300,"Awet Gebremichael - Fanusey (Official Video) | Eritrean Music by ADMAS MUSIC 2 years ago 4 minutes, 11 seconds 62,232 views",Admas Music,62232,62245,13
301,"Mulugeta Gebreselassie - Kiya Meito (Official Video) | Ethiopian Music by ADMAS MUSIC 2 years ago 5 minutes, 24 seconds 60,415 views",Admas Music,60415,60515,100
302,"Seare Tadesse - Amenzra (Official Video) | Eritrean Music by ADMAS MUSIC 2 years ago 5 minutes, 41 seconds 67,805 views",Admas Music,67805,67825,20
303,"Mikiele Gezzy - Tebzihiyo 'Leki (Official Video) | Ethiopian Tigrigna Music by ADMAS MUSIC 2 years ago 4 minutes, 26 seconds 2,857,534 views",Admas Music,2857534,2865877,8343
304,"Semere Okbamichael - Bsenki Mahazaki (Official Video) | Eritrean Music by ADMAS MUSIC 2 years ago 5 minutes, 10 seconds 90,235 views",Admas Music,90235,90248,13
305,"Wedi Hadera - Kemesgna'ye (Official Video) | Eritrean Music by ADMAS MUSIC 2 years ago 4 minutes, 32 seconds 56,053 views",Admas Music,56053,56082,29
306,"Kisanet Embahuney - Kibur Haw Eyu Simka (Official Video) | Eritrean Music by ADMAS MUSIC 2 years ago 6 minutes, 1 second 138,850 views",Admas Music,138850,138921,71
307,"Yared Mekonnen - Semeshen (Official Video) | Ethiopian Music by ADMAS MUSIC 2 years ago 3 minutes, 39 seconds 53,351 views",Admas Music,53351,53374,23
308,"Freselam Mussie - Mamisa (Official Video) | Eritrean Music by ADMAS MUSIC 2 years ago 5 minutes, 5 seconds 2,053,200 views",Admas Music,2053200,2055447,2247
309,"Alex Nigus ft Bling - Ethiopia Tikdem (Official Video) | Ethiopian Music by ADMAS MUSIC 2 years ago 5 minutes, 3 seconds 127,610 views",Admas Music,127610,128010,400
310,"Bruk Redae - Lbe Anchin Blo (Official Video) | Ethiopian Hip Hop Music by ADMAS MUSIC 2 years ago 3 minutes, 51 seconds 10,258 views",Admas Music,10258,10285,27
311,"Aweke Nure - Lalibela (Official Video) | Ethiopian Music by ADMAS MUSIC 2 years ago 5 minutes, 32 seconds 21,775 views",Admas Music,21775,21794,19
312,"Wedi Yemane - Taesa (Official Video) | Eritrean Music by ADMAS MUSIC 2 years ago 5 minutes, 23 seconds 450,076 views",Admas Music,450076,450268,192
313,"Tekalegn Fekadu - Ete Muna (Official Video) | Ethiopian Music by ADMAS MUSIC 2 years ago 4 minutes, 50 seconds 15,130 views",Admas Music,15130,15143,13
314,"Tikue Woldu - Tigray Milibama (Official Video) | Ethiopian Tigrigna Music by ADMAS MUSIC 2 years ago 6 minutes, 53 seconds 655,370 views",Admas Music,655370,658773,3403
315,"Tirhas Tareke - Tsigabey (Official Video) | Ethiopian Tigrigna Music by ADMAS MUSIC 2 years ago 3 minutes, 56 seconds 1,589,039 views",Admas Music,1589039,1595860,6821
316,"Hayleyesus Damte - Ney Beluat (Official Video) | Ethiopian Music by ADMAS MUSIC 2 years ago 4 minutes, 36 seconds 59,045 views",Admas Music,59045,59109,64
317,"Robel Michael - Aytehteyeni (Official Video) | Eritrean Music by ADMAS MUSIC 2 years ago 6 minutes, 12 seconds 1,796,958 views",Admas Music,1796958,1802782,5824
318,"Shewit Estifanos - Semiru (Official Video) | Eritrean Music by ADMAS MUSIC 2 years ago 4 minutes, 35 seconds 577,135 views",Admas Music,577135,578962,1827
319,"Fafi Mohammed - Anumana (Official Video) | Ethiopian Afar Music by ADMAS MUSIC 2 years ago 4 minutes, 10 seconds 288,728 views",Admas Music,288728,291104,2376
320,"Timnit Welday - Wenani (Official Video) | Ethiopian Tigrigna Music by ADMAS MUSIC 2 years ago 5 minutes, 35 seconds 16,884,048 views",Admas Music,16884048,16954227,70179
321,"Weynshet Amare - Teretahu (Official Video) | Ethiopian Music by ADMAS MUSIC 2 years ago 4 minutes, 56 seconds 38,189 views",Admas Music,38189,38208,19
322,"Endalkachew Fantu - Baregegn (Official Video) | Ethiopian Music by ADMAS MUSIC 2 years ago 4 minutes, 21 seconds 26,879 views",Admas Music,26879,26888,9
323,"Yonas Hailesellasie - Temezeni Eluki (Official Video) | Eritrean Music by ADMAS MUSIC 2 years ago 4 minutes, 14 seconds 34,511 views",Admas Music,34511,34536,25
324,"Eden Kesete - Ngusey (Official Video) | Eritrean Music by ADMAS MUSIC 3 years ago 3 minutes, 58 seconds 2,872,247 views",Admas Music,2872247,2876321,4074
325,"Silvana Samuel - Aytezembiyeni (Official Video) | Ethiopian Tigrigna Music by ADMAS MUSIC 3 years ago 5 minutes, 22 seconds 51,401 views",Admas Music,51401,51423,22
326,"Shime Blacky - Taa Woyigo (Official Video) | Ethiopian Wolayta Music by ADMAS MUSIC 3 years ago 3 minutes, 10 seconds 23,737 views",Admas Music,23737,23780,43
327,"Milen Seyoum - Qurtun Nigeregn (Official Video) | Ethiopian Music by ADMAS MUSIC 3 years ago 4 minutes, 15 seconds 51,695 views",Admas Music,51695,51957,262
328,"Bisrat Surafel - Alena (Official Video) | Ethiopian Music by ADMAS MUSIC 3 years ago 4 minutes, 44 seconds 5,553,593 views",Admas Music,5553593,5564972,11379
329,"Temesgen Bazigar - Mesharewi (Official Video) | Eritrean Music by ADMAS MUSIC 3 years ago 7 minutes, 7 seconds 1,183,016 views",Admas Music,1183016,1183735,719
330,"Znabu Kiros - Keremela (Official Video) | Ethiopian Tigrigna Music by ADMAS MUSIC 3 years ago 4 minutes, 52 seconds 329,272 views",Admas Music,329272,329521,249
331,"Solomon Yazachew - Newr Newr (Official Video) | Ethiopian Music by ADMAS MUSIC 3 years ago 4 minutes, 52 seconds 26,035 views",Admas Music,26035,26098,63
332,"Solomon Haile - Aronay (Official Audio) | Ethiopian Music by ADMAS MUSIC 3 years ago 5 minutes, 19 seconds 855,942 views",Admas Music,855942,857790,1848
333,"Dagmawi X Hermela - Lemeneh Wey (Official Video) | Ethiopian Music by ADMAS MUSIC 3 years ago 4 minutes, 46 seconds 32,500 views",Admas Music,32500,32539,39
334,"Girmawit Tadesse - Nqedem (Official Video) | Ethiopian Tigrigna Music by ADMAS MUSIC 3 years ago 4 minutes, 35 seconds 122,965 views",Admas Music,122965,123168,203
335,"Meaza Yohannes - Qelbey (Official Audio) | Ethiopian Music by ADMAS MUSIC 3 years ago 5 minutes, 12 seconds 58,001 views",Admas Music,58001,58036,35
336,"Bre Shagya - Sierkini (Official Video) | Ethiopian Music by ADMAS MUSIC 3 years ago 5 minutes, 32 seconds 28,273 views",Admas Music,28273,28287,14
337,"Kisanet Megos - Limedo (Official Video) | Eritrean Music by ADMAS MUSIC 3 years ago 4 minutes, 42 seconds 75,654 views",Admas Music,75654,75695,41
338,"Sisco Habesha - Ewedehalehu Beyn (Official Video) | Ethiopian Music by ADMAS MUSIC 3 years ago 3 minutes, 32 seconds 24,148 views",Admas Music,24148,24177,29
339,"Yonas Yemane feat. Feven Tsegay - Koynelki'do (Official Video) | Eritrean Music by ADMAS MUSIC 3 years ago 5 minutes, 34 seconds 95,575 views",Admas Music,95575,95649,74
340,"Temesgen Zegeye - Kemti Zeyele (Official Video) | Ethiopian Tigrigna Music by ADMAS MUSIC 3 years ago 5 minutes, 10 seconds 109,606 views",Admas Music,109606,109781,175
341,"Dereje Delelegn - Alelem (Official Video) | Ethiopian Music by ADMAS MUSIC 3 years ago 5 minutes, 50 seconds 20,464 views",Admas Music,20464,20491,27
342,"Dawit Tesfatsion - Axum Debabey (Official Video) | Eritrean Music by ADMAS MUSIC 3 years ago 5 minutes, 19 seconds 41,760 views",Admas Music,41760,41809,49
343,"Gezish Yana - Siqoo Dere (Official Video) | Ethiopian Wolayta Music by ADMAS MUSIC 3 years ago 5 minutes, 8 seconds 242,961 views",Admas Music,242961,245320,2359
344,"Yoyo - Kanchi Gara (Official Video) | Ethiopian Music by ADMAS MUSIC 3 years ago 4 minutes, 31 seconds 9,702 views",Admas Music,9702,9722,20
345,"Zenebe Welay - Fikriki Leni (Official Video) | Ethiopian Music by ADMAS MUSIC 3 years ago 4 minutes, 11 seconds 44,174 views",Admas Music,44174,44198,24
346,"Jimmy Man feat Lij Abebawu - Hon Bela (Official Video) | Ethiopian Music by ADMAS MUSIC 3 years ago 4 minutes, 49 seconds 25,910 views",Admas Music,25910,25932,22
347,"Tesfay Gidey - Chento (Official Video) | Ethiopian Music by ADMAS MUSIC 3 years ago 6 minutes, 2 seconds 494,620 views",Admas Music,494620,496525,1905
348,"Solomon Weldegergish - Fiqrina Sieru (Official Video) | Eritrean Music by ADMAS MUSIC 3 years ago 5 minutes, 21 seconds 63,506 views",Admas Music,63506,63539,33
349,"Abdu Mohammed - Befiker (Official Video) | Ethiopian Music by ADMAS MUSIC 3 years ago 5 minutes, 4 seconds 15,477 views",Admas Music,15477,15490,13
350,"Amir Dawud - Mekele (Official Video) | Ethiopian Music by ADMAS MUSIC 3 years ago 5 minutes, 49 seconds 661,599 views",Admas Music,661599,665162,3563
351,"Sesu feat Dawit Bekele - Bale Hageru (Official Video) | Ethiopian Music by ADMAS MUSIC 3 years ago 4 minutes, 40 seconds 17,118 views",Admas Music,17118,17130,12
352,"Kaleayu Mehari - Qedawitey (Official Video) | Ethiopian Music by ADMAS MUSIC 3 years ago 4 minutes, 59 seconds 55,900 views",Admas Music,55900,55957,57
353,"Ermias Kiflezghi - Sefera (Official Video) | Eritrean Music by ADMAS MUSIC 3 years ago 5 minutes, 26 seconds 454,652 views",Admas Music,454652,456290,1638
354,"Winta Berhane - Meksebey (Official Video) | Ethiopian Tigrigna Music by ADMAS MUSIC 3 years ago 4 minutes, 17 seconds 2,327,401 views",Admas Music,2327401,2340432,13031
355,"Nesru Muktar - Sarem (Official Video) | ሳረም - Ethiopian Music 2019 by ADMAS MUSIC 3 years ago 4 minutes, 43 seconds 42,951 views",Admas Music,42951,43074,123
356,"Natnael Taye - Yenetaye (Official Video) | የኔታዬ - Ethiopian Music 2019 by ADMAS MUSIC 3 years ago 4 minutes, 2 seconds 15,325 views",Admas Music,15325,15346,21
357,"Tekleab Mebrahtu - Men Aleni (Official Video) | መን ኣለኒ - Eritrean Music 2019 by ADMAS MUSIC 3 years ago 4 minutes, 51 seconds 48,913 views",Admas Music,48913,48943,30
358,"Samuel Beyene - Tizita (Official Video) | ትዝታ - Eritrean Music 2019 by ADMAS MUSIC 3 years ago 5 minutes, 18 seconds 46,550 views",Admas Music,46550,46642,92
359,"Tesfit Gebrehiwet - Amorey (Official Video) | ኣሞረይ - Ethiopian Music 2019 by ADMAS MUSIC 3 years ago 4 minutes, 5 seconds 32,819 views",Admas Music,32819,32835,16
360,"Yoya ft Jossi Jano - Ney Ney Mareye (Official Video) | ነይ ነይ ማርየ - Ethiopian Music 2019 by ADMAS MUSIC 3 years ago 3 minutes, 18 seconds 22,297 views",Admas Music,22297,22341,44
361,"Shagy - Regedi (Official Video) | Ethiopian Oromo Music by ADMAS MUSIC 3 years ago 4 minutes 24,352 views",Admas Music,24352,24390,38
362,"Pawlos Teklezghi - Mamet | ማመት - Eritrean Wedding Music 2019 by ADMAS MUSIC 3 years ago 6 minutes, 46 seconds 67,955 views",Admas Music,67955,67993,38
363,"Kahsay Zawya - Seb Mealti | ሰብ ምዓልቲ - Eritrean Wedding Music 2019 by ADMAS MUSIC 3 years ago 5 minutes, 55 seconds 56,990 views",Admas Music,56990,57037,47
364,"Solomon Bayre - Zebibey (Official Video) | Ethiopian Music by ADMAS MUSIC 3 years ago 4 minutes, 39 seconds 4,518,193 views",Admas Music,4518193,4536264,18071
365,"Meseret Getu - Tamryalesh (Official Video) | ታምሪያለሽ - Ethiopian Music 2019 by ADMAS MUSIC 3 years ago 4 minutes, 55 seconds 39,796 views",Admas Music,39796,39833,37
366,"Endryas Abdu - Mar Mar Yelal (Official Video) | ማር ማር ይላል - Ethiopian Music 2019 by ADMAS MUSIC 3 years ago 4 minutes, 22 seconds 27,164 views",Admas Music,27164,27226,62
367,"Tekie Tesfa - Ane'mo (Official Video) | ኣነ'ሞ - Ethiopian Music 2019 by ADMAS MUSIC 3 years ago 5 minutes, 13 seconds 54,355 views",Admas Music,54355,54391,36
368,"Tesfalem Kebede X Shimels Kifle - Sildo (Official Video) | Ethiopian Wolayta Music by ADMAS MUSIC 3 years ago 5 minutes, 5 seconds 24,020 views",Admas Music,24020,24059,39
369,"Kibret Amare - Erkinet (Official Video) | ዕርክነት - Eritrean Music 2019 by ADMAS MUSIC 3 years ago 5 minutes, 57 seconds 141,888 views",Admas Music,141888,141953,65
370,"Sabur Abdu - Mimsal Mihirkini (Official Video) | ምምሳል ምሂርክኒ - New Eritrean Music 2019 by ADMAS MUSIC 3 years ago 5 minutes, 58 seconds 1,825,341 views",Admas Music,1825341,1828869,3528
371,"Tamrat Feyssa - Eyasebkush (Official Video) | እያሰብኩሽ - Ethiopian Music 2019 by ADMAS MUSIC 3 years ago 5 minutes, 56 seconds 47,648 views",Admas Music,47648,47800,152
372,"Mulu Wubet - Sekota (Official Video) | ግኻ ግርድ ሳቁጠ - Ethiopian Music 2019 by ADMAS MUSIC 3 years ago 6 minutes 482,931 views",Admas Music,482931,485623,2692
373,"Shewit Kifle - Wedeley (Official Video) | ወደለይ - New Eritrean Music 2019 by ADMAS MUSIC 3 years ago 4 minutes, 35 seconds 318,129 views",Admas Music,318129,318444,315
374,"Atakilti Kahsay - Hiji Hishuni (Official Video) | ሕጂ ሒሹኑ - New Ethiopian Music 2019 by ADMAS MUSIC 3 years ago 5 minutes, 15 seconds 1,557,519 views",Admas Music,1557519,1559634,2115
375,"Filmon Gebretinsae (Keshat) - Koriyi 'Ba (Official Video) | ኮርዪ'ባ - Eritrean Music 2018 by ADMAS MUSIC 3 years ago 5 minutes, 51 seconds 537,481 views",Admas Music,537481,537929,448
376,"Various Artists - Alefe Halifu | አለፈ ሓሊፉ - Ethiopian Music + Eritrean Music by ADMAS MUSIC 3 years ago 7 minutes, 37 seconds 608,543 views",Admas Music,608543,612675,4132
377,"Biruk Kassahun - Qeresh Wey | ቀረሽ ወይ - New Ethiopian Music 2018 by ADMAS MUSIC 3 years ago 5 minutes, 13 seconds 31,321 views",Admas Music,31321,31336,15
378,"Rezene Teame - Zeytimino | ዘይትምኖ - New Ethiopian Music 2018 by ADMAS MUSIC 3 years ago 3 minutes, 54 seconds 70,944 views",Admas Music,70944,71079,135
379,"Tsegazeab Demeke - Esregna | እስረኛሽን ፍቺው - New Ethiopian Music 2018 by ADMAS MUSIC 3 years ago 4 minutes, 22 seconds 30,327 views",Admas Music,30327,30360,33
380,"Tomas Solomon - Eskawtey | እስካውተይ - New Eritrean Music 2018 by ADMAS MUSIC 3 years ago 4 minutes, 43 seconds 32,149 views",Admas Music,32149,32158,9
381,"Yosef Tefere - Senay | ሰናይ - New Ethiopian Music 2018 by ADMAS MUSIC 3 years ago 5 minutes, 16 seconds 21,679 views",Admas Music,21679,21696,17
382,"26th (Yesu) ft. Yemi Boom - Yante Neger | ያንተ ነገር - New Ethiopian Music 2018 by ADMAS MUSIC 3 years ago 3 minutes, 42 seconds 20,941 views",Admas Music,20941,20973,32
383,"Eyerusalem Amde - Ngereni (Official Video) | ንገረኒ - Ethiopian Music 2018 by ADMAS MUSIC 3 years ago 4 minutes, 28 seconds 1,676,940 views",Admas Music,1676940,1681224,4284
384,"Adiam Michael - Fetewtew (Official Video) | ፍትውትው - Eritrean Music 2018 by ADMAS MUSIC 3 years ago 4 minutes, 4 seconds 261,814 views",Admas Music,261814,262166,352
385,"Christina Melkamu - Bilen | ቢለን - New Ethiopian Music 2018 by ADMAS MUSIC 3 years ago 4 minutes, 22 seconds 124,273 views",Admas Music,124273,124509,236
386,"Mihreteab Michael - Fewsiyo Qanza (Official Video) | ፈውስዮ ቃንዛ - Eritrean Music 2018 by ADMAS MUSIC 3 years ago 5 minutes, 18 seconds 315,353 views",Admas Music,315353,315570,217
387,"Abu Shash - Bale Kemiswa | ባለ ቀሚስዋ - New Ethiopian Music 2018 by ADMAS MUSIC 3 years ago 5 minutes, 13 seconds 18,168 views",Admas Music,18168,18179,11
388,"Rahel Haile - Tebejawi (Official Audio) by ADMAS MUSIC 3 years ago 5 minutes, 44 seconds 481,547 views",Admas Music,481547,482238,691
389,"Eyob Tadesse - Aytfeleyni | ኣይትፈለይኒ - New Eritrean Music 2018 by ADMAS MUSIC 3 years ago 6 minutes, 23 seconds 57,403 views",Admas Music,57403,57420,17
390,"Yared Negu - Adimera (Official Video) | አዲ መራ - Ethiopian Music 2018 by ADMAS MUSIC 3 years ago 5 minutes, 15 seconds 15,383,558 views",Admas Music,15383558,15445218,61660
391,"Hadish Araya - Nskin Amsikin | ንስኽን ኣምሲኽን - New Eritrean Music 2018 by ADMAS MUSIC 3 years ago 4 minutes, 56 seconds 50,873 views",Admas Music,50873,50881,8
392,"Sami Zenebe - Kewelowa | ከወሎዋ - New Ethiopian Music 2018 by ADMAS MUSIC 3 years ago 5 minutes, 39 seconds 81,606 views",Admas Music,81606,81701,95
393,"Tesfay Measho - Shingrwa | ሽንግርዋ - New Eritrean Music 2018 by ADMAS MUSIC 3 years ago 4 minutes, 59 seconds 45,375 views",Admas Music,45375,45395,20
394,"Ermias Semaw - Hulene Hasabe | ሁሌኔ ሀሳቤ - New Ethiopian Music 2018 by ADMAS MUSIC 3 years ago 5 minutes, 34 seconds 20,102 views",Admas Music,20102,20111,9
395,"Melese Tezera feat. Asmelash Tamrayehu - Debabe | ድባቤ - New Ethiopian Music 2018 by ADMAS MUSIC 3 years ago 5 minutes, 9 seconds 33,460 views",Admas Music,33460,33477,17
396,"Solomon Haile - Gobez (Official Video) | Ethiopian Tigrigna Music by ADMAS MUSIC 3 years ago 5 minutes, 30 seconds 7,059,250 views",Admas Music,7059250,7095888,36638
397,"Click Mule - Konjit | ቆንጂት - New Ethiopian Music 2018 by ADMAS MUSIC 3 years ago 4 minutes, 12 seconds 24,189 views",Admas Music,24189,24204,15
398,"Kal's T - Wubet Weshet | ዉበት ውሸት - New Ethiopian Music 2018 by ADMAS MUSIC 3 years ago 2 minutes, 42 seconds 16,108 views",Admas Music,16108,16160,52
399,"Nathan X - Zare New | ዛሬ ነው - New Ethiopian Music 2018 by ADMAS MUSIC 3 years ago 4 minutes, 43 seconds 17,916 views",Admas Music,17916,17930,14
400,"Natnael Tesfaye - Eyamare | እያማሬ - New Ethiopian Music 2018 by ADMAS MUSIC 3 years ago 4 minutes, 7 seconds 16,793 views",Admas Music,16793,16818,25
401,"Likawent Mamo - Zewdun Chenewal | ዘውዱን ጭኗል - New Ethiopian Music 2018 by ADMAS MUSIC 3 years ago 5 minutes, 3 seconds 46,079 views",Admas Music,46079,46093,14
402,"Teme Hip Hop ft. Shewit Estifanos X Hannibal - Chir Abileley | ጭር ኣብለለይ - New Eritrean Music 2018 by ADMAS MUSIC 3 years ago 4 minutes, 53 seconds 429,153 views",Admas Music,429153,430759,1606
403,"Danait Yohannes - Nea Eto (Official Video) | ንዓ እቶ - Eritrean Music 2018 by ADMAS MUSIC 3 years ago 5 minutes, 46 seconds 1,668,001 views",Admas Music,1668001,1671660,3659
404,"Nahom Haile - Mitslal | ምጽላል - New Ethiopian Music 2018 by ADMAS MUSIC 3 years ago 4 minutes, 54 seconds 66,639 views",Admas Music,66639,66654,15
405,"Venus Alem - Hadani | ሃዳኒ - New Eritrean Music 2018 by ADMAS MUSIC 3 years ago 4 minutes, 36 seconds 119,440 views",Admas Music,119440,119493,53
406,"Afework Tsehaye - Anchin Biye | ኣንቺን ብየ - New Ethiopian Music 2018 by ADMAS MUSIC 3 years ago 4 minutes, 7 seconds 15,836 views",Admas Music,15836,15849,13
407,"Haben Negasi - Fleyti Fitret | ፍልይቲ ፍጥረት - New Eritrean Music 2018 by ADMAS MUSIC 3 years ago 4 minutes, 17 seconds 98,147 views",Admas Music,98147,98177,30
408,"Tewodros Kasay - Man Yengerat | ማን ይንገራት - New Ethiopian Music 2018 by ADMAS MUSIC 3 years ago 4 minutes, 3 seconds 33,414 views",Admas Music,33414,33433,19
409,"Alula Gebreamlak - Mabede | ማበዴ - New Ethiopian Music 2018 by ADMAS MUSIC 3 years ago 5 minutes, 37 seconds 29,349 views",Admas Music,29349,29503,154
410,"Asmerom Abraham - Meteabeyti (Tenshar) | መተዓብይቲ - New Eritrean Music 2018 by ADMAS MUSIC 3 years ago 6 minutes, 28 seconds 39,191 views",Admas Music,39191,39206,15
411,"Wende Tone -  Melk Yalat | መልክ ያላት - New Ethiopian Music 2018 by ADMAS MUSIC 3 years ago 4 minutes, 46 seconds 24,246 views",Admas Music,24246,24254,8
412,"Tsegay Abraha - Aber Albo | ኣበር ኣልቦ - New Ethiopian Music 2018 by ADMAS MUSIC 3 years ago 4 minutes, 27 seconds 61,598 views",Admas Music,61598,61645,47
413,"Tamrat Hailegebriel - Mamar | ማማር - New Ethiopian Music 2018 by ADMAS MUSIC 3 years ago 4 minutes, 46 seconds 26,600 views",Admas Music,26600,26655,55
414,"Fanus Misgina - Mizer | ሚዘር - New Eritrean Music 2018 by ADMAS MUSIC 3 years ago 5 minutes, 41 seconds 155,982 views",Admas Music,155982,156038,56
415,"Sahlu Wolde - Sheger Nat | ሸገር ናት - New Ethiopian Music 2018 by ADMAS MUSIC 3 years ago 4 minutes, 34 seconds 24,026 views",Admas Music,24026,24042,16
416,"Bereket Goitom - Deneba | ደነባ - New Eritrean Music 2018 by ADMAS MUSIC 3 years ago 4 minutes, 54 seconds 90,379 views",Admas Music,90379,90442,63
417,"Terefe Assefa - Marewa | ማሬዋ - New Ethiopian Music 2018 by ADMAS MUSIC 3 years ago 4 minutes, 51 seconds 40,928 views",Admas Music,40928,40964,36
418,"Fere Zenebe - Hazuley | ሓዙለይ - New Ethiopian Music 2018 by ADMAS MUSIC 3 years ago 3 minutes, 31 seconds 149,321 views",Admas Music,149321,149364,43
419,"Aron Solomon - Abayki | ኣባይኪ - New Eritrean Music 2018 by ADMAS MUSIC 3 years ago 6 minutes 63,475 views",Admas Music,63475,63508,33
420,"El Dagii feat Jossi - Yene Mamacita | የኔ ማማሲታ - New Ethiopian Music 2018 by ADMAS MUSIC 3 years ago 4 minutes, 56 seconds 34,147 views",Admas Music,34147,34187,40
421,"Goytom Tamrat - Lagedede | ላገደደ - New Ethiopian Music 2018 by ADMAS MUSIC 3 years ago 4 minutes, 4 seconds 84,477 views",Admas Music,84477,84518,41
422,"Hupa G X Young Same  - Yezalew Chewata | ይዛለው ጨዋታ - New Ethiopian Music 2018 by ADMAS MUSIC 3 years ago 3 minutes, 31 seconds 20,737 views",Admas Music,20737,20762,25
423,"Fana Abraha - Setet | ሰተት - New Eritrean Music 2018 by ADMAS MUSIC 3 years ago 4 minutes, 3 seconds 4,195,410 views",Admas Music,4195410,4200054,4644
424,"Frehiwot Yimam - Neshete | ንሽቴ - New Ethiopian Music 2018 by ADMAS MUSIC 3 years ago 4 minutes, 16 seconds 38,618 views",Admas Music,38618,38649,31
425,"Menyahel Getachew - Ete Benetelash | እቴ በነጠላሽ - New Ethiopian Music 2018 by ADMAS MUSIC 3 years ago 4 minutes, 3 seconds 10,339 views",Admas Music,10339,10356,17
426,"Aron Gebregziabher - Asey | ኣሰይ - New Eritrean Music 2018 by ADMAS MUSIC 3 years ago 6 minutes, 46 seconds 272,627 views",Admas Music,272627,272703,76
427,"SUNE - Egna Senewaded | እኛ ስንዋደድ - New Ethiopian Music 2018 (Official Video) by ADMAS MUSIC 3 years ago 5 minutes, 5 seconds 10,131 views",Admas Music,10131,10146,15
428,"Jungle Ranjer - Konjo Gual | ቆንጆ ጓል - New Ethiopian Music 2018 by ADMAS MUSIC 3 years ago 4 minutes, 9 seconds 25,735 views",Admas Music,25735,25751,16
429,"Robel Michael - Tsbahna Keykefie | ጽባሕና ከይከፍእ - New Eritrean Music 2018 by ADMAS MUSIC 3 years ago 7 minutes, 50 seconds 235,063 views",Admas Music,235063,235142,79
430,"Habtesellasie Abraha (Aynome) - Kilite Manna | ክልተ ማና - New Eritrean Music 2018 by ADMAS MUSIC 3 years ago 7 minutes, 49 seconds 94,545 views",Admas Music,94545,94743,198
431,"Jano Band - Yetikur Almaz | የጥቁር አልማዝ - New Ethiopian Music 2018 by ADMAS MUSIC 3 years ago 4 minutes, 24 seconds 313,100 views",Admas Music,313100,313485,385
432,"Fitawrari Kibromma - Kedet Nekelet | ከደት ነቐለት - New Ethiopian Music 2018 by ADMAS MUSIC 3 years ago 4 minutes, 49 seconds 47,560 views",Admas Music,47560,47645,85
433,"Tewodros Alemayehu - Dir Beyabir | ድር በያብር - New Ethiopian Music 2018 by ADMAS MUSIC 3 years ago 6 minutes, 23 seconds 14,929 views",Admas Music,14929,14936,7
434,"Mahlet Hailu - Nay Felemay | ናይ ፈለማይ - New Ethiopian Music 2018 by ADMAS MUSIC 3 years ago 3 minutes, 35 seconds 31,685 views",Admas Music,31685,31710,25
435,"Ruftalem Abraham - Wesinka | ወሲንካ - New Eritrean Music 2018 by ADMAS MUSIC 3 years ago 4 minutes, 58 seconds 587,041 views",Admas Music,587041,603232,16191
436,"Tirhas Gual Keren - Amen Ele'ye | ኣሜን ኢለ'የ - New Eritrean Music 2018 by ADMAS MUSIC 3 years ago 4 minutes, 48 seconds 1,233,230 views",Admas Music,1233230,1237523,4293
437,"Dawit Alemayehu - Tewedeshal (Official Video) | ተወደሻል - Ethiopian Music 2018 by ADMAS MUSIC 3 years ago 5 minutes, 21 seconds 5,785,236 views",Admas Music,5785236,5800643,15407
438,"Biniam Eshetu - Hello | ሄሎ - New Ethiopian Music 2018 by ADMAS MUSIC 3 years ago 4 minutes, 54 seconds 35,827 views",Admas Music,35827,35882,55
439,"Solomon Bayre - Merkeb | መርከብ - New Ethiopian Music 2018 by ADMAS MUSIC 3 years ago 7 minutes, 1 second 698,203 views",Admas Music,698203,701463,3260
440,"Tirhas Teweldemedhin - Shikorey | ሽኮረይ - New Ethiopian Music 2018 by ADMAS MUSIC 3 years ago 5 minutes, 6 seconds 83,516 views",Admas Music,83516,83597,81
441,"Kibrom Nadov - Yaz | ያዝ - New Ethiopian Music 2018 by ADMAS MUSIC 3 years ago 4 minutes, 8 seconds 16,347 views",Admas Music,16347,16363,16
442,"Kiros Girmay - Nmeskeley | ንመስቀለይ - New Ethiopian Music 2018 by ADMAS MUSIC 3 years ago 8 minutes, 20 seconds 235,452 views",Admas Music,235452,235513,61
443,"Rita Adere - Minew | ምነው - New Ethiopian Music 2018 by ADMAS MUSIC 3 years ago 6 minutes, 33 seconds 28,695 views",Admas Music,28695,28740,45
444,"Henok Ferede - Zeytinegrini | ዘይትነግርኒ - New Eritrean Music 2018 by ADMAS MUSIC 3 years ago 5 minutes, 42 seconds 56,809 views",Admas Music,56809,56836,27
445,"Kibrom Berhane - Werki Wenberey | ወርቂ ወንበረይ - New Ethiopian Music 2018 by ADMAS MUSIC 3 years ago 4 minutes, 56 seconds 2,535,193 views",Admas Music,2535193,2539145,3952
446,"Selmawit Abtew - Filagot | ፍላጎት - New Ethiopian Music 2018 by ADMAS MUSIC 3 years ago 6 minutes, 13 seconds 28,534 views",Admas Music,28534,28600,66
447,"Hermon Tadesse - Ms Bedela | ምስ በደላ - New Eritrean Music 2018 by ADMAS MUSIC 3 years ago 5 minutes, 51 seconds 161,968 views",Admas Music,161968,162014,46
448,"KOOLJAY - LOOK AROUND U! - New Ethiopian Music 2018 by ADMAS MUSIC 3 years ago 3 minutes, 5 seconds 9,415 views",Admas Music,9415,9423,8
449,"Dj Ashu Ethio - Afincha Rebietey | ኣፍንጫ ርብዒተይ - New Ethiopian Music 2018 by ADMAS MUSIC 3 years ago 4 minutes, 8 seconds 934,126 views",Admas Music,934126,935233,1107
450,"Sami Dan - Bado Rakot (Official Video) | ባዶ ራቁት - Ethiopian Music 2018 by ADMAS MUSIC 3 years ago 4 minutes, 40 seconds 160,190 views",Admas Music,160190,160308,118
451,"Maki - Endene | እንደእኔ - New Ethiopian Music 2018 by ADMAS MUSIC 3 years ago 4 minutes, 14 seconds 49,918 views",Admas Music,49918,49978,60
452,"Gerish Yalem - Dasey | ዳሰይ - New Ethiopian Music 2018 by ADMAS MUSIC 3 years ago 7 minutes, 25 seconds 68,574 views",Admas Music,68574,68607,33
453,"Rahel Haile - Heji Grem (Official Audio) | ሕጂ ግርም - Ethiopian Music 2018 by ADMAS MUSIC 3 years ago 5 minutes, 53 seconds 2,791,105 views",Admas Music,2791105,2796358,5253
454,"Dawit Mideksa - Enja Zendero | እንጃ ዘንድሮ - New Ethiopian Music 2018 by ADMAS MUSIC 3 years ago 5 minutes, 43 seconds 34,932 views",Admas Music,34932,34956,24
455,"Asefa Gebremichael - Tsegereda | ፅጌሬዳ - New Ethiopian Music 2018 by ADMAS MUSIC 3 years ago 4 minutes, 6 seconds 120,534 views",Admas Music,120534,120651,117
456,"Addis Mulat - Yefqireki | የፍቅረኪ - New Ethiopian Music 2018 by ADMAS MUSIC 3 years ago 4 minutes, 51 seconds 186,923 views",Admas Music,186923,187342,419
457,"Ephrem Amare - 'Sey (Official Video) | 'ሰይ - Ethiopian Music 2018 by ADMAS MUSIC 3 years ago 5 minutes, 1 second 34,485,566 views",Admas Music,34485566,34663379,177813
458,"Endegna - Ho Belen (Official Video) | ሆ ብለን - Ethiopian Music 2018 by ADMAS MUSIC 3 years ago 5 minutes, 35 seconds 6,458,345 views",Admas Music,6458345,6465194,6849
459,"Danny D - Hasabun Ersuna | ሀሳቡን እርሱና - New Ethiopian Music 2018 by ADMAS MUSIC 3 years ago 4 minutes, 46 seconds 68,687 views",Admas Music,68687,68724,37
460,"Simon Estifanos - Manatu | ማናቱ - New Eritrean Music 2018 by ADMAS MUSIC 3 years ago 5 minutes, 50 seconds 142,267 views",Admas Music,142267,142295,28
461,"Temu Kassa - Mamaye | ማማዬ - New Ethiopian Music 2018 by ADMAS MUSIC 3 years ago 3 minutes, 33 seconds 19,801 views",Admas Music,19801,19820,19
462,"Rahwa Tsegay - Lidetey | ልደተይ - New Ethiopian Music 2018 by ADMAS MUSIC 3 years ago 4 minutes, 59 seconds 82,007 views",Admas Music,82007,82056,49
463,"Dawit Haile - Metsikaley Do | መጺእኻለይ ዶ - New Eritrean Music 2018 by ADMAS MUSIC 3 years ago 5 minutes, 52 seconds 125,369 views",Admas Music,125369,125496,127
464,"Million Eshetu - Welelay | ወለላይ - New Ethiopian Music 2018 by ADMAS MUSIC 3 years ago 4 minutes, 41 seconds 555,891 views",Admas Music,555891,556274,383
465,"Dereje Belay - Tadarachihu Yidemek | ትዳራችሁ ይድመቅ - New Ethiopian Wedding Music by ADMAS MUSIC 3 years ago 6 minutes, 46 seconds 39,617 views",Admas Music,39617,39803,186
466,"Yodit Abebe - Kesemonu | ከሰሞኑ - New Ethiopian Music 2018 by ADMAS MUSIC 3 years ago 5 minutes, 10 seconds 13,363 views",Admas Music,13363,13375,12
467,"Christian feat. Dj Prince - Hiwot | ህይወት - New Ethiopian Hip Hop Music 2018 by ADMAS MUSIC 3 years ago 3 minutes, 59 seconds 16,387 views",Admas Music,16387,16413,26
468,"BBMJ - Selam | ሰላም - New Eritrean Music 2018 by ADMAS MUSIC 3 years ago 6 minutes, 39 seconds 130,303 views",Admas Music,130303,130338,35
469,"Robel Charu - Sienetey Keyakleni | ስእነተይ ከይኣኽለኒ - New Eritrean Music 2018 by ADMAS MUSIC 3 years ago 4 minutes, 56 seconds 155,266 views",Admas Music,155266,155506,240
470,"Filmon Gebretinsae (Keshat) - Tiemuka Aytibeluni | ጥዒሙካ ኣይትበሉኒ - New Eritrean Music 2018 by ADMAS MUSIC 3 years ago 6 minutes, 43 seconds 1,085,296 views",Admas Music,1085296,1086741,1445
471,"Ashenafi Tadesse - Adey | ዓደይ - New Eritrean Music 2018 by ADMAS MUSIC 3 years ago 5 minutes, 30 seconds 70,969 views",Admas Music,70969,71004,35
472,"Yohannes Endale - Nega - New Ethiopian Music 2018 by ADMAS MUSIC 3 years ago 4 minutes, 6 seconds 10,200 views",Admas Music,10200,10203,3
473,"Alemayehu Siyum - Hoya Hoye | ሆያ ሆየ - Traditional Ethiopian Music by ADMAS MUSIC 3 years ago 4 minutes, 59 seconds 8,480 views",Admas Music,8480,8486,6
474,"Timnit Welday - Ashenda (feat. Lemelem Alemayew & Eskedar Berhane) - Ethiopian Tigrigna Music 2018 by ADMAS MUSIC 3 years ago 5 minutes, 14 seconds 409,766 views",Admas Music,409766,410363,597
475,"Samson Siyum - Nibeyna Eya  | ልበይና እያ - Ethiopian Tigrigna Music 2018 by ADMAS MUSIC 3 years ago 5 minutes, 36 seconds 290,377 views",Admas Music,290377,290846,469
476,"Sertsebirhan Tadesse - Zew Abiliyo (Official Video) | ዘው ኣብልዮ - New Ethiopian Music 2018 by ADMAS MUSIC 3 years ago 5 minutes, 33 seconds 4,335,008 views",Admas Music,4335008,4363283,28275
477,"Comedian Thomas - Nezret (Official video) | ንዝረት - Ethiopian Music 2018 by ADMAS MUSIC 3 years ago 4 minutes, 59 seconds 554,216 views",Admas Music,554216,555242,1026
478,"Layne Tadesse - Nsemama'e - New Eritrean Music 2018 by ADMAS MUSIC 3 years ago 4 minutes, 41 seconds 144,648 views",Admas Music,144648,145355,707
479,"Aster Wolde - Shadey - New Ethiopian Music 2018 by ADMAS MUSIC 3 years ago 7 minutes, 1 second 227,412 views",Admas Music,227412,228251,839
480,"Tesfamariam Kesete - Ebuney - New Eritrean Music 2018 by ADMAS MUSIC 3 years ago 4 minutes, 51 seconds 122,343 views",Admas Music,122343,122517,174
481,"Mulugheta Medhanie -Teqebeli Ba Telephone - New Eritrean Music 2018 by ADMAS MUSIC 3 years ago 5 minutes, 22 seconds 58,076 views",Admas Music,58076,58108,32
482,"Mandas & Prinx feat Akiyana - No Money No Party (Official Video) by ADMAS MUSIC 3 years ago 4 minutes, 1 second 11,695 views",Admas Music,11695,11720,25
483,"Micky Kebede - Hayloga - New Ethiopian Music 2018 by ADMAS MUSIC 3 years ago 4 minutes, 7 seconds 85,521 views",Admas Music,85521,85702,181
484,"Zemenu Nega (ኩዚ) - Lingerish | ልንገርሽ - Ethiopian Music 2018 by ADMAS MUSIC 3 years ago 6 minutes, 16 seconds 563,287 views",Admas Music,563287,564499,1212
485,"Fithawi Netsereab - Entay'yu Ti Mistir | እንታይ'ዩ ት'ምስጢር - Eritrean Music 2018 by ADMAS MUSIC 3 years ago 4 minutes, 34 seconds 93,951 views",Admas Music,93951,93993,42
486,"Kepaso - Anichalim (Eritrea'ye) - New Ethiopian Music 2018 by ADMAS MUSIC 3 years ago 4 minutes, 5 seconds 26,711 views",Admas Music,26711,26718,7
487,"Andit Teklehaymanot - Tsibiktey - New Eritrean Music 2018 by ADMAS MUSIC 3 years ago 4 minutes, 17 seconds 109,067 views",Admas Music,109067,109119,52
488,"Veronica Solomon - Rahwa Kemets'eyu - New Eritrean Music 2018 by ADMAS MUSIC 3 years ago 5 minutes, 5 seconds 329,249 views",Admas Music,329249,329642,393
489,"Eden Kesete - Ferah Gorah - New Eritrean Music 2018 by ADMAS MUSIC 3 years ago 5 minutes, 9 seconds 2,936,664 views",Admas Music,2936664,2944213,7549
490,"Sean Shizee - Way'za - New Ethiopian Music 2018 by ADMAS MUSIC 3 years ago 3 minutes, 56 seconds 169,536 views",Admas Music,169536,169793,257
491,"Menberu Negash - Tiblets - New Ethiopian Music 2018 by ADMAS MUSIC 3 years ago 7 minutes, 36 seconds 169,200 views",Admas Music,169200,169249,49
492,"Tadele Getachew - Zelekna'ta - New Ethiopian Music 2018 by ADMAS MUSIC 3 years ago 5 minutes, 15 seconds 127,940 views",Admas Music,127940,128042,102
493,"Zerabruk Semaw - Gelagay - New Ethiopian Music 2018 by ADMAS MUSIC 3 years ago 5 minutes, 9 seconds 184,828 views",Admas Music,184828,185447,619
494,"Filmon Girmay - Nfqri Ya Tefetira - New Eritrean Music 2018 by ADMAS MUSIC 3 years ago 4 minutes, 38 seconds 147,373 views",Admas Music,147373,147420,47
495,"Daniel Tesfamariam - Weyney - New Eritrean Music 2018 by ADMAS MUSIC 3 years ago 5 minutes, 30 seconds 98,801 views",Admas Music,98801,98876,75
496,"Wave Slassian Ft Gildo Kassa - Shemah Beliley - New Ethiopian Music 2018 by ADMAS MUSIC 3 years ago 3 minutes, 58 seconds 87,679 views",Admas Music,87679,87839,160
497,"Gaga Siyum - Di Di (Official Video) | Ethiopian Wolayta Music by ADMAS MUSIC 3 years ago 4 minutes, 8 seconds 600,964 views",Admas Music,600964,604297,3333
498,"Adem Mohammed - Akuuleemma - New Ethiopian Music 2018 by ADMAS MUSIC 3 years ago 4 minutes, 28 seconds 38,044 views",Admas Music,38044,38290,246
499,"Samuel Seneshaw - Amarelesh - New Ethiopian Music 2018 by ADMAS MUSIC 3 years ago 6 minutes, 3 seconds 99,074 views",Admas Music,99074,99134,60
500,"Abel Tsegay - Abshay - New Eritrean Music 2018 by ADMAS MUSIC 3 years ago 5 minutes, 29 seconds 42,678 views",Admas Music,42678,42702,24
501,"Merhawi Wedi Haleka - Tenefafiqna Do - New Eritrean Music 2018 by ADMAS MUSIC 3 years ago 5 minutes, 28 seconds 324,386 views",Admas Music,324386,325116,730
502,"Ruftalem Abraham - Kab Zikuneno - New Eritrean Music 2018 by ADMAS MUSIC 3 years ago 4 minutes, 59 seconds 201,524 views",Admas Music,201524,201884,360
503,"Betel Endalkachew - Anten Anten - New Ethiopian Music 2018 by ADMAS MUSIC 3 years ago 4 minutes, 49 seconds 23,720 views",Admas Music,23720,23734,14
504,"Essayas Yukuno - Hadag Kuni - New Eritrean Music 2018 by ADMAS MUSIC 3 years ago 4 minutes, 41 seconds 41,173 views",Admas Music,41173,41216,43
505,"Saba Andemariam - Halengaye - New Eritrean Music 2018 by ADMAS MUSIC 3 years ago 5 minutes, 3 seconds 2,702,347 views",Admas Music,2702347,2704478,2131
506,"Hiwot Assefa - Kesu Gar - New Ethiopian Music 2018 by ADMAS MUSIC 3 years ago 6 minutes, 51 seconds 49,993 views",Admas Music,49993,50011,18
507,"Getachew Asfaw - Ende Tsegereda - New Ethiopian Music 2018 by ADMAS MUSIC 3 years ago 6 minutes, 3 seconds 34,149 views",Admas Music,34149,34306,157
508,"Robel Michael - Mizer - New Eritrean Music 2018 by ADMAS MUSIC 3 years ago 6 minutes, 43 seconds 6,443,715 views",Admas Music,6443715,6455636,11921
509,"Henok Getu - Eyatenya (Official Video) | Ethiopian Music by ADMAS MUSIC 3 years ago 5 minutes, 8 seconds 70,409 views",Admas Music,70409,70470,61
510,"Solomon Bayre - Alekum Do (Official Video) | ኣለኹም ዶ - Ethiopian Music 2018 by ADMAS MUSIC 3 years ago 6 minutes, 24 seconds 3,704,988 views",Admas Music,3704988,3711876,6888
511,"Selamawit Yohannes, Hahu Beatz - Zomawa - New Ethiopian Music 2018 by ADMAS MUSIC 3 years ago 4 minutes, 44 seconds 14,341,380 views",Admas Music,14341380,14371377,29997
512,"Tomas Mulugeta - Fiqrey - New Eritrean Music 2018 by ADMAS MUSIC 3 years ago 5 minutes, 24 seconds 811,142 views",Admas Music,811142,811784,642
513,"Tesfay Mengesha, Eseyas Saleh - Shawuley - New Eritrean Music 2018 by ADMAS MUSIC 3 years ago 6 minutes, 32 seconds 797,824 views",Admas Music,797824,798504,680
514,"Awet Tadesse - Besimesh Litera - New Ethiopian Music 2018 by ADMAS MUSIC 3 years ago 5 minutes 82,777 views",Admas Music,82777,82807,30
515,"Yohannes Estifanos, Semhar Yohannes, Danait Yohannes - Edu'ndo Beluley - New Eritrean Music 2018 by ADMAS MUSIC 3 years ago 7 minutes, 6 seconds 3,716,307 views",Admas Music,3716307,3724368,8061
516,"Rita Adere - Mela Belugn - New Ethiopian Music 2018 by ADMAS MUSIC 3 years ago 5 minutes, 17 seconds 1,059,159 views",Admas Music,1059159,1059483,324
517,"ATEGB - Melkam Sew - New Ethiopian Music 2018 by ADMAS MUSIC 3 years ago 5 minutes, 1 second 19,648 views",Admas Music,19648,19655,7
518,"Emnet Mesay - Weyne Weyne - New Ethiopian Music 2018 by ADMAS MUSIC 3 years ago 5 minutes, 43 seconds 63,198 views",Admas Music,63198,63223,25
519,"Azmera Chekol ft Samon Haile - Hadar Gerka - New Ethiopian Music 2018 by ADMAS MUSIC 3 years ago 5 minutes, 3 seconds 100,388 views",Admas Music,100388,100563,175
520,"Adbar Tilahun - Yemini Nano - New Ethiopian Music 2018 by ADMAS MUSIC 3 years ago 7 minutes, 10 seconds 14,455 views",Admas Music,14455,14491,36
521,"Solo Grande - Bellissima Asmera - New Eritrean Music 2018 by ADMAS MUSIC 3 years ago 8 minutes, 13 seconds 108,049 views",Admas Music,108049,108077,28
522,"Wedi Gezu - Welela - New Eritrean Music 2018 by ADMAS MUSIC 3 years ago 4 minutes, 30 seconds 61,439 views",Admas Music,61439,61471,32
523,"Dawit Nega - Benetselay - New Ethiopian Music 2018 by ADMAS MUSIC 3 years ago 6 minutes, 4 seconds 7,576,636 views",Admas Music,7576636,7617932,41296
524,"Dawit Nega - New Ethiopian Tigrigna Music Video  ""Benetselay"" Coming Soon on Admas Music by ADMAS MUSIC 3 years ago 17 seconds 30,767 views",Admas Music,30767,30781,14
525,"Dan Ab - Delina - New Ethiopian Music 2018 by ADMAS MUSIC 3 years ago 5 minutes, 28 seconds 56,809 views",Admas Music,56809,56944,135
526,"Azeb Wendwosen - Adere Adere - New Ethiopian Music 2018 by ADMAS MUSIC 3 years ago 5 minutes, 4 seconds 137,387 views",Admas Music,137387,137518,131
527,"Amanuel Goitom - Gamey - New Eritrean Music 2018 by ADMAS MUSIC 3 years ago 6 minutes, 49 seconds 657,994 views",Admas Music,657994,659962,1968
528,"Ze Aman Girmay - Ayam Bel | ኣያም በል -  New Ethiopian Music 2018 by ADMAS MUSIC 3 years ago 4 minutes, 6 seconds 90,723 views",Admas Music,90723,90827,104
529,"Saba Tesfamariam - Tinkleashew - ጥንቅላዓሸው - New Eritrean Music 2018 (Official Video) by ADMAS MUSIC 4 years ago 4 minutes, 42 seconds 163,231 views",Admas Music,163231,163340,109
530,"Haren Tesfay - Konjona | ቆንጆና - Eritrean Music 2018 by ADMAS MUSIC 4 years ago 3 minutes, 42 seconds 95,403 views",Admas Music,95403,95431,28
531,"Sabrina Kibreab - Handebet Fiqri | ሃንደበት ፍቕሪ - Eritrean Music 2018 by ADMAS MUSIC 4 years ago 4 minutes, 33 seconds 544,635 views",Admas Music,544635,545211,576
532,"Yohana Ghirmay - Jigna Fikri - New Eritrean Music 2018 (Official Video) by ADMAS MUSIC 4 years ago 5 minutes, 17 seconds 77,603 views",Admas Music,77603,77625,22
533,"Meshesh - Yata - Eritrean Music 2017 (Official Video) by ADMAS MUSIC 4 years ago 5 minutes, 39 seconds 142,206 views",Admas Music,142206,142411,205
534,"Liya Bayru - Hagizeni - (Official Video) | New Eritrean Music 2017 by ADMAS MUSIC 4 years ago 6 minutes, 19 seconds 135,670 views",Admas Music,135670,135877,207
535,"Mehret Zerhans - Selamki Keren - (Official Video) | New Eritrean Music 2017 by ADMAS MUSIC 4 years ago 5 minutes, 33 seconds 66,256 views",Admas Music,66256,66478,222
536,"Meshesh - Nigeri - (Official Video) - Traditional Eritrean Music by ADMAS MUSIC 4 years ago 6 minutes, 17 seconds 452,877 views",Admas Music,452877,458083,5206
537,"Meshesh - Mis Teadeghe - (Official Video) | Traditional Eritrean Music by ADMAS MUSIC 4 years ago 6 minutes, 3 seconds 313,999 views",Admas Music,313999,314412,413
538,"Wedi Gidey - Nitehagos Lomi - Official Video - New Eritrean Music 2017 by ADMAS MUSIC 4 years ago 5 minutes, 49 seconds 105,477 views",Admas Music,105477,105518,41
539,"Semhar Yohannes - Wedi Mislene - Instrumental Cover by ADMAS MUSIC 4 years ago 6 minutes, 16 seconds 89,113 views",Admas Music,89113,89170,57
540,"Minasie Haile - Zemen (Remix) - Modern Eritrean Music by ADMAS MUSIC 4 years ago 4 minutes, 49 seconds 15,105 views",Admas Music,15105,15121,16
541,"Natnael Aron - Ab Libina Aleka - Eritrean Music by ADMAS MUSIC 5 years ago 5 minutes, 52 seconds 25,534 views",Admas Music,25534,25542,8
542,"Solo Grande - Des Eluni - Eritrean Wedding Music by ADMAS MUSIC 5 years ago 6 minutes, 11 seconds 433,069 views",Admas Music,433069,433150,81
543,"Biniam Habte - Nafikeki Aleku - Eritrean Music by ADMAS MUSIC 5 years ago 4 minutes, 24 seconds 24,799 views",Admas Music,24799,24823,24
544,"Tesfalidet Kibrezghi (Birged) - Hager - Eritrean Music by ADMAS MUSIC 5 years ago 7 minutes, 13 seconds 38,298 views",Admas Music,38298,38305,7
545,"Tedros Rezene - Swnwano - Eritrean Music by ADMAS MUSIC 5 years ago 6 minutes, 44 seconds 206,344 views",Admas Music,206344,206395,51
546,"Eyob Tadesse - Zekire - Eritrean Music by ADMAS MUSIC 5 years ago 6 minutes, 47 seconds 37,097 views",Admas Music,37097,37103,6
547,"Eseyas Debesay - Hadish Amet - Eritrean Music by ADMAS MUSIC 5 years ago 5 minutes, 54 seconds 40,222 views",Admas Music,40222,40231,9
548,"Mehret Zerhans - Fenteta - Eritrean Wedding Music by ADMAS MUSIC 5 years ago 6 minutes, 14 seconds 205,043 views",Admas Music,205043,205777,734
549,"Wedi Gezu - Trhas Bellu - Eritrean Wedding Music by ADMAS MUSIC 5 years ago 6 minutes, 25 seconds 291,674 views",Admas Music,291674,291728,54
550,"Liya Bayru - Nea Nea - Eritrean Music by ADMAS MUSIC 5 years ago 5 minutes, 41 seconds 146,545 views",Admas Music,146545,146669,124
551,"Solomon Gebregergish - Adey - Eritrean Music by ADMAS MUSIC 5 years ago 6 minutes, 23 seconds 77,126 views",Admas Music,77126,77144,18
552,"Beraki Gebremedhin - Searit - Eritrean Music by ADMAS MUSIC 5 years ago 6 minutes, 13 seconds 2,288,641 views",Admas Music,2288641,2290238,1597
553,"Girmay Gergish - Birey - Eritrean Music by ADMAS MUSIC 5 years ago 5 minutes, 58 seconds 138,270 views",Admas Music,138270,138291,21
554,"Tomas Asefaw - Entay Faydeu - Eritrean Music by ADMAS MUSIC 5 years ago 5 minutes, 8 seconds 80,256 views",Admas Music,80256,80307,51
555,"Hermon Berhane - Taniko - Eritrean Music by ADMAS MUSIC 5 years ago 6 minutes, 31 seconds 691,755 views",Admas Music,691755,692221,466
556,"Meshesh - Awdeamet - Traditional Eritrean Music by ADMAS MUSIC 5 years ago 7 minutes, 53 seconds 707,561 views",Admas Music,707561,707756,195
557,"Liya Bayru - Geratlu Aytbeluni - Eritrean Music by ADMAS MUSIC 5 years ago 7 minutes, 2 seconds 217,589 views",Admas Music,217589,217650,61
558,"Eseyas Debesay - Banderay - Eritrean Music by ADMAS MUSIC 5 years ago 7 minutes, 23 seconds 31,411 views",Admas Music,31411,31430,19
559,"Natnael Aron - Bixeiti - Eritrean music by ADMAS MUSIC 5 years ago 5 minutes, 22 seconds 37,830 views",Admas Music,37830,37838,8
560,"Wedi Gezu - Shigey - Eritrean Music by ADMAS MUSIC 5 years ago 5 minutes, 55 seconds 59,606 views",Admas Music,59606,59617,11
561,"Meshesh - Sanda Libey - Traditional Eritrean Music by ADMAS MUSIC 5 years ago 6 minutes, 49 seconds 336,867 views",Admas Music,336867,337187,320
562,"William Gidey - Elim - Eritrean Music by ADMAS MUSIC 5 years ago 5 minutes, 49 seconds 146,705 views",Admas Music,146705,146922,217
563,"Biniam Habte - Tsmwa - Eritrean Music by ADMAS MUSIC 5 years ago 6 minutes, 31 seconds 105,036 views",Admas Music,105036,105046,10
564,"Tedros Rezene - Asmeray Semira - Eritrean Music by ADMAS MUSIC 5 years ago 7 minutes, 14 seconds 248,163 views",Admas Music,248163,248169,6
565,"Girmay Gergish - Aytdewliley - 2016 | Halenga Eritrea by ADMAS MUSIC 5 years ago 7 minutes, 1 second 115,912 views",Admas Music,115912,115914,2
566,"Liya Bayru - Semiru - Eritrean Music by ADMAS MUSIC 5 years ago 6 minutes, 41 seconds 107,439 views",Admas Music,107439,107473,34
567,"Habtom Fissehaye - Asmera Shikor - Eritrean Music by ADMAS MUSIC 5 years ago 6 minutes, 29 seconds 215,809 views",Admas Music,215809,215819,10
568,"Girmay Gergish - Zena Koynu - Eritrean Music by ADMAS MUSIC 5 years ago 8 minutes, 14 seconds 152,175 views",Admas Music,152175,152189,14
569,"Isaac Okbay - Zekiriyo'ba - Eritrean Music by ADMAS MUSIC 6 years ago 6 minutes, 26 seconds 273,445 views",Admas Music,273445,273507,62
570,"Eritrean Music (2016) - Mihretab Kidane - Hrayey | Halenga Eritrea by ADMAS MUSIC 6 years ago 5 minutes, 5 seconds 237,951 views",Admas Music,237951,237970,19
571,"Eritrean Music (2016) - Robel Yosef - Meqherietey | Halenga Eritrea by ADMAS MUSIC 6 years ago 7 minutes, 5 seconds 445,486 views",Admas Music,445486,445881,395
572,"Eritrean Music (2016) - Berhane Kuhlay - Sye Qumeta | Halenga Eritrea by ADMAS MUSIC 6 years ago 5 minutes, 3 seconds 634,181 views",Admas Music,634181,634257,76
573,"Eritrean Music (2016) - Daniel Tesfamariam - Nredadae | Halenga Eritrea by ADMAS MUSIC 6 years ago 6 minutes, 21 seconds 128,353 views",Admas Music,128353,128380,27
574,"Eritrean Music (2016) - Mussie Mekonnen (Eseghe) - Kichiney | Halenga Eritrea by ADMAS MUSIC 6 years ago 7 minutes, 21 seconds 742,099 views",Admas Music,742099,744699,2600
575,"Eritrean Music (2016) - Rashid Hussein - Ghitel | Halenga Eritrea by ADMAS MUSIC 6 years ago 6 minutes, 48 seconds 146,818 views",Admas Music,146818,147121,303
576,"Eritrean Music (2016) - Merhawi Tekleberhan - Hehu | Halenga Eritrea by ADMAS MUSIC 6 years ago 6 minutes, 38 seconds 157,088 views",Admas Music,157088,157241,153
577,"Eritrean Music (2016) - Samuel Mebrahtom - Leyley | Halenga Records by ADMAS MUSIC 6 years ago 4 minutes, 43 seconds 237,641 views",Admas Music,237641,237771,130
578,"Eritrean Music (2015) - Sennay Hadgu - Qeltfi | Halenga Eritrea by ADMAS MUSIC 6 years ago 7 minutes, 32 seconds 79,994 views",Admas Music,79994,79999,5
579,"Eritrean Music (2015) - Yohannes Yosef - Tegedesley | Halenga Eritrea by ADMAS MUSIC 6 years ago 5 minutes, 29 seconds 136,590 views",Admas Music,136590,136617,27
580,"Eritrean Music (2015) - Yirgalem Getachew - Xbqkti Afqaritey | Halenga Eritrea by ADMAS MUSIC 6 years ago 5 minutes, 24 seconds 44,502 views",Admas Music,44502,44524,22
581,"Eritrean Music (2015) - Kokob Kesar - Segheney | Halenga Eritrea by ADMAS MUSIC 6 years ago 6 minutes, 26 seconds 116,688 views",Admas Music,116688,116771,83
582,"Sham Geshu - Gotena Hidmo | ጎተና ህድሞ - New Eritrean Music 2015 by ADMAS MUSIC 6 years ago 6 minutes, 17 seconds 487,036 views",Admas Music,487036,487430,394
583,"Nahom Tekeste - Siemti Egri | ስዕምቲ እግሪ - New Eritrean Music 2015 by ADMAS MUSIC 6 years ago 6 minutes, 23 seconds 333,293 views",Admas Music,333293,333425,132
584,"Nahom Tekeste - Aytmhali | ኣይትምሓሊ - New Eritrean Music 2015 by ADMAS MUSIC 6 years ago 7 minutes, 17 seconds 260,013 views",Admas Music,260013,260045,32
585,"Beraki Gebremedhin - Sadulay | ሳዱላይ - Traditional Eritrean Music by ADMAS MUSIC 6 years ago 10 minutes, 52 seconds 1,830,076 views",Admas Music,1830076,1833061,2985
586,"Temesghen Ghide - Adey Meliskelom | ዓደይ መሊስክሎም - Eritrean Music by ADMAS MUSIC 6 years ago 5 minutes, 26 seconds 83,170 views",Admas Music,83170,83231,61
587,"Semhar Isaias - Nxawet | ንጻወት - New Eritrean Music 2015 by ADMAS MUSIC 6 years ago 7 minutes, 19 seconds 1,028,192 views",Admas Music,1028192,1031818,3626
588,"Eseyas Saleh (Rasha) - Zelekhwo | ዘለኽዎ - Eritrean Music (HALENGA Eritrea) by ADMAS MUSIC 6 years ago 7 minutes, 21 seconds 193,653 views",Admas Music,193653,193697,44
589,"Eritrean Music: Beraki Gebremedhin - Metshaf Jigninet - 2015 | Halenga Eritrea by ADMAS MUSIC 6 years ago 7 minutes, 40 seconds 3,685,623 views",Admas Music,3685623,3687765,2142
590,"Said Berhanu - Rhus Gamma - Eritrean Music by ADMAS MUSIC 6 years ago 6 minutes, 55 seconds 3,517,521 views",Admas Music,3517521,3518600,1079
591,"Dejen - Krarey - Traditional Eritrean Music by ADMAS MUSIC 6 years ago 7 minutes, 45 seconds 4,558,036 views",Admas Music,4558036,4564907,6871
592,"Beraki Gebremedhin - Weg'e Mezanu | ወግዒ መዛኑ - New Eritrean Music 2015 by ADMAS MUSIC 6 years ago 6 minutes, 4 seconds 1,327,513 views",Admas Music,1327513,1329174,1661
593,"Beraki Gebremedhin Ft Simret Kidane - Mihret | ምሕረት - New Eritrean Music 2015 by ADMAS MUSIC 6 years ago 5 minutes, 31 seconds 2,243,868 views",Admas Music,2243868,2245097,1229
594,"Eritrean Music: Tesfay Mengesha - Medhanitey | መድሃኒተይ - 2015 | Halenga Eritrea by ADMAS MUSIC 7 years ago 6 minutes, 34 seconds 1,487,397 views",Admas Music,1487397,1489502,2105
595,"Melake Abraham - Teyet Kolea | ጥይት ቆልዓ - Eritrean Music (HALENGA Eritrea) by ADMAS MUSIC 7 years ago 8 minutes, 5 seconds 1,200,552 views",Admas Music,1200552,1202486,1934
596,"Temesghen Ghide (Temesgen Hip Hop) - Azawirekindye | ኣዛዊረኪንድየ - New Eritrean Music 2015 by ADMAS MUSIC 7 years ago 6 minutes, 48 seconds 176,595 views",Admas Music,176595,176673,78
597,"Sabur Abdu - Mekeal Seineyo | ምኽኣል ስኢነዮ - New Eritrean Music 2015 by ADMAS MUSIC 7 years ago 6 minutes, 24 seconds 405,298 views",Admas Music,405298,405442,144
598,"Tesfay Mengesha - Edelegna yu Zweneneki | ዕድለኛ ዩ ዝወነነኪ - New Eritrean Music 2015 by ADMAS MUSIC 7 years ago 5 minutes, 35 seconds 490,895 views",Admas Music,490895,491471,576
599,"Said Berhanu - Kumeley | ኩመለይ - New Eritrean Music 2015 by ADMAS MUSIC 7 years ago 6 minutes, 52 seconds 261,222 views",Admas Music,261222,261256,34
600,"Nahom Yohannes - Seb Entay Zeybele - Eritrean Music by ADMAS MUSIC 7 years ago 5 minutes, 52 seconds 16,853,343 views",Admas Music,16853343,16879101,25758
601,"Tesfay Mengesha - Tizita | ትዝታ - Eritrean Music (HALENGA Eritrea) by ADMAS MUSIC 7 years ago 6 minutes, 57 seconds 526,210 views",Admas Music,526210,526303,93
602,"Said Berhanu - Ghirimtey | ግርምተይ - New Eritrean Music 2015 by ADMAS MUSIC 7 years ago 5 minutes, 42 seconds 314,603 views",Admas Music,314603,314658,55
603,"Said Berhanu - Aynresasae | ኣይንረሳሳዕ - Eritrean Music (HALENGA Eritrea) by ADMAS MUSIC 7 years ago 7 minutes, 31 seconds 544,286 views",Admas Music,544286,544446,160
604,"Million Eshetu - Kxibeyekiye | ክጽበየኪየ - Eritrean Music (HALENGA Eritrea) by ADMAS MUSIC 7 years ago 7 minutes, 25 seconds 859,480 views",Admas Music,859480,861060,1580
605,"Merhawi Sbhatleab - Aytsekefi | ኣይትሰከፊ - New Eritrean Music by ADMAS MUSIC 7 years ago 6 minutes, 57 seconds 1,483,016 views",Admas Music,1483016,1492899,9883
606,"Millen Hailu - Lbey Agwaniwo | ልበይ ኣጓኒዎ - Eritrean Music (HALENGA Eritrea) by ADMAS MUSIC 7 years ago 3 minutes, 24 seconds 523,199 views",Admas Music,523199,523505,306
607,"Sennay Hadgu - Nixnah | ንጽናሕ - Eritrean Music (HALENGA Eritrea) by ADMAS MUSIC 7 years ago 6 minutes 376,203 views",Admas Music,376203,376217,14
608,"Said Berhanu - Esel Esel | ዕሰል ዕሰል - Eritrean Music by ADMAS MUSIC 7 years ago 6 minutes, 51 seconds 91,318 views",Admas Music,91318,91378,60
609,"Said Berhanu - Mesetay | መሰታይ  - Eritrean Music by ADMAS MUSIC 7 years ago 6 minutes, 5 seconds 46,192 views",Admas Music,46192,46247,55
610,"Wedi Abera - Jobae | ጆባእ - New Eritrean Music 2014 by ADMAS MUSIC 7 years ago 5 minutes, 45 seconds 496,328 views",Admas Music,496328,496428,100
611,"Said Berhanu - Adnikeki | ኣድኒቐኪ - (Official Video ) by ADMAS MUSIC 7 years ago 6 minutes, 45 seconds 1,558,494 views",Admas Music,1558494,1561116,2622
612,"Said Berhanu - Nberare (Official Video) by ADMAS MUSIC 7 years ago 7 minutes, 51 seconds 764,454 views",Admas Music,764454,765379,925
613,"Said Berhanu - Qalkidan Neser | ቃልኪዳን ንእሰር - (Official Video) by ADMAS MUSIC 7 years ago 7 minutes, 3 seconds 1,721,333 views",Admas Music,1721333,1723142,1809
614,"Eritrean Music: Isaac Simon - Tizita Fikri | ትዝታ ፍቕሪ - Traditional 2014 | Halenga Eritrea by ADMAS MUSIC 8 years ago 8 minutes, 4 seconds 2,818,350 views",Admas Music,2818350,2826561,8211
615,"August 6, 2020 by Ãkìyã Entertainment 1 year ago 4 minutes, 13 seconds 15 views",Ãkìyã Entertainment,15,15,0
616,"August 6, 2020 by Ãkìyã Entertainment 1 year ago 4 minutes, 13 seconds 15 views",Ãkìyã Entertainment,15,16,1
617,"Epherm Amare    #@tiyo 🎧👈 by Ãkìyã Entertainment 2 years ago 4 minutes, 51 seconds 58 views",Ãkìyã Entertainment,58,59,1
618,"July 29, 2019 by Ãkìyã Entertainment 2 years ago 4 minutes, 53 seconds 19 views",Ãkìyã Entertainment,19,20,1
619,"July 29, 2019 by Ãkìyã Entertainment 2 years ago 1 minute, 56 seconds 12 views",Ãkìyã Entertainment,12,13,1
620,"New music Dawit Nega by Ãkìyã Entertainment 2 years ago 1 hour, 24 minutes 21,527 views",Ãkìyã Entertainment,21527,21630,103
621,"Andit Okbay amazing music by Ãkìyã Entertainment 3 years ago 7 minutes, 16 seconds 42 views",Ãkìyã Entertainment,42,45,3
622,"💗💗 so  l💖ve me  like do by Ãkìyã Entertainment 3 years ago 4 minutes, 13 seconds 12 views",Ãkìyã Entertainment,12,12,0
623,"The hearts wants what it wants by Ãkìyã Entertainment 3 years ago 3 minutes, 44 seconds 14 views",Ãkìyã Entertainment,14,15,1
624,"November 26, 2018 by Ãkìyã Entertainment 3 years ago 2 minutes, 20 seconds 14 views",Ãkìyã Entertainment,14,15,1
625,"Natural rose by Ãkìyã Entertainment 3 years ago 2 minutes, 55 seconds 13 views",Ãkìyã Entertainment,13,14,1
626,"Teshnfalhu by Ãkìyã Entertainment 3 years ago 5 minutes, 13 seconds 63 views",Ãkìyã Entertainment,63,64,1
627,"Wolayta Music -Hebebe Wopu - Aberash Gaga by Alex Shan 9 years ago 5 minutes, 7 seconds 212,894 views",Alex Shan,212894,213279,385
628,"Wolayta Music Beza Zeleke ft Samigo- Neban Neban by Alex Shan 9 years ago 5 minutes, 19 seconds 23,044 views",Alex Shan,23044,23085,41
629,"Wolayta,  the best Hip Hop - Holle Holle - Samigo by Alex Shan 9 years ago 2 minutes, 50 seconds 38,957 views",Alex Shan,38957,38971,14
630,"Asso Asso- Teddy Afro ft. Mamila & Kichini  2012 by Alex Shan 9 years ago 4 minutes, 33 seconds 104,812 views",Alex Shan,104812,105191,379
631,"Amazing moment of football fans in Addis Ababa, Meskel square- (Ethiopia 2-0 Sudan) by Alex Shan 9 years ago 6 minutes, 29 seconds 8,627 views",Alex Shan,8627,8628,1
632,"Wolayta Traditional food,,,, Nice one!!! Visit, taste then Rock with their music !!! by Alex Shan 9 years ago 16 minutes 27,777 views",Alex Shan,27777,27799,22
633,"Aroge Arada by ''Kako'' - Ethiopian Music - New version 2012 by Alex Shan 9 years ago 5 minutes, 10 seconds 116,724 views",Alex Shan,116724,118697,1973
634,"Wolayta music by Alemayehu Zassa- Kassay( Chewataw) by Alex Shan 10 years ago 4 minutes, 34 seconds 170,032 views",Alex Shan,170032,170420,388
635,"SebaSegel Metu Video by Tagel Seyfu.mp4 by Alex Shan 10 years ago 5 minutes, 55 seconds 3,973 views",Alex Shan,3973,3983,10
636,"Teddy Afro : Abay [Unofficial New Single] - Preview ONLY Video by Teddy Afro.mp4 by Alex Shan 10 years ago 59 seconds 2,734 views",Alex Shan,2734,2735,1
637,"Bethelihem Altaye ft Samson Ayele( Samigo)  ላሞቴሲ (ናፈቀኝ), ወላይትኛ by Alex Shan 10 years ago 4 minutes, 53 seconds 39,792 views",Alex Shan,39792,39869,77
638,"Taxi Driver and Teddy Afro song, so funny.flv by Alex Shan 10 years ago 5 minutes, 8 seconds 1,784 views",Alex Shan,1784,1785,1
639,"Jacky Gose  ''sela bey''!!  Nice one.flv by Alex Shan 10 years ago 5 minutes, 1 second 23,572 views",Alex Shan,23572,23578,6
640,"Waha Leyabe - Marta Getachew by Alex Shan 10 years ago 5 minutes, 5 seconds 2,061 views",Alex Shan,2061,2073,12
641,"Minyeshu  - Yopia-- Yopiaye... Yopiaye -Black ink -2011 by Alex Shan 10 years ago 4 minutes, 14 seconds 1,553 views",Alex Shan,1553,1569,16
642,"Wolayta New music 2011, Neway Debebe by Alex Shan 10 years ago 6 minutes, 14 seconds 319,603 views",Alex Shan,319603,320012,409
643,"Daniel Haylemichael - Seb Teqeyru - ዳኒኤል ሃይለሚካኤል - ሰብ ተቐይሩ - New Eritrean Music 2022(Official Video) by AMEN ENTERTAINMENT 3 hours ago 6 minutes, 50 seconds 491 views",AMEN ENTERTAINMENT,491,2296,1805
644,"AMEN - NEW ERITREAN MOVIE 2022 - UMUR TAKELA | ዑሙር ታኼላ - ሓዳስ ምሉእ ፊልም ብዮሃና በሪሁ by AMEN ENTERTAINMENT 13 days ago 1 hour, 9 minutes 4,107 views",AMEN ENTERTAINMENT,4107,4324,217
645,"AMEN - ዑሙር ታኼላ - Umur Takiela | ሓዳስ ፊልም ብዮሃና በሪሁ | New Eritrean Movie 2022 (Coming Soon) by AMEN ENTERTAINMENT 2 weeks ago 4 minutes, 9 seconds 1,416 views",AMEN ENTERTAINMENT,1416,1476,60
646,"AMEN - Abrahaley Mehari - Tesfaki’Berki | ተስፋኺ'በርኺ - New Eritrean Music 2022 by AMEN ENTERTAINMENT 2 weeks ago 4 minutes, 33 seconds 11,142 views",AMEN ENTERTAINMENT,11142,12037,895
647,"AMEN - Andemariam Siele - Uf Semay | ዑፍ ሰማይ - New Eritrean Music 2022 (Official Video) by AMEN ENTERTAINMENT 3 weeks ago 6 minutes, 52 seconds 13,742 views",AMEN ENTERTAINMENT,13742,13957,215
648,"AMEN - Wegahta Mehari (Gual Gash) - Seb Koine | ሰብ ኮይነ - ብወጋሕታ መሓሪ (ጓል ጋሽ) - New Eritrean Music 2022 by AMEN ENTERTAINMENT 1 month ago 6 minutes, 25 seconds 32,635 views",AMEN ENTERTAINMENT,32635,33120,485
649,"AMEN- AMSA | KILO - New Eritrean Music 2022 - Hip Hop Music (Official Video) by AMEN ENTERTAINMENT 1 month ago 2 minutes, 52 seconds 2,222 views",AMEN ENTERTAINMENT,2222,2252,30
650,"AMEN - ሓበን ኣለም - ከም ቀደም የለኹን - Haben Alem - Kem Qedem Yelekun - Eritrean Music 2022 - Tigrigna Music by AMEN ENTERTAINMENT 1 month ago 6 minutes, 21 seconds 11,087 views",AMEN ENTERTAINMENT,11087,11173,86
651,"AMEN - ማዓሾ የማነ - ፈቃር'ዶ ኣይነበርካን - Masho Yemane - Feqar'do Ayneberkan - New Eritrean Music 2022 by AMEN ENTERTAINMENT 2 months ago 4 minutes, 51 seconds 8,596 views",AMEN ENTERTAINMENT,8596,8695,99
652,"AMEN - ኣላይ ገረመ - ድንግላዊት ዓመት - Alay Gereme - Dnglawit Amet | New Eritrean Music 2022 (Official Video) by AMEN ENTERTAINMENT 2 months ago 5 minutes, 5 seconds 4,692 views",AMEN ENTERTAINMENT,4692,4750,58
653,"AMEN - Temesghen Wesani (Wedi Semere) - Hji Tblni Kukoneka - New Eritrean Music 2022 by AMEN ENTERTAINMENT 2 months ago 4 minutes, 19 seconds 6,794 views",AMEN ENTERTAINMENT,6794,6891,97
654,"AMEN - Tesfay Tewele (Aklis) - Abaka Yexhi Alo | ኣባኻ የጽሒ'ሎ - New Eritrean Music 2021 -Tigrigna Music by AMEN ENTERTAINMENT 2 months ago 4 minutes, 50 seconds 10,348 views",AMEN ENTERTAINMENT,10348,10474,126
655,"AMEN - Ermias Ghebrehiwet - Mensey | መንእሰይ - New Eritrean Music 2021 - Tigrigna Music by AMEN ENTERTAINMENT 2 months ago 4 minutes, 49 seconds 6,979 views",AMEN ENTERTAINMENT,6979,7016,37
656,"AMEN - Amanuel Zeriu - Hileley | ሒለለይ - New Eritrean Music 2021 - Tigrigna Music (Official Video) by AMEN ENTERTAINMENT 2 months ago 4 minutes, 45 seconds 8,047 views",AMEN ENTERTAINMENT,8047,8155,108
657,"AMEN - Shishay Haile (Azin) - Modeley | ሞዴለይ - New Eritrean Music 2021 (Official Video) by AMEN ENTERTAINMENT 2 months ago 3 minutes, 57 seconds 7,303 views",AMEN ENTERTAINMENT,7303,7346,43
658,"AMEN - Eazy 21Bullet - Meqeretey | መቐረተይ - (Official Video) - New Eritrean Hip Hop Music 2021 by AMEN ENTERTAINMENT 3 months ago 3 minutes, 27 seconds 7,443 views",AMEN ENTERTAINMENT,7443,7529,86
659,"AMEN - ወጋሕታ ምሉእ ፊልም Wegahta - New Eritrean Movie 2021 (Full Movie) by AMEN ENTERTAINMENT 3 months ago 2 hours, 47 minutes 88,199 views",AMEN ENTERTAINMENT,88199,101280,13081
660,"AMEN - Daniel Kesete - ውራየለ | Wurayele - New Eritrean Music 2021 (Official Video) by AMEN ENTERTAINMENT 3 months ago 5 minutes, 22 seconds 83,832 views",AMEN ENTERTAINMENT,83832,86286,2454
661,"AMEN - Nur Yosuf - Mishet Mishet | ምሸት ምሸት - New Eritrean Music 2021-Tigrigna Music (Official Video) by AMEN ENTERTAINMENT 3 months ago 5 minutes, 8 seconds 16,391 views",AMEN ENTERTAINMENT,16391,16509,118
662,"AMEN - Tsegay Mehari - Temelesi | ተመለሲ - New Eritrean Music 2021 - Tigrigna Music (Official Video) by AMEN ENTERTAINMENT 4 months ago 4 minutes, 27 seconds 5,838 views",AMEN ENTERTAINMENT,5838,5860,22
663,"AMEN - Berhane Weldemichael - Bnay Men Mircha | ብናይ መን ምርጫ -New Eritrean Music 2021 (Official Video) by AMEN ENTERTAINMENT 4 months ago 3 minutes, 43 seconds 4,256 views",AMEN ENTERTAINMENT,4256,4284,28
664,"AMEN - Daniel Berhane - Fqrey | ፍቕረይ - New Eritrean Music - Tigrigna Music by AMEN ENTERTAINMENT 4 months ago 3 minutes, 59 seconds 9,319 views",AMEN ENTERTAINMENT,9319,9354,35
665,"AMEN - Beraki Zeweldi (Absho) - Asli | ኣስሊ - New Eritrean Music 2021 (Official Video) by AMEN ENTERTAINMENT 5 months ago 4 minutes, 11 seconds 5,613 views",AMEN ENTERTAINMENT,5613,5637,24
666,"AMEN - John Tesfagabr - Tetaese | ተጣዒሰ - New Eritrean Tigrigna Music 2021 (Official Video) by AMEN ENTERTAINMENT 5 months ago 5 minutes, 3 seconds 7,756 views",AMEN ENTERTAINMENT,7756,7790,34
667,"AMEN - Michael Mehari - Msaki Kudum - New Eritrean Music 2021 - Tigrigna Music (Official Video) by AMEN ENTERTAINMENT 5 months ago 4 minutes, 20 seconds 13,647 views",AMEN ENTERTAINMENT,13647,13714,67
668,"Filmon Berhane (Jeriko) - Kmles’ye | ክምለስ'የ - New Eritrean Music 2021 (Official Video) by AMEN ENTERTAINMENT 5 months ago 6 minutes, 31 seconds 10,421 views",AMEN ENTERTAINMENT,10421,10483,62
669,"AMEN - Tekhlegergis Asrat (Harbi) - Hrmeti | ሕርመቲ - New Eritrean Music 2021 (Official Video) by AMEN ENTERTAINMENT 5 months ago 7 minutes, 2 seconds 32,471 views",AMEN ENTERTAINMENT,32471,32696,225
670,"AMEN - Ermias G7 - Adey | ኣደይ - New Eritrean Music 2021 (Official Video) by AMEN ENTERTAINMENT 5 months ago 4 minutes, 11 seconds 2,815 views",AMEN ENTERTAINMENT,2815,2862,47
671,"AMEN - Bereket Aynealem - Teraikni | ተራኢኽኒ - New Eritrean Music 2021 - Tigrigna Music by AMEN ENTERTAINMENT 5 months ago 6 minutes, 5 seconds 9,111 views",AMEN ENTERTAINMENT,9111,9208,97
672,"AMEN - Biniam Haile - Bleney - ቢንያም ሃይለ - ብሌነይ - New Eritrean Music 2021 (Official Video) by AMEN ENTERTAINMENT 6 months ago 5 minutes, 4 seconds 9,433 views",AMEN ENTERTAINMENT,9433,9472,39
673,"AMEN - Ogbay Mehari - Brurey - ዑቕባይ (ወዲ መሓሪ) - ብሩረይ - New Eritrean Music 2021 (Official Video) by AMEN ENTERTAINMENT 6 months ago 3 minutes, 41 seconds 21,312 views",AMEN ENTERTAINMENT,21312,21452,140
674,"AMEN -ፍናን መዓሾ (ሸጎዳ) - ቆንጆ ቆናጁ - Fnan (Shegoda) - Qonjo Qonaju - Eritrean Music 2021 - Tigrigna Music by AMEN ENTERTAINMENT 7 months ago 5 minutes, 27 seconds 18,652 views",AMEN ENTERTAINMENT,18652,19314,662
675,"ቀጥታዊ ምርኢት ብሙድመልት ባንድ | Eritrean Live Performance Music 2021 | Moodmeltt Band, Switzerland by AMEN ENTERTAINMENT 7 months ago 27 minutes 10,184 views",AMEN ENTERTAINMENT,10184,10325,141
676,"AMEN - ያቆብ ተስፋይ - በዲልካያ - Yacob Tesfay - Bedilkaya - New Eritrean Music 2021 (Official Video) by AMEN ENTERTAINMENT 7 months ago 5 minutes, 15 seconds 33,485 views",AMEN ENTERTAINMENT,33485,33682,197
677,"AMEN - ተኽሊት ክፍለ (ሜሪ) - ዓደይ - Teklit Kifle (Mieri) - Adey - New Eritrean Music 2021 (Official Video) by AMEN ENTERTAINMENT 7 months ago 4 minutes, 51 seconds 52,526 views",AMEN ENTERTAINMENT,52526,52788,262
678,"AMEN - Anday Tekle (ጋቸ) - Harestay Hagerna | ሓረስታይ ሃገርና - New Eritrean Music 2021 (Official Audio) by AMEN ENTERTAINMENT 7 months ago 5 minutes, 2 seconds 6,062 views",AMEN ENTERTAINMENT,6062,6114,52
679,"AMEN - ደበሳይ ሓይልኣብ (ደብሽ) - ሄዋን - Debesay Haileab - Hewan - New Eritrean Music 2021 (Official Audio) by AMEN ENTERTAINMENT 7 months ago 4 minutes, 18 seconds 4,239 views",AMEN ENTERTAINMENT,4239,4290,51
680,"AMEN - Kidane G/Hiwet (Zegem) - Ade Ngsti Sdra - New Eritrean Music 2021 (Official Audio) by AMEN ENTERTAINMENT 7 months ago 6 minutes, 1 second 5,063 views",AMEN ENTERTAINMENT,5063,5118,55
681,"AMEN - Hagos Zeresenay (Abi) ft. Semere (Wedi Gebru) - Aymenenan | ኣይመነናን - New Eritrean Music by AMEN ENTERTAINMENT 7 months ago 5 minutes, 18 seconds 4,459 views",AMEN ENTERTAINMENT,4459,4508,49
682,"AMEN -  Tesfalem Tsegay (Wedi Tsegay) - Zebibey | ዘቢበይ - New Eritrean Music (Official Music) by AMEN ENTERTAINMENT 8 months ago 4 minutes, 28 seconds 5,607 views",AMEN ENTERTAINMENT,5607,5632,25
683,"AMEN - Merhawi Kbrom - Edley Tsebiku | ዕድለይ ጸቢቑ - New Eritrean Music 2021 (Official Video) by AMEN ENTERTAINMENT 8 months ago 3 minutes, 50 seconds 12,203 views",AMEN ENTERTAINMENT,12203,12308,105
684,"AMEN - Tedros Sium - Aytbedlwa | ኣይትበድልዋ - New Eritrean Music 2021 (Official Video) by AMEN ENTERTAINMENT 8 months ago 4 minutes, 1 second 14,591 views",AMEN ENTERTAINMENT,14591,14749,158
685,"AMEN - Simon Tesheme - Nabey Ina - New Eritrean Music 2021 (Official Video) by AMEN ENTERTAINMENT 8 months ago 5 minutes, 23 seconds 15,195 views",AMEN ENTERTAINMENT,15195,15224,29
686,"AMEN - Ariam ft. Adiam (ኣM Sisters) - Merawi | መርዓዊ - New Eritrean Music 2021 (Official Lyric Video) by AMEN ENTERTAINMENT 8 months ago 3 minutes, 46 seconds 12,307 views",AMEN ENTERTAINMENT,12307,12332,25
687,"AMEN - Robel Medhanie (Wedi Abayu) - Tesfa | ተስፋ - New Eritrean Music 2021 (Official Video) by AMEN ENTERTAINMENT 8 months ago 5 minutes, 44 seconds 48,541 views",AMEN ENTERTAINMENT,48541,48797,256
688,"AMEN- Zerisenay Fsihaye - Zemen | ዘመን - New Eritrean Music 2021 by AMEN ENTERTAINMENT 8 months ago 4 minutes, 47 seconds 7,728 views",AMEN ENTERTAINMENT,7728,7755,27
689,"AMEN - Sami Ezra - Maeregey | ማዕረገይ - New Eritrean Music 2021 (Official Audio) by AMEN ENTERTAINMENT 9 months ago 4 minutes, 27 seconds 19,728 views",AMEN ENTERTAINMENT,19728,19786,58
690,"AMEN - Henok Nega (Wedi Nega) - Qedemna - New Eritrean Music 2021 (Official Video) by AMEN ENTERTAINMENT 9 months ago 4 minutes, 48 seconds 12,369 views",AMEN ENTERTAINMENT,12369,12396,27
691,"AMEN - Michael Teklay (Tela) - Ria Zseanet | ሪኣ ዝሰኣነት - New Eritrean Music 2021 (Official Video) by AMEN ENTERTAINMENT 9 months ago 5 minutes, 5 seconds 14,667 views",AMEN ENTERTAINMENT,14667,14710,43
692,"AMEN - Russom Mebrahtu - ኣነስ ኣይቀሰንኩን | Anes Ayqesenkun - New Eritrean Music 2021 (Official Audio) by AMEN ENTERTAINMENT 9 months ago 4 minutes, 27 seconds 6,331 views",AMEN ENTERTAINMENT,6331,6352,21
693,"AMEN - Medhanie G/Medhn (ንኡሰይ) ft. Kiflom Ykealo - Dluw Dika | ድሉው ዲኻ - Eritrean Tigrigna Music 2021 by AMEN ENTERTAINMENT 9 months ago 7 minutes, 9 seconds 1,255,229 views",AMEN ENTERTAINMENT,1255229,1267667,12438
694,"AMEN - Tsege Hagos (Krarist) - Tenqi Sdet | ጠንቂ ስደት - New Eritrean Music 2021 (Official Video) by AMEN ENTERTAINMENT 10 months ago 3 minutes, 50 seconds 44,997 views",AMEN ENTERTAINMENT,44997,45096,99
695,"AMEN - Hager Semere - Melikato Eya Xegema | መሊኻቶ እያ ጸገማ - New Eritrean Music 2021 (Official Video) by AMEN ENTERTAINMENT 10 months ago 5 minutes, 7 seconds 18,031 views",AMEN ENTERTAINMENT,18031,18107,76
696,"Bruk Chombie - Ftsum Beraki - Aklilu Hadera - Abraham Misgna - ኤርትራውነት | Eritrean Music 2021 by AMEN ENTERTAINMENT 10 months ago 4 minutes, 47 seconds 160,228 views",AMEN ENTERTAINMENT,160228,161142,914
697,"AMEN - Furtuna Nesterab - Zeyhalfeley | ዘይሓልፈለይ - New Eritrean Music 2021 (Official VIdeo) by AMEN ENTERTAINMENT 10 months ago 4 minutes, 31 seconds 20,569 views",AMEN ENTERTAINMENT,20569,20594,25
698,"Habtom Tekeste (Fetishe) - Ewan Hadnet | እዋን ሓድንት - New Eritrean Music 2021 by AMEN ENTERTAINMENT 10 months ago 4 minutes, 32 seconds 19,014 views",AMEN ENTERTAINMENT,19014,19022,8
699,"AMEN - Esayas Misgna - Zhshena Nmker | ዝሕሸና ንምከር - New Eritrean Music 2021 (Official Video) by AMEN ENTERTAINMENT 10 months ago 3 minutes, 45 seconds 14,746 views",AMEN ENTERTAINMENT,14746,14776,30
700,"AMEN - Nahom Tesfalem (Hubi) - Eru | ኤሩ - New Eritrean Music 2021 (Official Video) by AMEN ENTERTAINMENT 10 months ago 5 minutes, 2 seconds 286,406 views",AMEN ENTERTAINMENT,286406,286731,325
701,"AMEN - Bereket Fkare - Tehawawisuni | ተሓዋዊሱኒ - New Eritrean Music 2021 (Official Video) by AMEN ENTERTAINMENT 11 months ago 4 minutes, 48 seconds 21,791 views",AMEN ENTERTAINMENT,21791,21850,59
702,"AMEN - Mehari Nguse - Kem Hlmey Kuni | ከም ሕልመይ'ባ ኩኒ - New Eritrean Music 2021 (Official Video) by AMEN ENTERTAINMENT 11 months ago 5 minutes, 17 seconds 4,235 views",AMEN ENTERTAINMENT,4235,4239,4
703,"AMEN - Yemane Goitom - Nsley Kab Konki | ንስለይ ካብ ኮንኪ - New Eritrean Music 2021 (Official Audio) by AMEN ENTERTAINMENT 11 months ago 5 minutes, 3 seconds 5,808 views",AMEN ENTERTAINMENT,5808,5815,7
704,"AMEN - Abraham Zeremariam - Jema Nieromuni | ጀምዓ ኔረሙኒ - New Eritrean Music 2021 (Official Video) by AMEN ENTERTAINMENT 11 months ago 3 minutes, 36 seconds 5,535 views",AMEN ENTERTAINMENT,5535,5552,17
705,"AMEN - Tedros Amanuel (Wedi Ema) - Entay Ykun | እንታይ ይኹን - New Eritrean Music 2021 (Official Video) by AMEN ENTERTAINMENT 11 months ago 5 minutes, 2 seconds 16,277 views",AMEN ENTERTAINMENT,16277,16303,26
706,"AMEN - Gide Okbamichael - Ayqebxekn'ye - New Eritrean Music 2021 by AMEN ENTERTAINMENT 11 months ago 5 minutes, 9 seconds 12,305 views",AMEN ENTERTAINMENT,12305,12316,11
707,"AMEN - Keven Tesfalem (Aki) -  Nslieki Ele | ንስሌኺ ኢለ - New Eritrean Music 2021 by AMEN ENTERTAINMENT 1 year ago 5 minutes, 45 seconds 12,885 views",AMEN ENTERTAINMENT,12885,12929,44
708,"AMEN - Paulos Teklezghi - Ab Fqri'ba Nnber | ኣብ ፍቕሪ'ባ ንንበር - New Eritrean Music 2021 by AMEN ENTERTAINMENT 1 year ago 6 minutes, 39 seconds 43,995 views",AMEN ENTERTAINMENT,43995,44013,18
709,"AMEN - Alay Asgodom - Kemey Kilkmo | ከመይ ክኢልክሞ - New Eritrean Music 2021 (Official Video) by AMEN ENTERTAINMENT 1 year ago 7 minutes, 23 seconds 7,642 views",AMEN ENTERTAINMENT,7642,7656,14
710,"AMEN - Daniel Ghirmay - Zelalemawitey | ዘልኣለማዊተይ - New Eritrean Tigrigna Music 2021 by AMEN ENTERTAINMENT 1 year ago 6 minutes, 22 seconds 11,147 views",AMEN ENTERTAINMENT,11147,11174,27
711,"AMEN - Yonatan Kahsay - Shima Lbey | ሽምዓ ልበይ - New Eritrean Music 2021 (Official Video) by AMEN ENTERTAINMENT 1 year ago 6 minutes, 4 seconds 28,592 views",AMEN ENTERTAINMENT,28592,28632,40
712,"AMEN - Mussie Zekarias (ወዲ ዘኩ) - Aymlketenn'do Ilkiyo | ኣይምልከተንን'ዶ ኢልክዮ - New Eritrean Music 2021 by AMEN ENTERTAINMENT 1 year ago 5 minutes, 21 seconds 201,927 views",AMEN ENTERTAINMENT,201927,202055,128
713,"AMEN - Hana G/Michael - Maeger - ሃና ገ/ሚካኤል - ማአገር - New Eritrean Music 2021 (Official Video) by AMEN ENTERTAINMENT 1 year ago 4 minutes, 43 seconds 8,216 views",AMEN ENTERTAINMENT,8216,8238,22
714,"AMEN - Aman Solomon - Fqrey Nie'ba | ፍቕረይ ንዒ'ባ - New Eritrean Music 2021 (Official Audio) by AMEN ENTERTAINMENT 1 year ago 4 minutes, 41 seconds 6,349 views",AMEN ENTERTAINMENT,6349,6357,8
715,"Samuel Tesfagabr - Alemey Rie | ዓለመይ ርኤ - New Eritrean Music 2021 (Official Video) by AMEN ENTERTAINMENT 1 year ago 5 minutes, 20 seconds 11,593 views",AMEN ENTERTAINMENT,11593,11605,12
716,"Dawit Kidane (Gagu) - Zban Hgi - ዳዊት ኪዳነ (ጋጉ) - ዝባን ሕጊ - New Eritrean Music 2021 by AMEN ENTERTAINMENT 1 year ago 5 minutes, 32 seconds 33,553 views",AMEN ENTERTAINMENT,33553,33658,105
717,"Haben Gerie (Joker) - Htam'ki - ሓበን (ጆኬር) - ህጣምኪ - New Eritrean Music 2021 (Official Video) by AMEN ENTERTAINMENT 1 year ago 4 minutes, 45 seconds 13,352 views",AMEN ENTERTAINMENT,13352,13376,24
718,"Michael W/Mhret (መኒዓ) - Ksr'ye | ክስዕር'የ - New Eritrean Music 2021 (Official Video) by AMEN ENTERTAINMENT 1 year ago 4 minutes, 55 seconds 9,814 views",AMEN ENTERTAINMENT,9814,9844,30
719,"AMEN - Sirak Nguse - Merhawi Tekle - NMEKAKER | ንመኻኸር - New Eritrean Music 2021 (Official Video) by AMEN ENTERTAINMENT 1 year ago 6 minutes, 2 seconds 13,169 views",AMEN ENTERTAINMENT,13169,13183,14
720,"AMEN - Aman Talke - ቦሎ | Rap - New Eritrean Music 2021 (Official Rap Video) by AMEN ENTERTAINMENT 1 year ago 3 minutes, 25 seconds 4,111 views",AMEN ENTERTAINMENT,4111,4130,19
721,"AMEN - Merkeb Zersenay - Welela | ወለላ - New Eritrean Tigrigna Music 2021 (Official Video) by AMEN ENTERTAINMENT 1 year ago 4 minutes, 2 seconds 20,619 views",AMEN ENTERTAINMENT,20619,20655,36
722,"AMEN - Abel Abraham - Ntehalale | ንተሓላለ - New Modern Eritrean Music 2021 (Official Video) by AMEN ENTERTAINMENT 1 year ago 5 minutes, 37 seconds 10,692 views",AMEN ENTERTAINMENT,10692,10706,14
723,"AMEN - Haben Alem - Gdefi'ba | ግደፊ'ባ - New Eritrean Music 2021 (Official Video) by AMEN ENTERTAINMENT 1 year ago 5 minutes, 25 seconds 8,326 views",AMEN ENTERTAINMENT,8326,8332,6
724,"AMEN - Atebrhan Ghirmay (Atie) - Feridkni Beyney | ፈሪድክኒ በይነይ - New Eritrean Music 2021 by AMEN ENTERTAINMENT 1 year ago 5 minutes, 16 seconds 12,132 views",AMEN ENTERTAINMENT,12132,12159,27
725,"AMEN - Haben Kiflay | ኣፈርክቢ - Aferkbi - New Eritrean Music 2021 (Official Video) by AMEN ENTERTAINMENT 1 year ago 5 minutes, 4 seconds 11,729 views",AMEN ENTERTAINMENT,11729,11741,12
726,"AMEN - Ftsum Gebru (ወዲ ገባር) - Abey Keydu | ኣበይ ከይዱ (Official Video) - New Eritrean Music 2021 by AMEN ENTERTAINMENT 1 year ago 5 minutes, 54 seconds 206,792 views",AMEN ENTERTAINMENT,206792,207225,433
727,"AMEN - Bereket Habteab - Aferkbi | ኣፈርክቢ - New Eritrean Music 2021 (Official Video) by AMEN ENTERTAINMENT 1 year ago 5 minutes, 20 seconds 15,371 views",AMEN ENTERTAINMENT,15371,15405,34
728,"AMEN - Lidya Teklemariam - Zeyre Tki - ሊድያ ተ/ማርያም - ዘይርአ ትኪ - New Eritrean Music 2021 by AMEN ENTERTAINMENT 1 year ago 4 minutes, 42 seconds 33,482 views",AMEN ENTERTAINMENT,33482,33566,84
729,"AMEN - Dawit Seilay - Welela | ወለላ - New Eritrean Music 2021 (Official Video) by AMEN ENTERTAINMENT 1 year ago 4 minutes, 19 seconds 40,770 views",AMEN ENTERTAINMENT,40770,40793,23
730,"AMEN - Amanuel Tesfalem - Nafqot | ናፍቖት - New Eritrean Music 2021 (Official Video) by AMEN ENTERTAINMENT 1 year ago 5 minutes, 20 seconds 24,857 views",AMEN ENTERTAINMENT,24857,24886,29
731,"AMEN - Ezekiel - Fnan - Biniam - Yonas | New Year - ሓዲሽ ዓመት | New Eritrean Music 2021 by AMEN ENTERTAINMENT 1 year ago 3 minutes, 54 seconds 6,129 views",AMEN ENTERTAINMENT,6129,6133,4
732,"AMEN - Efrem G/Hiwet - Fetnni | ፈትንኒ - New Eritrean Music 2021 (Official Video) by AMEN ENTERTAINMENT 1 year ago 3 minutes, 54 seconds 18,012 views",AMEN ENTERTAINMENT,18012,18044,32
733,"AMEN - Habtemichael Zemo (Wedi Zemo) - Nmfllay Diyu Nieru | ንምፍልላይ ዲዩ ኔሩ - New Tigrigna Music 2020 by AMEN ENTERTAINMENT 1 year ago 5 minutes, 50 seconds 11,706 views",AMEN ENTERTAINMENT,11706,11724,18
734,"AMEN - Ariam Michael (ኣM Sisters) - Qonjoye | ቆንጆየ (Official Music) New Eritrean Music 2020 #Tedalo by AMEN ENTERTAINMENT 1 year ago 4 minutes, 48 seconds 14,413 views",AMEN ENTERTAINMENT,14413,14455,42
735,"AMEN - Awet G/Michael (Hafis) - Sesegey | ሰሰገይ - New Eritrean Music 2020 (Official Video) by AMEN ENTERTAINMENT 1 year ago 5 minutes, 14 seconds 24,067 views",AMEN ENTERTAINMENT,24067,24099,32
736,"AMEN - Jemal Ahmed (Gonbolo) - Ykeleki | ይእከለኪ - New Eritrean Music 2020 (Official Video) by AMEN ENTERTAINMENT 1 year ago 6 minutes, 33 seconds 38,745 views",AMEN ENTERTAINMENT,38745,38832,87
737,"AMEN - Dawit Melake (Wedi Mamma) - Fqri'yu Drara | ፍቕሪ'ዩ ድራራ - New Eritrean Music 2020 by AMEN ENTERTAINMENT 1 year ago 3 minutes, 43 seconds 22,159 views",AMEN ENTERTAINMENT,22159,22200,41
738,"AMEN - Awet Amanuel - ስንቀይ | Snqey - New Eritrean Music 2020 (Official Video) by AMEN ENTERTAINMENT 1 year ago 5 minutes, 16 seconds 21,782 views",AMEN ENTERTAINMENT,21782,21835,53
739,"AMEN - Gurum Habtom - Gobo Lbey | ጎቦ ልበይ - New Eritrean Music 2020 (Official Video) by AMEN ENTERTAINMENT 1 year ago 5 minutes, 11 seconds 7,783 views",AMEN ENTERTAINMENT,7783,7794,11
740,"AMEN - Estifanos Abraham (Zemach) - Afqri | ኣፍቅሪ ብእስቲፋኖስ ኣብርሃም (ዘማች) - New Eritrean Music 2020 by AMEN ENTERTAINMENT 1 year ago 5 minutes, 18 seconds 125,328 views",AMEN ENTERTAINMENT,125328,125586,258
741,"AMEN - Kidane G/Hiwet (Funti) - Lwamey | ልዋመይ (Official Video) - New Eritrean Music 2020 by AMEN ENTERTAINMENT 1 year ago 4 minutes, 12 seconds 13,815 views",AMEN ENTERTAINMENT,13815,13842,27
742,"Ermyas G7 - Tegadalay - New Eritrean Music 2020 (Official Lyrics Video) by AMEN ENTERTAINMENT 1 year ago 2 minutes, 18 seconds 2,855 views",AMEN ENTERTAINMENT,2855,2864,9
743,"AMEN - Mana Fikak - Rima | ሪማ - New Eritrean Music 2020 (Official Video) by AMEN ENTERTAINMENT 1 year ago 6 minutes, 53 seconds 54,908 views",AMEN ENTERTAINMENT,54908,54989,81
744,"AMEN - Shishay Assefa - Tesfa’ya Drarey | ተስፋ'ያ ድራርይ - New Eritrean Music 2020 by AMEN ENTERTAINMENT 1 year ago 5 minutes, 27 seconds 9,737 views",AMEN ENTERTAINMENT,9737,9751,14
745,"AMEN - Ermyas G7 - RIP (Official Music Video) | Eritrean Music 2020 by AMEN ENTERTAINMENT 1 year ago 5 minutes, 17 seconds 6,671 views",AMEN ENTERTAINMENT,6671,6687,16
746,"AMEN - Ykealo Beyn (Korea) - Abayki | ኣባይኪ - New Eritrean Music 2020 (Official Video) by AMEN ENTERTAINMENT 1 year ago 4 minutes, 33 seconds 103,281 views",AMEN ENTERTAINMENT,103281,103452,171
747,"AMEN - Merhawi Tekle (Ashegari) - Ayteqeyerkun - New Eritrean Music 2020 (Official Video) by AMEN ENTERTAINMENT 1 year ago 4 minutes, 46 seconds 9,934 views",AMEN ENTERTAINMENT,9934,9952,18
748,"AMEN - Ariam Michael (ኣM Sisters) - ቆንጆየ | Qonjoye - New Eritrean Music 2020 [COMING SOON] by AMEN ENTERTAINMENT 1 year ago 55 seconds 13,939 views",AMEN ENTERTAINMENT,13939,13945,6
749,"AMEN - Nahom Tesfalem (Hubi) - Deqi Hanti Mahxen | ደቂ ሓንቲ ማህጸን - New Eritrean Music 2020 by AMEN ENTERTAINMENT 1 year ago 5 minutes, 33 seconds 320,987 views",AMEN ENTERTAINMENT,320987,321337,350
750,"AMEN - Semere Abraham - Kezezeki | ክእዘዘኪ - New Eritrean Music 2020 (Official Video) by AMEN ENTERTAINMENT 1 year ago 4 minutes, 52 seconds 35,152 views",AMEN ENTERTAINMENT,35152,35214,62
751,"AMEN - Robel Amare - Yhsheni Do Elki | ይሕሸኒ ዶ ኢልኪ - New Eritrean Music 2020 (Official Video) by AMEN ENTERTAINMENT 1 year ago 4 minutes, 52 seconds 8,695 views",AMEN ENTERTAINMENT,8695,8711,16
752,"AMEN - Sami Teklay - Kidi Beli ኪዲ በሊ - New Eritrean Music 2020 (Official Video) by AMEN ENTERTAINMENT 1 year ago 5 minutes, 56 seconds 19,185 views",AMEN ENTERTAINMENT,19185,19226,41
753,"Nahom Tesfalem (Hubi) - Deki Hanti Mahtsen | ደቂ ሓንቲ ማህጸን - New Eritrean Music 2020 [Coming Soon] by AMEN ENTERTAINMENT 1 year ago 6 minutes, 49 seconds 89,884 views",AMEN ENTERTAINMENT,89884,89899,15
754,"AMEN - Shewhat Yohannes - Mchet | ምጨት - New Eritrean Music 2020 (Official Music) by AMEN ENTERTAINMENT 1 year ago 6 minutes, 16 seconds 107,400 views",AMEN ENTERTAINMENT,107400,108011,611
755,"AMEN - Tesfamariam Negasi ft. Mengsteab Hagos - Eyo'lena - Eritrean Tigrigna Music by AMEN ENTERTAINMENT 1 year ago 6 minutes, 9 seconds 6,391 views",AMEN ENTERTAINMENT,6391,6398,7
756,"AMEN - Tezaze Okbay - Habesha'ye Ane | ሓበሻ'የ ኣነ - New Eritrean Music 2020 (Official Video) by AMEN ENTERTAINMENT 1 year ago 5 minutes, 39 seconds 18,927 views",AMEN ENTERTAINMENT,18927,18935,8
757,"AMEN - Kuhlen Wedi Ebe - Nfqri Aytbedl | ንፍቕሪ ኣይትበድል - New Eritrean Music 2020 (Official Video) by AMEN ENTERTAINMENT 1 year ago 5 minutes, 2 seconds 11,306 views",AMEN ENTERTAINMENT,11306,11325,19
758,"AMEN - Telime'die - ጠሊመ'ዴ Part 1 Haben Teame (Habengo) ብሓበን ጠዓመ (ሓቤንጎ) - New Eritrean Comedy 2020 by AMEN ENTERTAINMENT 1 year ago 15 minutes 68,669 views",AMEN ENTERTAINMENT,68669,68727,58
759,"AMEN - Meron Russom (ወዲ ስክስቲን) - Abey'mo Lomi | ኣበይ'ሞ ሎሚ - New Eritrean Music 2020 (Official Video) by AMEN ENTERTAINMENT 1 year ago 4 minutes, 24 seconds 17,279 views",AMEN ENTERTAINMENT,17279,17292,13
760,"AMEN - Ermyas G7 - Taymo (Official Video) - Hazo 2 | New Eritrean Hip Hop Music 2020 by AMEN ENTERTAINMENT 1 year ago 5 minutes, 53 seconds 11,227 views",AMEN ENTERTAINMENT,11227,11263,36
761,"AMEN - Yohana Goitom - Aybelkn Diki | ኣይበልክን ዲኺ - New Eritrean Music 2020 (Official Video) by AMEN ENTERTAINMENT 1 year ago 5 minutes, 3 seconds 14,109 views",AMEN ENTERTAINMENT,14109,14125,16
762,"AMEN - Kaleab Rezene (Charu) - Rekibe | ረኺበ - New Eritrean Music 2020 (Official Video) by AMEN ENTERTAINMENT 1 year ago 4 minutes, 35 seconds 11,644 views",AMEN ENTERTAINMENT,11644,11668,24
763,"AMEN - Rgat Simon - Tezareb | ተዛረብ - New Eritrean Music 2020 (Official Video) by AMEN ENTERTAINMENT 1 year ago 5 minutes, 29 seconds 11,132 views",AMEN ENTERTAINMENT,11132,11148,16
764,"AMEN - Medhanie Michael - Ngeruley | ንገሩለይ - New Eritrean Music 2020 (Official Video) by AMEN ENTERTAINMENT 1 year ago 5 minutes, 51 seconds 21,141 views",AMEN ENTERTAINMENT,21141,21245,104
765,"AMEN - Mebrahtu Mamay (Mokria) - Ab Tsibah Emeni | ኣብ ጽባሕ እመኒ - New Ethiopian Music 2020 by AMEN ENTERTAINMENT 1 year ago 5 minutes, 42 seconds 7,974 views",AMEN ENTERTAINMENT,7974,7979,5
766,"AMEN - Daniel Kesete - Reda | ረዳ - New Eritrean Music 2020 (Official Video) by AMEN ENTERTAINMENT 1 year ago 5 minutes, 58 seconds 168,840 views",AMEN ENTERTAINMENT,168840,169730,890
767,"AMEN - Haben Okbamichael (ወዲ ሳርቶ) - Nafiqe | ናፊቐ - New Eritrean Music 2020 (Official Video) by AMEN ENTERTAINMENT 1 year ago 4 minutes, 32 seconds 16,780 views",AMEN ENTERTAINMENT,16780,16818,38
768,"AMEN - Okbay Habtetsion (Eliza) -  Ane Aykonkun Bedile | ኣነ ኣይኮንኩን በዲለ - New Eritrean Music 2020 by AMEN ENTERTAINMENT 1 year ago 5 minutes, 9 seconds 14,412 views",AMEN ENTERTAINMENT,14412,14431,19
769,"AMEN - Abraham Weldegebriel - Neaki - New Eritrean Music 2020 by AMEN ENTERTAINMENT 1 year ago 4 minutes, 12 seconds 19,478 views",AMEN ENTERTAINMENT,19478,19520,42
770,"AMEN - Adway Teklezghi - Kqebtseki'ye | ክቐብጸኪ'የ - New Eritrean Music 2020 (Official Video) by AMEN ENTERTAINMENT 1 year ago 6 minutes, 45 seconds 226,807 views",AMEN ENTERTAINMENT,226807,227281,474
771,"AMEN - Daniel Yohannes - Brqi | ብርቂ - New Eritrean Music 2020 (Official Video) by AMEN ENTERTAINMENT 1 year ago 4 minutes, 54 seconds 40,992 views",AMEN ENTERTAINMENT,40992,41021,29
772,"Daniel Estifanos ft. Lul Tedros - Lbey Kzeryelu | ልበይ ክዘርየሉ - Eritrean Music 2020 (Official Video) by AMEN ENTERTAINMENT 1 year ago 4 minutes, 56 seconds 106,206 views",AMEN ENTERTAINMENT,106206,106356,150
773,"AMEN - Esayas Misgna - Men Alo | መን ኣሎ - New Eritrean Music 2020 (Official VIdeo) by AMEN ENTERTAINMENT 1 year ago 6 minutes, 1 second 20,829 views",AMEN ENTERTAINMENT,20829,20866,37
774,"AMEN - Yohannes Abraha - Lul Bahri Adey | ሉል ባሕሪ ኣደይ - New Eritrean Music 2020 (Official Video) by AMEN ENTERTAINMENT 1 year ago 5 minutes, 48 seconds 13,832 views",AMEN ENTERTAINMENT,13832,13853,21
775,"Michael (Wedi Goje) - Htetuley Nzfelteni | ሕተቱለይ ንዝፈልጠኒ - New Eritrean Music 2020 (Official Video) by AMEN ENTERTAINMENT 1 year ago 7 minutes, 1 second 53,217 views",AMEN ENTERTAINMENT,53217,53240,23
776,"AMEN - Habom Mihretrab (Wedi Gelay) - Metabitey - New Eritrean Music 2020 (Official Video) by AMEN ENTERTAINMENT 1 year ago 5 minutes, 48 seconds 12,187 views",AMEN ENTERTAINMENT,12187,12198,11
777,"AMEN - Samuel Sium (Sye) - Bedilkni | በዲልክኒ - New Eritrean Music 2020 (Official Video) by AMEN ENTERTAINMENT 1 year ago 3 minutes, 47 seconds 7,771 views",AMEN ENTERTAINMENT,7771,7779,8
778,"AMEN - Filmon Mekonnen - Alekulki | ኣለኹልኪ - New Eritrean Music 2020 (Official Video) by AMEN ENTERTAINMENT 1 year ago 5 minutes, 21 seconds 15,181 views",AMEN ENTERTAINMENT,15181,15194,13
779,"AMEN - Merhawi Negede - Zermo Zermo | ዘርሞ ዘርሞ - New Eritrean Music 2020 (Official Video) by AMEN ENTERTAINMENT 1 year ago 6 minutes, 19 seconds 13,175 views",AMEN ENTERTAINMENT,13175,13190,15
780,"AMEN - Debas Zerabruk (Wedi Foto) - Brey | ብረይ - New Eritrean Music 2020 (Official Video) by AMEN ENTERTAINMENT 1 year ago 6 minutes, 12 seconds 33,113 views",AMEN ENTERTAINMENT,33113,33137,24
781,"AMEN - Sirak Fitsum - Nafiqeyo Hqfoki | ናፊቐዮ ሕቕፎኪ - New Eritrean Music 2020 (Official Video) by AMEN ENTERTAINMENT 1 year ago 5 minutes, 5 seconds 11,154 views",AMEN ENTERTAINMENT,11154,11165,11
782,"AMEN - Habtom Haile - Welelay | ወለላይ - New Eritrean Tigrigna Music 2020 by AMEN ENTERTAINMENT 1 year ago 4 minutes, 26 seconds 8,122 views",AMEN ENTERTAINMENT,8122,8137,15
783,"AMEN - Sirak Ngusse (Saka) - Feruzey | ፌሩዘይ - New Eritrean Music 2020 (Official Video) by AMEN ENTERTAINMENT 1 year ago 4 minutes, 36 seconds 27,093 views",AMEN ENTERTAINMENT,27093,27112,19
784,"AMEN - Kiflom Asmelash - Moshtat Melhas | ሞሽጣት መልሓስ - New Eritrean Music 2020 (Official Video) by AMEN ENTERTAINMENT 1 year ago 4 minutes, 29 seconds 16,890 views",AMEN ENTERTAINMENT,16890,16904,14
785,"AMEN - Medhanit Weldehaimanot- Ane ZeleKwo | ኣነ ዘለኽዎ - New Eritrean Music 2020 (Official Video) by AMEN ENTERTAINMENT 1 year ago 4 minutes, 59 seconds 41,088 views",AMEN ENTERTAINMENT,41088,41144,56
786,"AMEN - Josi Kiflay - Mamma Brhaney | ማማ ብርሃነይ - New Eritrean Music 2020 (Official Video) by AMEN ENTERTAINMENT 1 year ago 5 minutes, 7 seconds 16,095 views",AMEN ENTERTAINMENT,16095,16112,17
787,"AMEN - Okubay Araya - Lewah Kem Adey | ለዋህ ከም ኣደይ - New Eritrean Music 2020 (Official Video) by AMEN ENTERTAINMENT 1 year ago 5 minutes, 33 seconds 78,066 views",AMEN ENTERTAINMENT,78066,78108,42
788,"AMEN - AMEN - Yemane Zeray - Tearemi | ተኣረሚ - Eritrean Music 2020 (Official Video) by AMEN ENTERTAINMENT 1 year ago 5 minutes, 16 seconds 29,355 views",AMEN ENTERTAINMENT,29355,29388,33
789,"AMEN - Fitsum Zemichael - Men Eka | መን ኢኻ (Official Music Video) - Eritrean Modern Music 2020 by AMEN ENTERTAINMENT 1 year ago 6 minutes, 17 seconds 89,512 views",AMEN ENTERTAINMENT,89512,89590,78
790,"AMEN - NHNA | ንሕና - Biniam Chapin - Abraham Gumsa - Rezene Amine - Awet Hagos - Eritrean Music 2020 by AMEN ENTERTAINMENT 1 year ago 4 minutes, 37 seconds 141,701 views",AMEN ENTERTAINMENT,141701,141828,127
791,"ንዝኽሪ ስዉእ ስነ-ጥበባዊ ኢሰያስ ጸጋይ ''ኣይመሰላን'' ብእስቲፋኖስ ኣብርሃም (ዘማች) - Estifanos Abraham Zemach - Eritrean Music by AMEN ENTERTAINMENT 1 year ago 8 minutes, 52 seconds 20,207 views",AMEN ENTERTAINMENT,20207,20268,61
792,"AMEN - Estifanos Abraham (Zemach) - Musika Lbi'yu | ሙዚቃ ልቢ’ዩ - Eritrean Music (Official Stage Video) by AMEN ENTERTAINMENT 1 year ago 3 minutes, 29 seconds 12,579 views",AMEN ENTERTAINMENT,12579,12634,55
793,"AMEN - ኢንቪቴሽን 3ይ ክፋል INVITATION PART 3 | ERITREAN MOVIE | (OFFICIAL MOVIE) by AMEN ENTERTAINMENT 1 year ago 34 minutes 44,610 views",AMEN ENTERTAINMENT,44610,44761,151
794,"AMEN - ኢንቪቴሽን 2ይ ክፋል INVITATION PART 2 | ERITREAN MOVIE | (OFFICIAL MOVIE) by AMEN ENTERTAINMENT 1 year ago 32 minutes 41,233 views",AMEN ENTERTAINMENT,41233,41379,146
795,"AMEN - Efrem Tesfe (ሽጉጥ) - Seb Gierna'lena | ሰብ ጌርና'ለና - New Eritrean Music 2020 (Official Video) by AMEN ENTERTAINMENT 1 year ago 5 minutes, 13 seconds 18,552 views",AMEN ENTERTAINMENT,18552,18558,6
796,"AMEN - Simon Tesheme - Aykonen'do Nski | ኣይኮነን'ዶ ንስኺ - New Eritrean Music 2020 by AMEN ENTERTAINMENT 1 year ago 5 minutes, 37 seconds 20,289 views",AMEN ENTERTAINMENT,20289,20296,7
797,"AMEN - Nahom Biniam (Hnttish) - Telemeni - Eritrean Music 2020 (Official Video) by AMEN ENTERTAINMENT 1 year ago 5 minutes, 14 seconds 34,696 views",AMEN ENTERTAINMENT,34696,34734,38
798,"AMEN - Andom Shishay - Ruf Ilom Qesinom | ሩፍ ኢሎም ቀሲኖም - New Eritrean Wedding Music 2020 by AMEN ENTERTAINMENT 1 year ago 4 minutes, 2 seconds 15,759 views",AMEN ENTERTAINMENT,15759,15769,10
799,"AMEN - ኢንቪቴሽን 1ይ ክፋል INVITATION PART 1 | ERITREAN MOVIE | (OFFICIAL MOVIE) by AMEN ENTERTAINMENT 1 year ago 45 minutes 135,492 views",AMEN ENTERTAINMENT,135492,135758,266
800,"AMEN - Mulue Zeweldi (Shilaney) - Haye'ba Mensey | ሃየ'ባ መንእሰይ - New Eritrean Music 2020 by AMEN ENTERTAINMENT 1 year ago 5 minutes, 51 seconds 37,566 views",AMEN ENTERTAINMENT,37566,37583,17
801,"AMEN - Essayas Yukuno (Essu Yaki) - Tifto | ትፍቶ - New Eritrean Music 2020 (Official Video) by AMEN ENTERTAINMENT 1 year ago 6 minutes, 18 seconds 86,642 views",AMEN ENTERTAINMENT,86642,86687,45
802,"AMEN - Weldegabr (Wedi Bayre) - Ayferdelkn'ye | ኣይፈርደልክን'የ - New Eritrean Music 2020 by AMEN ENTERTAINMENT 1 year ago 5 minutes, 23 seconds 23,306 views",AMEN ENTERTAINMENT,23306,23316,10
803,"AMEN - Tesfalem Wedebablhatu - Hlqh - New Eritrean Music 2020 by AMEN ENTERTAINMENT 1 year ago 3 minutes, 56 seconds 18,879 views",AMEN ENTERTAINMENT,18879,18880,1
804,"AMEN - Tekeste Goitom - Adey | ኣደይ - New Eritrean Music 2020 (Official Video) by AMEN ENTERTAINMENT 1 year ago 6 minutes, 17 seconds 36,288 views",AMEN ENTERTAINMENT,36288,36327,39
805,"AMEN - Endrias Tsehaye - Debasitey - New Eritrean Music 2020 (Official Video) by AMEN ENTERTAINMENT 1 year ago 5 minutes, 41 seconds 44,921 views",AMEN ENTERTAINMENT,44921,44963,42
806,"AMEN - Sudies Mussa - Mqrti | ምቕርቲ - New Eritrean Music 2020 (Official Video) by AMEN ENTERTAINMENT 1 year ago 4 minutes, 55 seconds 55,769 views",AMEN ENTERTAINMENT,55769,55784,15
807,"AMEN - Abraham Hagos (Machawi) - Zkre Semaeti | ዝኽረ ሰማእቲ - Eritrean Music 2020 [Martyrs Song] by AMEN ENTERTAINMENT 1 year ago 4 minutes, 14 seconds 8,756 views",AMEN ENTERTAINMENT,8756,8763,7
808,"AMEN - ዝኽረ ሰማእታት ብሰሚር ኣቡበከር | Zkre Semaetat by Semir Abubaker - Eritrean Music 2020 [Martyrs Song] by AMEN ENTERTAINMENT 1 year ago 5 minutes 6,552 views",AMEN ENTERTAINMENT,6552,6558,6
809,"AMEN - Abel Kiflay (Fatile) - Rezin'yu Wieloka ረዚን'ዩ ዉዕሎኻ | Martyrs Song by AMEN ENTERTAINMENT 1 year ago 3 minutes, 22 seconds 12,047 views",AMEN ENTERTAINMENT,12047,12053,6
810,"AMEN - Medhanie G/Medhn (ንኡሰይ) - Aytelmekan'ye | ኣይጠልመካን'የ - New Eritrean Music 2020 [Martyrs Song] by AMEN ENTERTAINMENT 1 year ago 4 minutes, 29 seconds 208,523 views",AMEN ENTERTAINMENT,208523,208804,281
811,"AMEN - ህያብ ፍርቱና 3ይ ክፋል | HYAB FRTUNA - Part 3 - New Eritrean Movie 2020 by AMEN ENTERTAINMENT 1 year ago 23 minutes 25,179 views",AMEN ENTERTAINMENT,25179,25191,12
812,"AMEN - Hadish Zayd (Wedi Zayd) - Tmnitey | ትምኒተይ - New Eritrean Music 2020 (Official Video) by AMEN ENTERTAINMENT 1 year ago 4 minutes, 43 seconds 33,982 views",AMEN ENTERTAINMENT,33982,33997,15
813,"AMEN - Abel Mussie (ወዲ ጆሜ) - Men Kem Fqri | መን ከም ፍቕሪ - Eritrean Music 2020 (Official Video) by AMEN ENTERTAINMENT 1 year ago 6 minutes, 25 seconds 56,335 views",AMEN ENTERTAINMENT,56335,56366,31
814,"AMEN - Desale Kubaja (Joker) - Keyde Aytbeli | ከይደ ኣይትበሊ - New Eritrean Music 2020 (Official Video) by AMEN ENTERTAINMENT 1 year ago 4 minutes, 35 seconds 20,146 views",AMEN ENTERTAINMENT,20146,20159,13
815,"AMEN - ህያብ ፍርቱና - 2ይ ክፋል | HYAB FRTUNA - Part 2 - New Eritrean Movie 2020 by AMEN ENTERTAINMENT 1 year ago 21 minutes 17,188 views",AMEN ENTERTAINMENT,17188,17201,13
816,"Brother Hyabu (Dan) ft. Fiyori - KEMA SIENA | ከምኣ ስኢና - New Eritrean Music 2020 (Official Video) by AMEN ENTERTAINMENT 1 year ago 5 minutes, 30 seconds 27,481 views",AMEN ENTERTAINMENT,27481,27528,47
817,"AMEN - Winta Fsha - Chekinka Kitklo | ጨኪንካ ክትክእሎ - New Eritrean Music 2020 by AMEN ENTERTAINMENT 1 year ago 4 minutes, 33 seconds 20,637 views",AMEN ENTERTAINMENT,20637,20649,12
818,"AMEN - Fithawi Weldeab - Nie Eba | ንዒ እባ - New Eritrean Music 2020 (Official Video) by AMEN ENTERTAINMENT 1 year ago 5 minutes, 42 seconds 51,515 views",AMEN ENTERTAINMENT,51515,51544,29
819,"AMEN - ህያብ ፍርቱና - 1ይ ክፋል | HYAB FRTUNA - Part 1 - New Eritrean Movie 2020 by AMEN ENTERTAINMENT 1 year ago 31 minutes 40,297 views",AMEN ENTERTAINMENT,40297,40324,27
820,"AMEN - Alexsander Semere (Alex) - Tsbuqki Ybezh | ጽቡቕ’ኪ ይበዝሕ - New Eritrean Music 2020 by AMEN ENTERTAINMENT 1 year ago 5 minutes, 39 seconds 25,100 views",AMEN ENTERTAINMENT,25100,25130,30
821,"AMEN - Ermias Kiflai (Abash) - Nigreni | ንገርኒ - New Eritrean Music (Official Video) by AMEN ENTERTAINMENT 1 year ago 6 minutes, 46 seconds 15,666 views",AMEN ENTERTAINMENT,15666,15682,16
822,"AMEN - Rutha Gebre - Hdget Giere'ye | ሕድገት ገይረ'የ (Official Video) - Eritrean Music 2020 by AMEN ENTERTAINMENT 1 year ago 6 minutes, 32 seconds 88,642 views",AMEN ENTERTAINMENT,88642,88762,120
823,"AMEN - Tesfamariam Teklezghi - Qwamey | ቅዋመይ - New Eritrean Music 2020 (Official Video) by AMEN ENTERTAINMENT 1 year ago 5 minutes, 54 seconds 22,108 views",AMEN ENTERTAINMENT,22108,22136,28
824,"AMEN - Habtom Abraham (Buni) - Semai Nebsu | ሰማዒ ነብሱ - Eritrean Contemporary Reggae Music 2020 by AMEN ENTERTAINMENT 1 year ago 3 minutes, 57 seconds 5,545 views",AMEN ENTERTAINMENT,5545,5547,2
825,"AMEN - Yibrah Yeabyo (Asasino) - Semharey | ሰምሃረይ (Official Video) - New Eritrean Music 2020 by AMEN ENTERTAINMENT 1 year ago 4 minutes, 7 seconds 250,888 views",AMEN ENTERTAINMENT,250888,251019,131
826,"AMEN - Debesay Hagos (ወዲ ሓጎስ) - Nabra Sdet | ናብራ ስደት - New Eritrean Music 2020 (Official Video) by AMEN ENTERTAINMENT 1 year ago 5 minutes, 29 seconds 25,666 views",AMEN ENTERTAINMENT,25666,25692,26
827,"AMEN - Awet Teklebrhan - 7 ሳዕ 70 - New Eritrean Music 2020 (Official Video) by AMEN ENTERTAINMENT 1 year ago 5 minutes, 31 seconds 27,008 views",AMEN ENTERTAINMENT,27008,27023,15
828,"AMEN - Ftsum Gebru (ወዲ ገባር) - Emo Ane Ke | እሞ ኣነ ኸ (Official Video) - New Eritrean Music 2020 by AMEN ENTERTAINMENT 1 year ago 5 minutes, 26 seconds 3,605,742 views",AMEN ENTERTAINMENT,3605742,3623129,17387
829,"AMEN - Efrem Zeru - Tium Alamida | ጥዑም ኣላሚዳ - New Eritrean Music 2020 (Official Video) by AMEN ENTERTAINMENT 1 year ago 5 minutes, 3 seconds 36,291 views",AMEN ENTERTAINMENT,36291,36412,121
830,"AMEN - Samuel Gebrehiwet (Wedi Haylay) - Nmero | ንመርዖ (Official Video) | New Eritrean Music 2020 by AMEN ENTERTAINMENT 1 year ago 5 minutes, 29 seconds 230,148 views",AMEN ENTERTAINMENT,230148,230290,142
831,"AMEN - Jemal Ahmed (Gonbolo) - Msaki | ምሳኺ - New Eritrean Music 2020 (Official Video) by AMEN ENTERTAINMENT 1 year ago 4 minutes, 16 seconds 109,478 views",AMEN ENTERTAINMENT,109478,109721,243
832,"AMEN - Bereket Teklu - Dhrieki | ድሕሬኺ - New Eritrean Music 2020 (Official Video) by AMEN ENTERTAINMENT 1 year ago 4 minutes, 58 seconds 21,791 views",AMEN ENTERTAINMENT,21791,21802,11
833,"AMEN - Amanuel Goitom (Emawi) - Kibdel'ye Aybelkin | ክብደል'የ ኣይበልክን - New Eritrean Music 2020 by AMEN ENTERTAINMENT 1 year ago 6 minutes, 1 second 18,103 views",AMEN ENTERTAINMENT,18103,18116,13
834,"Biniam Habtemichael - Entay Ke Zeynafq | እንታይ ከ ዘይናፍቕ - New Eritrean Music 2020 (Official Video) by AMEN ENTERTAINMENT 1 year ago 5 minutes, 58 seconds 40,403 views",AMEN ENTERTAINMENT,40403,40415,12
835,"AMEN - Yohannes Abraha - Gdef Corona | ግደፍ ኮሮና - Eritrean Music 2020 (Official Video) by AMEN ENTERTAINMENT 1 year ago 3 minutes, 44 seconds 19,866 views",AMEN ENTERTAINMENT,19866,19882,16
836,"AMEN - Efrem Hdray - Mamma | ማማ - New Eritrean Music 2020 (Official Video) by AMEN ENTERTAINMENT 1 year ago 3 minutes, 33 seconds 26,482 views",AMEN ENTERTAINMENT,26482,26497,15
837,"AMEN - Medhanie G/Medhn (ንኡሰይ)  - Welad Mekan | ወላድ መኻን (Official Video) | Eritrean Music 2020 by AMEN ENTERTAINMENT 1 year ago 5 minutes, 54 seconds 2,033,060 views",AMEN ENTERTAINMENT,2033060,2046253,13193
838,"AMEN - Arsema Zerisenay - Sle Fqri | ስለ ፍቕሪ - New Eritrean Music 2020 (Official Video) by AMEN ENTERTAINMENT 1 year ago 6 minutes, 2 seconds 106,730 views",AMEN ENTERTAINMENT,106730,106811,81
839,"AMEN - Mehari Teklemariam (Mukuh) - Aythazley - New Eritrean Music 2020 (Official Video) by AMEN ENTERTAINMENT 1 year ago 3 minutes, 58 seconds 60,309 views",AMEN ENTERTAINMENT,60309,60364,55
840,"Fnan Measho (Shegoda) - Eti Mishet Mishet | እቲ ምሸት ምሸት (Official Video) -  Eritrean Hot Music 2020 by AMEN ENTERTAINMENT 1 year ago 5 minutes, 26 seconds 386,916 views",AMEN ENTERTAINMENT,386916,387305,389
841,"AMEN - Filmon Habtegabr - Gzie Halifuni | ግዜ ሓሊፉኒ - New Eritrean Music 2020 (Official Video) by AMEN ENTERTAINMENT 1 year ago 4 minutes, 22 seconds 64,175 views",AMEN ENTERTAINMENT,64175,64235,60
842,"AMEN - Tesfaldet Haile - Txbit Albo | ትጽቢት ኣልቦ - New Eritrean Music 2020 (Official Video) by AMEN ENTERTAINMENT 1 year ago 5 minutes, 40 seconds 32,527 views",AMEN ENTERTAINMENT,32527,32549,22
843,"AMEN - Goitom Negassi - Tesiu Tezmskr | ተሲኡ ተዝምስክር - (Official Video) | Eritrean Music 2020 by AMEN ENTERTAINMENT 1 year ago 6 minutes, 55 seconds 280,454 views",AMEN ENTERTAINMENT,280454,281160,706
844,"AMEN - Romodan Debesay (Rominzo) - Debasitey - New Eritrean Music 2020 (Official Video) by AMEN ENTERTAINMENT 1 year ago 5 minutes, 22 seconds 47,468 views",AMEN ENTERTAINMENT,47468,47510,42
845,"AMEN - Bereket Hayelom (Barkay) - Nmntay | ንምንታይ - New Eritrean Music 2020 (Official Video) by AMEN ENTERTAINMENT 1 year ago 5 minutes, 11 seconds 21,598 views",AMEN ENTERTAINMENT,21598,21636,38
846,"AMEN - Awet Embafrash - Luwamey | ልዋመይ - New Eritrean Music 2020 (Official Video) by AMEN ENTERTAINMENT 1 year ago 6 minutes, 1 second 22,293 views",AMEN ENTERTAINMENT,22293,22318,25
847,"AMEN - Andom Sbhatu - Shewitey | ሸዊተይ - New Eritrean Music 2020 (Official Video) by AMEN ENTERTAINMENT 1 year ago 4 minutes, 27 seconds 10,413 views",AMEN ENTERTAINMENT,10413,10443,30
848,"AMEN - Fithawi Zemuy (Katro) - Fanusey | ፋኑሰይ - New Eritrean Music 2020 (Official Video) by AMEN ENTERTAINMENT 1 year ago 4 minutes, 15 seconds 43,948 views",AMEN ENTERTAINMENT,43948,43976,28
849,"AMEN - Bajet Mehari - Luley | ሉለይ - (Official Music Video) | New Eritrean Music 2020 by AMEN ENTERTAINMENT 1 year ago 5 minutes, 54 seconds 103,833 views",AMEN ENTERTAINMENT,103833,104185,352
850,"AMEN - Robel Medhanie (Wedi Abayu) - Hrya | ሕርያ - New Eritrean Music 2020 (Offical Video) by AMEN ENTERTAINMENT 1 year ago 4 minutes, 53 seconds 226,433 views",AMEN ENTERTAINMENT,226433,226835,402
851,"AMEN - Anday Gerezgiher - Aqli Tray | ዓቕሊ ጥራይ - New Eritrean Music 2020 (Official Video) by AMEN ENTERTAINMENT 1 year ago 5 minutes, 53 seconds 23,839 views",AMEN ENTERTAINMENT,23839,23841,2
852,"AMEN - Mahare Briygbri - Ytammki | ይጥዓምኪ - New Eritrean Music 2020 (Official Video) by AMEN ENTERTAINMENT 1 year ago 5 minutes, 2 seconds 12,053 views",AMEN ENTERTAINMENT,12053,12060,7
853,"AMEN - Merhawi Beteketab (Wedi Bereketab) - Gdefi Eba - New Eritrean Music 2020 (Official Audio) by AMEN ENTERTAINMENT 1 year ago 4 minutes, 17 seconds 7,962 views",AMEN ENTERTAINMENT,7962,7969,7
854,"AMEN - Haben Alem - Mamaye - New Eritrean Music 2020 (Official Video) by AMEN ENTERTAINMENT 1 year ago 4 minutes, 2 seconds 9,597 views",AMEN ENTERTAINMENT,9597,9624,27
855,"AMEN - Dawit Yosief - Kealyo (Official Video) | New Eritrean Music 2020 by AMEN ENTERTAINMENT 2 years ago 4 minutes, 12 seconds 29,568 views",AMEN ENTERTAINMENT,29568,29582,14
856,"AMEN - Merhawi Ghebrezgabher (መራ ሸሸቢት) - Kemesgneki | ከመስግነኪ'የ - New Eritrean Music (Official Video) by AMEN ENTERTAINMENT 2 years ago 6 minutes, 9 seconds 19,237 views",AMEN ENTERTAINMENT,19237,19243,6
857,"AMEN - Yonas Kefali - Aytfredni - New Eritrean Music 2020 (Official Video) by AMEN ENTERTAINMENT 2 years ago 5 minutes, 3 seconds 36,238 views",AMEN ENTERTAINMENT,36238,36283,45
858,"AMEN - Shishay Haile (Azin) - Eruye - New Eritrean Audio Music 2020 by AMEN ENTERTAINMENT 2 years ago 4 minutes, 12 seconds 7,272 views",AMEN ENTERTAINMENT,7272,7274,2
859,"AMEN - Meron Fshaye - Kemey Krsio (Official Video) | New Eritrean Tribute Music 2020 by AMEN ENTERTAINMENT 2 years ago 4 minutes, 33 seconds 64,387 views",AMEN ENTERTAINMENT,64387,64464,77
860,"AMEN - Abraham Misgna - Akhokhuay | ዓኾዃይ - New Eritrean Music 2020 (Official Music Video) by AMEN ENTERTAINMENT 2 years ago 6 minutes, 53 seconds 25,025 views",AMEN ENTERTAINMENT,25025,25041,16
861,"AMEN - Elias Yemane - Entay Do Gierna Ena - New Eritrean Music 2020 (Official Music) by AMEN ENTERTAINMENT 2 years ago 5 minutes, 21 seconds 15,540 views",AMEN ENTERTAINMENT,15540,15554,14
862,"AMEN - John Amora - Alemey | ዓለመይ -  New Eritrean Music 2020 (Official Video) by AMEN ENTERTAINMENT 2 years ago 4 minutes, 50 seconds 13,142 views",AMEN ENTERTAINMENT,13142,13151,9
863,"AMEN - Ykealo Michael - Zyada Beyney | ዝያዳ በይነይ - New Eritrean Music 2020 (Official Video) by AMEN ENTERTAINMENT 2 years ago 6 minutes, 48 seconds 52,520 views",AMEN ENTERTAINMENT,52520,52602,82
864,"AMEN - Tesfit Cheay (Wedi Cheay) - Desta L'bey | ደስታ ልበይ - New Eritrean Music 2020 (Official Video) by AMEN ENTERTAINMENT 2 years ago 6 minutes, 9 seconds 14,079 views",AMEN ENTERTAINMENT,14079,14095,16
865,"Shishay Haile (Azin) - Nishak Nixawet | ንስሓቕ ንጻወት (Official Music Video) | Eritrean Music 2020 by AMEN ENTERTAINMENT 2 years ago 4 minutes, 48 seconds 65,979 views",AMEN ENTERTAINMENT,65979,65981,2
866,"AMEN - Dawit Weldemichael - Aythazley | ኣይትሓዝለይ (Official Music Video) | Eritrean Music 2020 by AMEN ENTERTAINMENT 2 years ago 5 minutes, 9 seconds 1,664,170 views",AMEN ENTERTAINMENT,1664170,1670156,5986
867,"AMEN - Tadese Tsigab - Tegagiki | ተጋጊኺ - New Eritrean Music 2020 (Official Video) by AMEN ENTERTAINMENT 2 years ago 4 minutes, 9 seconds 30,659 views",AMEN ENTERTAINMENT,30659,30730,71
868,"AMEN - Fitsum Zemichael - Welelo | ወለሎ - (Official Video) | New Eritrean Music 2020 by AMEN ENTERTAINMENT 2 years ago 5 minutes, 40 seconds 148,396 views",AMEN ENTERTAINMENT,148396,148787,391
869,"AMEN - Yonatan Tsegu - Tewediuni'yu (Official Video) | New Eritrean Music 2020 by AMEN ENTERTAINMENT 2 years ago 5 minutes, 21 seconds 37,384 views",AMEN ENTERTAINMENT,37384,37394,10
870,"AMEN - Awet Habtemariam - Ab Tselotey | ኣብ ጸሎተይ - New Eritrean Music 2020 (Official Music Video) by AMEN ENTERTAINMENT 2 years ago 5 minutes, 56 seconds 65,707 views",AMEN ENTERTAINMENT,65707,65850,143
871,"AMEN - Kibrom Kahsay - Aykelen Eye Beaki - New Eritrean Music 2020 (Official Music Video) by AMEN ENTERTAINMENT 2 years ago 5 minutes, 4 seconds 17,325 views",AMEN ENTERTAINMENT,17325,17337,12
872,"Amen Show: Interview with Dj Papu - Part 2 | Eritrean Talk Show 2020 by AMEN ENTERTAINMENT 2 years ago 33 minutes 3,731 views",AMEN ENTERTAINMENT,3731,3733,2
873,"AMEN - Asmerom Simu - Aytferedwa | ኣይትፍረድዋ - New Eritrean Music 2020 (Official Music Video) by AMEN ENTERTAINMENT 2 years ago 5 minutes, 2 seconds 24,311 views",AMEN ENTERTAINMENT,24311,24322,11
874,"AMEN - Jemal Wedi Hamie - Kealni - New Eritrean Music 2020 (Official Video Music) by AMEN ENTERTAINMENT 2 years ago 4 minutes, 58 seconds 27,878 views",AMEN ENTERTAINMENT,27878,27889,11
875,"AMEN - Munir Abdela - Emesleni Nieru | እመስለኒ ነይሩ - New Eritrean Music 2020 (Official Video) by AMEN ENTERTAINMENT 2 years ago 6 minutes, 22 seconds 19,776 views",AMEN ENTERTAINMENT,19776,19817,41
876,"AMEN - Eazy 21Bullet - Deqi Erey | ደቂ ኤረይ (Official Video) - New Eritrean Hip Hop Music 2020 by AMEN ENTERTAINMENT 2 years ago 3 minutes, 12 seconds 88,776 views",AMEN ENTERTAINMENT,88776,89006,230
877,"AMEN - Fnan Adal - Gedli'lena | ገድሊ'ለና - New Eritrean Music 2020 (Official Music Video) by AMEN ENTERTAINMENT 2 years ago 5 minutes, 49 seconds 101,750 views",AMEN ENTERTAINMENT,101750,101814,64
878,"Tewen Hagos (Lidu) - Tsaeda Ytsnahka | ጻዕዳ ይጽናሕካ - New Eritrean Music 2020 (Official Video Music) by AMEN ENTERTAINMENT 2 years ago 5 minutes, 8 seconds 120,346 views",AMEN ENTERTAINMENT,120346,120430,84
879,"AMEN - Eseyas Tekle - Alemey - New Eritrean Music 2020 (Official Audio) by AMEN ENTERTAINMENT 2 years ago 3 minutes, 13 seconds 24,462 views",AMEN ENTERTAINMENT,24462,24473,11
880,"AMEN - Kibrom Haile - Selel Belley | ሰለል በልለይ - New Eritrean Music 2020 (Official Traditional Music) by AMEN ENTERTAINMENT 2 years ago 6 minutes, 59 seconds 11,250 views",AMEN ENTERTAINMENT,11250,11255,5
881,"AMEN - Medhanie Alem - Koinkley | ኮይንክለይ - New Eritrean Music 2020 (Music Video) by AMEN ENTERTAINMENT 2 years ago 5 minutes, 10 seconds 82,637 views",AMEN ENTERTAINMENT,82637,82769,132
882,"AMEN - Ghide Yohannes (John) - Koninkni - New Eritrean Music 2020 by AMEN ENTERTAINMENT 2 years ago 4 minutes, 52 seconds 43,204 views",AMEN ENTERTAINMENT,43204,43229,25
883,"AMEN - Yonas Welday - Kemey'yu Ezi Gzie | ከመይ'ዩ እዚ ግዜ - New Eritrean Music 2020 (Official Video) by AMEN ENTERTAINMENT 2 years ago 6 minutes, 25 seconds 23,992 views",AMEN ENTERTAINMENT,23992,24008,16
884,"AMEN - Amen Show: Interview with Dj Papu - Part 1 | Eritrean Talk Show 2020 by AMEN ENTERTAINMENT 2 years ago 35 minutes 4,602 views",AMEN ENTERTAINMENT,4602,4609,7
885,"Mahray Abraha ft. Medhanie G/Medhn - Agibelki | ዓጊበልኪ - New Eritrean Music 2019 (Official Music) by AMEN ENTERTAINMENT 2 years ago 4 minutes, 53 seconds 1,996,766 views",AMEN ENTERTAINMENT,1996766,1999603,2837
886,"AMEN - Mussie Issak - Qonjo Habesha | ቆንጆ ሓበሻ - New Eritrean Music 2019 (Official Music Video) by AMEN ENTERTAINMENT 2 years ago 4 minutes, 51 seconds 45,784 views",AMEN ENTERTAINMENT,45784,45817,33
887,"AMEN - Aram Fshation - Gdef'ba - New Eritrean Music 2019 (Official Video) by AMEN ENTERTAINMENT 2 years ago 3 minutes, 37 seconds 22,793 views",AMEN ENTERTAINMENT,22793,22810,17
888,"AMEN - Dawit Kidane (Gagu) - Amisey - New Eritrean Music 2020 (Official Video) by AMEN ENTERTAINMENT 2 years ago 5 minutes, 4 seconds 85,064 views",AMEN ENTERTAINMENT,85064,85154,90
889,"AMEN - Efrem Mehari (Bingo) - Waniney | ዋኒነይ - New Eritrean Music Video 2019 (Official Music Video) by AMEN ENTERTAINMENT 2 years ago 4 minutes, 24 seconds 21,905 views",AMEN ENTERTAINMENT,21905,21934,29
890,"AMEN - Michael Guesh - Mesta Alewo Fqri - New Eritrean Music 2019 (Official Video) by AMEN ENTERTAINMENT 2 years ago 4 minutes, 36 seconds 6,638,861 views",AMEN ENTERTAINMENT,6638861,6666424,27563
891,"AMEN - Fishale Habtom - Hallow Gezana - New Eritrean Music 2019 (Official Video) by AMEN ENTERTAINMENT 2 years ago 5 minutes, 11 seconds 55,152 views",AMEN ENTERTAINMENT,55152,55499,347
892,"AMEN - Genet Fqadu - Hdget | ሕድግት - New Eritrean Music 2019 (Official Video) by AMEN ENTERTAINMENT 2 years ago 5 minutes, 8 seconds 94,239 views",AMEN ENTERTAINMENT,94239,94270,31
893,"AMEN - Bereket Mengisteab - Shelel Do Kblo - New Eritrean Music 2019 (Official Audio) by AMEN ENTERTAINMENT 2 years ago 5 minutes 10,825 views",AMEN ENTERTAINMENT,10825,10833,8
894,"AMEN - Semir Abubaker - Fetinkni | ፈቲንክኒ - New Eritrean Music 2019 (Official Video) by AMEN ENTERTAINMENT 2 years ago 5 minutes, 35 seconds 25,319 views",AMEN ENTERTAINMENT,25319,25354,35
895,"AMEN - Negash Abraham - Zemenawit Zema | ዘመናዊት ዜማ - New Eritrean Music 2019 (Official Video) by AMEN ENTERTAINMENT 2 years ago 4 minutes, 32 seconds 26,000 views",AMEN ENTERTAINMENT,26000,26013,13
896,"AMEN - Bruk Asmelash (Chombie) - Tehalifu | ተሓሊፉ - New Eritrean Music 2019 (Official Audio) by AMEN ENTERTAINMENT 2 years ago 6 minutes, 32 seconds 7,352 views",AMEN ENTERTAINMENT,7352,7360,8
897,"AMEN - Daniel Kesete - Mejoba | መጆባ - New Eritrean Bilen Music 2019 (Official Video) by AMEN ENTERTAINMENT 2 years ago 5 minutes, 59 seconds 120,513 views",AMEN ENTERTAINMENT,120513,120882,369
898,"AMEN - Robel Negasi - Btsayey | ብጻየይ - New Eritrean Music 2019 (Official Music) by AMEN ENTERTAINMENT 2 years ago 6 minutes, 53 seconds 39,260 views",AMEN ENTERTAINMENT,39260,39284,24
899,"AMEN - Seare Debesay (መሐጎሰይ) - Yteameki | ይጥዓመኪ - New Eritrean Music 2019 (Official Video) by AMEN ENTERTAINMENT 2 years ago 5 minutes, 12 seconds 279,836 views",AMEN ENTERTAINMENT,279836,280532,696
900,"AMEN - Shewit Kifle - Kealeley | ከኣለለይ - New Eritrean Music 2019 (Official Music Video) by AMEN ENTERTAINMENT 2 years ago 5 minutes, 26 seconds 203,824 views",AMEN ENTERTAINMENT,203824,204155,331
901,"AMEN - Medhanie G/Medhn (ንኡሰይ) - Teqedewi | ተቐደዊ - New Eritrean Music 2019 (Official Video) by AMEN ENTERTAINMENT 2 years ago 4 minutes, 39 seconds 2,429,196 views",AMEN ENTERTAINMENT,2429196,2437412,8216
902,"AMEN - Daniel Debesay (Tatula) - Hafti Kunni (Official Video) | Eritrean Music 2019 by AMEN ENTERTAINMENT 2 years ago 4 minutes, 14 seconds 53,949 views",AMEN ENTERTAINMENT,53949,54036,87
903,"AMEN - Dawit Tezare (Wedi Tezare) - Selamey - New Eritrean Music 2019 (Official Video) by AMEN ENTERTAINMENT 2 years ago 4 minutes, 59 seconds 8,387 views",AMEN ENTERTAINMENT,8387,8394,7
904,"AMEN - Natnael Mebrahtu (Sina) - Bsenki Tibitki - New Eritrean Music 2019 (Official Video) by AMEN ENTERTAINMENT 2 years ago 4 minutes, 48 seconds 17,121 views",AMEN ENTERTAINMENT,17121,17127,6
905,"AMEN - Robel Leul - Hulfna Resiyo | ሕሉፍና ረስዕዮ - New Eritrean Music 2019 (Official Video) by AMEN ENTERTAINMENT 2 years ago 5 minutes, 1 second 124,616 views",AMEN ENTERTAINMENT,124616,124662,46
906,"AMEN - Kuhlen Ibe - Nafqot - New Eritrean Music 2019 (Official Video) by AMEN ENTERTAINMENT 2 years ago 5 minutes, 17 seconds 13,987 views",AMEN ENTERTAINMENT,13987,13995,8
907,"AMEN - Haylab Yohannes (Barea) - Ezamey | እዛመይ - New Eritrean Music 2019 (Official Video) by AMEN ENTERTAINMENT 2 years ago 5 minutes, 30 seconds 211,991 views",AMEN ENTERTAINMENT,211991,212214,223
908,"AMEN - Ablel Berhane Avi - Ayrseakn (Official Video) | Eritrean Music 2019 by AMEN ENTERTAINMENT 2 years ago 5 minutes, 4 seconds 38,210 views",AMEN ENTERTAINMENT,38210,38230,20
909,"AMEN - Mulue Amare (Wedi Amare) - Telam Lbey (Official Video) | Eritrean Music 2019 by AMEN ENTERTAINMENT 2 years ago 4 minutes, 32 seconds 151,293 views",AMEN ENTERTAINMENT,151293,151338,45
910,"AMEN - Shishay Desbele (Bashu) - Lomi Nrakeb - New Eritrean Music 2019 (Official Video) by AMEN ENTERTAINMENT 2 years ago 5 minutes, 1 second 17,204 views",AMEN ENTERTAINMENT,17204,17205,1
911,"AMEN - Weyni Berhe - Gezay Yebleni Alo | ገዛይ የብለኒ'ሎ - New Eritrean Music 2019 (Official Video) by AMEN ENTERTAINMENT 2 years ago 4 minutes, 49 seconds 47,179 views",AMEN ENTERTAINMENT,47179,47228,49
912,"AMEN - Filmon Kesete - Yeqenyeley Tselai | የቐንየለይ ጸላኢ - New Eritrean Music 2019 (Official Video) by AMEN ENTERTAINMENT 2 years ago 4 minutes, 12 seconds 10,906 views",AMEN ENTERTAINMENT,10906,10912,6
913,"AMEN - Teame Teklemariam - Aferkbu | ኣፈርክቡ (Official Video) | Eritrean Music 2019 by AMEN ENTERTAINMENT 2 years ago 4 minutes, 46 seconds 16,975 views",AMEN ENTERTAINMENT,16975,16978,3
914,"AMEN - Afewerqi Mihretab (Walta) - Tesfa Habni | ተስፋ ሃብኒ - New Eritrean Music 2019 (Official Video) by AMEN ENTERTAINMENT 2 years ago 5 minutes, 56 seconds 38,783 views",AMEN ENTERTAINMENT,38783,38794,11
915,"AMEN - Dawit Kesete (ቢሓት) - Sdet Qeyrwa | ስደት ቐይርዋ | New Eritrean Music 2019 (Official Video) by AMEN ENTERTAINMENT 2 years ago 5 minutes, 38 seconds 77,579 views",AMEN ENTERTAINMENT,77579,77598,19
916,"Isaias Beyene (Farmacha) - Zeygage Yelen | ዘይጋገ የለን - New Eritrean Music 2019 (Official Video) by AMEN ENTERTAINMENT 2 years ago 4 minutes, 38 seconds 33,132 views",AMEN ENTERTAINMENT,33132,33148,16
917,"AMEN - Daniel Haylemikael ft. Daimon Fesshaye - Africa Need Change - New Eritrean African Music 2019 by AMEN ENTERTAINMENT 2 years ago 7 minutes, 29 seconds 4,497 views",AMEN ENTERTAINMENT,4497,4502,5
918,"AMEN - Haylab Barea ሓይልኣብ ባሪዓ ኣብ መድረኽ Part 3 | (Live From Amen Show) | Eritrean Music 2019 by AMEN ENTERTAINMENT 2 years ago 33 minutes 13,079 views",AMEN ENTERTAINMENT,13079,13086,7
919,"AMEN - Daniel Ghirmay - Fqri Alo (Official Video) | Eritrean Music 2019 by AMEN ENTERTAINMENT 2 years ago 5 minutes, 28 seconds 44,025 views",AMEN ENTERTAINMENT,44025,44040,15
920,"AMEN - Haylab Barea ሓይልኣብ ባሪዓ ኣብ መድረኽ Part 2 | (Live From Amen Show) Eritrean Music 2019 by AMEN ENTERTAINMENT 2 years ago 27 minutes 18,390 views",AMEN ENTERTAINMENT,18390,18411,21
921,"AMEN - Abraham Zermariam (Wedi Elsa) - Luwamey - New Eritrean Music 2019 (Official Video) by AMEN ENTERTAINMENT 2 years ago 5 minutes, 39 seconds 30,027 views",AMEN ENTERTAINMENT,30027,30042,15
922,"AMEN - Haylab Barea ሓይልኣብ ባሪዓ ኣብ መድረኽ Part 1 | (Live From Amen Show) Eritrean Music 2019 by AMEN ENTERTAINMENT 2 years ago 35 minutes 42,292 views",AMEN ENTERTAINMENT,42292,42367,75
923,"AMEN - Simon Mulgeta (Amora) - Guday Laeli Betsiha'la (Official Video) | New Eritrean Music 2019 by AMEN ENTERTAINMENT 2 years ago 5 minutes, 49 seconds 799,571 views",AMEN ENTERTAINMENT,799571,801078,1507
924,"Dawit Weldemichael ft. Efrem Tadesse - Nafqot Alena - New Eritrean Music 2019 (Official Video) by AMEN ENTERTAINMENT 2 years ago 7 minutes, 2 seconds 1,013,603 views",AMEN ENTERTAINMENT,1013603,1016199,2596
925,"AMEN - Okbamichael Zayd (Wedi Zayd) - Qetano - New Eritrean Music 2019 (Official Video) by AMEN ENTERTAINMENT 2 years ago 4 minutes, 25 seconds 32,126 views",AMEN ENTERTAINMENT,32126,32151,25
926,"AMEN - Tesfalem Tsegay (Wedi Tsegay) - Zewar Ayney (Official Video) | Eritrean Music 2019 by AMEN ENTERTAINMENT 2 years ago 4 minutes, 52 seconds 32,846 views",AMEN ENTERTAINMENT,32846,32858,12
927,"AMEN - Weldegabr Bayre (Wedi Bayre) - Wezbi'Dyu Lielana - Eritrean Music 2019 by AMEN ENTERTAINMENT 2 years ago 5 minutes, 27 seconds 66,708 views",AMEN ENTERTAINMENT,66708,66734,26
928,"AMEN - ERITREAN COMEDY 2019 ""መውስቦ | Mewsbo” Ghirmay Asfaha (Anki) by AMEN ENTERTAINMENT 2 years ago 30 minutes 57,056 views",AMEN ENTERTAINMENT,57056,57073,17
929,"AMEN - Eritrean Comedy 2019 ''መውስቦ | Mewsb'' Trailer by AMEN ENTERTAINMENT 2 years ago 1 minute, 38 seconds 9,327 views",AMEN ENTERTAINMENT,9327,9329,2
930,"AMEN - Eritrean Interview with Hayelom Abrahaley - Part 2 [2019] by AMEN ENTERTAINMENT 2 years ago 1 hour 91,649 views",AMEN ENTERTAINMENT,91649,91694,45
931,"AMEN - Maebel (Wedi Ayer) - Aye Neger Seb - New Eritrean Music 2019 (Official Video) by AMEN ENTERTAINMENT 2 years ago 6 minutes, 27 seconds 51,177 views",AMEN ENTERTAINMENT,51177,51218,41
932,"AMEN - Michael WeldeMihret (መኒዓ) - Zkri'loni - New Eritrean Music 2019 (Official Video) by AMEN ENTERTAINMENT 2 years ago 6 minutes, 12 seconds 34,587 views",AMEN ENTERTAINMENT,34587,34593,6
933,"AMEN - Temesgen Ermias (Temie) - Kidaney (Official Music Video) - New Eritrean Music 2019 by AMEN ENTERTAINMENT 2 years ago 5 minutes, 22 seconds 21,092 views",AMEN ENTERTAINMENT,21092,21106,14
934,"AMEN - Yibrah Yeabyo (Asasino) - Fithawitey - New Eritrean Music 2019 (Official Video) by AMEN ENTERTAINMENT 2 years ago 5 minutes, 24 seconds 32,857 views",AMEN ENTERTAINMENT,32857,32876,19
935,"AMEN - Nebiat Hagos - Tehabeneley - New Eritrean Music 2019 (Official Video) by AMEN ENTERTAINMENT 2 years ago 4 minutes, 30 seconds 80,974 views",AMEN ENTERTAINMENT,80974,81016,42
936,"AMEN - Robel Gebrehans - Waka Waka (Official Video Music) | New Eritrean Music 2019 by AMEN ENTERTAINMENT 2 years ago 4 minutes, 58 seconds 24,380 views",AMEN ENTERTAINMENT,24380,24390,10
937,"AMEN - Kiflay Solomon - Tmlatki - New Eritrean Music 2019 (Official Video) by AMEN ENTERTAINMENT 2 years ago 5 minutes, 56 seconds 17,597 views",AMEN ENTERTAINMENT,17597,17606,9
938,"AMEN - Eritrean Interview with Hayelom Abrahaley - Part 1 [2019] by AMEN ENTERTAINMENT 2 years ago 47 minutes 81,828 views",AMEN ENTERTAINMENT,81828,81897,69
939,"AMEN - Mehari Arefaine (Wedi Keshi) - Anbbni (Official Music Video) | New Eritrean Music 2019 by AMEN ENTERTAINMENT 2 years ago 4 minutes, 33 seconds 20,129 views",AMEN ENTERTAINMENT,20129,20136,7
940,"AMEN - Nazrawi Ghirmay (Hagos) - Aytqurexi Tesfa - New Eritrean Music 2019 by AMEN ENTERTAINMENT 2 years ago 6 minutes, 12 seconds 34,256 views",AMEN ENTERTAINMENT,34256,34306,50
941,"AMEN - Eritrean Music 2019 : Berhane Weldemichael - Mexico | ሜክሲኮ - New Eritrean Music 2019 by AMEN ENTERTAINMENT 2 years ago 6 minutes, 7 seconds 37,649 views",AMEN ENTERTAINMENT,37649,37662,13
942,"AMEN - Rezene Beyene - Wey Tata | ወይ ጣጣ ብረዘነ በየነ - New Eritrean Comedy 2019 by AMEN ENTERTAINMENT 2 years ago 26 minutes 242,355 views",AMEN ENTERTAINMENT,242355,242397,42
943,"AMEN - New Eritrean Music 2019 Tekleab Teklezghi (Tawq) ""Sdet ""  ተክልኣብ ተኽልዝጊ (ጠውቕ) ስደት by AMEN ENTERTAINMENT 2 years ago 6 minutes, 34 seconds 11,692 views",AMEN ENTERTAINMENT,11692,11700,8
944,"AMEN - Merhawi Hadish - Sfnti | ሽፍንቲ - (Official Music Video) New Eritrean Tigrigna Music 2019 by AMEN ENTERTAINMENT 2 years ago 6 minutes, 9 seconds 38,503 views",AMEN ENTERTAINMENT,38503,38507,4
945,"AMEN - Ghirmay Anki - CLIP | ክሊፕ  ብግርማይ ኣስፍሃ (ዓንቂ) - New Eritrean Comedy 2019 by AMEN ENTERTAINMENT 2 years ago 20 minutes 52,880 views",AMEN ENTERTAINMENT,52880,52894,14
946,"AMEN - Ghirmay Asfaha - CLIP ክሊፕ - New Eritrean Comedy 2019 [COMING SOON] by AMEN ENTERTAINMENT 2 years ago 1 minute, 47 seconds 7,043 views",AMEN ENTERTAINMENT,7043,7046,3
947,"AMEN - Meron Habtemichael - Neay Ktbli | ንዓይ ክትብሊ (Official Video) | New Eritrean Music 2019 by AMEN ENTERTAINMENT 2 years ago 4 minutes, 7 seconds 16,163 views",AMEN ENTERTAINMENT,16163,16164,1
948,"AMEN - Solomon Tsegay (Mt Maru) - Sle Fqri'le | ስለ ፍቕሪ'ለ - New Eritrean Music 2019 by AMEN ENTERTAINMENT 2 years ago 4 minutes, 58 seconds 841,369 views",AMEN ENTERTAINMENT,841369,842285,916
949,"AMEN - Yosief Wedi Shiwa #5 ዕላል ምስ ስነ-ጥበበኛ ሚኪኤል ካሕሳይ (ጩቤ) Part 2 - New Eritrean Talk Show 2019 by AMEN ENTERTAINMENT 2 years ago 46 minutes 2,552 views",AMEN ENTERTAINMENT,2552,2555,3
950,"AMEN - Beraki Zeweldi (Beriye) - Ayteamekn (Official Music Video) | Eritrean Music 2019 by AMEN ENTERTAINMENT 2 years ago 4 minutes, 11 seconds 21,953 views",AMEN ENTERTAINMENT,21953,21972,19
951,"AMEN - Hayelom Abrahale (Eri Power) - Zematitey (Official Music Video) | New Eritrean Music 2019 by AMEN ENTERTAINMENT 2 years ago 4 minutes, 51 seconds 2,803,889 views",AMEN ENTERTAINMENT,2803889,2807770,3881
952,"AMEN - Fanus Msgna (Fani) - Temelesi - New Eritrean Music 2019 (Official Music) by AMEN ENTERTAINMENT 2 years ago 4 minutes, 30 seconds 36,368 views",AMEN ENTERTAINMENT,36368,36400,32
953,"AMEN - Sqtaka Sbero ስቕታኻ ስበሮ New Eritrean Short Film 4K by AMEN ENTERTAINMENT 2 years ago 8 minutes, 38 seconds 45,442 views",AMEN ENTERTAINMENT,45442,45444,2
954,"AMEN - Yosief Wedi Shiwa #5 ዕላል ምስ ስነ-ጥበበኛ ሚኪኤል ካሕሳይ (ጩቤ) Part 1 - New Eritrean Talk Show 2019 by AMEN ENTERTAINMENT 2 years ago 39 minutes 3,653 views",AMEN ENTERTAINMENT,3653,3656,3
955,"AMEN - Yosief Wedi Shiwa #4 ''ዘቢብ ወናኒት ምሉእ ሕልና'' New Eritrean Talk Show 2019 by AMEN ENTERTAINMENT 2 years ago 45 minutes 46,838 views",AMEN ENTERTAINMENT,46838,46867,29
956,"AMEN - Yosief Wedi Shiwa #4 ''ዘቢብ ወናኒት ምሉእ ሕልና'' New Eritrean Talk Show 2019 by AMEN ENTERTAINMENT 2 years ago 36 minutes 41,242 views",AMEN ENTERTAINMENT,41242,41248,6
957,"AMEN - Wedi Shiwa Show #3 - ዕላል ምስ ሳርቶ | Sarto (Part 2) - New Eritrean Talk Show 2019 by AMEN ENTERTAINMENT 2 years ago 27 minutes 9,420 views",AMEN ENTERTAINMENT,9420,9424,4
958,"AMEN - Awet Yhaysh - Tebedalit | ተበዳሊት - New Eritrean Music 2019 by AMEN ENTERTAINMENT 2 years ago 5 minutes, 15 seconds 23,655 views",AMEN ENTERTAINMENT,23655,23667,12
959,"AMEN - Meles Tikue - Entay Ybehal Alo | እንታይ ይበሃል ኣሎ - New Eritrean Music 2019 by AMEN ENTERTAINMENT 3 years ago 4 minutes, 37 seconds 61,329 views",AMEN ENTERTAINMENT,61329,61387,58
960,"AMEN - Shiden Bashay - Aleku Ab Mahlay | ኣለኹ ኣብ ማሕላይ - New Eritrean Music 2019 (Official Audio) by AMEN ENTERTAINMENT 3 years ago 3 minutes, 42 seconds 5,553 views",AMEN ENTERTAINMENT,5553,5557,4
961,"AMEN - Tekle Goitom - Maernet - New Eritrean Short Movie 2019 by AMEN ENTERTAINMENT 3 years ago 25 minutes 81,862 views",AMEN ENTERTAINMENT,81862,81875,13
962,"AMEN - Wedi Shiwa Show #3 - ዕላል ምስ ሳርቶ - New Eritrean Talk Show 2019 by AMEN ENTERTAINMENT 3 years ago 21 minutes 12,462 views",AMEN ENTERTAINMENT,12462,12468,6
963,"AMEN - Teame Segid (Wedi Segid) - Tsibuqey Zekri | ጽቡቐይ ዘክሪ - New Eritrean Music 2019 by AMEN ENTERTAINMENT 3 years ago 5 minutes, 56 seconds 37,074 views",AMEN ENTERTAINMENT,37074,37110,36
964,"AMEN - Deju P (PROD 2namit) - Seniorita | ሲኞሪታ - New Eritrean Music 2019 by AMEN ENTERTAINMENT 3 years ago 2 minutes, 42 seconds 16,053 views",AMEN ENTERTAINMENT,16053,16055,2
965,"AMEN - Deju P (PROD 2namit) - Sinorita - New Eritrean Music 2019 Coming Soon (Official Trailer) by AMEN ENTERTAINMENT 3 years ago 28 seconds 7,981 views",AMEN ENTERTAINMENT,7981,7981,0
966,"AMEN - Wedi Shiwa Show #2 - Qemqamo (Part 2) - New Eritrean Talk Show 2019 by AMEN ENTERTAINMENT 3 years ago 20 minutes 36,912 views",AMEN ENTERTAINMENT,36912,36914,2
967,"AMEN - Afewerki Mengesha - Qal | ቃል - New Eritrean Music 2019 by AMEN ENTERTAINMENT 3 years ago 5 minutes, 48 seconds 8,283 views",AMEN ENTERTAINMENT,8283,8285,2
968,"AMEN - Yonas Aregay - Fthiyo'Ti Mahleka | ፍትሒዮ'ቲ ማሕለኻ - New Eritrean Music 2019 by AMEN ENTERTAINMENT 3 years ago 4 minutes, 53 seconds 28,333 views",AMEN ENTERTAINMENT,28333,28340,7
969,"AMEN - Wedi Shiwa Show #2 - Qemqamo (Part 1) - New Eritrean Talk Show 2019 by AMEN ENTERTAINMENT 3 years ago 22 minutes 16,883 views",AMEN ENTERTAINMENT,16883,16888,5
970,"AMEN - Natnael Beyn (Natu) - Semiruley | ሰሚሩለይ - New Eritrean Music 2019 by AMEN ENTERTAINMENT 3 years ago 4 minutes, 35 seconds 37,162 views",AMEN ENTERTAINMENT,37162,37165,3
971,"AMEN - Wedi Shiwa Show #1 - Zufan Ghebrehannes (Hugusha) Part 2 - New Eritrean Talk Show 2019 by AMEN ENTERTAINMENT 3 years ago 35 minutes 61,209 views",AMEN ENTERTAINMENT,61209,61234,25
972,"AMEN - Kesete Ghebremedhn - Hawki'ye | ሓውኺ'የ - New Eritrean Music 2019 by AMEN ENTERTAINMENT 3 years ago 5 minutes, 33 seconds 15,406 views",AMEN ENTERTAINMENT,15406,15411,5
973,"AMEN - Wedi Shiwa Show #1 - Zufan Ghebrehannes (Hugusha) Part 1 - New Eritrean Talk Show 2019 by AMEN ENTERTAINMENT 3 years ago 21 minutes 184,592 views",AMEN ENTERTAINMENT,184592,184644,52
974,"AMEN - Fili ft. (Yoni, Haben, Ashenafi, Habtom) - Selam - New Eritrean Music 2019 by AMEN ENTERTAINMENT 3 years ago 6 minutes, 38 seconds 79,615 views",AMEN ENTERTAINMENT,79615,79711,96
975,"AMEN - Merhawi Ghebrezgabhier (መራ ሽሽቢት) - Ade Kulna | ኣደ ኩልና - New Eritrean Music 2019 by AMEN ENTERTAINMENT 3 years ago 4 minutes, 56 seconds 180,044 views",AMEN ENTERTAINMENT,180044,180052,8
976,"AMEN - Zaki Naju - Deki Adey | ደቂ ዓደይ - New Eritrean Music 2018 by AMEN ENTERTAINMENT 3 years ago 6 minutes, 19 seconds 44,574 views",AMEN ENTERTAINMENT,44574,44628,54
977,"AMEN - Wedi Shiwa Show - New Eritrean Talk Show 2019 Coming Soon by AMEN ENTERTAINMENT 3 years ago 2 minutes, 5 seconds 35,817 views",AMEN ENTERTAINMENT,35817,35823,6
978,"AMEN - Mulgeta Andetsion - Norit | ኖሪት - New Eritrean Music 2018 by AMEN ENTERTAINMENT 3 years ago 4 minutes, 53 seconds 25,399 views",AMEN ENTERTAINMENT,25399,25406,7
979,"AMEN - Temesghen Negashi - Ngsti Africa - New Eritrean Music 2018 by AMEN ENTERTAINMENT 3 years ago 5 minutes, 46 seconds 21,744 views",AMEN ENTERTAINMENT,21744,21780,36
980,"AMEN - Filmon Mihretab - Agibki Do | ዓጊብኪ'ዶ - New Eritrean Music 2018 by AMEN ENTERTAINMENT 3 years ago 4 minutes, 15 seconds 22,502 views",AMEN ENTERTAINMENT,22502,22514,12
981,"AMEN - Abraham Teklemariam - Nay Lomi Fqri - New Eritrean Music 2018 by AMEN ENTERTAINMENT 3 years ago 4 minutes, 37 seconds 20,236 views",AMEN ENTERTAINMENT,20236,20250,14
982,"AMEN - Dawit Weldemichael ft. Ephrem Amare - Newri | ነውሪ - New Eritrean Music 2018 by AMEN ENTERTAINMENT 3 years ago 4 minutes, 58 seconds 9,669,958 views",AMEN ENTERTAINMENT,9669958,9699891,29933
983,"AMEN - Biniam Berhane - Metan Ktmeki | መታን ክጥዕመኪ - New Eritrean Music 2018 by AMEN ENTERTAINMENT 3 years ago 5 minutes, 17 seconds 49,245 views",AMEN ENTERTAINMENT,49245,49253,8
984,"AMEN - Tesfamariam Teklezghi - Sye Nay Ruba - New Eritrean Music 2018 by AMEN ENTERTAINMENT 3 years ago 5 minutes, 42 seconds 42,394 views",AMEN ENTERTAINMENT,42394,42414,20
985,"Rezene Goitom (DJ Rozosky) - Gezana Nafike | ገዛና ናፊቐ - New Eritrean Music 2018 (Official Video) by AMEN ENTERTAINMENT 3 years ago 5 minutes, 29 seconds 23,014 views",AMEN ENTERTAINMENT,23014,23025,11
986,"AMEN - Awet Embaye - Keshafit Lbi | ከሻፊት ልቢ - New Eritrean Music 2018 by AMEN ENTERTAINMENT 3 years ago 6 minutes, 52 seconds 28,771 views",AMEN ENTERTAINMENT,28771,28779,8
987,"AMEN - ንስሓ ብግርማይ ኣስፋሃ (ዓንቂ) Nsha by Ghirmay Asfaha (Anki) - New Eritrean Comedy 2018 by AMEN ENTERTAINMENT 3 years ago 7 minutes 101,296 views",AMEN ENTERTAINMENT,101296,101308,12
988,"AMEN - Mussie Berhe (Emberwel) - Selam | ሰላም - New Eritrean Music 2018 (Official Video) by AMEN ENTERTAINMENT 3 years ago 3 minutes, 53 seconds 180,588 views",AMEN ENTERTAINMENT,180588,180757,169
989,"AMEN - ባይቶ ብግርማይ ኣስፋሃ (ዓንቂ) Bayto by Ghirmay Asfaha - New Eritrean Comedy 2018 by AMEN ENTERTAINMENT 3 years ago 19 minutes 130,096 views",AMEN ENTERTAINMENT,130096,130123,27
990,"AMEN - Teame Weldemichael - Niu Ngezana | ንዑ ንገዛና - New Eritrean Music 2018 (Official Audio) by AMEN ENTERTAINMENT 3 years ago 5 minutes, 2 seconds 147,345 views",AMEN ENTERTAINMENT,147345,147368,23
991,"AMEN - Awet Embaye ‘‘Gzien Sebn’’ New Eritrean Music 2018 (Official Video) by AMEN ENTERTAINMENT 3 years ago 5 minutes, 39 seconds 35,396 views",AMEN ENTERTAINMENT,35396,35407,11
992,"AMEN - New Eritrean Music 2018 Daniel Semere (Ajente) ""Lwamey"" ልዋመይ by AMEN ENTERTAINMENT 3 years ago 5 minutes, 17 seconds 13,747 views",AMEN ENTERTAINMENT,13747,13753,6
993,"AMEN - Haylab Ghebretnsae (ዳሩ) - Gasha Alem | ጋሻ ዓለም - New Eritrean Music 2018 - Baptism Music by AMEN ENTERTAINMENT 3 years ago 5 minutes, 24 seconds 38,587 views",AMEN ENTERTAINMENT,38587,38618,31
994,"AMEN - Ermyas G7 - Qonjo Nay Qonaju | ቆንጆ ናይ ቆናጁ - New Eritrean Hip Hop  Music 2018 by AMEN ENTERTAINMENT 3 years ago 5 minutes, 25 seconds 176,059 views",AMEN ENTERTAINMENT,176059,176078,19
995,"AMEN - Mussie Berhe (Mberwel) - Hidget | ሕድገት - New Eritrean Music 2018 by AMEN ENTERTAINMENT 3 years ago 5 minutes, 42 seconds 25,382 views",AMEN ENTERTAINMENT,25382,25421,39
996,"AMEN - Qerana New Eritrean Film Cinema Release by AMEN ENTERTAINMENT 3 years ago 2 minutes, 31 seconds 17,391 views",AMEN ENTERTAINMENT,17391,17397,6
997,"AMEN - New Eritrean Music 2018 Shishay Haile(Azin )Aythmeyuwa by AMEN ENTERTAINMENT 3 years ago 6 minutes, 54 seconds 53,590 views",AMEN ENTERTAINMENT,53590,53596,6
998,"AMEN - Efrem Bereket (Abule) - Genzeb Tkabo | ገንዘብ ትካቦ - New Eritrean Music 2018 by AMEN ENTERTAINMENT 4 years ago 5 minutes, 41 seconds 42,243 views",AMEN ENTERTAINMENT,42243,42257,14
999,"AMEN - Okbamichael Zayd (Wedi Zayd) - Kumeley | ኩመለይ - New Eritrean Music 2018 by AMEN ENTERTAINMENT 4 years ago 5 minutes, 4 seconds 112,375 views",AMEN ENTERTAINMENT,112375,112387,12
1000,"AMEN - Robel Tewahbo (China) - Kialiya N'Adey | ክኣልያ ነደይ - New Eritrean Music 2018 (Official Video) by AMEN ENTERTAINMENT 4 years ago 6 minutes, 12 seconds 117,905 views",AMEN ENTERTAINMENT,117905,117941,36
1001,"AMEN - Shiden Solomon - Misaki Mihasheni | ምሳኺ ምሓሸኒ - New Eritrean Music 2018 (Official Audio) by AMEN ENTERTAINMENT 4 years ago 4 minutes, 19 seconds 164,826 views",AMEN ENTERTAINMENT,164826,164961,135
1002,"AMEN - Merhawi Habteslassie - ""Aytkoninini"" ኣይትኾንንኒ New Eritrean Music   2018 by AMEN ENTERTAINMENT 4 years ago 5 minutes, 17 seconds 23,082 views",AMEN ENTERTAINMENT,23082,23087,5
1003,"AMEN - New Eritrean Film Qerana Trailer by AMEN ENTERTAINMENT 4 years ago 2 minutes, 31 seconds 124,983 views",AMEN ENTERTAINMENT,124983,124987,4
1004,"AMEN - Brhane Zemichael (Wedi Nazu) - Eritrean Music 2018 ""Dhri Esele"" ድሕሪ ዕሰለ by AMEN ENTERTAINMENT 4 years ago 4 minutes, 59 seconds 241,976 views",AMEN ENTERTAINMENT,241976,242171,195
1005,"New Eritrean Music 2018 Mulgeta (Wedi Ketema) ""Nafike"" ናፊቐ by AMEN ENTERTAINMENT 4 years ago 5 minutes, 6 seconds 25,063 views",AMEN ENTERTAINMENT,25063,25076,13
1006,"New Eritrean Music 2018 Esayas Okubaldet ""Rihus Gama"" ርሑስ ጋማ by AMEN ENTERTAINMENT 4 years ago 6 minutes, 12 seconds 50,900 views",AMEN ENTERTAINMENT,50900,50905,5
1007,"New Eritrean Music 2018 Solomon Weldegergish ""Melak Bietey""  መልኣኽ ቤተይ by AMEN ENTERTAINMENT 4 years ago 5 minutes, 35 seconds 41,469 views",AMEN ENTERTAINMENT,41469,41479,10
1008,"Temesgen Abraham (Teme) - Brhan Ayney - Remix Eritrean Music 2018 (Original by Yousuf Said) by AMEN ENTERTAINMENT 4 years ago 5 minutes, 6 seconds 362,240 views",AMEN ENTERTAINMENT,362240,364400,2160
1009,"New Eritrean Music 2018 Resom Negassi (Raesu) ""Mekiru"" መቂሩ by AMEN ENTERTAINMENT 4 years ago 5 minutes, 41 seconds 33,766 views",AMEN ENTERTAINMENT,33766,33793,27
1010,"Efrem Tadese - Qal Kidan - New Eritrean Music 2018 by AMEN ENTERTAINMENT 4 years ago 5 minutes, 12 seconds 297,563 views",AMEN ENTERTAINMENT,297563,298080,517
1011,"New Eritrean Music 2018 Dejen Habtemariam ""Abiet Kitchikni"" ኣቤት ክትጭክኒ by AMEN ENTERTAINMENT 4 years ago 5 minutes, 23 seconds 41,143 views",AMEN ENTERTAINMENT,41143,41166,23
1012,"New Eritrean Music 2018 Bereket Teklay  ""Gezana"" ገዛና by AMEN ENTERTAINMENT 4 years ago 8 minutes, 30 seconds 35,331 views",AMEN ENTERTAINMENT,35331,35359,28
1013,"New Eritrean Music 2018 Grmay Okubaldet "" kereney"" ከረነይ by AMEN ENTERTAINMENT 4 years ago 5 minutes, 29 seconds 43,078 views",AMEN ENTERTAINMENT,43078,43095,17
1014,"New Eritrean Music 2018 Awet Tesfahans ""Kiftno ye'"" ክፍትኖ 'የ by AMEN ENTERTAINMENT 4 years ago 4 minutes, 51 seconds 38,823 views",AMEN ENTERTAINMENT,38823,38845,22
1015,"ፍቕሪ ስዒሩ | Fkri Sieru - ኮሜዲ Eritrean Comedy 2017 by AMEN ENTERTAINMENT 4 years ago 10 minutes, 26 seconds 403,946 views",AMEN ENTERTAINMENT,403946,403975,29
1016,"Coming Soon On Amen Entertainment: Bereket Teklay by AMEN ENTERTAINMENT 4 years ago 52 seconds 8,331 views",AMEN ENTERTAINMENT,8331,8332,1
1017,"New Eritrean Music 2018 Hadish Abraham ""Hadish Amet"" ሓድሽ ዓመት by AMEN ENTERTAINMENT 4 years ago 4 minutes, 13 seconds 31,887 views",AMEN ENTERTAINMENT,31887,31898,11
1018,"New Eritrean Music 2017 Bereket G/hiwet (Hubi) ""Aymselkum"" ኣይምሰልኩም by AMEN ENTERTAINMENT 4 years ago 6 minutes, 17 seconds 28,085 views",AMEN ENTERTAINMENT,28085,28093,8
1019,"Alexander Kahsay ""Abziheyo do""ኣብዚሐዮ’ዶ ሳንድሮ New Eritrean Music 2017 by AMEN ENTERTAINMENT 4 years ago 5 minutes, 31 seconds 284,651 views",AMEN ENTERTAINMENT,284651,286654,2003
1020,"New Eritrean Music 2017 Bereket Asmerom (Arish) Aytmhaliley ኣይትምሓልለ by AMEN ENTERTAINMENT 4 years ago 6 minutes, 32 seconds 53,074 views",AMEN ENTERTAINMENT,53074,53117,43
1021,"Afkari zrekbo - New Comedy 2017 by AMEN ENTERTAINMENT 4 years ago 26 minutes 364,013 views",AMEN ENTERTAINMENT,364013,364036,23
1022,"Eritrean Wedding  Fitsum and Almaz ; Redai and Gidey by AMEN ENTERTAINMENT 4 years ago 7 minutes, 13 seconds 14,052 views",AMEN ENTERTAINMENT,14052,14056,4
1023,"New Eritrean Music 2017 Medhanie Yohanes Ayblekin ye (ኣይብለከን'የ) by AMEN ENTERTAINMENT 4 years ago 5 minutes, 45 seconds 82,359 views",AMEN ENTERTAINMENT,82359,82382,23
1024,"New Eritrean Music 2017 Awet Embaye ""Zla fkri"" ዝላ ፍቕሪ by AMEN ENTERTAINMENT 4 years ago 6 minutes, 34 seconds 51,676 views",AMEN ENTERTAINMENT,51676,51692,16
1025,"New Eritrean Music 2017 John Gebre ""Aykealkiwon"" ኣይከኣልክዎን by AMEN ENTERTAINMENT 4 years ago 5 minutes, 58 seconds 26,338 views",AMEN ENTERTAINMENT,26338,26340,2
1026,"New Eritrean Music 2018 Selam Tesfamicael ""Erebay Wedi"" by AMEN ENTERTAINMENT 4 years ago 5 minutes, 46 seconds 15,964 views",AMEN ENTERTAINMENT,15964,15967,3
1027,"New Eritrean Music 2017  Kifle Berhe (Wedi Berhe) ኣስመራን ናፍቆታን Asmeran Nafkotan by AMEN ENTERTAINMENT 4 years ago 6 minutes 11,275 views",AMEN ENTERTAINMENT,11275,11292,17
1028,"New Eritrean Music 2017 Tesfagabr Gebreyesus Yqre Beliley ይቕረ በልለይ by AMEN ENTERTAINMENT 4 years ago 4 minutes, 45 seconds 35,998 views",AMEN ENTERTAINMENT,35998,36003,5
1029,"New Eritrean Music 2017 Teame Teklemariam & Awet Hagos “Bzey beakin” ብዘይ ብኣኽን by AMEN ENTERTAINMENT 4 years ago 4 minutes, 59 seconds 37,993 views",AMEN ENTERTAINMENT,37993,38008,15
1030,"Abel Weldehariat (Rasha) - Sensolomay | ሰንሰሎማይ - New Eritrean Music 2017 (Offical Video) by AMEN ENTERTAINMENT 4 years ago 5 minutes, 48 seconds 157,359 views",AMEN ENTERTAINMENT,157359,157417,58
1031,"Coming Soon Awet Hagos and Teame Teklemariam ""Bzey Beakin"" by AMEN ENTERTAINMENT 4 years ago 1 minute, 6 seconds 16,173 views",AMEN ENTERTAINMENT,16173,16176,3
1032,"Senselomay - Abel Woldehawariat  Coming Soon ሓዳስ ደርፊ፡ ሰንሰሎማይ ኣቤል ወ/ሃዋርያት (ራሻ) by AMEN ENTERTAINMENT 4 years ago 1 minute 24,175 views",AMEN ENTERTAINMENT,24175,24178,3
1033,"New Eritrean Music 2017 Merhawi Ghebregziabher ""Ade Kulna""  ኣደ ኩልና by AMEN ENTERTAINMENT 4 years ago 4 minutes, 50 seconds 69,273 views",AMEN ENTERTAINMENT,69273,69317,44
1034,"New Eritrean Music 2017 Zeray Hagos (ወዲ ሓጎስ) Mesetay መሰታይ by AMEN ENTERTAINMENT 4 years ago 7 minutes, 9 seconds 21,518 views",AMEN ENTERTAINMENT,21518,21529,11
1035,"New Eritrean Music 2017 Fitsum Zemichael ""Nigeruni"" ንገሩኒ by AMEN ENTERTAINMENT 4 years ago 4 minutes, 58 seconds 33,573 views",AMEN ENTERTAINMENT,33573,33587,14
1036,"New Erirean Music 2017 Petros Yosef ""Hanse meskele"" ሃንሰ መስቀለ by AMEN ENTERTAINMENT 4 years ago 5 minutes, 22 seconds 11,450 views",AMEN ENTERTAINMENT,11450,11454,4
1037,"New Eritrean Music 2017 Adiam Bahta ""Gdefuni Sebey"" 2017 by AMEN ENTERTAINMENT 4 years ago 6 minutes, 9 seconds 149,174 views",AMEN ENTERTAINMENT,149174,149215,41
1038,"New Eritrean Music 2017 Teklu Yohannes ""Halengo"" ሓለንጎ by AMEN ENTERTAINMENT 4 years ago 5 minutes, 38 seconds 28,062 views",AMEN ENTERTAINMENT,28062,28069,7
1039,"New Eritrean Music 2017 Alexander Kahsay (Sandro) ""Abziheyo do"" ኣብዚሐዮ ዶ? (Official Audio) by AMEN ENTERTAINMENT 4 years ago 5 minutes, 3 seconds 77,560 views",AMEN ENTERTAINMENT,77560,77634,74
1040,"Hayelom Abrahaley (Eri Power) - Manaye | ማናየ - New Eritrean Music 2017 (Official Video) by AMEN ENTERTAINMENT 4 years ago 4 minutes, 45 seconds 131,477 views",AMEN ENTERTAINMENT,131477,131610,133
1041,"Shewit Kifle - Hibeka Eye Baeley | ሂበካ'የ ባዕለይ - New Eritrean Music 2017 (Official Video) by AMEN ENTERTAINMENT 4 years ago 5 minutes, 11 seconds 4,381,742 views",AMEN ENTERTAINMENT,4381742,4392156,10414
1042,"New Eritrean Song 2017 Awet Hagos (እስታላ) ""Zebene Ezni"" ዘበነ እዝኒ by AMEN ENTERTAINMENT 4 years ago 4 minutes, 46 seconds 31,618 views",AMEN ENTERTAINMENT,31618,31651,33
1043,"New Eritrean Song 2017 Kaleab Gebremariam (wedi Ayni Mear) ""Telimu Aytbelu"" ጠሊሙ ኣይትበሉ by AMEN ENTERTAINMENT 4 years ago 6 minutes, 6 seconds 50,099 views",AMEN ENTERTAINMENT,50099,50113,14
1044,"New Eritrean Music 2017 Awet Berhe ""Rahwa"" ራህዋ by AMEN ENTERTAINMENT 4 years ago 5 minutes, 38 seconds 148,049 views",AMEN ENTERTAINMENT,148049,148067,18
1045,"Shiden Solomon - Aynomey | ዓይኖመይ - New Eritrean Music 2017 (Official Video) by AMEN ENTERTAINMENT 4 years ago 5 minutes, 31 seconds 1,354,295 views",AMEN ENTERTAINMENT,1354295,1355190,895
1046,"New Eritrean Music 2017 Filmon Meseret ""Fnotey"" ፍኖተይ by AMEN ENTERTAINMENT 4 years ago 4 minutes, 6 seconds 41,921 views",AMEN ENTERTAINMENT,41921,41928,7
1047,"New Eritrean Music 2017 Asmerom Teklay ""Wegihu do?"" ወጊሑ ዶ? Featuring Timnit Welday by AMEN ENTERTAINMENT 4 years ago 6 minutes, 27 seconds 28,066 views",AMEN ENTERTAINMENT,28066,28074,8
1048,"Ruftalem Abraham - Teref Yelen | ተረፍ የለን - New Eritrean Music 2017 (Official Video) by AMEN ENTERTAINMENT 4 years ago 6 minutes, 15 seconds 488,424 views",AMEN ENTERTAINMENT,488424,489356,932
1049,"Hanna Kahsay - Kidaney - ኪዳነይ - New Eritrean Music 2017 by AMEN ENTERTAINMENT 4 years ago 5 minutes, 2 seconds 63,499 views",AMEN ENTERTAINMENT,63499,63543,44
1050,"New Eritrean Music 2017 Filmon Berhane ""kumeley"" ኩመለይ by AMEN ENTERTAINMENT 4 years ago 6 minutes, 3 seconds 303,793 views",AMEN ENTERTAINMENT,303793,303855,62
1051,"New Eritrean Music 2017 Fred Haile ""hiriyti"" ሕርይቲ by AMEN ENTERTAINMENT 4 years ago 5 minutes, 14 seconds 76,465 views",AMEN ENTERTAINMENT,76465,76476,11
1052,"New Eritrean Music 2017 Daniel semere (Ajente) Rieyeki ሪእየኪ by AMEN ENTERTAINMENT 4 years ago 6 minutes, 38 seconds 30,549 views",AMEN ENTERTAINMENT,30549,30554,5
1053,"New Eritrean Music 2017 Awet Embaye ""hadish firdi"" ሓድሽ ፍርዲ by AMEN ENTERTAINMENT 4 years ago 7 minutes, 27 seconds 37,111 views",AMEN ENTERTAINMENT,37111,37131,20
1054,"New Eritrean Music 2017 Yohanes Shishay (John) ""Emenini"" እመንኒ by AMEN ENTERTAINMENT 4 years ago 7 minutes, 30 seconds 16,206 views",AMEN ENTERTAINMENT,16206,16213,7
1055,"New Eritrean Music 2017 Yosief Tsegai ""Men ala kemaki"" by AMEN ENTERTAINMENT 4 years ago 5 minutes, 21 seconds 54,474 views",AMEN ENTERTAINMENT,54474,54487,13
1056,"New Eritrean Music 2017 ""Hiyab Semay"" Naod Andebrhan (Wedi Ande) by AMEN ENTERTAINMENT 4 years ago 5 minutes, 2 seconds 31,495 views",AMEN ENTERTAINMENT,31495,31520,25
1057,"New Eritrean Music 2017 Haylab Yohannes (ባሪዓ) ""Aytferarekni"" ኣይትፈራረቕኒ by AMEN ENTERTAINMENT 4 years ago 6 minutes, 10 seconds 1,641,775 views",AMEN ENTERTAINMENT,1641775,1642709,934
1058,"New Eritrean Song 2017 Alganesh Yehdego (China) ""Kem lbey"" ከም ልበይ by AMEN ENTERTAINMENT 4 years ago 8 minutes, 18 seconds 228,950 views",AMEN ENTERTAINMENT,228950,229003,53
1059,"New Eritrean Music Yodit Brhane  (Baytheway)  Lgsi Fetari “ልግሲ ፈጣሪ” by AMEN ENTERTAINMENT 4 years ago 5 minutes, 27 seconds 98,356 views",AMEN ENTERTAINMENT,98356,98369,13
1060,"New Eritrean Music ""Abiela"" ኣቤላ Solomun Yohannes by AMEN ENTERTAINMENT 4 years ago 4 minutes, 36 seconds 10,002 views",AMEN ENTERTAINMENT,10002,10002,0
1061,"New Eritrean Music Lchom Mhretu ""Mnasey"" ምንኣሰይ  2017 by AMEN ENTERTAINMENT 4 years ago 4 minutes, 21 seconds 76,930 views",AMEN ENTERTAINMENT,76930,76937,7
1062,"New Eritrean Music 2017 Abraham kahsay (Wasila) Lebewa ti Jigna ለበዋ ቲ ጅግና by AMEN ENTERTAINMENT 4 years ago 4 minutes, 20 seconds 13,178 views",AMEN ENTERTAINMENT,13178,13180,2
1063,"New Eritrean Music 2017 Teame Teklemariam ""Simeana ba lomis"" ስምዓና 'ባ ሎምስ by AMEN ENTERTAINMENT 4 years ago 6 minutes 35,952 views",AMEN ENTERTAINMENT,35952,35956,4
1064,"Eritrean Music Bajet Mehari - Emnetey by AMEN ENTERTAINMENT 4 years ago 5 minutes, 30 seconds 21,152 views",AMEN ENTERTAINMENT,21152,21180,28
1065,"New Eritrean Music 2017 Mohammed Ibrahim (Hamie)  akmey eye zigebr ዓቕመይ ኢየ ዝገብር by AMEN ENTERTAINMENT 4 years ago 4 minutes, 35 seconds 71,828 views",AMEN ENTERTAINMENT,71828,71834,6
1066,"New Eritrean Music 2017 Bajet Mehari ""Aykealen Kebdey"" ኣይከኣለን ከብደይ by AMEN ENTERTAINMENT 4 years ago 5 minutes, 55 seconds 102,366 views",AMEN ENTERTAINMENT,102366,102423,57
1067,"New Eritrean Music 2017 Mohammed Ibrahim (hamie) ""Men Alo"" መን ኣሎ by AMEN ENTERTAINMENT 4 years ago 5 minutes, 26 seconds 102,176 views",AMEN ENTERTAINMENT,102176,102180,4
1068,"New Eritrean Music 2017 Robi Barya Alo gnay nfas ኣሎ ግናይ ንፋስ by AMEN ENTERTAINMENT 4 years ago 5 minutes, 35 seconds 22,038 views",AMEN ENTERTAINMENT,22038,22043,5
1069,"New Eritrean Music 2017 Tesfasion Gerezgiher (Reagan)  ዕምበባ ጽገረዳ by AMEN ENTERTAINMENT 4 years ago 6 minutes, 40 seconds 8,871 views",AMEN ENTERTAINMENT,8871,8872,1
1070,"New Eritrean Music 2017 Dawit Yared ""Tim kealu"" ትም ክኣሉ by AMEN ENTERTAINMENT 4 years ago 5 minutes, 24 seconds 130,982 views",AMEN ENTERTAINMENT,130982,130993,11
1071,"New Eritrean Bilen music 2017 Omar Amer  kidakuana ኪዳኳና by AMEN ENTERTAINMENT 4 years ago 6 minutes, 16 seconds 391,950 views",AMEN ENTERTAINMENT,391950,392384,434
1072,"New Eritrean Music 2017 Yakob Negassi (Wedi Guandie) ተናሲሐ ""Tenasihe"" by AMEN ENTERTAINMENT 4 years ago 5 minutes, 35 seconds 22,342 views",AMEN ENTERTAINMENT,22342,22351,9
1073,"New Eritrean Music 2017 Daniel Semere (Ajente) ""menen"" መነን by AMEN ENTERTAINMENT 4 years ago 5 minutes, 8 seconds 165,856 views",AMEN ENTERTAINMENT,165856,165868,12
1074,"New Eritrean Music 2017 Mohammed Ibrahim (Hamie) ""Nfalale Dehan"" by AMEN ENTERTAINMENT 4 years ago 5 minutes, 3 seconds 6,362 views",AMEN ENTERTAINMENT,6362,6366,4
1075,"New Eritrean Music 2017 Bajet Mehari ""Snbade"" ስንባደ by AMEN ENTERTAINMENT 4 years ago 6 minutes, 9 seconds 92,672 views",AMEN ENTERTAINMENT,92672,92839,167
1076,"New Eritrean Music 2017 Abiel Tsegay (Chakur) ናይ ሰብ ነገር Nay Seb Neger by AMEN ENTERTAINMENT 4 years ago 5 minutes, 8 seconds 14,771 views",AMEN ENTERTAINMENT,14771,14778,7
1077,"New Eritrean Music 2017 Sadat Ahmed (Wedi Mazu) by AMEN ENTERTAINMENT 4 years ago 4 minutes, 37 seconds 51,281 views",AMEN ENTERTAINMENT,51281,51332,51
1078,"New Eritrean Music 2017 Bajet Mehari ""Nafikeki"" by AMEN ENTERTAINMENT 4 years ago 6 minutes, 3 seconds 126,829 views",AMEN ENTERTAINMENT,126829,126889,60
1079,"New Eritrean Music 2017 Merih Andebrhan ሓድነት 'ዩ ግርማና ""Hadnet yu grmana"" by AMEN ENTERTAINMENT 4 years ago 9 minutes, 5 seconds 34,787 views",AMEN ENTERTAINMENT,34787,34792,5
1080,"New Eritrean Comedy 2017 Ermile Stage comedy by AMEN ENTERTAINMENT 4 years ago 9 minutes, 29 seconds 182,049 views",AMEN ENTERTAINMENT,182049,182073,24
1081,"Seare Debesay - Mehegosey | መሐጎሰይ - New Eritrean Music 2017 (Official Video) by AMEN ENTERTAINMENT 4 years ago 5 minutes, 12 seconds 419,714 views",AMEN ENTERTAINMENT,419714,419825,111
1082,"New Eritrean Music 2017 Robel Ghebremariam (Rubi) ጸዋር ኢኺ  ""Tsewar iki"" by AMEN ENTERTAINMENT 4 years ago 4 minutes, 38 seconds 91,308 views",AMEN ENTERTAINMENT,91308,91353,45
1083,"New Eritrean Music 2017 Mohammed Ibrahim (Hamie) ""Ajoki"" by AMEN ENTERTAINMENT 4 years ago 5 minutes, 43 seconds 10,914 views",AMEN ENTERTAINMENT,10914,10915,1
1084,"New Eritrean Music 2017 Mohammed Ibrahim (Hamie) Weini Zelela by AMEN ENTERTAINMENT 4 years ago 5 minutes, 20 seconds 13,683 views",AMEN ENTERTAINMENT,13683,13685,2
1085,"New Eritrean Music 2017 Mohammed Ibrahim (Hamie) Mama by AMEN ENTERTAINMENT 4 years ago 5 minutes, 27 seconds 15,127 views",AMEN ENTERTAINMENT,15127,15129,2
1086,"Lidya Teklemariam - Hanen | ሃነን - New Eritrean Music 2017 by AMEN ENTERTAINMENT 4 years ago 5 minutes, 27 seconds 165,766 views",AMEN ENTERTAINMENT,165766,165832,66
1087,"New Eritrean Music 2017 Million Goitom & Sham Geshu  (ዓለመይ) ሚልዮን ጎይትኦም (ወዲ ሑጻ) ሻም ጌሹ by AMEN ENTERTAINMENT 4 years ago 5 minutes, 27 seconds 1,508,325 views",AMEN ENTERTAINMENT,1508325,1510309,1984
1088,"New Eritrean music 2017 Filmon Berhane “aqayiha” ኣቃይሓ by AMEN ENTERTAINMENT 4 years ago 6 minutes, 5 seconds 317,806 views",AMEN ENTERTAINMENT,317806,317931,125
1089,"New Eritrean Music 2017 Abraham Tewelde ""Aywielon'ye"" ኣይውዕሎን' የ by AMEN ENTERTAINMENT 4 years ago 5 minutes, 52 seconds 77,837 views",AMEN ENTERTAINMENT,77837,77898,61
1090,"New Eritrean Music 2017 (Wedi Gash) Hawey Aytbeli ሓወይ ኣይትበልኒ by AMEN ENTERTAINMENT 4 years ago 6 minutes, 49 seconds 36,994 views",AMEN ENTERTAINMENT,36994,37001,7
1091,"New Eritrean Music 2017 Efrem Knfe ""Gual Dege"" ጋል ደገ by AMEN ENTERTAINMENT 4 years ago 4 minutes, 59 seconds 49,754 views",AMEN ENTERTAINMENT,49754,49758,4
1092,"Amanuel Habtegabr - Ygbiana'yu - New Eritrean Music 2017 (Official Video) by AMEN ENTERTAINMENT 4 years ago 5 minutes, 52 seconds 697,777 views",AMEN ENTERTAINMENT,697777,698584,807
1093,"New Eritrean Music 2017 ""Asmera Shikor"" Selomun Denbelash (Shelela) by AMEN ENTERTAINMENT 4 years ago 6 minutes, 28 seconds 46,332 views",AMEN ENTERTAINMENT,46332,46349,17
1094,"New Eritrean Music 2017  - Mihreteab Goitom ""Welela"" by AMEN ENTERTAINMENT 4 years ago 7 minutes, 14 seconds 28,902 views",AMEN ENTERTAINMENT,28902,28911,9
1095,"New Eritrean Music  ""Tewasait"" Tomas Hagos by AMEN ENTERTAINMENT 4 years ago 6 minutes, 32 seconds 22,629 views",AMEN ENTERTAINMENT,22629,22641,12
1096,"New Eritrean Music 2017 ""Halafay endyu kulu"" by Teame Teklemariam by AMEN ENTERTAINMENT 5 years ago 5 minutes, 20 seconds 187,584 views",AMEN ENTERTAINMENT,187584,187600,16
1097,"Jemal Romodan - Men Eyu Asmarino | መን'ዩ ኣዝማሪኖ - New Eritrean Music 2017 (Official Video) by AMEN ENTERTAINMENT 5 years ago 7 minutes, 45 seconds 5,072,987 views",AMEN ENTERTAINMENT,5072987,5079982,6995
1098,"Eritrean Film ""kemalemey"" -Official (Part 2) by AMEN ENTERTAINMENT 5 years ago 53 minutes 53,297 views",AMEN ENTERTAINMENT,53297,53387,90
1099,"Tsor Lbi Part 2 - Official by AMEN ENTERTAINMENT 5 years ago 2 minutes, 27 seconds 9,833 views",AMEN ENTERTAINMENT,9833,9847,14
1100,"New Eritrean Music Video 2017 ""Kimles 'ye"" by Habtom Gebreigziabher by AMEN ENTERTAINMENT 5 years ago 6 minutes, 56 seconds 51,590 views",AMEN ENTERTAINMENT,51590,51635,45
1101,"Awel Comedy Part 3 ""መዓልካ ተኽላይ"" by AMEN ENTERTAINMENT 5 years ago 5 minutes, 21 seconds 77,808 views",AMEN ENTERTAINMENT,77808,77809,1
1102,"Awel Comedy Part 6 ""ዓንጁ"" New Eritrean Comedy 2017 by AMEN ENTERTAINMENT 5 years ago 4 minutes, 31 seconds 104,473 views",AMEN ENTERTAINMENT,104473,104479,6
1103,"Awel Comedy Part 4 ""ሰታሪተይ"" New Eritrean Comedy 2017 by AMEN ENTERTAINMENT 5 years ago 6 minutes, 9 seconds 68,941 views",AMEN ENTERTAINMENT,68941,68943,2
1104,"Awel Comedy Part 5 ካርተሊና New Eritrean Comedy 2017 by AMEN ENTERTAINMENT 5 years ago 5 minutes, 2 seconds 90,125 views",AMEN ENTERTAINMENT,90125,90129,4
1105,"Awel Comedy Part 2 ""ሕልማዊ ፍቕሪ"" - New Eritrean Comedy 2017 by AMEN ENTERTAINMENT 5 years ago 5 minutes, 8 seconds 118,153 views",AMEN ENTERTAINMENT,118153,118158,5
1106,"Awel comedy  Part 1 ""ሃናን"" - New Eritrean Comedy 2017 by AMEN ENTERTAINMENT 5 years ago 4 minutes, 22 seconds 246,085 views",AMEN ENTERTAINMENT,246085,246095,10
1107,"New Eritrean Music 2017 Merhawit Araya (Merry) ""Adey"""" by AMEN ENTERTAINMENT 5 years ago 7 minutes, 31 seconds 82,480 views",AMEN ENTERTAINMENT,82480,82489,9
1108,"Official Eritrean Film ""Tsor Lbi"" PART 1 by AMEN ENTERTAINMENT 5 years ago 46 minutes 64,057 views",AMEN ENTERTAINMENT,64057,64160,103
1109,"New Eritrean Music 2017 Isayas Gebrengus (Selihomey) ""aytzarebu"" by AMEN ENTERTAINMENT 5 years ago 7 minutes, 12 seconds 25,149 views",AMEN ENTERTAINMENT,25149,25154,5
1110,"New Eritrean Music 2017 Samuel Habtemichael (Eyet) ""halwley "" by AMEN ENTERTAINMENT 5 years ago 6 minutes, 56 seconds 69,447 views",AMEN ENTERTAINMENT,69447,69472,25
1111,"New Eritrean Music 2017 ""Qelebie"" Million Negassi by AMEN ENTERTAINMENT 5 years ago 5 minutes, 28 seconds 64,929 views",AMEN ENTERTAINMENT,64929,64991,62
1112,"Estifanos Abraham (Zemach) - Bdho | ብድሆ - New Eritrean Music 2017 (Official Stage Video) by AMEN ENTERTAINMENT 5 years ago 8 minutes, 59 seconds 980,807 views",AMEN ENTERTAINMENT,980807,984188,3381
1113,"Estifanos Abraham (Zemach) - Hijum | ህጁም - New Eritrean Music 2017 (Official Stage Video) by AMEN ENTERTAINMENT 5 years ago 6 minutes, 18 seconds 823,204 views",AMEN ENTERTAINMENT,823204,834773,11569
1114,"Estifanos Abraham (Zemach) - Wede Geba | ወደ ገባ - New Eritrean Music 2017 (Official Stage Video) by AMEN ENTERTAINMENT 5 years ago 5 minutes, 26 seconds 307,633 views",AMEN ENTERTAINMENT,307633,308815,1182
1115,"Meron Estifanos - Adrashana | ኣድራሻና - New Eritrean Remix Music 2017 (Official Concert) by AMEN ENTERTAINMENT 5 years ago 4 minutes 162,099 views",AMEN ENTERTAINMENT,162099,162302,203
1116,"Estifanos Abraham (Zemach) - Sahl Dejenna | ሳሕል ደጀን’ና - Eritrean Music 2017 (Official Stage Video) by AMEN ENTERTAINMENT 5 years ago 6 minutes, 31 seconds 181,603 views",AMEN ENTERTAINMENT,181603,182683,1080
1117,"Estifanos Abraham (Zemach) - Hzbawi Serawit | ህዝባዊ ሰራዊት - Eritrean Music 2017 (Official Stage Video) by AMEN ENTERTAINMENT 5 years ago 6 minutes, 23 seconds 452,727 views",AMEN ENTERTAINMENT,452727,455034,2307
1118,"New Eritrean Music 2017 Awet Teklebrhan ""Dgemeley"" by AMEN ENTERTAINMENT 5 years ago 6 minutes, 35 seconds 130,779 views",AMEN ENTERTAINMENT,130779,130837,58
1119,"Bajet Mehari ""Omega Tsbake"" by AMEN ENTERTAINMENT 5 years ago 7 minutes, 51 seconds 262,409 views",AMEN ENTERTAINMENT,262409,263319,910
1120,"New Eritrean Music 2017 ""Hadish Amet"" Habtom Siyum (Wedi Shel) by AMEN ENTERTAINMENT 5 years ago 5 minutes, 32 seconds 35,131 views",AMEN ENTERTAINMENT,35131,35135,4
1121,"New Eritrean Music 2017 Saimon Abraham "" Mgagekni"" by AMEN ENTERTAINMENT 5 years ago 4 minutes, 33 seconds 171,913 views",AMEN ENTERTAINMENT,171913,171933,20
1122,"New Eritrean Music 2017 ""Serbi Gama"" by Efrem Baryagabr by AMEN ENTERTAINMENT 5 years ago 7 minutes, 4 seconds 109,177 views",AMEN ENTERTAINMENT,109177,109193,16
1123,"New Eritrean Music Bajet Mehari ""Selam beluley"" by AMEN ENTERTAINMENT 5 years ago 7 minutes, 16 seconds 30,411 views",AMEN ENTERTAINMENT,30411,30471,60
1124,"Amen Entertainment by AMEN ENTERTAINMENT 5 years ago 1 minute, 3 seconds 50,289 views",AMEN ENTERTAINMENT,50289,50290,1
1125,"New Eritrean Music 2017 Tesfalem Melake ""Alilula"" by AMEN ENTERTAINMENT 5 years ago 6 minutes, 38 seconds 27,473 views",AMEN ENTERTAINMENT,27473,27475,2
1126,"New Eritrean Music 2017 Issayas Kesete Fekrki ""barkley"" by AMEN ENTERTAINMENT 5 years ago 7 minutes, 19 seconds 80,912 views",AMEN ENTERTAINMENT,80912,80930,18
1127,"New Eritrean Music Bajet mehari ""Temeniyeki"" by AMEN ENTERTAINMENT 5 years ago 5 minutes, 48 seconds 55,003 views",AMEN ENTERTAINMENT,55003,55041,38
1128,"New Eritrean Music 2017 ""Reaywa ba za alem"" Solomun Denbelash (Shelela) by AMEN ENTERTAINMENT 5 years ago 4 minutes, 59 seconds 18,314 views",AMEN ENTERTAINMENT,18314,18318,4
1129,"""Abera"" ኣፍራዪ  ባህላዊ ጉዳያት ህግደፍ  New Eritrean Musical short film by AMEN ENTERTAINMENT 5 years ago 17 minutes 173,929 views",AMEN ENTERTAINMENT,173929,173961,32
1130,"New Eritrean Mussie Tsegay Music 2017 ""Alafacha"" ኣላፋቻ by AMEN ENTERTAINMENT 5 years ago 5 minutes, 42 seconds 71,417 views",AMEN ENTERTAINMENT,71417,71427,10
1131,"New Eritrean Music 2017 ""Hawey"" by Saymon Abraham by AMEN ENTERTAINMENT 5 years ago 5 minutes, 52 seconds 73,345 views",AMEN ENTERTAINMENT,73345,73351,6
1132,"New Eritrean Music 2017 Saarom Mihreteab (Suzawi) ""Zendo"" ዘንዶ by AMEN ENTERTAINMENT 5 years ago 5 minutes, 57 seconds 342,742 views",AMEN ENTERTAINMENT,342742,342930,188
1133,"New Eritrean music 2017 ""Aymeselenin"" by Yonatan Kiros by AMEN ENTERTAINMENT 5 years ago 6 minutes, 15 seconds 159,003 views",AMEN ENTERTAINMENT,159003,159009,6
1134,"Meles Tikue - Zewar'ye | ዘዋር 'የ - New Eritrean Music 2016 (Official Video) by AMEN ENTERTAINMENT 5 years ago 6 minutes, 37 seconds 107,762 views",AMEN ENTERTAINMENT,107762,107779,17
1135,"New Eritrean Music 2016 ""Zelekuwo"" by Efrem Tesfamicael by AMEN ENTERTAINMENT 5 years ago 7 minutes, 16 seconds 71,099 views",AMEN ENTERTAINMENT,71099,71177,78
1136,"New Eritrean Music 2016 ""Maganey"" by Mensur Ali by AMEN ENTERTAINMENT 5 years ago 6 minutes, 22 seconds 3,881 views",AMEN ENTERTAINMENT,3881,3884,3
1137,"New Eritrean Music 2016 ""Memahrtey"" by Medrek Abraha by AMEN ENTERTAINMENT 5 years ago 6 minutes, 27 seconds 18,798 views",AMEN ENTERTAINMENT,18798,18803,5
1138,"New Eritrean Music 2016 ""Jelemtay"" by Filmon Berhane by AMEN ENTERTAINMENT 5 years ago 6 minutes, 38 seconds 11,289 views",AMEN ENTERTAINMENT,11289,11303,14
1139,"Cute Tigrinya guyala dancer by AMEN ENTERTAINMENT 5 years ago 32 seconds 4,673 views",AMEN ENTERTAINMENT,4673,4674,1
1140,"New Eritrean Music 2016 ""teqlibley do""  by Efrem Baryagabr by AMEN ENTERTAINMENT 5 years ago 7 minutes, 25 seconds 13,328 views",AMEN ENTERTAINMENT,13328,13331,3
1141,"New Eritrean Music 2016 ""Mereat Neqila"" Bajet Mehari by AMEN ENTERTAINMENT 5 years ago 7 minutes, 2 seconds 46,857 views",AMEN ENTERTAINMENT,46857,46867,10
1142,"New Eritrean Music - Rehase Gebrhiwet (Wedi Ubel) ""Felamit Fikrey"" by AMEN ENTERTAINMENT 5 years ago 7 minutes, 7 seconds 10,189 views",AMEN ENTERTAINMENT,10189,10190,1
1143,"New Eritrean Music by Helen Tsegai ""Yalo"" by AMEN ENTERTAINMENT 5 years ago 5 minutes, 23 seconds 40,589 views",AMEN ENTERTAINMENT,40589,40641,52
1144,"New Eritrean Music 2016 Bajet Mehari ""Teshelemley"" by AMEN ENTERTAINMENT 5 years ago 7 minutes, 26 seconds 58,897 views",AMEN ENTERTAINMENT,58897,58964,67
1145,"New Eritrean Music 2016 Million Amanuel (Wedi Nashih) - ""Enafeletkini"" by AMEN ENTERTAINMENT 5 years ago 5 minutes, 27 seconds 2,396 views",AMEN ENTERTAINMENT,2396,2408,12
1146,"New Eritrean music 2016 Abiel W/hawariat (Rasha) - ""qonjo"" by AMEN ENTERTAINMENT 5 years ago 5 minutes, 17 seconds 55,265 views",AMEN ENTERTAINMENT,55265,55275,10
1147,"New Eritrean Song 2016 ""Tsigabey"" by Awet Embaye by AMEN ENTERTAINMENT 5 years ago 4 minutes, 55 seconds 11,345 views",AMEN ENTERTAINMENT,11345,11349,4
1148,"New Eritrean Song 2016 ""Keren Aje"" by Awet Embaye by AMEN ENTERTAINMENT 5 years ago 6 minutes, 22 seconds 5,040 views",AMEN ENTERTAINMENT,5040,5042,2
1149,"New Eritrean Music 2016 Amanuel Tadesse (Wedi Tadi) - Aytn' asi ""ኣይትንኣሲ"" by AMEN ENTERTAINMENT 5 years ago 6 minutes, 41 seconds 30,518 views",AMEN ENTERTAINMENT,30518,30524,6
1150,"Efrem Baryagabr ""Bahri Sieru"" ባህሪ ስዒሩ - New Eritrean Music 2016 by AMEN ENTERTAINMENT 5 years ago 7 minutes, 55 seconds 25,410 views",AMEN ENTERTAINMENT,25410,25416,6
1151,"New Eritrean song 2016 ""Filmawitey"" by Awet Embaye by AMEN ENTERTAINMENT 5 years ago 7 minutes, 15 seconds 26,139 views",AMEN ENTERTAINMENT,26139,26143,4
1152,"New Eritrean song by Teame Teklemariam ""Brhan Gesu"" by AMEN ENTERTAINMENT 5 years ago 5 minutes, 18 seconds 264,547 views",AMEN ENTERTAINMENT,264547,264618,71
1153,"New Eritrean Music 2016 by Helen Tsegay ""HAWEY"" by AMEN ENTERTAINMENT 5 years ago 5 minutes, 27 seconds 23,166 views",AMEN ENTERTAINMENT,23166,23177,11
1154,"Estifanos Abraham -  ""Hinsa Fikri"" by AMEN ENTERTAINMENT 5 years ago 5 minutes, 39 seconds 6,860 views",AMEN ENTERTAINMENT,6860,6870,10
1155,"New Eritrean Music 2016 Yonas Haileslassie (Yoniti) ""Tebedilki"" by AMEN ENTERTAINMENT 5 years ago 5 minutes, 26 seconds 18,647 views",AMEN ENTERTAINMENT,18647,18653,6
1156,"New Eritrean Music 2016 Angesom Tesfu ""Mebrahti lbey"" by AMEN ENTERTAINMENT 5 years ago 8 minutes, 19 seconds 183,246 views",AMEN ENTERTAINMENT,183246,183446,200
1157,"New Eritrean Music by HELEN TSEGAI  ""ADEY"" by AMEN ENTERTAINMENT 5 years ago 4 minutes, 59 seconds 16,950 views",AMEN ENTERTAINMENT,16950,16959,9
1158,"Estifanos Abraham (Zemach) - Kindey Emo Kbleki | ክንደይ'ሞ ክብለኪ - New Eritrean Music 2016 by AMEN ENTERTAINMENT 5 years ago 6 minutes, 19 seconds 1,990,951 views",AMEN ENTERTAINMENT,1990951,2009678,18727
1159,"New Eritrean Music 2016 Helen Tsegay  ""MUKUREY"" by AMEN ENTERTAINMENT 5 years ago 6 minutes, 33 seconds 23,865 views",AMEN ENTERTAINMENT,23865,23887,22
1160,"New Eritrean Music 2016 by Bereket Dawit (Shum Nihbi) ""Shebo Zemenmeno"" by AMEN ENTERTAINMENT 5 years ago 7 minutes, 5 seconds 55,706 views",AMEN ENTERTAINMENT,55706,55712,6
1161,"Estifanos Abraham (Zemach) - Astatlile | ኣስታሊለ - New Eritrean Music 2016 by AMEN ENTERTAINMENT 5 years ago 5 minutes, 58 seconds 294,330 views",AMEN ENTERTAINMENT,294330,295410,1080
1162,"New Eritrean Music Smonn Ghoitom (Wedi Haleka) 's Official Music Video ""Aymselki Waza"" by AMEN ENTERTAINMENT 5 years ago 6 minutes, 19 seconds 429,752 views",AMEN ENTERTAINMENT,429752,429790,38
1163,"New Eritrean Music by Selomun Dembelash ""Shelela"" - Meteabiytey by AMEN ENTERTAINMENT 5 years ago 5 minutes, 48 seconds 50,616 views",AMEN ENTERTAINMENT,50616,50632,16
1164,"New Eritrean Music 2016 Fnan Hagos ""Tesfa"" by AMEN ENTERTAINMENT 5 years ago 5 minutes, 25 seconds 76,808 views",AMEN ENTERTAINMENT,76808,76820,12
1165,"New Eritrean Music 2017 - Shishay Haile (Azin) - Alatni by AMEN ENTERTAINMENT 5 years ago 6 minutes, 31 seconds 189,801 views",AMEN ENTERTAINMENT,189801,189809,8
1166,"Helen Tsegai - Tedebise by AMEN ENTERTAINMENT 5 years ago 4 minutes, 12 seconds 6,414 views",AMEN ENTERTAINMENT,6414,6415,1
1167,"Mussie Ghirmay  & Samuel Habtom - Kemey'yu Negeru by AMEN ENTERTAINMENT 5 years ago 5 minutes, 32 seconds 200,635 views",AMEN ENTERTAINMENT,200635,201277,642
1168,"Helen Tsegai - Gudam Eka by AMEN ENTERTAINMENT 5 years ago 5 minutes, 57 seconds 55,105 views",AMEN ENTERTAINMENT,55105,55115,10
1169,"Estifanoes Abraham (Zemach) - Hintsa Fikri | ህንጻ ፍቕሪ - New Eritrean Music 2016 by AMEN ENTERTAINMENT 5 years ago 5 minutes, 39 seconds 190,364 views",AMEN ENTERTAINMENT,190364,194629,4265
1170,"Selomon Teame (Siko)- Tselim Ketema ጸሊም ከተማ by AMEN ENTERTAINMENT 5 years ago 7 minutes, 12 seconds 5,191 views",AMEN ENTERTAINMENT,5191,5193,2
1171,"Estifanos Abraham (Zemach) - Nfelale'mo Nrakeb | ንፈላለ'ሞ ንራኸብ - New Eritrean Music 2016 by AMEN ENTERTAINMENT 5 years ago 6 minutes, 9 seconds 1,122,838 views",AMEN ENTERTAINMENT,1122838,1125507,2669
1172,"Estifanos Abraham (Zemach) - Nestey | ንእስተይ - New Eritrean Music 2016 by AMEN ENTERTAINMENT 5 years ago 6 minutes, 50 seconds 2,579,535 views",AMEN ENTERTAINMENT,2579535,2583209,3674
1173,"Estifanos Abraham (Zemach) - Hjum | ህጁም - New Eritrean Music 2016 by AMEN ENTERTAINMENT 5 years ago 5 minutes, 39 seconds 241,902 views",AMEN ENTERTAINMENT,241902,242261,359
1174,"New Music ""bei endo beli"" by Fenan Shimbahri by AMEN ENTERTAINMENT 5 years ago 7 minutes, 39 seconds 23,958 views",AMEN ENTERTAINMENT,23958,23959,1
1175,"New Eritrean music video 2016 by Mogos Merhawi ""ተወሊፈኪ"" by AMEN ENTERTAINMENT 5 years ago 5 minutes, 14 seconds 85,409 views",AMEN ENTERTAINMENT,85409,85418,9
1176,"Estifanos Abraham (Zemach) - Abey Nierki | ኣበይ ኔርኪ- New Eritrean Music 2016 by AMEN ENTERTAINMENT 5 years ago 6 minutes, 8 seconds 84,752 views",AMEN ENTERTAINMENT,84752,84872,120
1177,"Estifanos Abraham (Zemach) - Semira | ሰሚራ - New Eritrean Music 2016 by AMEN ENTERTAINMENT 5 years ago 7 minutes, 12 seconds 2,022,015 views",AMEN ENTERTAINMENT,2022015,2040890,18875
1178,"New Eritrean  music  by Sandiago ""ደማሙ ኣስመራ"" by AMEN ENTERTAINMENT 5 years ago 2 minutes, 19 seconds 27,807 views",AMEN ENTERTAINMENT,27807,27810,3
1179,"Estifanos Abraham ""Nay men'a"" ናይ መን ኢያ by AMEN ENTERTAINMENT 5 years ago 6 minutes, 26 seconds 1,092,683 views",AMEN ENTERTAINMENT,1092683,1101064,8381
1180,"Estifanos Abraham (Zemach) - Mereat Adina | መርዓት ዓድና - New Eritrean Music 2016 by AMEN ENTERTAINMENT 5 years ago 6 minutes, 22 seconds 912,423 views",AMEN ENTERTAINMENT,912423,927023,14600
1181,"New Eritrean Music Video 2016 ""Tesebeyini"" by Efrem Capitano (Chare) by AMEN ENTERTAINMENT 5 years ago 6 minutes, 9 seconds 108,929 views",AMEN ENTERTAINMENT,108929,108936,7
1182,"New Eritrean Music Video 2016 ""Meksebey: by Eyob Berhane (Aleba Lbey) by AMEN ENTERTAINMENT 5 years ago 6 minutes, 51 seconds 71,650 views",AMEN ENTERTAINMENT,71650,71769,119
1183,"New Eritrean Music Video 2016 ""Bsalaki"" by Yoni Roki by AMEN ENTERTAINMENT 5 years ago 7 minutes, 54 seconds 243,092 views",AMEN ENTERTAINMENT,243092,243191,99
1184,"New Eritrean Music  Selomon Dembelash (Shelela) Entay terekibu by AMEN ENTERTAINMENT 5 years ago 6 minutes, 39 seconds 43,103 views",AMEN ENTERTAINMENT,43103,43219,116
1185,"Eritrean Song 2016 ""ነደይ ነጊርኩማ ዶ"" Yohannes Tekle  (John Air Force). by AMEN ENTERTAINMENT 5 years ago 6 minutes, 26 seconds 238,326 views",AMEN ENTERTAINMENT,238326,238368,42
1186,"Goitom Negassi - ""Sean Fkri"" ሰኣን ፍቕሪ New Eritrean Music 2016 by AMEN ENTERTAINMENT 5 years ago 7 minutes, 4 seconds 1,005,392 views",AMEN ENTERTAINMENT,1005392,1007396,2004
1187,"New Eritrean Music 2016 ""Fredni"" by Bereket Tekle (Wedi Mana) by AMEN ENTERTAINMENT 5 years ago 6 minutes, 14 seconds 131,373 views",AMEN ENTERTAINMENT,131373,131386,13
1188,"New eritrean song 2016 ""HANDEBET MEGESHA"" remix by Filmon Daniel (PHILA) by AMEN ENTERTAINMENT 5 years ago 5 minutes, 9 seconds 73,164 views",AMEN ENTERTAINMENT,73164,73191,27
1189,"New Eritrean song 2016 ""TEMESGEN BEL""  by Bajet Mehari by AMEN ENTERTAINMENT 5 years ago 5 minutes, 35 seconds 142,248 views",AMEN ENTERTAINMENT,142248,142402,154
1190,"New Eritrean Song 2016 ""Selamey"" by Fnan Shimbahri by AMEN ENTERTAINMENT 5 years ago 5 minutes, 52 seconds 143,519 views",AMEN ENTERTAINMENT,143519,143545,26
1191,"New Eritrean Music 2016 ""Shawuley"" Efrem Bereket (Abule) by AMEN ENTERTAINMENT 5 years ago 4 minutes, 58 seconds 27,264 views",AMEN ENTERTAINMENT,27264,27268,4
1192,"New Eritrean Song 2016 ""Hana"" by Fred Haile by AMEN ENTERTAINMENT 5 years ago 5 minutes, 8 seconds 228,276 views",AMEN ENTERTAINMENT,228276,228363,87
1193,"New Eritrean song 2016 ""ሙዘይ"" by Filmon Teklab by AMEN ENTERTAINMENT 5 years ago 4 minutes, 25 seconds 4,877 views",AMEN ENTERTAINMENT,4877,4878,1
1194,"New Eritrean Song 2016 ""የመክሕ' ጽዩ ፍቕሪ"" by Filmon Teklab (Kurara) by AMEN ENTERTAINMENT 5 years ago 6 minutes, 37 seconds 6,108 views",AMEN ENTERTAINMENT,6108,6108,0
1195,"New Eritrean song ""ክልእከክን ረጋቢት"" by Filmon Teklab (Kurara) by AMEN ENTERTAINMENT 5 years ago 4 minutes, 45 seconds 7,782 views",AMEN ENTERTAINMENT,7782,7784,2
1196,"New Eritrean stand up Aru Show 2016 ""MISTIR"" by Ariam Weldeab by AMEN ENTERTAINMENT 5 years ago 17 minutes 339,047 views",AMEN ENTERTAINMENT,339047,339277,230
1197,"Eseyas Salh (Rasha) - Tiabrni Aleki | ትዓብርኒ ኣለኺ - New Eritrean Music 2016 (Official Video) by AMEN ENTERTAINMENT 6 years ago 6 minutes, 31 seconds 2,875,207 views",AMEN ENTERTAINMENT,2875207,2886663,11456
1198,"New Eritrean Song 2016 ""Aytweseni"" by Filmon Teklab (Kurara) by AMEN ENTERTAINMENT 6 years ago 7 minutes, 22 seconds 179,129 views",AMEN ENTERTAINMENT,179129,179183,54
1199,"Efrem Bereket (Abule) - Aybeleyeleyn | ኣይበለየለይን - New Eritrean Music 2016 (Official Video) by AMEN ENTERTAINMENT 6 years ago 8 minutes, 7 seconds 348,262 views",AMEN ENTERTAINMENT,348262,348358,96
1200,"New Eritrean Song 2016 ""Mkal Sine"" by Ambesajir Araya by AMEN ENTERTAINMENT 6 years ago 6 minutes, 53 seconds 53,494 views",AMEN ENTERTAINMENT,53494,53500,6
1201,"Efrem Bereket (Abule) - Haftey | ሓፍተይ - New Eritrean Music 2016 (Official Video) by AMEN ENTERTAINMENT 6 years ago 7 minutes, 36 seconds 187,880 views",AMEN ENTERTAINMENT,187880,188005,125
1202,"New Eritrean Song 2016 ""DIAMOND"" by  Fred Haile by AMEN ENTERTAINMENT 6 years ago 6 minutes, 39 seconds 513,603 views",AMEN ENTERTAINMENT,513603,513649,46
1203,"Seare Debesay - Shrboki | ሽርቦኺ - New Eritrean Music 2016 (Official Video) by AMEN ENTERTAINMENT 6 years ago 5 minutes, 36 seconds 441,108 views",AMEN ENTERTAINMENT,441108,441255,147
1204,"Efrem Bereket (Abule) - Adey | ኣደይ - New Eritrean Music 2015 (Official Video) by AMEN ENTERTAINMENT 6 years ago 6 minutes, 31 seconds 390,160 views",AMEN ENTERTAINMENT,390160,390456,296
1205,"New eritrean song 2015 ""Meskrula"" by kbrab tsegay by AMEN ENTERTAINMENT 6 years ago 7 minutes, 43 seconds 20,892 views",AMEN ENTERTAINMENT,20892,20899,7
1206,"Dawit Kahsay - Nhme Alena | ንሕመ'ለና - New Eritrean Music 2015 (Official Video) by AMEN ENTERTAINMENT 6 years ago 6 minutes, 9 seconds 280,513 views",AMEN ENTERTAINMENT,280513,280575,62
1207,"Hayelom Abrahaley - Netsihe | ነጺሀ - New Eritrean Music 2015 (Official Video) by AMEN ENTERTAINMENT 6 years ago 5 minutes, 40 seconds 436,592 views",AMEN ENTERTAINMENT,436592,436892,300
1208,"Dawit Kidane (Gagu) - Yelekun Kem Qedem | የለኹን ከም ቀደም - New Eritrean Music 2015 (Official Video) by AMEN ENTERTAINMENT 6 years ago 6 minutes, 25 seconds 376,190 views",AMEN ENTERTAINMENT,376190,376373,183
1209,"Awet Embaye - Hawey | ሓወይ - New Eritrean Music 2015 (Official Video) by AMEN ENTERTAINMENT 6 years ago 7 minutes, 22 seconds 105,803 views",AMEN ENTERTAINMENT,105803,105854,51
1210,"Mihretab Ghebrezghi (Sandro) - Sdet | ስደት - New Eritrean Music 2015 (Official Video) by AMEN ENTERTAINMENT 6 years ago 8 minutes, 12 seconds 8,261,158 views",AMEN ENTERTAINMENT,8261158,8275932,14774
1211,"Kiflom Tewelde - Aykelon'ye | ኣይክእሎን'የ - New Eritrean Music 2015 (Official Video) by AMEN ENTERTAINMENT 7 years ago 6 minutes, 34 seconds 60,142 views",AMEN ENTERTAINMENT,60142,60213,71
1212,"Teklu Yohannes - Gdefni | ግደፍኒ - New Eritrean Music 2015 (Official Video) by AMEN ENTERTAINMENT 7 years ago 8 minutes, 46 seconds 464,393 views",AMEN ENTERTAINMENT,464393,464408,15
1213,"New Ethiopian Music Biruk Bekele ብሩክ በቀለ-የሃገሬ ጀግና | New Ethiopian Music 2022 (Official Video) by AND TV 1 month ago 4 minutes, 55 seconds 433 views",AND TV,433,453,20
1214,"#Nomore Washington DC Ethiopians demonstration against TPLF by AND TV 3 months ago 3 minutes, 3 seconds 16,244 views",AND TV,16244,16281,37
1215,"Helen & Biruk Bella - 1Nen New Ethiopian Music 2021 - AndTv Ethiopia Exclusive by AND TV 11 months ago 4 minutes, 19 seconds 1,132 views",AND TV,1132,1143,11
1216,"New Ethiopian Music 2020 - Meron Abebe - Yefikir Emebet - Neway Debebe Cover (Official Music Video) by AND TV 1 year ago 5 minutes, 13 seconds 12,099 views",AND TV,12099,12301,202
1217,"አንድ ወግ - Ethiopian War Stories | ብላቴናው የጦር ሜዳ ተሽላሚ | And Tv Ethiopia 2020 by AND TV 1 year ago 5 minutes, 34 seconds 468 views",AND TV,468,468,0
1218,"New Ethiopian Hardcore Hip-hop Music ABELO DX - Rapper Negn Bay | ራፐር ነኝ ባይ -  And Tv Ethiopia 2020 by AND TV 1 year ago 4 minutes, 47 seconds 808 views",AND TV,808,816,8
1219,"New Ethiopian Music Cover 2020 - Ziada Araya(ZI) #ዚያዳ - Hagere/ሃገሬ (Official Music Video ) by AND TV 1 year ago 6 minutes, 13 seconds 437,040 views",AND TV,437040,439384,2344
1220,"New Ethiopian cover music 2020  Ziada Araya(ZI) #ዚያዳ - ሃገሬ 2020 Ziada (Official music ) by AND TV 1 year ago 6 minutes, 10 seconds 6,575 views",AND TV,6575,6607,32
1221,"Ethiopia - Kassahun Lema - ካሳሁንና ዶ/ር ሂሩት ካሳዬ -ያሆዴ (On Stage) New Hadiya Ethiopian Music 2020 by AND TV 1 year ago 6 minutes, 33 seconds 22,743 views",AND TV,22743,23213,470
1222,"And Tv Ethiopia 2020 | ድንቅ ግጥም - ማይክል ሰለሞን - እብዶች ነን (Ethiopian Poem) by AND TV 1 year ago 3 minutes, 19 seconds 98 views",AND TV,98,100,2
1223,"And Tv Ethiopia 2020 | አንቺ ከሄድሽ ወዲ - ግጥም በሚካኤል ሰለሞን (Amazing Breakup Poem) 🛑Romantic videos ❤️ by AND TV 1 year ago 2 minutes, 21 seconds 292 views",AND TV,292,295,3
1224,"# ፋና ላምሮት - አቤል ጳውሎስ - ዮናታን ንብረት - መቅደስ ግርማ And Wog | And Tv Ethiopia 2020 by AND TV 1 year ago 5 minutes, 26 seconds 266 views",AND TV,266,271,5
1225,And Tv Ethiopia - Happy Mesqel | እንኳን ለብርሀነ መስቀሉ በሰላም አደረሳችሁ    🔥   🔥  🔥 by AND TV 1 year ago 36 seconds 103 views,AND TV,103,105,2
1226,"Abinet Agonafir|አብነት አጎናፍር - And TV Ethiopia- And Wog - New Ethiopian Music 2020 (Official Video) by AND TV 1 year ago 14 minutes, 1 second 393 views",AND TV,393,396,3
1227,"And Tv Ethiopia 2020 | Nuni iso - ኑኒ ኢሶ አማረ ሶንቆ (ሀሹ ሀሹ)  እና አለማየሁ ጨፋቆ (ባሊ ሄሌሌ) New Ethiopian Music by AND TV 1 year ago 5 minutes, 30 seconds 846 views",AND TV,846,852,6
1228,And TV Ethiopia | መልካም አዲስ አመት - Happy Ethiopian new year 2013 by AND TV 1 year ago 32 seconds 353 views,AND TV,353,355,2
1229,"And Tv Ethiopia - Ziada Araya(ZI) #ዚያዳ New Ethiopian cover music 2020 (Official music ) by AND TV 1 year ago 5 minutes, 36 seconds 15,681 views",AND TV,15681,15747,66
1230,"And Tv Ethiopia 2020 | አንድ ወግ ተሾመ ምትኩ | Best Ethiopian Music by AND TV 1 year ago 6 minutes, 41 seconds 334 views",AND TV,334,342,8
1231,And TV Ethiopia | ደጓ - ቀን የኢድ አልአድሃ በዓል አከባበር - Eid Al Adha Program by AND TV 1 year ago 35 minutes 145 views,AND TV,145,147,2
1232,"And Tv Ethiopia - Kassahun Lega & Tesefay taye - Lirame (Official Music Video) New Hadiya Music 2020 by AND TV 1 year ago 6 minutes, 39 seconds 1,640 views",AND TV,1640,1643,3
1233,"ድንቅ መልእክት ቀዳማዊ ሙፍቲ ሀጂ ኡመር እንድሪስ | Haji Mufti Endris -And Tv Ethiopia 2020 by AND TV 1 year ago 5 minutes, 25 seconds 278 views",AND TV,278,281,3
1234,"አዎዛጋቢው አስተያየት  ማሀመድ አሊ ቢራ | Ali Birra Controversial Comments on recent unrest in Ethiopia by AND TV 1 year ago 6 minutes, 31 seconds 298 views",AND TV,298,301,3
1235,"Lelem Muluneh - Tiztaye | New AndTv Ethiopian Music 2020 by AND TV 1 year ago 6 minutes, 58 seconds 1,084 views",AND TV,1084,1088,4
1236,"ከጂጂም በላይ ጠላት ለአሳር | AndTv Ethiopia - Ejigayehu Shibabaw - Abay by AND TV 1 year ago 14 minutes, 2 seconds 570 views",AND TV,570,574,4
1237,"Fentaw abera ( እምየ ) New Ethiopian Traditional Music 2020 ( official video) by AND TV 1 year ago 6 minutes, 16 seconds 4,628 views",AND TV,4628,4637,9
1238,"AndTv Ethiopia | New Ethiopian Music 2020 | Besho Gudumala - Welebara [Official Audio Video] by AND TV 1 year ago 12 minutes, 16 seconds 251 views",AND TV,251,253,2
1239,"Romantic Ethiopian Music Collection 2020 by AND TV 1 year ago 3 minutes, 36 seconds 1,408 views",AND TV,1408,1425,17
1240,"And Tv Ethiopia - ሹሙቡሎ ሹዴ - ወቶ ይሬና | New ethiopian sidama music 2020 (official audio) by AND TV 1 year ago 4 minutes, 6 seconds 3,670 views",AND TV,3670,3740,70
1241,"And Tv Ethiopia - ድንቅ ችሎታ | New Ethiopian Music 2020 by AND TV 1 year ago 2 minutes, 25 seconds 637 views",AND TV,637,638,1
1242,"And Tv Ethiopia - አስራት  ማርቆስ - ቡርቱካንቾያ | New Ethiopian Music 2020 (official audio) by AND TV 1 year ago 4 minutes, 33 seconds 750 views",AND TV,750,793,43
1243,"And Tv Ethiopia - Amazing Duet - Tizita (ትዝታ) New Ethiopian Music 2020 (Official Video) by AND TV 1 year ago 1 minute, 5 seconds 179 views",AND TV,179,185,6
1244,"And Tv Ethiopia - Abel Odx - #Rapper negn Bay |New Ethiopian Music 2020 (official Audio) by AND TV 1 year ago 1 minute, 51 seconds 310 views",AND TV,310,313,3
1245,"And Tv Ethiopia - Etsub - ካላይዳዱ | New Ethiopian Music 2020 (official Audio) by AND TV 1 year ago 3 minutes, 47 seconds 359 views",AND TV,359,359,0
1246,"And Tv Ethiopia - Besho - Eseke New Ethiopian Music 2020 (official Audio) by AND TV 1 year ago 5 minutes, 1 second 361 views",AND TV,361,362,1
1247,"And tv ኢትዮጵያ - Hadiya Music - ማቴያኔ | New Ethiopian Music 2020 (Official Exclusive Audio) by AND TV 1 year ago 4 minutes, 5 seconds 4,631 views",AND TV,4631,4648,17
1248,And tv ኢትዮጵያ - Haymanot - Buna Cover | New Ethiopian Music 2020 (Official Video) by AND TV 1 year ago 29 seconds 337 views,AND TV,337,339,2
1249,"Fiker - New Ethiopian Music cover 2020 by AND TV 1 year ago 52 seconds 1,177 views",AND TV,1177,1210,33
1250,"Marhuwaye - Shumet Tewabe - New Ethiopian Music 2020 by AND TV 1 year ago 5 minutes, 27 seconds 368 views",AND TV,368,374,6
1251,"Amazing Ethiopian Dance (Eskista) - New Ethiopian Eskista 2020 by AND TV 1 year ago 3 minutes, 51 seconds 427 views",AND TV,427,430,3
1252,"Biniyam Tesema (yemawayish) - Comin Soon new Ethiopian music 2020 by AND TV 1 year ago 42 seconds 1,753 views",AND TV,1753,1769,16
1253,"Abdiisaa Gammadaa - Warra Walloo | New Ethiopian Oromo Music 2018 (Official Video) by AND TV 3 years ago 6 minutes, 43 seconds 13,627 views",AND TV,13627,13914,287
1254,"Best Ethiopian Dance - Dagi Reggae - Habesha  | New Ethiopian Music 2018 (Official Video) by AND TV 3 years ago 5 minutes, 44 seconds 3,718 views",AND TV,3718,3726,8
1255,"Ethiopia - Kassahun Lema - Yahode (Official Music Video) New Hadiya Ethiopian Music 2018 by AND TV 3 years ago 6 minutes, 27 seconds 53,016 views",AND TV,53016,53088,72
1256,"AndTunes by AND TV 3 years ago 4 minutes, 31 seconds 987 views",AND TV,987,991,4
1257,"New Ethiopian Traditional Music 2018 | Alex - Official Music Video by AND TV 3 years ago 5 minutes, 23 seconds 2,821 views",AND TV,2821,2825,4
1258,"New Ethiopian Music 2018 Trivia - Shemsu and Amoraw Funny ኢትዮጵያ Skit by AND TV 3 years ago 11 minutes, 1 second 142,303 views",AND TV,142303,142684,381
1259,"Habtamu Nebiyu Abet Sitamri New Ethiopian Music 2018 Official Music Video by AND TV 3 years ago 5 minutes, 1 second 2,922 views",AND TV,2922,2927,5
1260,"Eshetu Brehan (አችየዋ) New Ethiopian Music (official video) by AND TV 3 years ago 6 minutes, 3 seconds 5,241 views",AND TV,5241,5255,14
1261,"New Ethiopian Traditional Oromo  Music 2018 | KOME - GIRMAA OLLAANAA (OFFICIAL VIDEO) by AND TV 3 years ago 4 minutes, 46 seconds 35,892 views",AND TV,35892,35918,26
1262,"New Ethiopian Music 2018 | Yimechal - Edme Wana (official video) by AND TV 3 years ago 6 minutes, 50 seconds 14,335 views",AND TV,14335,14337,2
1263,"New Ethiopian Music 2018 - TARIKU GANKISI HAISE HAISE (official video) by AND TV 3 years ago 5 minutes, 16 seconds 5,636 views",AND TV,5636,5663,27
1264,"New Gojjam Ethiopian Music 2018 -Aschane Teshome (Official Video) by AND TV 3 years ago 6 minutes, 13 seconds 294,412 views",AND TV,294412,294668,256
1265,"Amazing Oromo Music 2018 Girmaa Ethiopian Music (Official Music Video) by AND TV 3 years ago 3 minutes, 52 seconds 891 views",AND TV,891,892,1
1266,"New Ethiopian Music 2018 | Girma - Kommee Gara Koo - Oromia Music (Official Video) by AND TV 3 years ago 3 minutes, 52 seconds 857 views",AND TV,857,859,2
1267,"New Ethiopian Music 2018 - Girmaa (Official Music Video) by AND TV 3 years ago 6 minutes, 13 seconds 612 views",AND TV,612,613,1
1268,"New Ethiopian Music 2018 | Jimma (Official music Video) by AND TV 3 years ago 4 minutes, 54 seconds 2,543 views",AND TV,2543,2548,5
1269,"New music Ethiopia 2018 | Traditional Oromo Song (Official Video) by AND TV 3 years ago 5 minutes, 16 seconds 938 views",AND TV,938,941,3
1270,"Track 7 New 2018 Ethiopian Oromo Music (Official Video) by AND TV 3 years ago 4 minutes, 35 seconds 876 views",AND TV,876,878,2
1271,"OROMIYAA ** NEW 2018 OROMO MUSIC by AND TV 3 years ago 4 minutes, 15 seconds 727 views",AND TV,727,729,2
1272,"New Oromo Music 2018 (Official music video) by AND TV 3 years ago 4 minutes, 38 seconds 2,010 views",AND TV,2010,2011,1
1273,"Best ኢትዮጵያ ሙዚቃ | New Ethiopian music 2018 (official video) by AND TV 3 years ago 4 minutes, 10 seconds 1,790 views",AND TV,1790,1792,2
1274,"Girmaa Olanaa - Magaal Dammaa | New Ethiopian Oromo music 2018 (official video) by AND TV 3 years ago 4 minutes, 56 seconds 1,038 views",AND TV,1038,1050,12
1275,"Oromo Music -  Girmaa Olanaa - ኢትዮጵያ ሙዚቃ | New Ethiopian music 2018 (official video) by AND TV 3 years ago 5 minutes, 22 seconds 1,288 views",AND TV,1288,1290,2
1276,"Girmaa Olanaa - ኢትዮጵያ ሙዚቃ | New Ethiopian Oromo Music 2018 (official video) by AND TV 3 years ago 6 minutes, 53 seconds 1,249 views",AND TV,1249,1251,2
1277,"ኢትዮጵያ ሙዚቃ | Yonebe - New Ethiopian Tembaro Music 2018 (official video) by AND TV 4 years ago 5 minutes, 33 seconds 12,707 views",AND TV,12707,12749,42
1278,"ኢትዮጵያ ሙዚቃ ሹሚ ገሚዶ  New Ethiopian Oromo Music 2018 official video by AND TV 4 years ago 5 minutes, 1 second 54,998 views",AND TV,54998,55028,30
1279,"Kassahun Lema - Habamo | New Ethiopian Music 2018 (official video) by AND TV 4 years ago 4 minutes, 36 seconds 27,819 views",AND TV,27819,27871,52
1280,"Best Wollo Eskista - አለኝ አልረሳ | New Ethiopian Music 2017 (Official Video) by AND TV 4 years ago 5 minutes, 39 seconds 17,148 views",AND TV,17148,17163,15
1281,"New Oromo Ethiopian Music 2017 | Dagi Reggae - Matigegeb (Official Video) by AND TV 4 years ago 4 minutes, 51 seconds 3,728 views",AND TV,3728,3733,5
1282,"New Ethiopian Hiphop Music 2017 | Wonde Ft. Minyahil - Woynitu(ወይኒቱ) Official Video by AND TV 4 years ago 3 minutes, 23 seconds 12,352 views",AND TV,12352,12360,8
1283,"Lene Selame Nesh | New Ethiopian Hip Hop Music 2017 (Official Video) by AND TV 4 years ago 2 minutes, 49 seconds 2,127 views",AND TV,2127,2134,7
1284,"Ethiopia: New Ethiopian Gojjam Music 2017 | ክፉኛ ነው (Official Music Video) by AND TV 4 years ago 5 minutes, 49 seconds 5,840 views",AND TV,5840,5844,4
1285,"Ethiopian Hip Hop / Amiy | M-21| V-Goo | Ruk | Fie-Be | New Ethiopian Music 2017 by AND TV 4 years ago 5 minutes, 11 seconds 1,148 views",AND TV,1148,1149,1
1286,"New Ethiopian Oromo Traditional Music 2017 | Siyum - Negemechisi (Official Music Video) by AND TV 4 years ago 4 minutes, 15 seconds 13,368 views",AND TV,13368,13372,4
1287,"New Oromo Traditional Ethiopian Music 2017 | Sulxan Badhiyya - Sabboontuu (Official Video) by AND TV 4 years ago 5 minutes 18,459 views",AND TV,18459,18469,10
1288,"Ethiopian Gojam Traditional Music 2017 | Alex Mulu - Gojam New Adare(ጎጃም ነው አዳሬ) Official Video by AND TV 4 years ago 6 minutes, 23 seconds 15,959 views",AND TV,15959,15974,15
1289,"Berihun Demisse - Balambarua(ባላምባሯ) New Ethiopian Wollo Traditional Music 2017 by AND TV 4 years ago 4 minutes, 11 seconds 18,839 views",AND TV,18839,18855,16
1290,"Merkeb Bonitua |Teddy Yo | Miky Yo | Ablex007 | JP - Cypher Abyssinia 3 | New Ethiopian Music 2017 by AND TV 4 years ago 3 minutes, 47 seconds 597,301 views",AND TV,597301,599809,2508
1291,"New Ethiopian Music | Cypher Abyssinia 3 - Behind The Scenes (official Video) by AND TV 4 years ago 1 minute, 58 seconds 2,299 views",AND TV,2299,2303,4
1292,"New Ethiopian Music | Wolloye Squad - Zime Hme(ዝሜ ህሜ) official video by AND TV 4 years ago 3 minutes, 30 seconds 13,921 views",AND TV,13921,13955,34
1293,"New Ethiopian Gonder Music | Asne - Shiwshiw(ሽዉ ሽው) Official Video by AND TV 4 years ago 4 minutes, 54 seconds 6,514 views",AND TV,6514,6531,17
1294,"New Ethopian Music 2017 | Ethiopian Hip hop - KaLIII Ft GG GaGIII - EskiiineGa (official Video) by AND TV 4 years ago 4 minutes, 37 seconds 9,973 views",AND TV,9973,9975,2
1295,"New Ethiopian Music 2017 | Traditional Gojjam Music - Gebrshet - Mewoled Gojjam (official Video) by AND TV 4 years ago 5 minutes, 53 seconds 72,333 views",AND TV,72333,72354,21
1296,"Biruk Bekele - Anchin(አንችን) | Best New Ethiopian Traditional Music 2017 (Official Video) by AND TV 4 years ago 5 minutes, 28 seconds 3,157 views",AND TV,3157,3161,4
1297,"New Ethiopian Music 2017 Oromo Music Collections Abera Abdisa official music video by AND TV 4 years ago 3 minutes, 40 seconds 6,838 views",AND TV,6838,6848,10
1298,"Assefa - Sabboontuu - New Ethiopian Oromo Music 2017 (Official Video) by AND TV 4 years ago 4 minutes, 56 seconds 5,354 views",AND TV,5354,5354,0
1299,"New Ethiopain Music 2017 HipHop | TizAzu Ft. Tsion (Official HD Music video) by AND TV 4 years ago 3 minutes, 38 seconds 1,939 views",AND TV,1939,1940,1
1300,"New Traditional Oromo Ethiopian Music 2017 | Merga Assefa(Official Music Video) by AND TV 4 years ago 5 minutes, 20 seconds 2,354 views",AND TV,2354,2356,2
1301,"New Ethiopian Music 2017 | Best Of Ethiopian Music Networks Oromo Music Collections by AND TV 4 years ago 3 minutes, 1 second 62,445 views",AND TV,62445,62446,1
1302,"New Ethiopian Oromo Music 2017 | Hana Kuratu(KoKo) - Taye (Official Music video) by AND TV 4 years ago 5 minutes, 14 seconds 74,217 views",AND TV,74217,74232,15
1303,"New Ethiopian Music 2017 | Fantaye Asmare - Yihunlish |  (official music video) by AND TV 4 years ago 5 minutes, 3 seconds 4,787 views",AND TV,4787,4790,3
1304,"New Ethiopian Wollo Music 2017 - Tesfa Amare  | Official Music Video by AND TV 4 years ago 5 minutes, 20 seconds 9,642 views",AND TV,9642,9649,7
1305,"New Ethiopian Music 2017 | Biruk Bekele - Feta (Official Music Video) by AND TV 4 years ago 1 minute, 57 seconds 1,392 views",AND TV,1392,1394,2
1306,"New Ethiopian Tigrigna Music 2017 | አስቴር ሙሉአለም (official video) by AND TV 4 years ago 4 minutes, 56 seconds 19,219 views",AND TV,19219,19330,111
1307,"Habtamu Alemayehu - Kifugna New(ክፉኛ ነው) - New Ethiopian Music 2017 (official music video) by AND TV 4 years ago 5 minutes, 56 seconds 9,727 views",AND TV,9727,9729,2
1308,"ENGEDAW WERKU  YEGOJJAM LIJ | የጎጃም ልጅ New Ethiopian Music 2017 (official video) by AND TV 4 years ago 6 minutes, 25 seconds 12,176 views",AND TV,12176,12185,9
1309,"Yeshi Demelash - Liyu Qen - New Ethiopian Music 2017 (official video) by AND TV 4 years ago 4 minutes, 2 seconds 70,567 views",AND TV,70567,70922,355
1310,"New Ethiopian Music 2017 - Yeshi Demelash - Liyu Qen  | Coming Soon by AND TV 4 years ago 2 minutes, 13 seconds 3,651 views",AND TV,3651,3652,1
1311,"New Ethiopian Gamo Music 2017 - Serawit Tadesse - Bayira (Official Hd Music Video) by AND TV 4 years ago 4 minutes, 48 seconds 9,389 views",AND TV,9389,9408,19
1312,"Ethiopian music 2017 - Maselama - Belen Haylu | Official HD Music Video by AND TV 4 years ago 5 minutes, 24 seconds 20,945 views",AND TV,20945,20950,5
1313,"New Traditional Southern Ethiopia Music 2017 - Abebe Girma - Bodi | Official HD Music Video by AND TV 4 years ago 5 minutes, 30 seconds 8,099 views",AND TV,8099,8122,23
1314,"Ethiopian Hip Hop - Yo Yo Gen Lemenedenew | Official HD Music Video 2017 by AND TV 4 years ago 3 minutes 2,357 views",AND TV,2357,2357,0
1315,"Ethiopian Afro Beat - Biniyam Assefa - Kadelegn | New Ethiopain Music 2017 (official HD Music Video) by AND TV 4 years ago 5 minutes, 38 seconds 4,395 views",AND TV,4395,4412,17
1316,"Gonder Traditional Music - Gashu Tesera - Gedaye | New Ethiopian music 2017 (official HD Video) by AND TV 4 years ago 4 minutes, 32 seconds 52,497 views",AND TV,52497,52533,36
1317,"Funny Ethiopian Music 2017 New - Amoraw | Official HD Music Video by AND TV 4 years ago 5 minutes, 19 seconds 59,766 views",AND TV,59766,60046,280
1318,"New Ethiopain Halaba Music 2017 | Abebe Girma - Qomit (Official Music Video by AND TV 4 years ago 4 minutes, 56 seconds 47,849 views",AND TV,47849,48325,476
1319,"Ethiopian Music Networks 2017 | And Engda Show Wollo Kemise Star - Esmail by AND TV 4 years ago 7 minutes, 20 seconds 5,937 views",AND TV,5937,5944,7
1320,"Ethiopian Gojam Traditional Music 2017  Chekula Takele - Tolo Na (Official HD Video) by AND TV 4 years ago 4 minutes, 45 seconds 38,263 views",AND TV,38263,38278,15
1321,"New Ethiopian Wollo Music 2017 | አስቴር ሙሉአለም - Arhibu (Official Music Video) by AND TV 4 years ago 5 minutes, 14 seconds 145,176 views",AND TV,145176,145378,202
1322,"Ethiopian Gojam Traditional Music 2017 | YeBelay - ምንያህል ታደለ (Official HD Video) by AND TV 4 years ago 4 minutes, 46 seconds 123,435 views",AND TV,123435,123474,39
1323,"New Ethiopian Wedding Music | Zare New Qenu - Selemon and Eleni (Official video) by AND TV 4 years ago 6 minutes, 8 seconds 53,095 views",AND TV,53095,53127,32
1324,"New Ethiopian Music 2017 | Alemayehu Eshete - Biniyam Eshetu Cover (official video) by AND TV 4 years ago 5 minutes, 40 seconds 14,350 views",AND TV,14350,14363,13
1325,"New Ethiopian Hip Hop Music 2017 Dani - D ft. Marta | HD Official Music Video by AND TV 4 years ago 3 minutes, 57 seconds 17,629 views",AND TV,17629,17640,11
1326,"New Ethiopian Hip Hop Music 2017 - ABEL-O DX- Ney Ney | New HD Official Music Video by AND TV 4 years ago 4 minutes, 42 seconds 29,814 views",AND TV,29814,29827,13
1327,"New Ethiopian Gojam Music 2017 - Habte Abraham - Metadele | New HD Official Music Video by AND TV 4 years ago 6 minutes, 13 seconds 150,357 views",AND TV,150357,150495,138
1328,"New Ethiopian Wollo Kemise Music 2017 - Esmail Mohammed - Yaamagaallee | New Music HD Video by AND TV 4 years ago 6 minutes, 31 seconds 95,801 views",AND TV,95801,96103,302
1329,"New Ethiopian Music 2017 - Hewan Addis DJ Sami | official music video by AND TV 4 years ago 3 minutes, 46 seconds 3,752 views",AND TV,3752,3753,1
1330,"Ethiopian Traditional Music 2017 - አስቴር ሙሉአለም - ዞምዬ | Official Music Video by AND TV 4 years ago 6 minutes, 47 seconds 66,789 views",AND TV,66789,66995,206
1331,"Besho - Elil Bey (እልል በይ) | New Ethiopian Music 2017 (Official Video) by AND TV 4 years ago 4 minutes, 44 seconds 4,643 views",AND TV,4643,4644,1
1332,"Andinet Ali - Gamogofi siqo | New Ethiopian Traditional Music 2017 (official video) by AND TV 5 years ago 5 minutes, 4 seconds 3,873 views",AND TV,3873,3874,1
1333,"Ethiopian Music Networks | And Engda Show - Tesfaye Ajema by AND TV 5 years ago 7 minutes, 33 seconds 757 views",AND TV,757,757,0
1334,"Diseka - Tariku Teshome | New Ethiopian Music 2017 (offical Music video) by AND TV 5 years ago 4 minutes, 22 seconds 23,685 views",AND TV,23685,23699,14
1335,"Girmaa Olaanaa - Karameellaa | New Ethiopian Oromo Traditional Music 2017 (official Video) by AND TV 5 years ago 4 minutes, 59 seconds 38,744 views",AND TV,38744,38772,28
1336,"Arada 2 - Solomon & Yared | Ethiopian Hiphop music 2017 (Official Video) by AND TV 5 years ago 4 minutes, 34 seconds 75,699 views",AND TV,75699,75903,204
1337,"Ethiopian music networks | And Engda Show - Abel Odx by AND TV 5 years ago 11 minutes, 12 seconds 1,570 views",AND TV,1570,1571,1
1338,"Africa - Dj Sami feat. Ras Siyume and Juno | New Ethiopian Music 2017 (official music video) by AND TV 5 years ago 4 minutes, 22 seconds 4,267 views",AND TV,4267,4269,2
1339,"Ethiopian Music Networks | And Engda Show  -  Wondmagegn Kawo by AND TV 5 years ago 10 minutes, 17 seconds 3,939 views",AND TV,3939,3942,3
1340,"Fentaw Abera -Lalye | New Wollo Traditional Ethiopian Music 2017 (Official Video) by AND TV 5 years ago 6 minutes, 6 seconds 182,559 views",AND TV,182559,182908,349
1341,"DONGA - Alemseged & Abebe | New Traditional Ethiopian music 2017 (official video) by AND TV 5 years ago 5 minutes, 6 seconds 23,066 views",AND TV,23066,23125,59
1342,"Banchiw Lay - Tesfaye Ajema | New Ethiopian Music 2017 (Official Video) by AND TV 5 years ago 4 minutes, 13 seconds 40,230 views",AND TV,40230,40237,7
1343,"Ethiopian Music Networks | And Engda Show - Ashu Jeba (Official Interview) by AND TV 5 years ago 8 minutes, 57 seconds 10,987 views",AND TV,10987,10992,5
1344,"Afework G/Medhin - Besho -ኤሴቅ | New Ethiopian Music 2017 (Official Audio) by AND TV 5 years ago 5 minutes, 1 second 3,867 views",AND TV,3867,3869,2
1345,"Ethiopia አሉላ ገ/አምላክ - ማህተቤ | New Ethiopian Music 2017 by AND TV 5 years ago 5 minutes, 14 seconds 73,755 views",AND TV,73755,73777,22
1346,"Ethiopian Music Networks - And Endgda Show - Ali Umer by AND TV 5 years ago 15 minutes 3,438 views",AND TV,3438,3440,2
1347,"Biruk Bekele - Kotu Kotu | Best New Ethiopian Oromo Traditional Music 2017 (Official Video) by AND TV 5 years ago 5 minutes, 3 seconds 171,983 views",AND TV,171983,172070,87
1348,"Selam Mitku - Adebanat | New Ethiopian Oromo music 2017(official video) by AND TV 5 years ago 5 minutes, 33 seconds 16,126 views",AND TV,16126,16155,29
1349,"Ethiopian Music Networks And Endgda Show - Biruk Bekele - Bella  (Ethiopian Artist Interview) by AND TV 5 years ago 17 minutes 2,827 views",AND TV,2827,2831,4
1350,"Selam and Girma - Anbabalim Woy | New Ethiopian Music 2017 (Official Video) by AND TV 5 years ago 6 minutes, 52 seconds 199,877 views",AND TV,199877,199887,10
1351,"ABEBE & DEGEFA - HAMAMOBE | New Ethiopian Music 2017 (Official Video) by AND TV 5 years ago 4 minutes, 10 seconds 25,696 views",AND TV,25696,25699,3
1352,"Ethiopian Music Networks And Engda Show by AND TV 5 years ago 21 minutes 1,935 views",AND TV,1935,1936,1
1353,"Ethiopia - Lula - Tamime | New Ethiopian Music 2017 (Official Video) by AND TV 5 years ago 6 minutes, 1 second 4,271 views",AND TV,4271,4278,7
1354,"New Ethiopian Oromo Music 2017 - Abebe Kefeni - Beredu Jimma (Official Video) by AND TV 5 years ago 7 minutes, 24 seconds 74,067 views",AND TV,74067,74197,130
1355,"Jeje Trump - Shegitu | New Ethiopian Oromo Music 2017 (Official Video) by AND TV 5 years ago 3 minutes, 55 seconds 135,927 views",AND TV,135927,135940,13
1356,"Miky Yo - Miss U | New Ethiopian Hip Hop Music 2017 (Official Video) by AND TV 5 years ago 3 minutes, 28 seconds 884,250 views",AND TV,884250,887547,3297
1357,"Ethiopian Music Networks - And Engda Show Mekdes A/Meskel by AND TV 5 years ago 8 minutes, 36 seconds 4,526 views",AND TV,4526,4527,1
1358,"Bini Goytom - Anbessa Geday | New Ethiopian Gonder Music (official Video) by AND TV 5 years ago 6 minutes, 14 seconds 839,462 views",AND TV,839462,842160,2698
1359,"Ethiopian Music Networks | And Engda Show - Alula G/Amlak by AND TV 5 years ago 4 minutes, 22 seconds 2,069 views",AND TV,2069,2103,34
1360,"Amazing Gojjam traditional song - Habte Abrham - Zemenay New Ethiopian music 2016 (official Video) by AND TV 5 years ago 6 minutes 85,137 views",AND TV,85137,85200,63
1361,"Ethiopian music Networks And Engda Show - Best Ethiopian Singer - Banchiamlak Getnet by AND TV 5 years ago 13 minutes, 3 seconds 24,648 views",AND TV,24648,24787,139
1362,"Best Gonder Song: ጌታሁን ክንዱ - ያ ጎበዝ ጀግና New Ethiopian Music 2016 (official video) by AND TV 5 years ago 5 minutes, 47 seconds 147,045 views",AND TV,147045,147131,86
1363,"Best Gojjam Song - Dessalegn Dires - Shimunmun New Ethiopian music 2016 (official music video) by AND TV 5 years ago 5 minutes, 34 seconds 49,884 views",AND TV,49884,49917,33
1364,"Ethiopian music networks And Endgda show - Bini Mela Nice by AND TV 5 years ago 7 minutes, 42 seconds 1,703 views",AND TV,1703,1706,3
1365,"Ethiopian Music :  Habtamu Tedla - Bayhon - New Ethiopian Music 2016 (Official Video) by AND TV 5 years ago 5 minutes, 34 seconds 14,021 views",AND TV,14021,14031,10
1366,"Ethiopian Music Networks And እንግዳ Show - Micky Gonderigana by AND TV 5 years ago 10 minutes, 3 seconds 7,273 views",AND TV,7273,7278,5
1367,"Best Ethiopian Eskista: Dagi Reggae - Kebet Weto - New Ethiopian Music 2016 (Official Video) by AND TV 5 years ago 5 minutes, 38 seconds 107,812 views",AND TV,107812,107820,8
1368,"Awesome Ethiopian Piano performance by Ethiopian Idol judge Yeshi Demelash - ብትመጣልኝ by AND TV 5 years ago 4 minutes, 43 seconds 232,671 views",AND TV,232671,234058,1387
1369,"Patoranking My Woman Cover - Yene Mar | New Ethiopian music 2016 by AND TV 5 years ago 3 minutes, 13 seconds 204,904 views",AND TV,204904,205247,343
1370,"ዮኔቤ - Abrham Abebe & Mulugeta Sugamo New Ethiopian Music 2016 by AND TV 5 years ago 5 minutes, 25 seconds 4,496 views",AND TV,4496,4502,6
1371,"Mekuanet Abebe - Gojam (Official Music Video) New Ethiopian music 2016 by AND TV 5 years ago 6 minutes, 8 seconds 20,110 views",AND TV,20110,20119,9
1372,"ታደሰ ዘለቀ - ዳኤ ቡሹ ሀዋሳ (Official Music Video) New Ethiopian Music 2016 by AND TV 5 years ago 6 minutes, 8 seconds 37,574 views",AND TV,37574,37620,46
1373,"Taaddasaa Gabbiisaa - Simalee (Official Music Video) Ethiopian Oromo Music 2016 by AND TV 5 years ago 5 minutes, 21 seconds 21,502 views",AND TV,21502,21522,20
1374,"Ethiopian Music - Ali Umer - ባለ አደሷ - (Official Music Video) New Ethiopian Music 2016 by AND TV 5 years ago 4 minutes, 30 seconds 45,681 views",AND TV,45681,45686,5
1375,"Ethiopian Music - Mimi Addisu - ሰላም ነኝ (Official Music Video) New Ethiopian music 2016 by AND TV 5 years ago 6 minutes, 28 seconds 74,832 views",AND TV,74832,74846,14
1376,"Ethiopian Music - Ashu Jeba - ጀባ አለኝ (Official Music Video) New Ethiopian Music 2016 by AND TV 5 years ago 5 minutes, 58 seconds 15,967 views",AND TV,15967,15972,5
1377,"The First New Ethiopian Cypher Abyssinia Returns (Official Music Video) Ethiopian music 2016 by AND TV 5 years ago 4 minutes 418,711 views",AND TV,418711,420621,1910
1378,"Ethiopian Music - ጆ ቆቦ (official music video) New Ethiopian Music 2016 by AND TV 5 years ago 6 minutes 28,070 views",AND TV,28070,28071,1
1379,"Ethiopian Music - BanchiAmlak Getnet - Awalay (official music video) New Ethiopian music video 2016 by AND TV 5 years ago 5 minutes, 26 seconds 222,077 views",AND TV,222077,223998,1921
1380,"Ethiopian Gonder Music - Tesfa Amare - Biye Biye (official Debut Music video) Ethiopian Music 2016 by AND TV 5 years ago 5 minutes, 55 seconds 137,690 views",AND TV,137690,137839,149
1381,"Ethiopian music - Befi Yad - Anqelba (Official Debut Music Video) New Ethiopian music video 2016 by AND TV 5 years ago 6 minutes, 9 seconds 281,249 views",AND TV,281249,281784,535
1382,"Ethiopian music - ዮሐንስ (Jon) ጆን ተንቤን (official music video 2016) New Ethiopian music 2016 by AND TV 5 years ago 6 minutes, 4 seconds 56,315 views",AND TV,56315,56354,39
1383,"Ethiopian music - Befi Yad Interview (Coming Soon Anqelba music video) by AND TV 5 years ago 2 minutes, 51 seconds 3,928 views",AND TV,3928,3929,1
1384,"Ethiopian Oromo Music ዘይኑ ሙሀቡብ (Official Music Video) New Ethiopian Music 2016 by AND TV 5 years ago 5 minutes, 44 seconds 78,021 views",AND TV,78021,78047,26
1385,"Gumma Film Awards 2017 - Sint Honshilign - New Ethiopian movie HEROL official sound track by AND TV 5 years ago 6 minutes, 1 second 77,269 views",AND TV,77269,77328,59
1386,"Ethiopian music - Martha Solomon - Atchenek (Official Music Video) New Ethiopian Music 2016 by AND TV 5 years ago 4 minutes, 22 seconds 7,557 views",AND TV,7557,7560,3
1387,"Ethopian music - Nahom Mekuria - Tinishua Enate (Official Music Video) New music 2016 by AND TV 5 years ago 4 minutes, 19 seconds 19,863 views",AND TV,19863,19874,11
1388,"Ethiopian music - Mc Mike - Habeshawit (Official music video) New Ethiopian Dance hall music 2016 by AND TV 5 years ago 5 minutes, 1 second 208,092 views",AND TV,208092,208123,31
1389,"New Ethiopian Music - Biniyam Assefa - Silemamnat (Official Audio 2016) by AND TV 5 years ago 4 minutes, 17 seconds 3,581 views",AND TV,3581,3583,2
1390,"Ethiopian Music - ትብለጽ ተከስተ - Ane Xuma (Official Music Video) New Ethiopian Music 2016 by AND TV 5 years ago 4 minutes, 22 seconds 28,830 views",AND TV,28830,28844,14
1391,"Ethiopian Music - wondmagegn kawo - ishiidhan (Official Music Video) New Ethiopian Oromo Music 2016 by AND TV 5 years ago 5 minutes, 51 seconds 7,206 views",AND TV,7206,7209,3
1392,"Ethiopian Music - Micky Gonderegna - Geredo (Official debut video) New Ethiopian music 2016 by AND TV 5 years ago 3 minutes, 10 seconds 175,572 views",AND TV,175572,175764,192
1393,"Ethiopian Music - Fantaye Asmare - Yegonder Lij (New Traditional Ethiopian music 2016) by AND TV 5 years ago 5 minutes, 39 seconds 376,388 views",AND TV,376388,376855,467
1394,"Ethiopian Music - Teddy itegie - Yagere Lij - New Official Ethiopian Music Video debut 2016 by AND TV 5 years ago 4 minutes, 34 seconds 63,322 views",AND TV,63322,63335,13
1395,"Best New Ethiopian music videos of 2016 - Ethiopian music networks by AND TV 5 years ago 2 minutes, 28 seconds 5,308 views",AND TV,5308,5309,1
1396,"Best African Music/New music Ethiopia 2016 Buju Star - Hambasa Gaammoo [Official music video] by AND TV 5 years ago 5 minutes, 19 seconds 80,179 views",AND TV,80179,80445,266
1397,"New Ethiopian Music 2016 - Biniyam Tessema - Yu Yu/ትምጣ ትምጣ (official music video) by AND TV 5 years ago 5 minutes, 32 seconds 402,899 views",AND TV,402899,404243,1344
1398,"Ethiopian Music - Haymi Lenger - Worqiye (official music video) New Ethiopian Music 2016 by AND TV 5 years ago 3 minutes, 7 seconds 9,163 views",AND TV,9163,9167,4
1399,"Ethiopia - Kassahun Lema - Lega (Official Music Video) New Hadiya Ethiopian Music 2016 by AND TV 5 years ago 5 minutes, 29 seconds 693,619 views",AND TV,693619,695935,2316
1400,"Asgegnew Ashko (Asge) - Dendasho (ዴንዳሾ) - New Ethiopian Music 2016 (Official Video) by AND TV 5 years ago 4 minutes, 34 seconds 74,373 views",AND TV,74373,78601,4228
1401,"Ethiopian Music - Wasi Habesha - Himeme (official Music Video) New Ethiopian Music 2016 by AND TV 5 years ago 5 minutes, 10 seconds 12,822 views",AND TV,12822,12833,11
1402,"Ethiopian Music - Biniyam Woldu - Mela Bilesh - (Official Music Video) New Ethiopian Music 2016 by AND TV 5 years ago 5 minutes, 12 seconds 58,522 views",AND TV,58522,58539,17
1403,"Ujulu Fera - Borodii Duussa Deere New Ethiopian music 2016 (Official Music Video) by AND TV 5 years ago 5 minutes, 38 seconds 8,802 views",AND TV,8802,8824,22
1404,"Best New Ethiopian Traditional Music 2016 Biruk Bekele - Bella (Official music video) by AND TV 5 years ago 5 minutes, 8 seconds 132,876 views",AND TV,132876,132909,33
1405,"Ethiopian music - Behlme Aychesh - Best New Ethiopian love music 2016 (Official music Video) by AND TV 5 years ago 5 minutes, 2 seconds 12,994 views",AND TV,12994,13002,8
1406,"WorkAferahu Kebede - ሊረንች ዮኮ - New! Ethiopian Music 2016 (official music video) by AND TV 5 years ago 4 minutes, 49 seconds 30,342 views",AND TV,30342,30345,3
1407,"Mule Kebera - Abebicho New Ethiopina Music 2016 (Official Music Video) by AND TV 5 years ago 5 minutes, 39 seconds 196,088 views",AND TV,196088,196748,660
1408,"Mekdes A Meskel - ዎስዋስ New Ethiopian music 2016 (Official Video) by AND TV 5 years ago 5 minutes, 5 seconds 10,880 views",AND TV,10880,10887,7
1409,"solomon beyene - yedi konjio (Official Music Video) New Ethiopian music 2016 by AND TV 5 years ago 4 minutes, 59 seconds 5,331 views",AND TV,5331,5345,14
1410,"Wendwesen Selfago - Amo Amo (Official Music Video) [New Ethiopian Music 2016] by AND TV 5 years ago 3 minutes, 52 seconds 4,026 views",AND TV,4026,4028,2
1411,"Abebe Girma - ሶያማ New Ethiopian music 2016 (Burji Tradition official video) by AND TV 6 years ago 4 minutes, 50 seconds 19,789 views",AND TV,19789,19999,210
1412,"Wondye Abebe - ጎፋ መሎኮዛ New Ethiopian Music 2016 (Amazing intro) Official Music Video by AND TV 6 years ago 6 minutes, 5 seconds 99,077 views",AND TV,99077,99203,126
1413,"Mekdes A/Meskel - Woswas (official audio) New Ethiopian music 2016 by AND TV 6 years ago 5 minutes, 12 seconds 1,739 views",AND TV,1739,1740,1
1414,"ራስ ነብዩ - Lion Talk (Official Music Video) New Ethiopian Hiphop music 2016 by AND TV 6 years ago 4 minutes, 40 seconds 36,825 views",AND TV,36825,36895,70
1415,"Abebe Girma - ይጎሰም ነጋሪት - (Official Music Video) New Ethiopian Music 2016 by AND TV 6 years ago 6 minutes, 7 seconds 101,402 views",AND TV,101402,101424,22
1416,"Gezahagn Israel - አባቢያ ሎሜ ቴራ - (Official Music Video) New Ethiopian music 2016 by AND TV 6 years ago 5 minutes, 19 seconds 77,382 views",AND TV,77382,77511,129
1417,"Sam Yerom - ኦካ ኦሃ (Official Music Video) New Ethiopian Music 2015 by AND TV 6 years ago 4 minutes, 31 seconds 13,059 views",AND TV,13059,13071,12
1418,"Tibilets Tekeste - Qalli Yoomma (official music video) - New Ethiopian Music 2016 by AND TV 6 years ago 3 minutes, 48 seconds 12,956 views",AND TV,12956,13010,54
1419,"Abebe Girma - Woylala - ወይላላ - (Official music video) [New traditional Ethiopian Music 2016] by AND TV 6 years ago 4 minutes, 3 seconds 8,076 views",AND TV,8076,8101,25
1420,"Ali Umer (Baba) - Silale - (official music video) New Ethiopian Oromo Music 2016 by AND TV 6 years ago 4 minutes, 12 seconds 18,981 views",AND TV,18981,18983,2
1421,"Gossaye Tesfaye - Enatye - New year Ethiopian Music video 2016 by AND TV 6 years ago 5 minutes, 44 seconds 2,062 views",AND TV,2062,2076,14
1422,"Teddy Afro - Abebayehosh -New year Ethiopian Music video 2016 by AND TV 6 years ago 5 minutes, 55 seconds 131,346 views",AND TV,131346,131431,85
1423,"Abebe Girma - ደንበሌሳ (official music video) Ethiopian music 2016 by AND TV 6 years ago 5 minutes, 1 second 19,449 views",AND TV,19449,19541,92
1424,"Seble Tadesse -Mabede New - ማበዴ ነው (Official music video) [New Ethiopian Music 2016] by AND TV 6 years ago 4 minutes, 26 seconds 451,888 views",AND TV,451888,452134,246
1425,"New Ethiopian Habesha Music 2016 - ከድር አሊ (አቡ) - Zim Endalil (Official video) by AND TV 6 years ago 5 minutes, 29 seconds 29,357 views",AND TV,29357,29361,4
1426,"Ethiopian Music - Sam Yerom - Tokufa - (official Ethiopian Soccer Anthem) New Ethiopian Music 2015 by AND TV 6 years ago 4 minutes, 6 seconds 1,858 views",AND TV,1858,1860,2
1427,"Ethiopian Music - Abebe Girma - Zeyse (Official Video) New Ethiopian Traditional Music 2015 by AND TV 6 years ago 5 minutes, 29 seconds 6,115 views",AND TV,6115,6118,3
1428,"Ethiopian Music - Tefe Lali - ደርባብዬ (official Audio) New Habesha Music 2015 by AND TV 6 years ago 3 minutes, 36 seconds 2,543 views",AND TV,2543,2544,1
1429,"Ethiopian Music - አያያ መኪና - መቅደስ ዓ/መስቀል - (Official Music Video) New Ethiopian Sidamo Music 2015 by AND TV 6 years ago 4 minutes, 40 seconds 11,752 views",AND TV,11752,11784,32
1430,"Ethiopian Music - Bini Lali - ወስኑላት (offcial Audio) Habesha Music 2015 by AND TV 6 years ago 4 minutes, 12 seconds 5,543 views",AND TV,5543,5551,8
1431,"Ethiopian Music - አዳዋና - መቅደስ ዓ/መስቀል - (Official Music Video) New Ethiopian Sidamo Music 2015 by AND TV 6 years ago 4 minutes, 58 seconds 38,731 views",AND TV,38731,38860,129
1432,"Habehsa Music - የሺጥላ ተሰማ - አንቺ ልጅ ወሎዬ - (Official Video) [Wollo Traditional Ethiopian Music 2015] by AND TV 6 years ago 5 minutes, 51 seconds 7,293 views",AND TV,7293,7296,3
1433,"Nahom Mekuria - ሰዎች አይረዱም - (Official Audio) - New Ethiopian Music 2015 by AND TV 6 years ago 5 minutes, 2 seconds 1,640 views",AND TV,1640,1641,1
1434,"Ethiopian music - Nahom Mekuria - Kene New (Official Music Video) New Ethiopian Music 2015 by AND TV 6 years ago 4 minutes, 24 seconds 12,693 views",AND TV,12693,12703,10
1435,"New Ethiopian Music Befekadu Yadete - Addis Aydelem by AND TV 6 years ago 4 minutes, 11 seconds 3,778 views",AND TV,3778,3782,4
1436,"New Ethiopian Wedding Song Bini Lali - Enquan Des Yalachu by AND TV 6 years ago 5 minutes, 11 seconds 2,695 views",AND TV,2695,2700,5
1437,"New Ethiopian Music Mimi Addisu - Engenagnalen by AND TV 6 years ago 3 minutes, 40 seconds 3,153 views",AND TV,3153,3163,10
1438,"Ethiopian Music Mimi Addisu - Endet New Gedawo by AND TV 6 years ago 4 minutes, 14 seconds 3,871 views",AND TV,3871,3878,7
1439,"Bini Lali - Ere Erye Erye (Official Music Video) [ Hot New Ethiopian Music Video 2015] by AND TV 6 years ago 6 minutes, 24 seconds 105,211 views",AND TV,105211,105225,14
1440,"AndTunes Collection Vol. 1  [NEW! Ethiopian Music Video 2015] by AND TV 6 years ago 1 minute, 6 seconds 1,274 views",AND TV,1274,1275,1
1441,"Ethiopian music ""ወይኖ"" ግዛቸው ተክለ ማሪያም by AND TV 6 years ago 6 minutes, 28 seconds 1,522 views",AND TV,1522,1524,2
1442,"Ethiopian Oldies - Alemayehu Eshete ኮቱማ by AND TV 6 years ago 4 minutes, 55 seconds 1,609 views",AND TV,1609,1612,3
1443,"Ethiopian Oldies - Netsanet Melese ያለ ስንብት by AND TV 6 years ago 4 minutes, 54 seconds 6,185 views",AND TV,6185,6204,19
1444,"Ethiopian Oldies - Neway and Hamelmal by AND TV 6 years ago 7 minutes, 1 second 46,083 views",AND TV,46083,46335,252
1445,"Abdi Nuressa -  Bareedduu Baadiya by AND TV 7 years ago 5 minutes, 5 seconds 13,501 views",AND TV,13501,13507,6
1446,"Alemayehu Eshete and Kuku Sebsibe - Engdaye Nesh by AND TV 7 years ago 7 minutes, 47 seconds 15,297 views",AND TV,15297,15346,49
1447,"Bizeayehu Demissie in ATL by AND TV 7 years ago 3 minutes, 51 seconds 2,090 views",AND TV,2090,2103,13
1448,"Fasil Demoz 2014 - Thank You! by AND TV 7 years ago 2 minutes, 50 seconds 36,636 views",AND TV,36636,36641,5
1449,"Hot - Fasil Demoz new music by AND TV 7 years ago 5 minutes, 35 seconds 746,936 views",AND TV,746936,746975,39
1450,"Fasil Demoz - New Album 2014 by AND TV 7 years ago 1 minute, 12 seconds 44,847 views",AND TV,44847,44857,10
