,Posts,Channel,Views_03/03,Views_03/12,view_delta
0,"new ethiopian cover music mahelet gashaw  ማህሌት ጋሻዉ ከቨር ሙዚቃ  2021 by Awash Entertainment 2 months ago 3 minutes, 19 seconds 3,135 views",Awash Entertainment,3135,3303,168
1,"የሀዋሳ ከተማ በረከቶች  Hawassa Ethiopia 2021 by Awash Entertainment 3 months ago 4 minutes, 7 seconds 545 views",Awash Entertainment,545,558,13
2,"የገጣሚያን ቆይታ ከ ሙዚቀኞች ጋር 2021 by Awash Entertainment 3 months ago 13 minutes, 37 seconds 322 views",Awash Entertainment,322,336,14
3,ጉድ እኮ ነዉ  new interview 2021 gude eko new by Awash Entertainment 3 months ago 21 minutes 404 views,Awash Entertainment,404,417,13
4,"ሻጠማ እድር አዲስ ኮሜዲ ታጠብ New Ethiopian Comedy 2021 by Awash Entertainment 7 months ago 19 minutes 1,389 views",Awash Entertainment,1389,1395,6
5,"አረግዛለው ሻጠማ እድር አጭር ኮሜዲ 2021 Ethiopian comedy by Awash Entertainment 7 months ago 15 minutes 1,586 views",Awash Entertainment,1586,1623,37
6,"New Ethiopian comedy Highlight (2021) አረግዛለሁ; ሻጠማ እድሮች by Awash Entertainment 7 months ago 1 minute, 24 seconds 1,008 views",Awash Entertainment,1008,1015,7
7,"Rahel G/Mikael (ልቺ) - TEREDAALEY (ተረዳኣለይ) - New Ethiopian Tigrigna Music 2020 | Official Music Video by Awash Entertainment 1 year ago 5 minutes, 22 seconds 10,238 views",Awash Entertainment,10238,10262,24
8,"Abrhaley Azenaw - ZELMEDKNI (ዘልመድክኒ) - New Ethiopian Tigrigna Music 2020 | Official Music Video by Awash Entertainment 1 year ago 4 minutes, 34 seconds 5,394 views",Awash Entertainment,5394,5432,38
9,"WEY GIZE ወይ ግዜ New Comedy Tigrigna Drama 2020 by Awash Entertainment 1 year ago 11 minutes, 56 seconds 2,980 views",Awash Entertainment,2980,2998,18
10,"ፃውዒት New Ethiopian Tigrigna Drama 2020 part 2 by Awash Entertainment 1 year ago 20 minutes 2,630 views",Awash Entertainment,2630,2633,3
11,"Ashenafi Teka - SALAKI(ሳላኪ) - New Ethiopian Tigrigna Music 2020 | Official Music Video by Awash Entertainment 1 year ago 5 minutes, 29 seconds 8,561 views",Awash Entertainment,8561,8584,23
12,"Mesqalah መስቃላህ New Ethiopian Traditional Erob Music (Official Video) by Awash Entertainment 1 year ago 5 minutes, 58 seconds 226,226 views",Awash Entertainment,226226,226966,740
13,"MESQEL 2012 Adigrat መስቀል 2012 ኣብ ዓዲግራት by Awash Entertainment 1 year ago 47 minutes 13,747 views",Awash Entertainment,13747,13816,69
14,"Mogos Kahsay BRKI LILO ብርኪ ሊሎ (Official Video) Ethiopian Tigrigna Music 2020 by Awash Entertainment 1 year ago 5 minutes, 24 seconds 23,364 views",Awash Entertainment,23364,23381,17
15,"NaboNmen Nahabo ናቦ ንመን ናሃቦ New Ethiopian Tigrigna Comedy 2020 part 1 by Awash Entertainment 1 year ago 16 minutes 1,932 views",Awash Entertainment,1932,1936,4
16,"ፃውዒት New Ethiopian Tigrigna Drama 2020 part 1 by Awash Entertainment 1 year ago 23 minutes 6,137 views",Awash Entertainment,6137,6144,7
17,"Selamta Ezni  ሰለምታ እዝኒ New Ethiopian Tigrigna Comedy 2020 by Awash Entertainment 1 year ago 17 minutes 2,237 views",Awash Entertainment,2237,2241,4
18,"3G  SEGARI MEAT ሰጋሪ መዓት(Official Video) Ethiopian Tigrigna Music 2020 by Awash Entertainment 1 year ago 7 minutes, 5 seconds 115,089 views",Awash Entertainment,115089,115261,172
19,"Tewelde Gebru GIZE ግዜ(Official Video) Ethiopian Tigrigna Music 2020 by Awash Entertainment 1 year ago 7 minutes, 12 seconds 56,299 views",Awash Entertainment,56299,56322,23
20,"Helen Alem ASHENDA-ኣሽንዳ (Official Video) Ethiopian Tigrigna Music 2020 by Awash Entertainment 1 year ago 8 minutes, 12 seconds 505,011 views",Awash Entertainment,505011,505456,445
21,"Fisaha Hailay (Wedi Tsehay)TAALELE-ታዓለለ (Official Video) Ethiopian Tigrigna Music 2020 by Awash Entertainment 1 year ago 5 minutes, 10 seconds 344,876 views",Awash Entertainment,344876,346636,1760
22,"Haftom Seged AB GOBO MWALA-ኣብ ጎቦ ምውኣላ(Official Video) Ethiopian Tigrigna Music 2020 by Awash Entertainment 1 year ago 6 minutes, 29 seconds 33,575 views",Awash Entertainment,33575,33603,28
23,"Haftom Gebre  TAAWITULEY -ተዊቱለይ(Official Video) Ethiopian Tigrigna Music 2020 by Awash Entertainment 1 year ago 4 minutes, 47 seconds 5,941 views",Awash Entertainment,5941,5946,5
24,"Hani Berhane(Sayber)AKLILEY- ኣክሊለይ(Official Video) Ethiopian Tigrigna Music 2020 by Awash Entertainment 1 year ago 6 minutes, 16 seconds 121,251 views",Awash Entertainment,121251,121335,84
25,"Amanual G/kidan   AMBESA EYU| ኣምበሳ እዩ (Official Video) Ethiopian Tigrigna Music 2020 by Awash Entertainment 1 year ago 5 minutes, 56 seconds 3,438 views",Awash Entertainment,3438,3440,2
26,"Solomon Gebru  TIGRAY (ትግራይ) New Ethiopian Tigrigna Music 2020 (Official Video) by Awash Entertainment 1 year ago 7 minutes, 2 seconds 236,195 views",Awash Entertainment,236195,236361,166
27,"Negash G/medhin ALMAZ BURUREY(ኣልማዝ ቡሩረይ) New Ethiopian Tigrigna Music 2020 (Official Video) by Awash Entertainment 1 year ago 5 minutes, 48 seconds 7,900 views",Awash Entertainment,7900,7907,7
28,"Germay Kidane TFETWNI DO? (ትፈትውኒ ዶ?) New Ethiopian Tigrigna Music 2020 (Official Video) by Awash Entertainment 1 year ago 4 minutes, 58 seconds 61,156 views",Awash Entertainment,61156,61169,13
29,"New Ethiopian Tigrigna Comedy 2020 ገ እናበሉካ ዶ? by Awash Entertainment 1 year ago 11 minutes, 31 seconds 2,998 views",Awash Entertainment,2998,3000,2
30,"Kahsay  Gebregziabher B TIGRAY  (ብ ትግራይ) New Ethiopian Tigrigna Music 2020 (Official Video) by Awash Entertainment 1 year ago 6 minutes, 40 seconds 29,996 views",Awash Entertainment,29996,30009,13
31,"Asfaw Gebrecherkos ZATIGRAYADEY (ዛ ትግራይ ዓደይ) New Ethiopian Tigrigna Music 2020 (Official Video) by Awash Entertainment 1 year ago 6 minutes, 15 seconds 14,414 views",Awash Entertainment,14414,14425,11
32,"Solomon G/Slassie Desalegn Mengustu SHELUMULEY  New Ethiopian Tigrigna Music 2020 (Official Video) by Awash Entertainment 1 year ago 8 minutes, 8 seconds 51,443 views",Awash Entertainment,51443,51479,36
33,"Ephrem Haylay Hnsa G/Hiwot TAAZEBOM(ታዓዘቦም) New Ethiopian Tigrigna Music 2020 (Official Video) by Awash Entertainment 1 year ago 5 minutes, 34 seconds 55,602 views",Awash Entertainment,55602,55677,75
34,"Zayd Abrahaley WANINEY (ዋኒነይ) New Ethiopian Tigrigna Music 2020 (Official Video) by Awash Entertainment 1 year ago 5 minutes, 4 seconds 6,860 views",Awash Entertainment,6860,6866,6
35,"Tuom Hailu  BSALAKUM (ብሳላኩም) New Ethiopian Tigrigna Music 2020 (Official Video) by Awash Entertainment 1 year ago 5 minutes, 5 seconds 15,044 views",Awash Entertainment,15044,15052,8
36,"New Ethiopian Tigrigna Comedy 2020 MENSUTA (መንሱታ) by Awash Entertainment 1 year ago 28 minutes 1,037 views",Awash Entertainment,1037,1040,3
37,"Ras_Willy_Moto_ft_Slassian_Recordes_  JOROYALEWYSMA ጆሮ ያለው ይስማ New Ethiopian music 2020 by Awash Entertainment 1 year ago 3 minutes, 53 seconds 3,582 views",Awash Entertainment,3582,3585,3
38,"Abraham G/yohans ALEM (ዓለም) New Ethiopian Tigrigna Music 2020 (Official Video) by Awash Entertainment 1 year ago 5 minutes, 11 seconds 38,301 views",Awash Entertainment,38301,38350,49
39,"Haftom Muez & Muluberhan kahsay -YEKLLELNA(የቅልለልና) New Tigrigna Music 2020(Official Video) by Awash Entertainment 1 year ago 3 minutes, 24 seconds 3,027 views",Awash Entertainment,3027,3033,6
40,"Lidya Birhanu  SYE (ስየ) New Ethiopian Tigrigna Music 2020 (Official Video) by Awash Entertainment 1 year ago 5 minutes, 55 seconds 6,784 views",Awash Entertainment,6784,6809,25
41,"nash ft. epxi ''ናተይ'' natey  New Ethiopian Music 2020(Official Video) by Awash Entertainment 1 year ago 3 minutes, 56 seconds 3,168 views",Awash Entertainment,3168,3173,5
42,"New Ethiopian Tigrigna Comedy 2020  ሽሙን ወርቅን SHEMUN WERQEN by Awash Entertainment 1 year ago 4 minutes, 32 seconds 2,778 views",Awash Entertainment,2778,2780,2
43,"New Ethiopian Tigrigna Comedy 2020 Goytom Tewelde (Wedi Kuras) ኮሮና  CORONA by Awash Entertainment 1 year ago 2 minutes, 55 seconds 5,888 views",Awash Entertainment,5888,5893,5
44,"Hray Asfaw(gal zamra) MEHENEN(መሀነን) New Ethiopian Tigrigna Music 2020 (Official Video) by Awash Entertainment 1 year ago 5 minutes, 46 seconds 10,042 views",Awash Entertainment,10042,10052,10
45,"Zekarias gebretsadik ABHADE NSMER (ኣብ ሓደ ንስመር) New Ethiopian Tigrigna Music 2020 (Official Video) by Awash Entertainment 2 years ago 4 minutes, 46 seconds 6,061 views",Awash Entertainment,6061,6066,5
46,"ጠርጣራው  ስቡሕ ኣብ መክፈቲ ፓነል ምይይጥ 11 የካቲት by Awash Entertainment 2 years ago 7 minutes, 21 seconds 3,247 views",Awash Entertainment,3247,3261,14
47,"Awet Lijalem  SEMAETATINA(ሰማእታትና )Ft Rahwa Yemane New Ethiopian Tigrigna Music 2020 (Official Video) by Awash Entertainment 2 years ago 5 minutes, 13 seconds 16,108 views",Awash Entertainment,16108,16111,3
48,"ንሕና  ዊንታ/ወዲ ረሚጥ/ ኣበበ  ኣርኣያ ን ኣብ መክፈቲ ፓነል ምይይጥ 11 የካቲት by Awash Entertainment 2 years ago 6 minutes, 44 seconds 14,660 views",Awash Entertainment,14660,14668,8
49,"(ቆቃሓት) ሙዚቃዊ ድራማ ኣብ መክፈቲ ፓነል ምይይጥ 11 የካቲት by Awash Entertainment 2 years ago 21 minutes 12,525 views",Awash Entertainment,12525,12539,14
50,"Timnit Welday ft. Ephrem Amare - Mizekerkani doትምኒት  ምስ ኤፍሬም  መክፈቲ ፓነል ምይይጥ 11 የካቲት  ምለለኻኒ ዶ ? by Awash Entertainment 2 years ago 5 minutes, 54 seconds 159,627 views",Awash Entertainment,159627,159743,116
51,"Tommy JEE  (BADO HADE)~ባዶ ሓደ~- New Ethiopian Music 2020(Official Video) by Awash Entertainment 2 years ago 3 minutes, 38 seconds 1,905 views",Awash Entertainment,1905,1907,2
52,"Tesfay Zeray ALENA DO (ኣለና ዶ? ) New Ethiopian Tigrigna Music 2020 (Official Video) by Awash Entertainment 2 years ago 6 minutes, 14 seconds 18,887 views",Awash Entertainment,18887,18904,17
53,"Tahguas Teshome -SEGEN (ሰገን ) New Ethiopian Tigrigna Music 2020 (Official Video) by Awash Entertainment 2 years ago 4 minutes, 37 seconds 24,618 views",Awash Entertainment,24618,24626,8
54,"Berhe Kahsay -WUDBEY(ዉድበይ)New Ethiopian Tigrigna Music 2020 (Official Video) by Awash Entertainment 2 years ago 6 minutes, 16 seconds 20,993 views",Awash Entertainment,20993,21004,11
55,"Abedom G/slase # ABAY TIGRAY( ኣባይ ትግራይ) New Ethiopian Tigrigna Music 2020 (Official Video) by Awash Entertainment 2 years ago 7 minutes, 25 seconds 73,908 views",Awash Entertainment,73908,73932,24
56,"Yapi Mapi ft John Haftu (BITSAY)~ብፃይ~- New Ethiopian Music 2020(Official Video) by Awash Entertainment 2 years ago 7 minutes, 24 seconds 57,451 views",Awash Entertainment,57451,57488,37
57,"Zenawi Hailemariam& Husen Ali Barahle(ሓደ ኢና) New Ethiopian Tigrigna Music 2020 (Official Video by Awash Entertainment 2 years ago 4 minutes, 25 seconds 12,168 views",Awash Entertainment,12168,12196,28
58,"ዳይ ዳይ X-DOP BOYZ-Ona Jany & MillGas Ethiopian Tigrigna Music 2020 (Official Video) by Awash Entertainment 2 years ago 3 minutes, 57 seconds 5,493 views",Awash Entertainment,5493,5502,9
59,"Girmay Gebrehiwet -MENDINA(መን ዲና)New Ethiopian Tigrigna Music 2020 (Official Video) by Awash Entertainment 2 years ago 5 minutes, 12 seconds 12,063 views",Awash Entertainment,12063,12072,9
60,"Tsigabu Teshale AWRERU (ኣውረሩ) New Ethiopian Tigrigna Music 2020 (Official Video) by Awash Entertainment 2 years ago 6 minutes, 8 seconds 1,206,109 views",Awash Entertainment,1206109,1211787,5678
61,"Birhanu Abrha MEDHANITEY(መድሓኒተይ) New Ethiopian Tigrigna Music 2020 (Official Video) by Awash Entertainment 2 years ago 5 minutes, 15 seconds 6,715 views",Awash Entertainment,6715,6721,6
62,"KMS BELI NG FT G-M New Ethiopian Tigrigna Music 2020 (Official Video) by Awash Entertainment 2 years ago 3 minutes, 24 seconds 5,388 views",Awash Entertainment,5388,5394,6
63,"Amanual Tesfay (ማእከል ትግራይ ንዕናይ) New Ethiopian Tigrigna Music 2020 (Official Video) by Awash Entertainment 2 years ago 6 minutes, 45 seconds 209,539 views",Awash Entertainment,209539,209964,425
64,"Abraham G/yohans EDLEY (ዕድለይ) New Ethiopian Tigrigna Music 2020 (Official Video) by Awash Entertainment 2 years ago 5 minutes, 17 seconds 14,032 views",Awash Entertainment,14032,14038,6
65,"Husen Ali Barahle HALEWAT (ሃለዋት)  New Ethiopian Music 2019 (Official Video) by Awash Entertainment 2 years ago 5 minutes, 7 seconds 5,901 views",Awash Entertainment,5901,5927,26
66,"Ashmelash Teklay (ወዲ ጅግና) New Ethiopian Music 2019 (Official Video) by Awash Entertainment 2 years ago 5 minutes, 14 seconds 2,695 views",Awash Entertainment,2695,2698,3
67,"New Ethiopian Tigrigna Comedy 2019 Goytom Tewelde (Wedi Kuras)  ማዓር ኣፉ Maare Auf by Awash Entertainment 2 years ago 8 minutes, 48 seconds 8,762 views",Awash Entertainment,8762,8767,5
68,"Gush kahsay  (Melsi HABI Meryet) ''መልሲ ሃቢ መርየት'' New Ethiopian Tigrigna Music 2019 (Official Video) by Awash Entertainment 2 years ago 5 minutes, 35 seconds 9,957 views",Awash Entertainment,9957,9961,4
69,"Ashu Ft Ashu  (Kaf Alewa)'' ኬፍ ኣለዋ '' New Ethiopian Tigrigna Music 2019 (Official Video by Awash Entertainment 2 years ago 3 minutes, 57 seconds 280,214 views",Awash Entertainment,280214,280512,298
70,"Yohannes  G/Tsadiq (HADNETNA)'' ሓድነትና '' New Ethiopian Tigrigna Music 2019 (Official Video) by Awash Entertainment 2 years ago 5 minutes, 33 seconds 78,254 views",Awash Entertainment,78254,78270,16
71,"Sofia Atsbeha ''ኣብዚዓጋመ ማይ ደለዎ ማየ''  Live@ Meskel Tigray Agame 2012 by Awash Entertainment 2 years ago 8 minutes, 26 seconds 2,945 views",Awash Entertainment,2945,2963,18
72,"Solomon Haile Live@Meskel Tigray Agame 2012 by Awash Entertainment 2 years ago 10 minutes, 1 second 11,891 views",Awash Entertainment,11891,11989,98
73,"Mulubrhan Fiseha (Wari-Wedizom) ዋሪ ወዲ'ዞም@Meskel Tigray Agame 2012 by Awash Entertainment 2 years ago 11 minutes, 16 seconds 3,152 views",Awash Entertainment,3152,3165,13
74,"Haftom Gebreselassie (FTAY FTAY) ''ፍታይ ፍታይ '' New Ethiopian Tigrigna Music 2019 (Official Video) by Awash Entertainment 2 years ago 6 minutes, 39 seconds 347,511 views",Awash Entertainment,347511,347686,175
75,"Tmnit Welday Kiatwa demo Live ''DAMERA''@Meskel Tigray Agame 2012 by Awash Entertainment 2 years ago 11 minutes, 18 seconds 3,653 views",Awash Entertainment,3653,3674,21
76,"Ephrem Teklit  ''AJOKI TIGRAY''(ኣጆኪ ትግራይ) New Ethiopian Tigrigna Music 2019 (Official Video) by Awash Entertainment 2 years ago 5 minutes, 11 seconds 8,558 views",Awash Entertainment,8558,8568,10
77,"Yewelad Mekan Ager (የወላድ መካን አገር) ዳሪክ ነጋሽ (ኣረጋ) by Awash Entertainment 2 years ago 6 minutes, 29 seconds 1,085 views",Awash Entertainment,1085,1088,3
78,"Nguse Abadi - ZEMAY (ዘማይ)  Live@Meskel Tigray Agame 2012 by Awash Entertainment 2 years ago 11 minutes, 15 seconds 10,161 views",Awash Entertainment,10161,10227,66
79,"Tmnit Welday Kiatwa demo Live@Meskel Tigray Agame 2012 by Awash Entertainment 2 years ago 11 minutes, 17 seconds 8,512 views",Awash Entertainment,8512,8530,18
80,"Legesse Hailemariam ''Terakibom do''(ተራኪቦም'ዶ) New Ethiopian Tigrigna Music 2019 (Official Video) by Awash Entertainment 2 years ago 7 minutes, 1 second 11,900 views",Awash Entertainment,11900,11908,8
81,"Dejen Tsigab ''AB AGAME (ኣብ ዓጋመ ) New Ethiopian Tigrigna Music 2019 (Official Video) by Awash Entertainment 2 years ago 5 minutes, 58 seconds 44,460 views",Awash Entertainment,44460,44492,32
82,"Teklay Berhe Chlfit & Tesfu Teklay ''ሓይልካ ጥበብ'ዮ'' New Ethiopian Tigrigna Music 2019(Official Video) by Awash Entertainment 2 years ago 5 minutes, 38 seconds 62,563 views",Awash Entertainment,62563,62934,371
83,"""ኩነታት ግድብ ገረብ ግባ ግልጺ ዘይኾነሉ ምኽንያት የጠራጥር እዩ።"" by Awash Entertainment 2 years ago 34 minutes 8,807 views",Awash Entertainment,8807,8808,1
84,"Girmay Tesfay ግርማይ ተስፋይ''ወያናይ '' በ ድሮን የተቀረፀ Live @ዓይኒ ዋሪ ኣክሱም || Axum Ayni Wari CONCERT 2011 by Awash Entertainment 2 years ago 5 minutes, 21 seconds 2,084 views",Awash Entertainment,2084,2088,4
85,"Mulugeta Kahsay ወዲ ሮሚጥ''ሓወልተይ '' በ ድሮን የተቀረፀ Live @ዓይኒ ዋሪ ኣክሱም || Axum Ayni Wari CONCERT 2011 by Awash Entertainment 2 years ago 10 minutes, 4 seconds 1,653 views",Awash Entertainment,1653,1659,6
86,"Huluf  Tewelde ''MESILWOM''(መሲልዎም)New Ethiopian Tigrigna Music 2019(Official Video) by Awash Entertainment 2 years ago 5 minutes, 5 seconds 34,518 views",Awash Entertainment,34518,34536,18
87,"ALEM G/Hiwet(BAHLNA) ''ባህልና''New Ethiopian Tigrigna Music 2019(Official Video) by Awash Entertainment 2 years ago 5 minutes, 55 seconds 11,287 views",Awash Entertainment,11287,11293,6
88,"Tikue Woldu - Tigray Milibama ኣብ ትግራይ ምልባማ ኮንሰርት ሓድሽ ዓመት by Awash Entertainment 2 years ago 6 minutes, 37 seconds 2,048 views",Awash Entertainment,2048,2052,4
89,"Mizan tesfay ሚዛን ተስፋይ ''ንትግራይ'' ኣብ ትግራይ ምልባማ ኮንሰርት ሓድሽ ዓመት by Awash Entertainment 2 years ago 10 minutes, 11 seconds 1,451 views",Awash Entertainment,1451,1453,2
90,"Zemen Alemseged ኣብ ትግራይ ምልባማ ኮንሰርት ሓድሽ ዓመት by Awash Entertainment 2 years ago 7 minutes, 57 seconds 8,451 views",Awash Entertainment,8451,8460,9
91,"Kiros G/medhin(TIGRAWAY) ''ትግራዋይ''New Ethiopian Tigrigna Music 2019(Official Video) by Awash Entertainment 2 years ago 7 minutes, 28 seconds 719,417 views",Awash Entertainment,719417,719603,186
92,"Timnit Welday - Wenani ''ወናኒ''ኣብ ትግራይ ምልባማ ኮንሰርት ሓድሽ ዓመት by Awash Entertainment 2 years ago 7 minutes, 27 seconds 2,968 views",Awash Entertainment,2968,2972,4
93,"Muez G/ hiwot  Hber '' ሕበር''New Ethiopian Tigrigna Music 2019(Official Video) by Awash Entertainment 2 years ago 5 minutes, 16 seconds 33,613 views",Awash Entertainment,33613,33623,10
94,"AndSewuye (አንድ ሰውየ) New Ethiopian Tigrigna Music 2019(Official Video) by Awash Entertainment 2 years ago 5 minutes, 53 seconds 150,607 views",Awash Entertainment,150607,150683,76
95,"Zemen Alemseged Live @ዓይኒ ዋሪ ኣክሱም || Axum Ayni Wari CONCERT 2011 by Awash Entertainment 2 years ago 9 minutes, 2 seconds 60,657 views",Awash Entertainment,60657,60684,27
96,"Birtukuan Mebrahtu - Gere Live @ዓይኒ ዋሪ ኣክሱም || Axum Ayni Wari CONCERT 2011 by Awash Entertainment 2 years ago 14 minutes, 37 seconds 21,703 views",Awash Entertainment,21703,21709,6
97,"Mulugeta Kahsay - Asheweyna (አሸወይና) Live @ዓይኒ ዋሪ ኣክሱም || Axum Ayni Wari CONCERT 2011 by Awash Entertainment 2 years ago 14 minutes, 37 seconds 12,650 views",Awash Entertainment,12650,12658,8
98,"Birhanu Mache - Ayam Belu  Live @ዓይኒ ዋሪ ኣክሱም || Axum Ayni Wari CONCERT 2011 by Awash Entertainment 2 years ago 10 minutes, 5 seconds 25,654 views",Awash Entertainment,25654,25670,16
99,"Solomon Bayre - Merkeb | መርከብ Live @ዓይኒ ዋሪ ኣክሱም || Axum Ayni Wari CONCERT 2011 by Awash Entertainment 2 years ago 8 minutes, 58 seconds 39,935 views",Awash Entertainment,39935,39945,10
100,"Tiemtu Gebrehiwet - Kuhlo | ኩሕሎ Live @ዓይኒ ዋሪ ኣክሱም || Axum Ayni Wari CONCERT 2011 by Awash Entertainment 2 years ago 13 minutes, 4 seconds 11,868 views",Awash Entertainment,11868,11873,5
101,"Mekuanent Melesse Live @ዓይኒ ዋሪ ኣክሱም || Axum Ayni Wari CONCERT 2011 by Awash Entertainment 2 years ago 8 minutes, 27 seconds 542,774 views",Awash Entertainment,542774,543434,660
102,"Zafu Kiros - Ashenda ዓይኒ ዋሪ ኣክሱም || Axum Ayni Wari CONCERT 2011 by Awash Entertainment 2 years ago 13 minutes, 25 seconds 58,049 views",Awash Entertainment,58049,58095,46
103,"Tigrigna Poem by Awot Wedaje ዓይኒ ዋሪ ኣክሱም || Axum Ayni Wari CONCERT 2011 by Awash Entertainment 2 years ago 5 minutes, 29 seconds 30,557 views",Awash Entertainment,30557,30562,5
104,"Arena Tigray Press Release Nehase 23/2011 EC by Awash Entertainment 2 years ago 23 minutes 1,687 views",Awash Entertainment,1687,1696,9
105,"ABRHALEY AZENAW ''NBERELNA''(ንበረልና)New Ethiopian Tigrigna Music 2019(Official Video) by Awash Entertainment 2 years ago 4 minutes, 7 seconds 35,229 views",Awash Entertainment,35229,35236,7
106,"Kibrom Birhane - Ari (ዓሪ)  ASHENDA CONCERT 2011 by Awash Entertainment 2 years ago 13 minutes, 57 seconds 23,431 views",Awash Entertainment,23431,23443,12
107,"Tiemtu G/hiwet - Bikebero Tiri ASHENDA CONCERT 2011 by Awash Entertainment 2 years ago 11 minutes, 4 seconds 11,221 views",Awash Entertainment,11221,11224,3
108,"Elsa Weldejewergs - Hreseley ASHENDA CONCERT 2011 by Awash Entertainment 2 years ago 8 minutes, 30 seconds 578,574 views",Awash Entertainment,578574,579720,1146
109,"Tikue Woldu - Tigray Milibama  ASHENDA CONCERT 2011 by Awash Entertainment 2 years ago 6 minutes, 14 seconds 24,655 views",Awash Entertainment,24655,24659,4
110,"Birtukuan Mebrahtu - Awaldo | ኣዋልዶ / ASHENDA CONCERT 2011 by Awash Entertainment 2 years ago 10 minutes, 30 seconds 130,334 views",Awash Entertainment,130334,130409,75
111,"Sofia Atsbeha ''ASHENDA ABEBA'' (ኣሽንዳ ኣበባ) New Tigrigna Ashenda Music 2019(Official Video) by Awash Entertainment 2 years ago 6 minutes, 4 seconds 109,004 views",Awash Entertainment,109004,109045,41
112,"NARDOS ASAY ''AWALD TIGRAY'' (ኣዋልድ ትግራይ) New Tigrigna Ashenda Music 2019(Official Video) by Awash Entertainment 2 years ago 7 minutes, 53 seconds 709,123 views",Awash Entertainment,709123,710369,1246
113,"SAMUEL KIROS  ''SELASIWAY'' (ስላስዋይ) New Ethiopian Tigrigna Music 2019(Official Video) by Awash Entertainment 2 years ago 6 minutes, 38 seconds 396,964 views",Awash Entertainment,396964,399757,2793
114,"HAGOS HAYLAY ''WELIDATOM'' (ወሊዳቶም) New Ethiopian Tigrigna Music 2019(Official Video) by Awash Entertainment 2 years ago 6 minutes, 34 seconds 64,559 views",Awash Entertainment,64559,64572,13
115,"Kibrom Birhane - Ari (ዓሪ) Festival diaspora Tegaru 2019 Mekelle by Awash Entertainment 2 years ago 10 minutes, 40 seconds 4,201 views",Awash Entertainment,4201,4204,3
116,"Rahel Fiyorina - Fetweka | ፈትወካFestival diaspora Tegaru 2019  Mekelle by Awash Entertainment 2 years ago 5 minutes, 7 seconds 3,665 views",Awash Entertainment,3665,3667,2
117,"Eyerus Gebrezgi-bahlawi (ባህላዊ) music (2019) by Awash Entertainment 2 years ago 10 minutes, 4 seconds 185,540 views",Awash Entertainment,185540,185748,208
118,"TOMAS NUGUSE ''WEYN'' (ወይን) New Ethiopian Erob Music 2019(Official Video) by Awash Entertainment 2 years ago 4 minutes, 44 seconds 18,483 views",Awash Entertainment,18483,18509,26
119,"Selemon Gidena ''KELEMYE (ቀለምየ) New Ethiopian Tigrigna Music 2019(Official Video) by Awash Entertainment 2 years ago 5 minutes, 10 seconds 10,487 views",Awash Entertainment,10487,10492,5
120,"Atsede Kasa Ta''GAL ADEY AMLESU'' by Awash Entertainment 2 years ago 2 minutes, 37 seconds 5,928 views",Awash Entertainment,5928,5973,45
121,"""እቲ ንትግራይ መሰረት ገይሩ ክኸይድ ዝነበሮ ብሄራዊ ቃልሲ በቲ መሪሕነት ደው ኢሉ ስለዝተረፈ ንዕኡ ንምቅጻልን ንምምላስን ኢና ተላዒልና።"" by Awash Entertainment 2 years ago 19 minutes 4,008 views",Awash Entertainment,4008,4009,1
122,"Adey G/micheal ''GOBEZ ADI (ጎበዝ ዓዲ) New Ethiopian Tigrigna Music 2019(Official Video) by Awash Entertainment 2 years ago 5 minutes, 26 seconds 61,537 views",Awash Entertainment,61537,61637,100
123,"NIGUSS GIDEY (70 እንደርታ) New Ethiopian Tigrigna Music 2019(Official Video) by Awash Entertainment 2 years ago 5 minutes, 33 seconds 59,563 views",Awash Entertainment,59563,60005,442
124,"Teklay Eqbu (ነብሮም) New Ethiopian Tigrigna Music 2019 (Official Video) by Awash Entertainment 2 years ago 6 minutes, 41 seconds 63,557 views",Awash Entertainment,63557,63576,19
125,"'' ትግራይ ተዛረቢ ኣይተብዝሒ ሱቅታ'' by Awash Entertainment 2 years ago 10 minutes, 49 seconds 12,633 views",Awash Entertainment,12633,12635,2
126,"Tigrigna poem by Awot Wedaje SEB KALKIDAN(ሰብ ቃል-ኪዳን) ብጋዜጠኛ ዓወት ወዳጅ by Awash Entertainment 2 years ago 11 minutes, 19 seconds 56,812 views",Awash Entertainment,56812,56949,137
127,"Girmay Gebrehiwet -Tigray Adey (ትግራይ ዓደይ)New Ethiopian Tigrigna Music 2019 (Official Video) by Awash Entertainment 2 years ago 5 minutes, 55 seconds 36,552 views",Awash Entertainment,36552,36559,7
128,"Yonas Mokonen -swnwano (ስውንዋኖ)New Ethiopian Tigrigna Music 2019 (Official Video) by Awash Entertainment 2 years ago 5 minutes, 5 seconds 32,620 views",Awash Entertainment,32620,32636,16
129,"Solomon Bayre/Girmay /Asfaw/Timtu /Tedros /Rahwa(ሓደራ) New Tigrigna Music 2019(Official Video) by Awash Entertainment 2 years ago 7 minutes, 3 seconds 102,259 views",Awash Entertainment,102259,102268,9
130,"Tewelde Teklay Tigray (ትግራይ)New Ethiopian Tigrigna Music 2019 (Oqfficial Video) by Awash Entertainment 2 years ago 5 minutes, 54 seconds 9,248 views",Awash Entertainment,9248,9249,1
131,"Gebre kristos Welday  Tigray Ajoki (ትግራይ ኦጆኪ)New Ethiopian Tigrigna Music 2019 (Official Video) by Awash Entertainment 2 years ago 4 minutes, 55 seconds 34,656 views",Awash Entertainment,34656,34662,6
132,"DJ MC TOMMY ''ሰምበት ስናብቲ''New Ethiopian Tigrigna Music 2019(Official Video) by Awash Entertainment 2 years ago 5 minutes, 32 seconds 3,909 views",Awash Entertainment,3909,3910,1
133,"Tsegalul H/Mariam ft Kiros  Eti Mahder(እቲ ማህደር)New Ethiopian Tigrigna Music 2019(Official Video) by Awash Entertainment 2 years ago 8 minutes, 12 seconds 29,904 views",Awash Entertainment,29904,29911,7
134,"Mulat Gidey Esti Gemae Belu (እስቲ ገማዕ  በሉ ዳዓዲና) New Ethiopian Tigrigna Music 2019(Official Video) by Awash Entertainment 2 years ago 6 minutes, 1 second 172,813 views",Awash Entertainment,172813,173151,338
135,"Lij Solomon Weyzero Yeshi (ወይዘሮ የሺ) New EthiopianTigrigna Music 2019(Official Video) by Awash Entertainment 2 years ago 3 minutes, 50 seconds 75,108 views",Awash Entertainment,75108,75221,113
136,"Goytoum G/Medhin/gojo/ Ayam Bel(ያም በል)New Ethioian Traditional Tigrigna Music 2019 (Official Video) by Awash Entertainment 2 years ago 5 minutes, 5 seconds 39,703 views",Awash Entertainment,39703,39734,31
137,"Phillo Ethiopia (ኢትዮጵያ) New Ethiopian Music 2019(Official Video) by Awash Entertainment 2 years ago 4 minutes, 23 seconds 900 views",Awash Entertainment,900,901,1
138,"''የትግራይ ህዝብ ስልጡን ነው ዝም ብሎ አይነዳም'' የታሪክ ሙሁር እና ተመራማሪ መ/ር ገ/ኪዳን ደስታ (ክፍል-2 ) by Awash Entertainment 2 years ago 46 minutes 53,218 views",Awash Entertainment,53218,53436,218
139,"""ግንቦት 20 የከረፋው ታሪክ እንዳይመለስ ድባቅ የተመታበት ቀን ነው"" የታሪክ ሙሁር እና ተመራማሪ መ/ር ገ/ ኪዳን  ደስታ (ክፍል-1 ) by Awash Entertainment 2 years ago 32 minutes 41,279 views",Awash Entertainment,41279,41332,53
140,"''አሁን ያለው  የኢትዮጵያ ሁኔታ ያሳስበኛል''  ""የአሲምባ ፍቅር"" መፅሃፍ ፀሃፊ እና የኢህአፓ ነባር ታጋይ አቶ ካሕሳይ አብርሃ by Awash Entertainment 2 years ago 14 minutes, 34 seconds 5,351 views",Awash Entertainment,5351,5352,1
141,"""ህወሓትን ለመምታትም ሆነ ለመከላከል በቂ አቅም ነበረን"" ""የአሲምባ ፍቅር"" መፅሃፍ ፀሃፊ እና የኢህአፓ ነባር ታጋይ አቶ ካሕሳይ አብርሃ (ክፍል - 2) by Awash Entertainment 2 years ago 24 minutes 15,749 views",Awash Entertainment,15749,15756,7
142,"‘‘ኤርትራውያኖች የኢህአፓ ከተራ አባል እስከ አመራር ነበሩ’’ ""የአሲምባ ፍቅር"" መፅሃፍ ፀሃፊ እና የኢህአፓ ነባር ታጋይ አቶ ካሕሳይ አብርሃ (ክፍል-1) by Awash Entertainment 2 years ago 23 minutes 17,201 views",Awash Entertainment,17201,17207,6
143,"T-Ibex Ft, Mik- Mearg Mekelleway (መቐለዋይ) New Ethiopian Music 2019(Official Video) by Awash Entertainment 2 years ago 4 minutes, 27 seconds 34,297 views",Awash Entertainment,34297,34516,219
144,"መግለፂ ሳልሳይ ወያነ ትግራይ ጉንበት 2/2019 by Awash Entertainment 2 years ago 28 minutes 3,106 views",Awash Entertainment,3106,3108,2
145,"አዋሽ እለታዊ ዜና ሚያዝያ 25/2011 ዓ.ም by Awash Entertainment 2 years ago 4 minutes, 52 seconds 523 views",Awash Entertainment,523,532,9
146,"አዋሽ እለታዊ ዜና ሚያዝያ 24/2011 ዓ.ም by Awash Entertainment 2 years ago 5 minutes, 12 seconds 345 views",Awash Entertainment,345,346,1
147,"አዋሽ እለታዊ ዜና ሚያዝያ 23/2011 ዓ.ም by Awash Entertainment 2 years ago 4 minutes, 35 seconds 293 views",Awash Entertainment,293,294,1
148,"አዋሽ እለታዊ ዜና ሚያዝያ 22/2011 ዓ.ም by Awash Entertainment 2 years ago 4 minutes, 56 seconds 365 views",Awash Entertainment,365,367,2
149,"Tsgereda Demewoz Awdamet (ኣውዳኣመት)New Ethiopian Tigrigna Music 2019(Official Video) by Awash Entertainment 2 years ago 6 minutes, 7 seconds 27,651 views",Awash Entertainment,27651,27660,9
150,"አዋሽ እለታዊ ዜና ሚያዝያ 17/2011 ዓ.ም by Awash Entertainment 2 years ago 4 minutes, 48 seconds 208 views",Awash Entertainment,208,209,1
151,"አዋሽ እለታዊ ዜና ሚያዝያ 16/2011 ዓ.ም by Awash Entertainment 2 years ago 6 minutes, 2 seconds 242 views",Awash Entertainment,242,243,1
152,"አዋሽ እለታዊ ዜና ሚያዝያ 15/2011 ዓ.ም by Awash Entertainment 2 years ago 4 minutes, 53 seconds 162 views",Awash Entertainment,162,163,1
153,"አዋሽ እለታዊ ዜና ሚያዝያ 14/2011 ዓ.ም by Awash Entertainment 2 years ago 7 minutes, 10 seconds 210 views",Awash Entertainment,210,211,1
154,"አዋሽ እለታዊ ዜና ሚያዝያ 11/2011 ዓ.ም by Awash Entertainment 2 years ago 3 minutes, 44 seconds 337 views",Awash Entertainment,337,338,1
155,"Henok Tafere - Ydegem (ይደገም)New Ethiopian Tigrigna Music 2019 (Official Video) by Awash Entertainment 2 years ago 5 minutes, 1 second 16,424 views",Awash Entertainment,16424,16440,16
156,The TAND leadership member Mekonen Zelelew (part-3) by Awash Entertainment 2 years ago 36 minutes 780 views,Awash Entertainment,780,783,3
157,Abraha Desta interview with Awash Media Network by Awash Entertainment 2 years ago 20 minutes 557 views,Awash Entertainment,557,563,6
158,"Alay Selomon Teadile(ተዓዲለ) New Ethiopian Tigrigna Music 2019 (Official Video) by Awash Entertainment 2 years ago 5 minutes, 34 seconds 54,199 views",Awash Entertainment,54199,54285,86
159,Abraha Desta interview with Awash Media Network (part -2) by Awash Entertainment 2 years ago 24 minutes 935 views,Awash Entertainment,935,940,5
160,"Abraha Desta interview with Awash Media Network (part -1) by Awash Entertainment 2 years ago 29 minutes 4,118 views",Awash Entertainment,4118,4213,95
161,"''በለውጡ ስም የህዝብ ጠላቶች ተቀላቅለው ገብተዋል’’ አቶ መኮነን ዘለለው #Mekonen Zelelew on Current Affairs by Awash Entertainment 2 years ago 23 minutes 2,015 views",Awash Entertainment,2015,2019,4
162,"አዋሽ እለታዊ ዜና ሚያዝያ 5/2011 ዓ.ም by Awash Entertainment 2 years ago 4 minutes, 6 seconds 196 views",Awash Entertainment,196,197,1
163,"John Tadesse Lebem Tigraway (ለብም ትግራዋይ) New Ethiopian Music 2019 (Official Video) by Awash Entertainment 2 years ago 5 minutes, 45 seconds 20,077 views",Awash Entertainment,20077,20085,8
164,"አዋሽ እለታዊ ዜና ሚያዝያ 4/2011 ዓ.ም by Awash Entertainment 2 years ago 4 minutes, 46 seconds 327 views",Awash Entertainment,327,328,1
165,"አዋሽ እለታዊ ዜና ሚያዝያ 3/2011 ዓ.ም by Awash Entertainment 2 years ago 3 minutes, 47 seconds 253 views",Awash Entertainment,253,255,2
166,"""ገብረመድህን አርአይ ኢሳት ላይ የማያውቀውን ነው የዘባረቀው""አቶ መኮነን ዘለለው #Mekonen Zelelew on Current Affairs and ESAT by Awash Entertainment 2 years ago 34 minutes 11,768 views",Awash Entertainment,11768,11772,4
167,አዋሽ እለታዊ ዜና ሚያዝያ 2/2011 ዓ.ም by Awash Entertainment 2 years ago 4 minutes 405 views,Awash Entertainment,405,407,2
168,"አዋሽ እለታዊ ዜና ሚያዝያ  1/2011 ዓ.ም by Awash Entertainment 2 years ago 4 minutes, 20 seconds 591 views",Awash Entertainment,591,592,1
169,"አዋሽ እለታዊ ዜና መጋቢት 30/2011 ዓ.ም by Awash Entertainment 2 years ago 8 minutes, 14 seconds 988 views",Awash Entertainment,988,989,1
170,"አዋሽ እለታዊ ዜና መጋቢት 28/2011 ዓ.ም by Awash Entertainment 2 years ago 5 minutes, 47 seconds 370 views",Awash Entertainment,370,371,1
171,"አዋሽ  እለታዊ  ዜና መጋቢት 27/2011 ዓ.ም by Awash Entertainment 2 years ago 3 minutes, 45 seconds 225 views",Awash Entertainment,225,226,1
172,"አዋሽ ዜና by Awash Entertainment 2 years ago 3 minutes, 59 seconds 553 views",Awash Entertainment,553,554,1
173,"አዋሽ ዜና by Awash Entertainment 2 years ago 6 minutes, 7 seconds 602 views",Awash Entertainment,602,603,1
174,""" ዶ/ር ኣምባቸው ከዶ/ር ደብረዕዮን ጋር ለመደራደር የመሪነት ሱሪ መታጠቅ ኣለበት"" ክፍል 2 by Awash Entertainment 2 years ago 29 minutes 60,677 views",Awash Entertainment,60677,60682,5
175,"አዋሽ ዜና by Awash Entertainment 2 years ago 9 minutes, 47 seconds 349 views",Awash Entertainment,349,350,1
176,"'' የ ዶ/ር አብይ አህመድ የአንድ አመት ቆይታ  በዳንኤል ብርሃነ እይታ'' ክፍል 1 by Awash Entertainment 2 years ago 30 minutes 54,169 views",Awash Entertainment,54169,54172,3
177,"''ስለድጅታል ወያነ ኣልገባቸውም ፤ መጨነቅ ካለባቸውም መጨነቅ ኣለባቸው'' ጀነራል ዶ/ር ተክለብርሃን ወልደኣረጋይ (ክፍል - 2) by Awash Entertainment 2 years ago 22 minutes 26,566 views",Awash Entertainment,26566,26570,4
178,"""የወያኔ እንቅስቃሴ በመረጃ  የተደገፈ መሆን አለበት"" ጀነራል ዶ/ር ተክለብርሃን ወልደ ኣረጋይ (ክፍል - 1) by Awash Entertainment 2 years ago 15 minutes 12,766 views",Awash Entertainment,12766,12768,2
179,"ከጀነራል ዶ/ር ተክለብርሃን ወልደአረጋይ በአዲሱ""ሞገድ አስጋሪው(00)""የተሰኘ መፅሓፍእና ወቅታዊ ጉዳዮች ከአዋሽ ሚድያ ጋር ያደረጉት ቃለምልልስ ማታ ይጠብቁን by Awash Entertainment 2 years ago 2 minutes, 4 seconds 1,787 views",Awash Entertainment,1787,1788,1
180,"''በ ኣንድ ማህበር ዉስጥ ኣንድ ህገ ወጥ ሰው ቢገኝ ማህበሩ ይፈርሳል'' የትግራይ ክልል ፍትህ ቢሮ ሃላፊ አቶ አማኑኤል አስፋ by Awash Entertainment 2 years ago 25 minutes 1,456 views",Awash Entertainment,1456,1460,4
181,"""ራእይ ኣቦ አለዋ'' ጋዜጠኛ አቤል ግዑሽ by Awash Entertainment 2 years ago 10 minutes, 12 seconds 713 views",Awash Entertainment,713,714,1
182,"""አብ ክልል ትግራይ ዝተአከበ ግብሪ ናብ ፌደራል አታዊ አይግበርን""በዓል መዚ ልምዓትን እቶትን ቤት ፅሕፈት ክልል ትግራይ  ዋና ዳይሬክተር ወ/ሮ አሰፉ ሊላይ by Awash Entertainment 2 years ago 5 minutes, 49 seconds 4,155 views",Awash Entertainment,4155,4156,1
183,"""ዛሬ ለምረቃ የበቃችሁት በ ክልላችን የተረጋጋ ሰላም ማስጠበቅ ስለተቻለ ነው"" ዶክተር ደብረፅዮን ገ/ሚካኤል by Awash Entertainment 2 years ago 8 minutes, 27 seconds 586 views",Awash Entertainment,586,587,1
184,"Dagem Asrat Wey Gize (ወይ ጊዜ) New Ethiopian music 2019(Official Video) by Awash Entertainment 2 years ago 4 minutes, 53 seconds 4,368 views",Awash Entertainment,4368,4375,7
185,"""ናይ 60ታት ትውልዲ ንዓና ጎዲኡና እዩ"" ውድብ ዓረና ትግራይ ምስ ነበርቲ ከተማ መቐለ ዝነበር ዘተ by Awash Entertainment 3 years ago 24 minutes 3,436 views",Awash Entertainment,3436,3437,1
186,"""የአሁኑ ኢሀዴግ ለሃገር አስጊ ነው ጨለማ እንጂ ተስፋ አይታይበትም "" አቶ ጎይቶኦም በርሀ by Awash Entertainment 3 years ago 17 minutes 1,545 views",Awash Entertainment,1545,1546,1
187,"""ወያኔ እስካለ ከመርፌ እስከ መድፍ እናግዛቹሃለን ተብለን ነበር""አቶ ጎይቶኦም በርሀ by Awash Entertainment 3 years ago 17 minutes 19,256 views",Awash Entertainment,19256,19261,5
188,"""ማንም የሚከበን  እና ሊያሸንፈን የሚችል ሃይል የለም"" የቀድሞ የትግራይ ክልል ፕሬዝደንት የነበሩት ገብሩ አስራት by Awash Entertainment 3 years ago 11 minutes, 22 seconds 78,814 views",Awash Entertainment,78814,78841,27
189,"""ብዙ ብንቆሳሰልም በውስጣችን ግን የጋራ ታሪክ አለን"" ስየ አብርሃ by Awash Entertainment 3 years ago 9 minutes, 37 seconds 93,352 views",Awash Entertainment,93352,93375,23
190,"Mulu Abrha  Hzbi hayal (ህዝቢ ሓያል) New Ethiopian Tigrigna Music 2019(Official Video) by Awash Entertainment 3 years ago 5 minutes, 11 seconds 39,552 views",Awash Entertainment,39552,39555,3
191,"የሕወሓት 44ኛ የምስረታ በአል በማስመልከት የሚካሄድ ስፖርታዊ ጨዋታዎች ዙርያ ላይ የተሰጠ መግለጫ by Awash Entertainment 3 years ago 3 minutes, 18 seconds 673 views",Awash Entertainment,673,674,1
192,"Aynalem Hadush Hiwot (ሂወት) New Ethiopian  Tigrigna  Music 2019(Official Video) by Awash Entertainment 3 years ago 6 minutes, 18 seconds 106,909 views",Awash Entertainment,106909,106976,67
193,"""የትግራይ ክልል ምክር ቤት የወሰነው ውሳኔ ህገመንግስታዊ እና ወቅታዊ ውሳኔ ነው""ዳኛ ዘርአይ ወ/ሰንበት by Awash Entertainment 3 years ago 27 minutes 26,068 views",Awash Entertainment,26068,26070,2
194,"የትግራይ ሰብ ሕድሪ ማህበር የራስ አሉላ አባነጋ 122ኛው ዝክረ ሙት ዓመትን ለማሰብ ወደ መቃብር ስፍራው የእግር ጉዞ እንደሚደረግ ተገለፀ by Awash Entertainment 3 years ago 16 minutes 12,911 views",Awash Entertainment,12911,12914,3
195,"""የክልሎች ሉአላዊነት በጠቅላይ ሚኒስትሩ ሲሸረሸር እያየን ኢሀአዴግ አለ ብዬ አላምንም"" መ/ር መሓሪ ዮሃንስ (ክፍል -2) by Awash Entertainment 3 years ago 19 minutes 54,063 views",Awash Entertainment,54063,54068,5
196,"""እርቁ እውን የሚሆነው በአማራ ክልል ያሉ ሽፍቶች ለማስቆም የአማራ ክልል መንግስት ማረጋገጫ ሲሰጥ ነው"" መ/ር መሓሪ ዮሃንስ by Awash Entertainment 3 years ago 27 minutes 103,925 views",Awash Entertainment,103925,103943,18
197,"Tesfaalem Tefera Ruhus Gama (ሩሑስ ጋማ) New Ethioian  Music 2019 (Official Video) by Awash Entertainment 3 years ago 15 minutes 2,711 views",Awash Entertainment,2711,2712,1
198,"የትግራይ ክልል ምክር ቤት ከጥር 14  19 2011 የሚካሄደው ጉባኤ መግለጫ by Awash Entertainment 3 years ago 11 minutes, 47 seconds 1,443 views",Awash Entertainment,1443,1443,0
199,"Goytom Gebrye Tegaru (ተጋሩ) New Ethiopian Tigrigna  Music 2019(Official Video) by Awash Entertainment 3 years ago 5 minutes, 33 seconds 131,957 views",Awash Entertainment,131957,132060,103
200,"Tsigabu Teshale  Shambel (ሻምበል) New Ethiopian Music 2019 (Official Video) by Awash Entertainment 3 years ago 7 minutes, 30 seconds 1,978,391 views",Awash Entertainment,1978391,1990792,12401
201,"Fisaha  Alemseged Wedi Tigray(ወዲ ትግራይ)New Ethiopian Tigrigna Raya Music(Official Video) by Awash Entertainment 3 years ago 5 minutes, 49 seconds 290,831 views",Awash Entertainment,290831,292542,1711
202,"Seyfe Hailu  Ayndenn (አይንደንን) New Ethiopian Tigrigna Music 2018(Official Video) by Awash Entertainment 3 years ago 4 minutes, 30 seconds 36,949 views",Awash Entertainment,36949,36950,1
203,"የህዝብ ስሜት የተንፀባረቀበት መዝሙርዘይንድይቦ ጎቦ ዘይንሰግሮ ሩባ by Awash Entertainment 3 years ago 3 minutes, 43 seconds 1,978 views",Awash Entertainment,1978,1979,1
204,"Dawit H/Micael(Bawra) Ashoyamano (አሾያማኖ)  New Ethiopian Kunama Music 2018(Official Video) by Awash Entertainment 3 years ago 5 minutes, 21 seconds 4,373 views",Awash Entertainment,4373,4406,33
205,"Ashenafi  Amare  Tgraway (ትግራዋይ) New Ethiopian Tigrigna Music 2018(Official Video) by Awash Entertainment 3 years ago 6 minutes, 18 seconds 101,345 views",Awash Entertainment,101345,101361,16
206,"Abenezer Assefa/Ab/አና ሲወያ)ANAA  SI WAYYAA by Awash Entertainment 3 years ago 4 minutes, 36 seconds 1,800 views",Awash Entertainment,1800,1807,7
207,"መርከብ_ቦኒቷ_ኣግርጭው_ሰላም_ኮንሰርት_መቐለ by Awash Entertainment 3 years ago 13 minutes, 42 seconds 1,505 views",Awash Entertainment,1505,1506,1
208,"ሄለን_መለስ - ሻመይ -ኣብ_ ከተማ_መቐለ_ኮንሰርት_ሰላም by Awash Entertainment 3 years ago 4 minutes, 9 seconds 767 views",Awash Entertainment,767,768,1
209,"Kahsay_Berhe_and_Nahom_Yohannes_[Meste] by Awash Entertainment 3 years ago 23 minutes 1,201 views",Awash Entertainment,1201,1204,3
210,"ናሆም ዮሃንስ (መስተ) - ጉያ ጉያ - ኣብ ሰላም ኮንሰርት መቐለ by Awash Entertainment 3 years ago 6 minutes, 59 seconds 8,018 views",Awash Entertainment,8018,8047,29
211,"Tesfamichael_Gidey_Institutionalisation_Study_Paper_SEBHIDRI_WAELA_PART_TWO by Awash Entertainment 3 years ago 27 minutes 1,574 views",Awash Entertainment,1574,1575,1
212,Tesfamichael_Gidey_Institutionalisation_Study_Paper_SEBHIDRI_WAELA_PART_ONE by Awash Entertainment 3 years ago 28 minutes 579 views,Awash Entertainment,579,580,1
213,"Mahari_Yohans_tigray_on_critical_juncture_SEBHIDRI_WAELA_PART_THREE by Awash Entertainment 3 years ago 30 minutes 5,173 views",Awash Entertainment,5173,5174,1
214,"Mahari_Yohans_tigray_on_critical_juncture_SEBHIDRI_WAELA_PART_TWO by Awash Entertainment 3 years ago 28 minutes 5,602 views",Awash Entertainment,5602,5604,2
215,"Mahari_Yohans_tigray_on_critical_juncture_SEBHIDRI_WAELA_PART_ONE by Awash Entertainment 3 years ago 27 minutes 7,562 views",Awash Entertainment,7562,7563,1
216,"MEMHIR_MEKONEN_SEBHIDRI_WAELA_ROLE_OF_CIVIC_ASSOCIATION_ON_DEMOCRATIZATION_PART_TWO by Awash Entertainment 3 years ago 24 minutes 1,270 views",Awash Entertainment,1270,1270,0
217,MEMHIR_MEKONEN_SEBHIDRI_WAELA_ROLE_OF_CIVIC_ASSOCIATION_ON_DEMOCRATIZATION_PART_ONE by Awash Entertainment 3 years ago 29 minutes 741 views,Awash Entertainment,741,742,1
218,"DR_GOITOM_LEELINETHIGI_SEBHIDRI_PART_TWO by Awash Entertainment 3 years ago 24 minutes 5,431 views",Awash Entertainment,5431,5432,1
219,"DR_GOITOM_LEELINETHIGI_SEBHIDRI_PART_ONE by Awash Entertainment 3 years ago 31 minutes 1,319 views",Awash Entertainment,1319,1320,1
220,"SEBHIDRI_HAFESHAWI_WAELA_PART_ONE_3 by Awash Entertainment 3 years ago 26 minutes 1,479 views",Awash Entertainment,1479,1480,1
221,"SEBHIDRI_HAFESHAWI_WAELA_PART_ONE_2 by Awash Entertainment 3 years ago 21 minutes 1,720 views",Awash Entertainment,1720,1721,1
222,"SEBHIDRI_HAFESHAWI_WAELA_PART_ONE by Awash Entertainment 3 years ago 28 minutes 6,488 views",Awash Entertainment,6488,6492,4
223,"SEB_HDRI_CIVIC_SOCIETY_DISCUSSION_HIGHLIGHTS by Awash Entertainment 3 years ago 6 minutes, 25 seconds 10,487 views",Awash Entertainment,10487,10489,2
224,"ዮሃና- Awet Birhane (Yohana) New Ethiopian Music 2018 by Awash Entertainment 3 years ago 5 minutes, 20 seconds 2,308 views",Awash Entertainment,2308,2325,17
225,"""አውደ አመት እንደ አቅሜ"" Dagmawi W/Mariam (Dagi Rege) Awdeamet Endeakme  New Video Clip 2018 by Awash Entertainment 3 years ago 6 minutes, 6 seconds 2,241 views",Awash Entertainment,2241,2242,1
226,"ዶ/ር ደብረፅዮን የአሸንዳ መዝጊያ ዝግጅት ላይ የተናገሩት D/r Debretsion by Awash Entertainment 3 years ago 10 minutes, 35 seconds 5,104 views",Awash Entertainment,5104,5104,0
227,"ፅጋቡ ተሻለ Tsigabu Teshale by Awash Entertainment 3 years ago 8 minutes, 51 seconds 6,810 views",Awash Entertainment,6810,6828,18
228,"ፍቅሪ Kahsay Berhe & Solomon Bayre (FIKRI) by Awash Entertainment 3 years ago 7 minutes, 58 seconds 1,036,640 views",Awash Entertainment,1036640,1038137,1497
229,የአመቱ የበጎ ሰዎች ሽልማት እጩዎች ታወቁ by Awash Entertainment 3 years ago 42 minutes 160 views,Awash Entertainment,160,163,3
230,'' ለቡሄ ያበደ ሆ ሲል ይኖራል '' የመምህር እጸገነት አስቂኝ ወግ by Awash Entertainment 3 years ago 16 minutes 642 views,Awash Entertainment,642,643,1
231,"የሁለት ዘመን ሁለት  . . . . . . by Awash Entertainment 3 years ago 6 minutes, 8 seconds 535 views",Awash Entertainment,535,536,1
232,"ይህ ግጥም ፖለቲካ አይደለም . . . . . by Awash Entertainment 3 years ago 8 minutes, 50 seconds 298 views",Awash Entertainment,298,300,2
233,"የኢንጂነር ስመኘው በቀለ የቀብር ስነ ስርአት engineer Simegnew Bekele by Awash Entertainment 3 years ago 7 minutes, 7 seconds 28,525 views",Awash Entertainment,28525,28536,11
234,"""አብይ ዘመን"" Abiy Zemen by Awash Entertainment 3 years ago 13 minutes, 2 seconds 203 views",Awash Entertainment,203,203,0
235,ፕሬዝዳንት ኢሳያስ አፎርቂ አዲስ አበባ ሲገቡ የተደረገላቸው ደማቅ አቀባበል እና የተለያዩ ጭፈራዎች by Awash Entertainment 3 years ago 19 minutes 252 views,Awash Entertainment,252,253,1
236,"""ገምጋሚው"" ተወዳጅዋ አርቲስት ሐረገወይን አሰፋ  7ኛው ሰም እና ወርቅ የኪነ-ጥበብ ምሽት ላይ እንደተረከችው። by Awash Entertainment 3 years ago 22 minutes 1,659 views",Awash Entertainment,1659,1697,38
237,"""አብይ ዘመን"" እንዲህም ይቀለዳል by Awash Entertainment 3 years ago 14 minutes, 35 seconds 571 views",Awash Entertainment,571,572,1
238,ግጥም በጠበንጃ by Awash Entertainment 3 years ago 23 minutes 821 views,Awash Entertainment,821,823,2
239,"ጠ/ሚ ዶክተር አብይ አሕመድ ከአፋር ህዝብ ለቀረበላቸው ጥያቄ  የሰጡት አስገራሚ ምላሽ by Awash Entertainment 3 years ago 7 minutes, 19 seconds 737 views",Awash Entertainment,737,738,1
240,"ፍቅረኛሽ የእንደሚያፈቅርሽ ምታውቂበት ወሳኝ መንገድ by Awash Entertainment 3 years ago 4 minutes, 21 seconds 35,072 views",Awash Entertainment,35072,35074,2
241,"የቦንብ ፍንዳታን ያስተናገደው የምስጋናና የድጋፍ ሰልፍ። by Awash Entertainment 3 years ago 5 minutes, 11 seconds 1,433 views",Awash Entertainment,1433,1435,2
242,"Tigray Governance Forum(3) by Awash Entertainment 3 years ago 35 minutes 20,429 views",Awash Entertainment,20429,20444,15
243,"Tigray Governance Forum(2) by Awash Entertainment 3 years ago 37 minutes 26,166 views",Awash Entertainment,26166,26187,21
244,"Tigray Governance Forum(4) by Awash Entertainment 3 years ago 32 minutes 19,767 views",Awash Entertainment,19767,19780,13
245,"Tigray Governance Forum(1) by Awash Entertainment 3 years ago 21 minutes 22,302 views",Awash Entertainment,22302,22322,20
246,"Awash - Interview with Ekubay Berhe on Tigrai Governance Forum 2018 by Awash Entertainment 3 years ago 12 minutes, 14 seconds 4,456 views",Awash Entertainment,4456,4457,1
247,"Awash - Interview with Seyfu Hailu on Tigrai Governance Forum 2018 by Awash Entertainment 3 years ago 10 minutes, 48 seconds 1,901 views",Awash Entertainment,1901,1903,2
248,"Awash -  a dicussion between Getcahcew Reda and Abraha Desta  on  (TGF_2018) by Awash Entertainment 3 years ago 57 minutes 12,262 views",Awash Entertainment,12262,12307,45
249,"Tigray Governance Forum by Awash Entertainment 3 years ago 36 minutes 12,133 views",Awash Entertainment,12133,12137,4
250,"Awash - Interview with D.r Goytom Aregawi on Tigrai Governance Forum 2018 by Awash Entertainment 3 years ago 5 minutes, 36 seconds 4,380 views",Awash Entertainment,4380,4385,5
251,"Awash - Interview with Abraha Desta of Arena Tigray on Tigrai Governance Forum 2018 by Awash Entertainment 3 years ago 3 minutes, 34 seconds 22,161 views",Awash Entertainment,22161,22172,11
252,የዒድ አልፈጥር በአል አከባበር በአዲስ አበባ Eid Mubarek by Awash Entertainment 3 years ago 4 minutes 967 views,Awash Entertainment,967,968,1
253,"በቂ እንቅልፍ በማግኘት የሚገኙ ወሳኝ የጤና ጥቅሞች (Hellen Sleshi) by Awash Entertainment 3 years ago 3 minutes, 13 seconds 640 views",Awash Entertainment,640,642,2
254,"የኢሮብ ከተማ ነዋሪዎች ኢትዮጵያውያን ነን አትገንጥሉን በማለት ኢህዴግ ተቀብየዋለው ያለውን የአልጀርሱ ስምምነት ተቃውምው ሰላማዊ ሰልፍ ወጡ። by Awash Entertainment 3 years ago 2 minutes, 40 seconds 685 views",Awash Entertainment,685,685,0
255,"የቀለም ምርጫዎ ከባህሪዎ ጋር ያለውን ትስስር : : (Helen Sileshi) by Awash Entertainment 3 years ago 4 minutes, 29 seconds 637 views",Awash Entertainment,637,638,1
256,"9ኝ የካሮት ወሳኝ የጤና ጥቅሞች (Helen Sleshi) by Awash Entertainment 3 years ago 2 minutes, 12 seconds 373 views",Awash Entertainment,373,374,1
257,Forum for democracy and good governance by Awash Entertainment 3 years ago 28 minutes 237 views,Awash Entertainment,237,238,1
258,"🇪🇹 - 🇪🇷 - Desalegn Hailu Speaking on Peace song for Ethio-Eritrea event -2018 by Awash Entertainment 3 years ago 15 minutes 63,431 views",Awash Entertainment,63431,63437,6
259,"🇪🇹 - 🇪🇷 -Yonas Abreham - Speech on Peace song for Ethio-Eritrea Event - Harmony Hotel 2018 by Awash Entertainment 3 years ago 4 minutes, 18 seconds 23,694 views",Awash Entertainment,23694,23699,5
260,"🇪🇹 - 🇪🇷 - Prof. Gebru Tarekegn Speaking on Peace song for Ethio-Eritrea event -2018 by Awash Entertainment 3 years ago 8 minutes, 49 seconds 19,604 views",Awash Entertainment,19604,19606,2
261,"🇪🇹 - 🇪🇷 - Yemane Kidane (Jamaica) Speaking on Peace song for Ethio-Eritrea event -2018 by Awash Entertainment 3 years ago 1 minute, 44 seconds 28,832 views",Awash Entertainment,28832,28853,21
262,"🇪🇹 - 🇪🇷 - Hewan Gebrewold(Jano) Speaking on Peace song for Ethio-Eritrea event -2018 by Awash Entertainment 3 years ago 1 minute, 19 seconds 12,513 views",Awash Entertainment,12513,12530,17
263,"🇪🇹 - 🇪🇷 - Artist Daniel Tegegn Speaking on Peace song for Ethio-Eritrea event -2018 by Awash Entertainment 3 years ago 5 minutes, 53 seconds 12,843 views",Awash Entertainment,12843,12858,15
264,"🇪🇹 - 🇪🇷 - Bereket Abreham -  Speech on Peace song for Ethio-Eritrea Event - Harmony Hotel 2018 by Awash Entertainment 3 years ago 7 minutes, 35 seconds 11,855 views",Awash Entertainment,11855,11856,1
265,"🇪🇹 - 🇪🇷 - Peace song for Ethio-Eritrea - Celebrity Events - Addis Ababa 2018 by Awash Entertainment 3 years ago 19 minutes 151,551 views",Awash Entertainment,151551,151623,72
266,"በፍቅር ግንኙነታችን የግጭት መንሲኤዎች  ናቸው ተብለው የሚነገርላቸው 4 ወሳኝ የግንኙነታችን ጠንቆች by Awash Entertainment 3 years ago 5 minutes, 5 seconds 833 views",Awash Entertainment,833,834,1
267,"Water by Awash Entertainment 3 years ago 4 minutes, 4 seconds 210 views",Awash Entertainment,210,211,1
268,"Patriots day celebration in Addis Abeba Ethiopia የአርበኞች ቀን አከባበር በአዲስ አበባ by Awash Entertainment 3 years ago 5 minutes 2,747 views",Awash Entertainment,2747,2750,3
269,"Awtar Tv -  Endale Admike | እንዳለ አድምቄ  -  Petros | ጴጥሮስ -  New Ethiopian Music Video 2022 by Awtar TV 1 day ago 6 minutes, 1 second 5,910 views",Awtar TV,5910,10174,4264
270,"Awtar Tv -  Tigist Takele | ትዕግስት ታከለ  -  Yante Yaleh | ያንተ ያለህ -  New Ethiopian Music Video 2022 by Awtar TV 2 days ago 4 minutes, 44 seconds 4,107 views",Awtar TV,4107,5898,1791
271,"Awtar Tv -  Lelaalem Manaye | ሌላዓለም ማናዬ  -  Hager Hager | ሀገር ሀገር -  New Ethiopian Music Video 2022 by Awtar TV 3 days ago 6 minutes, 47 seconds 4,256 views",Awtar TV,4256,5892,1636
272,"Awtar Tv -  Linda Adera | ሊንዳ አደራ  - Sabew | ሳበው -  New Ethiopian Music Video 2022 by Awtar TV 3 days ago 3 minutes, 32 seconds 4,127 views",Awtar TV,4127,5781,1654
273,"Awtar Tv -  Abel Kifle | አቤል ክፍሌ (stella) - Nafkotish | ናፍቆትሽ -  New Ethiopian Music Video 2022 by Awtar TV 4 days ago 4 minutes, 44 seconds 14,203 views",Awtar TV,14203,31474,17271
274,"AwtarTv -  Getachew, Fikreaddis, Addis , Fitsum, Mustefa, Africa Lali , Desalegn - Yibekal Le Africa by Awtar TV 6 days ago 5 minutes, 41 seconds 14,336 views",Awtar TV,14336,16369,2033
275,"Awtar Tv -  Abinet, Asge, Bisrat , Hibist & Chala - YeAbay Zemen Sew -  New Ethiopian Music 2022 by Awtar TV 6 days ago 6 minutes, 42 seconds 35,809 views",Awtar TV,35809,48236,12427
276,"Awtar Tv -  Nina Girma | ኒና ግርማ - Awaj  | አዋጅ -  New Ethiopian Music  2022 by Awtar TV 13 days ago 3 minutes, 28 seconds 66,908 views",Awtar TV,66908,84955,18047
277,"Awtar Tv -  Nina Girma | ኒና ግርማ - Hilm Elim | ህልም እልም -  New Ethiopian Music 2022 by Awtar TV 13 days ago 3 minutes, 46 seconds 49,477 views",Awtar TV,49477,65297,15820
278,"Awtar Tv -  Nina Girma | ኒና ግርማ - Simetir | ስመ ጥር -  New Ethiopian Music 2022 by Awtar TV 13 days ago 4 minutes, 26 seconds 45,370 views",Awtar TV,45370,60344,14974
279,"Awtar Tv -  Nina Girma | ኒና ግርማ - Yaselale  | ያሰላሌ-  New Ethiopian Music 2022 by Awtar TV 13 days ago 3 minutes, 32 seconds 24,708 views",Awtar TV,24708,32304,7596
280,"Awtar Tv -  Nina Girma | ኒና ግርማ - Majete | ማጀቴ -  New Ethiopian Music 2022 by Awtar TV 13 days ago 3 minutes, 37 seconds 75,900 views",Awtar TV,75900,93446,17546
281,"Awtar Tv -  Nina Girma | ኒና ግርማ - Mogno | ሞኞ -  New Ethiopian Music 2022 by Awtar TV 13 days ago 3 minutes, 15 seconds 38,700 views",Awtar TV,38700,49571,10871
282,"Awtar Tv -  Nina Girma | ኒና ግርማ - Selame | ሰላሜ -  New Ethiopian Music 2022 by Awtar TV 13 days ago 3 minutes, 21 seconds 52,101 views",Awtar TV,52101,70783,18682
283,"Awtar Tv -  Nina Girma | ኒና ግርማ - Tegabezu | ተጋበዙ -  New Ethiopian Music 2022 by Awtar TV 13 days ago 4 minutes, 5 seconds 42,467 views",Awtar TV,42467,52999,10532
284,"Awtar Tv -  Nina Girma | ኒና ግርማ - Yekenfera Kelem  | የከንፈሬ ቀለም -  New Ethiopian Music 2022 by Awtar TV 13 days ago 4 minutes, 53 seconds 76,639 views",Awtar TV,76639,98346,21707
285,"Awtar Tv -  Nina Girma | ኒና ግርማ - Misoso | ምሶሶ -  New Ethiopian Music 2022 by Awtar TV 13 days ago 3 minutes, 35 seconds 24,151 views",Awtar TV,24151,31330,7179
286,"Awtar Tv -  Nina Girma | ኒና ግርማ - Muziqa | ሙዚቃ -  New Ethiopian Music 2022 by Awtar TV 13 days ago 3 minutes, 3 seconds 26,219 views",Awtar TV,26219,34073,7854
287,"Awtar Tv -  Nina Girma | ኒና ግርማ - Yelibe chilot |  የልቤ ችሎት -  New Ethiopian Music 2022 by Awtar TV 13 days ago 3 minutes, 55 seconds 25,353 views",Awtar TV,25353,31871,6518
288,"Awtar Tv -  Nina Girma | ኒና ግርማ - Yesikete mama |  የስኬቴን ማማ -  New Ethiopian Music 2022 by Awtar TV 13 days ago 3 minutes, 48 seconds 24,244 views",Awtar TV,24244,30911,6667
289,"Awtar Tv -  Nina Girma | ኒና ግርማ - Ethiopian -  New Ethiopian Music 2022 by Awtar TV 13 days ago 2 minutes, 53 seconds 23,820 views",Awtar TV,23820,29948,6128
290,"Awtar Tv -  Nina Girma | ኒና ግርማ - Yaselale  | ያሰላሌ-  New Ethiopian Music Video 2022 by Awtar TV 2 weeks ago 3 minutes, 57 seconds 584,343 views",Awtar TV,584343,814228,229885
291,"Awtar Tv -  Misikir_Yitbarek | ምስክር ይትባረክ - Sitotaye | ስጦታዬ-  New Ethiopian Music Video 2022 by Awtar TV 2 weeks ago 6 minutes, 37 seconds 11,959 views",Awtar TV,11959,13283,1324
292,"Awtar Tv -  Birhanu Maleko | ብርሃኑ ማለቆ - Anchi Nesh Selame | አንቺ ነሽ ሰላሜ -  New Ethiopian Music 2022 by Awtar TV 2 weeks ago 4 minutes, 37 seconds 5,660 views",Awtar TV,5660,5911,251
293,"Awtar Tv -  Dj Lee ft Menen Alen | ዲጄ ሊ ft. መነን አለን - Wogene | ወገኔ -  New Ethiopian Music Video 2022 by Awtar TV 2 weeks ago 5 minutes, 4 seconds 32,724 views",Awtar TV,32724,58685,25961
294,"Awtar Tv -  Rahel Alemu | ራሔል አለሙ - Lela Lela | ሌላ ሌላ -  New Ethiopian Music Video 2022 by Awtar TV 2 weeks ago 4 minutes, 15 seconds 13,149 views",Awtar TV,13149,13715,566
295,"Awtar Tv -Tigist Lulesegd | ትዕግስት ልዑልሰገድ (ዶ/ር) - Aygermishm wey | አይገርምሽም ወይ -  Ethiopian Music by Awtar TV 2 weeks ago 6 minutes, 6 seconds 22,513 views",Awtar TV,22513,23659,1146
296,"Awtar Tv -  Etsubdink Hailu | እፁብድንቅ ሀይሉ - Be Melkih Mamar  | በመልክህ ማማር -  Ethiopia Music video 2022 by Awtar TV 3 weeks ago 4 minutes, 43 seconds 5,469 views",Awtar TV,5469,5625,156
297,"Awtar Tv -  Mihret Hailu | ምህረት በኃይሉ -  Bel Ghion  | በል ግዮን -  New Ethiopian Music video 2022 by Awtar TV 3 weeks ago 4 minutes, 41 seconds 4,819 views",Awtar TV,4819,4953,134
298,"Awtar Tv -  Jada King | ጃዳ ኪንግ -  Ye Ethiopia Wetat  | የኢትዮጵያ ወጣት -  New Ethiopian Music video 2022 by Awtar TV 3 weeks ago 3 minutes, 39 seconds 5,533 views",Awtar TV,5533,5715,182
299,"Awtar Tv -  Weynishet_Ayenew  | ወይንሸት አየነው -  Ye Ethiopia Jegna -  New Ethiopian Music video 2022 by Awtar TV 3 weeks ago 5 minutes, 34 seconds 26,160 views",Awtar TV,26160,27182,1022
300,"Awtar Tv - Kidus Yared and Daniel Tesfaye | Hagere - New Ethiopian Music video 2022 by Awtar TV 3 weeks ago 3 minutes, 51 seconds 7,422 views",Awtar TV,7422,7585,163
301,"Awtar Tv - Yosi Yo and Mik_Nely   | የዮሲ ዮ እና ሚክ ኔሊ - weyda  | ወይዳ- New Ethiopian Music Video 2022 by Awtar TV 1 month ago 3 minutes, 44 seconds 5,333 views",Awtar TV,5333,5444,111
302,"Awtar Tv - Helen Getachew  | ሄለን ጌታቸው -  Tew Eski  | ተው እስኪ- New Ethiopian Music Video 2022 by Awtar TV 1 month ago 3 minutes, 47 seconds 9,254 views",Awtar TV,9254,9736,482
303,"Awtar Tv - Robi Rosh |ሮቢ ሮሽ -  No More | በቃ - New Ethiopian Music 2022 by Awtar TV 1 month ago 4 minutes, 22 seconds 11,196 views",Awtar TV,11196,11529,333
304,"Awtar Tv - Dagne Dan | ዳኜ ዳን - ወልቃይቴ - Kila_Belew | ክላ በለው - New Ethiopian Music 2022 by Awtar TV 1 month ago 5 minutes, 48 seconds 23,522 views",Awtar TV,23522,24576,1054
305,"Awtar Tv - Tsiegereda Abebe| ፅጌሬዳ አበበ (ጃፒ) - ShiwShiw | ሽውሽው - Ethiopian Music video 2022 by Awtar TV 1 month ago 6 minutes, 20 seconds 21,692 views",Awtar TV,21692,23104,1412
306,"Awtar Tv - Yezena Negash - Awiy - አዊይ - New Ethiopian Music 2022 (Official Muisc Video ) by Awtar TV 1 month ago 4 minutes, 27 seconds 38,744 views",Awtar TV,38744,39733,989
307,"Awtar Tv - Flora Samson ( lidiya )|  የፍሎራ ሳምሶን (ሊዲያ) - Esat |  እሳት - New Ethiopian Music 2022 by Awtar TV 1 month ago 7 minutes, 14 seconds 9,901 views",Awtar TV,9901,10471,570
308,"Awtar Tv - Mesfin Eristu - Wa Belew - መስፍን እርስቱ (ሜስ) ""ዋ በለው"" - New Ethiopian Music 2022 by Awtar TV 1 month ago 7 minutes, 13 seconds 17,034 views",Awtar TV,17034,17455,421
309,"Awtar Tv - Yilkal Belisti | ይልቃል በልስቲ - Hagere Tamalech | ሀገሬ ታማለች - Ethiopian Music 2022 by Awtar TV 1 month ago 5 minutes, 46 seconds 57,039 views",Awtar TV,57039,63942,6903
310,"Awtar Tv - Derib Alemayehu | ደርብ አለማየሁ - Hagere | ሀገሬ - Ethiopian Music 2022 by Awtar TV 1 month ago 6 minutes, 34 seconds 10,778 views",Awtar TV,10778,11055,277
311,"Awtar Tv - Hailemaryam Mengeset | ስማ በለው - New Ethiopian Music Video 2022 by Awtar TV 1 month ago 6 minutes, 34 seconds 8,629 views",Awtar TV,8629,8956,327
312,"Awtar Tv - Senait Hailemariam ሰናይት ሀ/ማርያም - Ye Ethiopia Tinsae - የኢትዮጵያ ትንሳኤ - Ethiopian Music 2022 by Awtar TV 1 month ago 4 minutes, 30 seconds 8,182 views",Awtar TV,8182,8359,177
313,"Awtar Tv - Selam Amsal | ሰላም አምሳል - Lashmonminh | ላሽሞንሙንህ - New Ethiopian Music 2022 by Awtar TV 1 month ago 5 minutes, 15 seconds 40,902 views",Awtar TV,40902,42323,1421
314,"Awtar Tv - Yezena Negash እናመስግናቸው- Enamsginachew - New Ethiopian Music 2022 (Official Music ) by Awtar TV 1 month ago 7 minutes, 43 seconds 17,693 views",Awtar TV,17693,18045,352
315,"Awtar Tv - Yezena Negash ኢትዮጵያዬ፣እንዴት ነሽ  - New Ethiopian Music 2022 (Official Muisc) by Awtar TV 1 month ago 5 minutes, 4 seconds 11,233 views",Awtar TV,11233,11605,372
316,"Awtar Tv - Yezena Negash ተመከር- Temeker - New Ethiopian Music 2022 (Official Muisc ) by Awtar TV 1 month ago 6 minutes 8,735 views",Awtar TV,8735,9052,317
317,"Awtar Tv - Yezena Negash የእምነቴ ቦታነው- Ye Emnete Bota naw - New Ethiopian Music 2022 (Official Muisc ) by Awtar TV 1 month ago 4 minutes, 6 seconds 56,375 views",Awtar TV,56375,57616,1241
318,"Awtar Tv - Yezena Negash ጥንት አራዳዎቹ- Tint Aradawochu - New Ethiopian Music 2022 (Official Muisc ) by Awtar TV 1 month ago 5 minutes, 48 seconds 10,652 views",Awtar TV,10652,11017,365
319,"Awtar Tv - Yezena Negash አንኮበር- Ancober - New Ethiopian Music 2022 (Official Muisc ) by Awtar TV 1 month ago 6 minutes, 12 seconds 8,483 views",Awtar TV,8483,8662,179
320,"Awtar Tv - Yezena Negash መሄጃ ሲያሳጣኝ - Meheja Siyasatagn - New Ethiopian Music 2022 (Official Muisc ) by Awtar TV 1 month ago 7 minutes, 16 seconds 25,696 views",Awtar TV,25696,26399,703
321,"Awtar Tv - Yezena Negash - Awiy  - አዊይ - New Ethiopian Music 2022 (Official Muisc ) by Awtar TV 1 month ago 4 minutes, 14 seconds 6,225 views",Awtar TV,6225,6501,276
322,"Awtar Tv - Yezena Negash አዘነበው ማሩን- Azenebew Marun - New Ethiopian Music 2022 (Official Muisc ) by Awtar TV 1 month ago 4 minutes, 20 seconds 14,093 views",Awtar TV,14093,14612,519
323,"Awtar Tv - Yezena Negash (Etege Tayitu) የዝና ነጋሽ (እቴጌ ጣይቱ) -New Ethiopian Music 2022 (Official Muisc by Awtar TV 1 month ago 6 minutes, 53 seconds 10,070 views",Awtar TV,10070,10396,326
324,"Awtar Tv - Yezena Negash ወይ፣ሀረር፣ወይ ድሬ- Woy Harer, Woy Dire-New Ethiopian Music 2022 (Official Muisc) by Awtar TV 1 month ago 5 minutes, 14 seconds 10,845 views",Awtar TV,10845,11415,570
325,"Awtar Tv  - Semre Tarekegn - Ayiwa | ሰምረ ታረቀኝ - አይዋ - New Ethiopian Music 2022 (Official Video) by Awtar TV 1 month ago 6 minutes, 23 seconds 21,920 views",Awtar TV,21920,22483,563
326,"Awtar Tv  - Maseresh Alebel  | ኢትዮዽያ - New Ethiopian Music 2022 (Official Video) by Awtar TV 1 month ago 5 minutes, 18 seconds 15,477 views",Awtar TV,15477,16234,757
327,"Awtar Tv - Kefele Wesen & Rebka Guday  ክፍለ ወሰን እና ርብቃ ጉዳይ (አንዛ ሊካ ሊኮ)  - New Ethiopian Music 2022 by Awtar TV 1 month ago 4 minutes, 53 seconds 13,145 views",Awtar TV,13145,14307,1162
328,"Awtar Tv - Meregid Sound ( Zeraf ) መረግድ ሳውንድ ( ዘራፍ ) - New Ethiopian Music 2022 (Official Video) by Awtar TV 1 month ago 4 minutes, 31 seconds 14,899 views",Awtar TV,14899,16207,1308
329,"Awtar Tv - Temesegen Bekele - ተመስገን በቀለ -  (እናት ስትጣራ ) - New Ethiopian Music 2022 (Official Video) by Awtar TV 1 month ago 5 minutes, 1 second 25,575 views",Awtar TV,25575,28030,2455
330,"Awtar Tv - Amare Anteneh ( Satenaw ) አማረ አንተነህ ( ሳተናው ) - New Ethiopian Music 2022 (Official Video) by Awtar TV 1 month ago 5 minutes, 7 seconds 19,547 views",Awtar TV,19547,19770,223
331,"Awtar Tv - Temeche Negus - ተመቸ ንጉስ |  እነ ልክ አያውቁ - New Ethiopian Music 2022 (Official Video) by Awtar TV 1 month ago 8 minutes, 35 seconds 680,304 views",Awtar TV,680304,730432,50128
332,"Awtar Tv - Seyoumekal Gebre ( ስዩመቃል ገብሬ ) - Shiferaw (ሺ..ፈራው) - New Ethiopian Music 2022 by Awtar TV 1 month ago 6 minutes, 43 seconds 149,107 views",Awtar TV,149107,160615,11508
333,"Yared Negu - Yegir Esat |ያሬድ ነጉ - የእግር እሳት - New Ethiopian Music 2021 by Awtar TV 1 month ago 4 minutes, 36 seconds 985,777 views",Awtar TV,985777,1008984,23207
334,"Awtar Tv - Mesfin Bekele መስፍን በቀለ (ባንቺ ከመጡብን) - New Ethiopian Music 2022 (Official Video) by Awtar TV 1 month ago 5 minutes, 37 seconds 71,610 views",Awtar TV,71610,75255,3645
335,"Awtar Tv - Desalegn Mersha | Gazeneno ደሣለኝ መርሻ  ጋዘነኖ New Ethiopian Music 2022 - Official Music Video by Awtar TV 1 month ago 5 minutes, 55 seconds 56,185 views",Awtar TV,56185,58427,2242
336,"Awtar Tv - Kal-Kidan - Min Hogne Naw (ምን ሆኜ ነው)  - New Ethiopian Music 2021- (Official Music Video) by Awtar TV 2 months ago 4 minutes, 16 seconds 2,398,972 views",Awtar TV,2398972,2622594,223622
337,"Awtar Tv - Anteneh Minalu - Fidel Temaru አንተነህ ምናሉ - ፊደል ተማሩNew Ethiopian Music 2021- Official Video by Awtar TV 2 months ago 5 minutes, 6 seconds 13,614 views",Awtar TV,13614,13796,182
338,"Awtar Tv - Seyoumekal Gebre - Weloye - ስዩመቃል ገብሬ - ወሎዬ - New Ethiopian Music 2021 (Official Video) by Awtar TV 2 months ago 6 minutes, 48 seconds 450,590 views",Awtar TV,450590,485833,35243
339,"Awtar Tv - Girma Tefera (Adera) ግርማ ተፈራ (አደራ) - New Ethiopian Music 2021 (Official Video) by Awtar TV 2 months ago 5 minutes, 8 seconds 810,793 views",Awtar TV,810793,832127,21334
340,"Awtar Tv - Tizita Mekonnen ( Balerstu ) ትዝታ መኮንን ( ባለርስቱ ) New Ethiopian Music 2021 (Official Video) by Awtar TV 2 months ago 6 minutes, 29 seconds 82,772 views",Awtar TV,82772,83444,672
341,"Awtar Tv - Yigerem Simachew (Lanesasaw) ይግረም ስማቸው  (ላነሳሳው) New Ethiopian Music 2021(Official Video) by Awtar TV 2 months ago 8 minutes, 36 seconds 311,788 views",Awtar TV,311788,329434,17646
342,"Awtar Tv - Teref Kassahun (Kiya) Mare ጠረፍ ካሳሁን (ኪያ) ማሬ - New Ethiopian Music 2021(Official Video) by Awtar TV 2 months ago 4 minutes, 54 seconds 484,388 views",Awtar TV,484388,497887,13499
343,"Awtar Tv - Semahegn Belew | ሰማኸኝ በለዉ - አረ በዛ - New Ethiopian Music 2021 - (Official Music Video) by Awtar TV 2 months ago 8 minutes, 24 seconds 1,048,645 views",Awtar TV,1048645,1084316,35671
344,"Awtar Tv-Addis Gurmessa-Le Ethiopia Sendeq(ለኢትዮጵያ ሰንደቅ)New Ethiopian Music 2021(Official MusicVideo) by Awtar TV 2 months ago 5 minutes, 48 seconds 26,952 views",Awtar TV,26952,27076,124
345,"Awtar Tv -Abebaw H/michael - (አበባው ኋ/ሚካኤል) - Anesemam  | አንሰማም New Ethiopian Music 2021 by Awtar TV 2 months ago 4 minutes, 48 seconds 14,357 views",Awtar TV,14357,14427,70
346,"Awtar Tv - Fitsum Gebretsadik -(ፍፁም ገብረፃዲቅ)-Satenaw-(ሳተናው) New Ethiopian Music 2021(Official Video ) by Awtar TV 2 months ago 4 minutes, 50 seconds 44,686 views",Awtar TV,44686,45105,419
347,"Awtar Tv - Yonatan Damene  - Ethiopia (ኢትዮጵያ) - New Ethiopian Music 2021 - ( Official Music  Video ) by Awtar TV 2 months ago 7 minutes, 38 seconds 322,738 views",Awtar TV,322738,339338,16600
348,"Awtar Tv - Amlake sitegn - (አምላኬ ስጠኝ) -Yagere Sew(ያገሬ ሰው) New Ethiopian Music 2021-(Official Video ) by Awtar TV 3 months ago 5 minutes, 44 seconds 89,091 views",Awtar TV,89091,89980,889
349,"Awtar Tv - Zelalem Tsegay(ዘላለም ፀጋዬ) - Kal Neber - (ቃል ነበር) New Ethiopian Music 2021(Official Video) by Awtar TV 3 months ago 5 minutes, 36 seconds 8,549 views",Awtar TV,8549,8611,62
350,"Awtar Tv - Endegna - (እንደኛ) - Ewedatalew - (እወዳታለው) New Ethiopian Music 2021 - ( Official  Video ) by Awtar TV 3 months ago 4 minutes, 57 seconds 814,836 views",Awtar TV,814836,828680,13844
351,"Awtar Tv Show ወግ - Habtamu Bogale - Interview with Song writer Part 2 - Talk Show 2021 by Awtar TV 3 months ago 42 minutes 3,513 views",Awtar TV,3513,3526,13
352,"Awtar Tv - Beza Tadesse - Ethiopia - (ኢትዮጵያ) New Ethiopian Music 2021(Official Music Video) by Awtar TV 3 months ago 4 minutes, 51 seconds 36,080 views",Awtar TV,36080,36222,142
353,"Awtar Tv - Abinet Agonafir - Alen  - (አለን)  New Ethiopian Music 2021(Official Music Video) by Awtar TV 3 months ago 4 minutes, 17 seconds 1,397,155 views",Awtar TV,1397155,1411821,14666
354,"Awtar TV - Rahel Getu - Etemete - New Ethiopian Music 2021 -  ( Official Music Video ) by Awtar TV 4 months ago 4 minutes, 22 seconds 1,609,418 views",Awtar TV,1609418,1642280,32862
355,"Awtar Tv -Yohannes Melaku - yesew sew nafekegn  -New Ethiopian Music 2021(Official Video) by Awtar TV 4 months ago 5 minutes, 24 seconds 13,572 views",Awtar TV,13572,13664,92
356,"Awtar Tv Show ወግ - Habtamu Bogale - Interview with Song writer  - Talk Show 2021 by Awtar TV 4 months ago 31 minutes 3,787 views",Awtar TV,3787,3800,13
357,"Awtar Tv-Tafarii salaalee(Abbabu) -TOKKO TA’I- New Ethiopian Oromo Music 2021(Official Music Video) by Awtar TV 4 months ago 5 minutes, 45 seconds 310,476 views",Awtar TV,310476,316830,6354
358,"Awtar Tv Show ወግ - With Artist jalud - አዝናኝ ቆይታ ከአርቲስት ጃሉድ ጋር  - 2021 - by Awtar TV 4 months ago 16 minutes 7,320 views",Awtar TV,7320,7414,94
359,"Awtar TV - Yabu Jc -Temelaleshibet- New Ethiopian Music 2021 - ( Official Audio ) by Awtar TV 4 months ago 2 minutes, 32 seconds 5,012 views",Awtar TV,5012,5043,31
360,"Awtar TV - Yabu Jc - Ummy - New Ethiopian Music 2021 - ( Official Audio ) by Awtar TV 4 months ago 3 minutes, 1 second 2,430 views",Awtar TV,2430,2448,18
361,"Awtar TV - Yabu Jc - Yene Guzo - New Ethiopian Music 2021 - ( Official Audio ) by Awtar TV 4 months ago 2 minutes, 9 seconds 2,010 views",Awtar TV,2010,2035,25
362,"Awtar TV - Yabu Jc - 8000 intro - New Ethiopian Music 2021 - ( Official Audio ) by Awtar TV 4 months ago 2 minutes, 38 seconds 1,563 views",Awtar TV,1563,1575,12
363,"Awtar TV - Yabu Jc - Alchelem Alem - New Ethiopian Music 2021 - ( Official Audio ) by Awtar TV 4 months ago 2 minutes, 1 second 1,281 views",Awtar TV,1281,1298,17
364,"Awtar TV - Yabu Jc - Berana - New Ethiopian Music 2021 - ( Official Audio ) by Awtar TV 4 months ago 2 minutes, 24 seconds 1,003 views",Awtar TV,1003,1017,14
365,"Awtar TV - Yabu Jc - Drama - New Ethiopian Music 2021 - ( Official Audio ) by Awtar TV 4 months ago 3 minutes, 14 seconds 1,091 views",Awtar TV,1091,1105,14
366,"Awtar TV - Yabu Jc - Ene Emawkew- New Ethiopian Music 2021 - ( Official Audio ) by Awtar TV 4 months ago 2 minutes, 46 seconds 907 views",Awtar TV,907,921,14
367,"Awtar TV - Yabu Jc - Ethiopia Ft Moged - New Ethiopian Music 2021 - ( Official Audio ) by Awtar TV 4 months ago 2 minutes, 36 seconds 846 views",Awtar TV,846,857,11
368,"Awtar TV - Yabu Jc - Ezim Ezam - New Ethiopian Music 2021 - ( Official Audio ) by Awtar TV 4 months ago 2 minutes, 43 seconds 751 views",Awtar TV,751,760,9
369,"Awtar TV - Yabu Jc - Helem Elem - New Ethiopian Music 2021 - ( Official Audio ) by Awtar TV 4 months ago 2 minutes, 48 seconds 685 views",Awtar TV,685,694,9
370,"Awtar TV - Yabu Jc -Hiwot Yeketelal - New Ethiopian Music 2021 - ( Official Audio ) by Awtar TV 4 months ago 2 minutes, 42 seconds 672 views",Awtar TV,672,688,16
371,"Awtar TV - Yabu Jc - Ketsehay Betach - New Ethiopian Music 2021 - ( Official Audio ) by Awtar TV 4 months ago 2 minutes, 24 seconds 682 views",Awtar TV,682,692,10
372,"Awtar TV - Yabu Jc - Koy Manew Ft Moged - New Ethiopian Music 2021 - ( Official Audio ) by Awtar TV 4 months ago 3 minutes, 3 seconds 706 views",Awtar TV,706,711,5
373,"Awtar TV - Yabu Jc - Mastewal - New Ethiopian Music 2021 - ( Official Audio ) by Awtar TV 4 months ago 2 minutes, 48 seconds 715 views",Awtar TV,715,727,12
374,"Awtar TV - Yabu Jc - Nebey Behageru Ft Dave Ahadu - New Ethiopian Music 2021 - ( Official Audio ) by Awtar TV 4 months ago 2 minutes, 48 seconds 1,124 views",Awtar TV,1124,1130,6
375,"Awtar TV - Yabu Jc - Sayekatel Beketel - New Ethiopian Music 2021 - ( Official Audio ) by Awtar TV 4 months ago 1 minute, 42 seconds 811 views",Awtar TV,811,819,8
376,"Awtar TV - Yabu Jc - Tekuso Mesat - New Ethiopian Music 2021 - ( Official Audio ) by Awtar TV 4 months ago 2 minutes, 37 seconds 1,141 views",Awtar TV,1141,1151,10
377,"Awtar Tv -Mohammed Hassen(koys) Yikirta- መሀመድ ሀሰን(ኮይስ) ይቅርታ-New Ethiopian Music 2021(Official Video) by Awtar TV 4 months ago 5 minutes, 3 seconds 12,184 views",Awtar TV,12184,12264,80
378,"Awtar Tv-Gaarummaa Hundee -Irreechaa - New Ethiopian Oromo Music 2021(Official  Music Video) by Awtar TV 5 months ago 4 minutes, 42 seconds 5,026 views",Awtar TV,5026,5054,28
379,"Awtar TV - Rahel Getu - Neber - New Ethiopian Music 2021 - ( Official Audio ) by Awtar TV 5 months ago 4 minutes, 53 seconds 660,501 views",Awtar TV,660501,666320,5819
380,"Awtar TV - Rahel Getu - Lene Kaleh - New Ethiopian Music 2021 - ( Official Audio ) by Awtar TV 5 months ago 4 minutes, 7 seconds 698,928 views",Awtar TV,698928,704465,5537
381,"Awtar TV - Rahel Getu - Etemete - New Ethiopian Music 2021 - ( Official Audio ) by Awtar TV 5 months ago 4 minutes, 1 second 1,064,042 views",Awtar TV,1064042,1071247,7205
382,"Awtar TV - Rahel Getu - Tirefi - New Ethiopian Music 2021 - ( Official Lyric Video ) by Awtar TV 5 months ago 6 minutes, 1 second 1,575,526 views",Awtar TV,1575526,1593714,18188
383,"Awtar TV - Rahel Getu - Beketemaw - New Ethiopian Music 2021 - ( Official Audio ) by Awtar TV 5 months ago 4 minutes, 30 seconds 916,569 views",Awtar TV,916569,930808,14239
384,"Awtar TV - Rahel Getu - Kisto - New Ethiopian Music 2021 - ( Official Audio ) by Awtar TV 5 months ago 4 minutes, 30 seconds 674,275 views",Awtar TV,674275,682430,8155
385,"Awtar TV - Rahel Getu - Astaraki  - New Ethiopian Music 2021 - ( Official Audio ) by Awtar TV 5 months ago 4 minutes, 28 seconds 1,431,555 views",Awtar TV,1431555,1451896,20341
386,"Awtar TV - Rahel Getu - Yene Fikir - New Ethiopian Music 2021 - ( Official Lyirc Video ) by Awtar TV 5 months ago 4 minutes, 32 seconds 1,326,783 views",Awtar TV,1326783,1343213,16430
387,"Awtar TV - Rahel Getu - Geday - New Ethiopian Music 2021 - ( Official Audio ) by Awtar TV 5 months ago 5 minutes, 12 seconds 2,209,067 views",Awtar TV,2209067,2249693,40626
388,"Awtar TV - Rahel Getu - Hahu - New Ethiopian Music 2021 - ( Official Lyric Video ) by Awtar TV 5 months ago 5 minutes, 57 seconds 1,093,392 views",Awtar TV,1093392,1105338,11946
389,"Awtar TV - Rahel Getu - Nigeregn  - New Ethiopian Music 2021 - ( Official Audio ) by Awtar TV 5 months ago 4 minutes, 24 seconds 1,233,486 views",Awtar TV,1233486,1250044,16558
390,"Awtar TV - Rahel Getu - Sereq- New Ethiopian Music 2021 - ( Official Audio ) by Awtar TV 5 months ago 4 minutes, 19 seconds 2,677,187 views",Awtar TV,2677187,2731530,54343
391,"Awtar TV - Rahel Getu - Ethiopiaye - New Ethiopian Music 2021 - ( Official Audio ) by Awtar TV 5 months ago 4 minutes, 30 seconds 331,144 views",Awtar TV,331144,334085,2941
392,"Awtar tv - Rahel Getu - Ethiopiaye - New Ethiopian Music 2021 - ( Official Music Video ) by Awtar TV 5 months ago 5 minutes, 15 seconds 7,067,065 views",Awtar TV,7067065,7140985,73920
393,"Awtar Tv Show ወግ - With Artist Rahel Getu - New Ethiopian Music 2021 - by Awtar TV 5 months ago 26 minutes 121,957 views",Awtar TV,121957,122365,408
394,"Awtar Tv Show ወግ - With Artist Abraham Belayneh -  Ethiopian Music 2021 by Awtar TV 6 months ago 26 minutes 6,149 views",Awtar TV,6149,6160,11
395,"Awtar tv - Ashebir Belay - ጅንኑ - New Ethiopian Music 2021 ( Official Music Video ) - አሸብር በላይ by Awtar TV 6 months ago 6 minutes, 59 seconds 305,285 views",Awtar TV,305285,313052,7767
396,"Awtar Tv Show ወግ - Abel Paulos - Interview with Ethiopian Music composer - Talk Show by Awtar TV 6 months ago 43 minutes 13,901 views",Awtar TV,13901,13953,52
397,"Awtar Tv Show ወግ  - Ashebir Belay - - Interview with Ethiopian artist - Ashebir Belay  - Talk Show by Awtar TV 6 months ago 21 minutes 1,820 views",Awtar TV,1820,1857,37
398,"Ethiopian Music 2021 - SHAHOYBA - Various Artists - New Ethiopian Music 2021 (Official Music Video) by Awtar TV 6 months ago 4 minutes, 54 seconds 4,149 views",Awtar TV,4149,4256,107
399,"Ethiopian Music 2021 - kasaye Mideksa  - Ayqerm - New Ethiopian Music 2021 -  ( Official  Video ) by Awtar TV 7 months ago 4 minutes, 13 seconds 1,875 views",Awtar TV,1875,1896,21
400,"Awtar tv - Amarech Molla - Lamie bora - New Ethiopian Music 2021 - ( Official Music Video ) by Awtar TV 7 months ago 5 minutes, 49 seconds 3,118 views",Awtar TV,3118,3192,74
401,"Awtar tv - Fasil Anchihoye - Berhan Yehun Ale - New Ethiopian Music 2021 - ( Official Music Video ) by Awtar TV 7 months ago 4 minutes, 51 seconds 1,959 views",Awtar TV,1959,2003,44
402,"Awtar tv - Melaku Yakob - Eyemantenhu -  New Ethiopian Music 2021 - ( Official Music Video ) by Awtar TV 7 months ago 4 minutes, 53 seconds 3,143 views",Awtar TV,3143,3187,44
403,Awtar Weg - Dawit Yifru - Interview - Weg Talk Show by Awtar TV 7 months ago 34 minutes 977 views,Awtar TV,977,999,22
404,"Biniam Abera - Beredikie - New Ethiopian Music 2021 - ( Official Music Video) by Awtar TV 8 months ago 5 minutes, 8 seconds 5,344 views",Awtar TV,5344,5605,261
405,"Awtar Tv - Tariku Woleda  - Shmjetu - New Ethiopian Music 2021 - (Official Music Video) by Awtar TV 8 months ago 6 minutes, 29 seconds 4,777 views",Awtar TV,4777,5021,244
406,"Haile Roots - Yemata Mata - New Ethiopian Music 2021 - ( Official Audio ) by Awtar TV 8 months ago 3 minutes, 23 seconds 26,232 views",Awtar TV,26232,26467,235
407,"Awtar TV -  Kebe bekele ft kastu -  Nisiqa - New Ethiopian Music 2021 - ( Official Music Video ) by Awtar TV 9 months ago 3 minutes, 51 seconds 4,066 views",Awtar TV,4066,4217,151
408,"Awtar TV - Jonny Ragga - Habeshawi - New Ethiopian Music - (Official Music Video) by Awtar TV 9 months ago 3 minutes, 47 seconds 8,197 views",Awtar TV,8197,8435,238
409,"Awtar TV - Jonny Ragga - Yeney Nat - New Ethiopian Music - (Official Music Video) by Awtar TV 9 months ago 4 minutes, 44 seconds 17,169 views",Awtar TV,17169,17561,392
410,"Henok Mehari - Brand New Album - Azmach - Out Now on Awtar by Awtar TV 9 months ago 1 minute, 1 second 6,399 views",Awtar TV,6399,6437,38
411,"Awtar TV - Jonny Ragga - Give me the key - New Ethiopian Music - (Official Music Video) by Awtar TV 9 months ago 4 minutes, 58 seconds 48,231 views",Awtar TV,48231,50317,2086
412,"Awtar TV - Jonny Ragga - Habeshawi 2 - New Ethiopian Music - (Official Music Video) by Awtar TV 9 months ago 4 minutes, 7 seconds 15,513 views",Awtar TV,15513,15770,257
413,"Awtar tv - Dagim Tesfaye - Alwedeshem - New Ethiopian Music 2021 - (Official Music Video) by Awtar TV 9 months ago 4 minutes, 17 seconds 216,693 views",Awtar TV,216693,218844,2151
414,"Awtar Tv - Abay Tewodros - Shemeles JADROS - New Ethiopian Music 2021- ( Official Music Video ) by Awtar TV 10 months ago 3 minutes, 40 seconds 21,386 views",Awtar TV,21386,22198,812
415,"Awtar TV - Tilahun gutamaa - Sabbontuu  - New Ethiopian Music 2021 - Oromo Music 2021 by Awtar TV 11 months ago 4 minutes, 42 seconds 8,699 views",Awtar TV,8699,9158,459
416,"Semahegn Belew | ሰማኸኝ በለዉ - ጥቅሙ የጋራ ነዉ- New Ethiopian Music 2021 - (Official Music Video) by Awtar TV 11 months ago 4 minutes, 28 seconds 95,738 views",Awtar TV,95738,96557,819
417,"Haile Roots - lafta - New Ethiopian Music 2021 - ( Official Audio ) by Awtar TV 11 months ago 3 minutes, 40 seconds 13,277 views",Awtar TV,13277,13581,304
418,"Meselu Fantahun - Weye lemeta woye meta  - New Ethiopian Music 2021 - ( Official Audio ) by Awtar TV 11 months ago 4 minutes, 53 seconds 8,306 views",Awtar TV,8306,8382,76
419,"Awtar multimedia in collaboration with Bank of Abyssinia to Launch International system of Awtar by Awtar TV Streamed 11 months ago 1 hour, 58 minutes 1,711 views",Awtar TV,1711,1721,10
420,"Meselu Fantahun - Yawekebetam - ያወቀበትማ - New Ethiopian Music 2021 - ( Official Audio ) by Awtar TV 1 year ago 4 minutes, 52 seconds 16,522 views",Awtar TV,16522,16642,120
421,"Meselu Fantahun - Safekerhe - ሳፈቅርክ - New Ethiopian Music 2021 - ( Official Audio ) by Awtar TV 1 year ago 5 minutes, 4 seconds 370,759 views",Awtar TV,370759,378283,7524
422,"Meselu Fantahun - Nalegn Gelagela - ናልኝ የኔ ገላ - New Ethiopian Music 2021 - ( Official Audio ) by Awtar TV 1 year ago 6 minutes, 35 seconds 38,578 views",Awtar TV,38578,39528,950
423,"Meselu Fantahun - Bezint Geremaye - በዚነተ ግርማይ - New Ethiopian Music 2021 - ( Official Audio ) by Awtar TV 1 year ago 7 minutes, 25 seconds 61,414 views",Awtar TV,61414,62541,1127
424,"Meselu Fantahun - Engedi Meshelet - እንግዲ መሸ - New Ethiopian Music 2021 - ( Official Audio ) by Awtar TV 1 year ago 4 minutes, 50 seconds 40,021 views",Awtar TV,40021,40930,909
425,"Meselu Fantahun - Kelebey Benafekeh - ከልቤ ብናፍቅህ - New Ethiopian Music 2021 - ( Official Audio ) by Awtar TV 1 year ago 3 minutes, 47 seconds 47,085 views",Awtar TV,47085,48092,1007
426,"Meselu Fantahun - Endemogn Wedaji - እንደሞኝ ወዳጅ - New Ethiopian Music 2021 - ( Official Audio ) by Awtar TV 1 year ago 4 minutes, 59 seconds 32,501 views",Awtar TV,32501,33256,755
427,"Meselu Fantahun - Beselam Wale Lebey- በሰላም ዋለ ልቤ - New Ethiopian Music 2021 - ( Official Audio ) by Awtar TV 1 year ago 4 minutes, 28 seconds 148,868 views",Awtar TV,148868,151551,2683
428,"Meselu Fantahun - Bante New Mamarey - ባንተ ነው ማማሬ - New Ethiopian Music 2021 - ( Official Audio ) by Awtar TV 1 year ago 4 minutes, 28 seconds 487,806 views",Awtar TV,487806,498224,10418
429,"Meselu Fantahun - Beney Mote - በኔ ሞት - New Ethiopian Music 2021 - ( Official Audio ) by Awtar TV 1 year ago 5 minutes, 58 seconds 110,753 views",Awtar TV,110753,113029,2276
430,"Meselu Fantahun - Atsheshi Jenber - እትሺሺ ጀምበር - New Ethiopian Music 2021 - ( Official Audio ) by Awtar TV 1 year ago 5 minutes, 25 seconds 79,038 views",Awtar TV,79038,81357,2319
431,"Meselu Fantahun - Beayenur - በዓይኑ - New Ethiopian Music 2021 - ( Official Audio ) by Awtar TV 1 year ago 5 minutes, 13 seconds 111,758 views",Awtar TV,111758,114056,2298
432,"Awtar Tv ወግ - Interview with Ethiopian artist  - Zeleke Gesese - Talk Show by Awtar TV 1 year ago 56 minutes 1,614 views",Awtar TV,1614,1633,19
433,"Haile Roots - Yezemene - New Ethiopian Music 2021 - ( Official Audio ) by Awtar TV 1 year ago 4 minutes, 1 second 7,958 views",Awtar TV,7958,8072,114
434,"Haile Roots - Yigeletal - New Ethiopian Music 2021 - ( Official Audio ) by Awtar TV 1 year ago 3 minutes, 37 seconds 4,655 views",Awtar TV,4655,4759,104
435,"Haile roots - Man Awkot - New Ethiopian Music 2021 - ( Official Audio ) by Awtar TV 1 year ago 4 minutes, 44 seconds 5,756 views",Awtar TV,5756,5887,131
436,"Haile Roots - layechal yelem - New Ethiopian Music 2021 - ( Official Audio ) by Awtar TV 1 year ago 3 minutes, 27 seconds 5,534 views",Awtar TV,5534,5740,206
437,"Haile roots - Tazual - New Ethiopia Music 2021 - ( Official Audio ) by Awtar TV 1 year ago 3 minutes, 34 seconds 5,052 views",Awtar TV,5052,5218,166
438,"Haile Roots - Yetamene - New Ethiopia Music 2021 - ( Official Audio ) by Awtar TV 1 year ago 4 minutes, 52 seconds 13,121 views",Awtar TV,13121,13407,286
439,"Haile Roots - Kelebuwa - New Ethiopian Music 2021 - ( Official Audio ) by Awtar TV 1 year ago 4 minutes, 7 seconds 10,647 views",Awtar TV,10647,10948,301
440,"Haile Roots - Nesanet - New Ethiopian Music 2021 - ( Official Audio ) by Awtar TV 1 year ago 3 minutes, 15 seconds 4,741 views",Awtar TV,4741,4973,232
441,"Haile Roots - Endewalelech - New Ethiopian Music 2021 - ( Official Audio ) by Awtar TV 1 year ago 4 minutes, 49 seconds 9,031 views",Awtar TV,9031,9350,319
442,"Haile Roots - laymola - New Ethiopian Music 2021 - ( Official Audio ) by Awtar TV 1 year ago 4 minutes, 27 seconds 6,580 views",Awtar TV,6580,6776,196
443,"Haile Roots - Sewu alat - New Ethiopian Music 2021 - ( Official Audio ) by Awtar TV 1 year ago 3 minutes, 42 seconds 4,976 views",Awtar TV,4976,5130,154
444,"Haile roots - Yanchin - New Ethiopian Music 2021 - ( Official Audio ) by Awtar TV 1 year ago 4 minutes, 1 second 3,867 views",Awtar TV,3867,3996,129
445,"Jonny Ragga - My pocket & your purse - New Ethiopian Music - ( Official Audio ) by Awtar TV 1 year ago 4 minutes, 16 seconds 15,485 views",Awtar TV,15485,15950,465
446,"Jonny Ragga - Love of music - New Ethiopian Music - ( Official Audio ) by Awtar TV 1 year ago 5 minutes, 29 seconds 13,491 views",Awtar TV,13491,13940,449
447,"Awtar TV - Jonny Rgga - Ethiopia - New Ethiopian Music ( Official Audio ) by Awtar TV 1 year ago 4 minutes, 33 seconds 10,242 views",Awtar TV,10242,10590,348
448,"Jonny Ragga - Fire Love - New Ethiopian Music - ( Official Audio ) by Awtar TV 1 year ago 4 minutes, 11 seconds 9,920 views",Awtar TV,9920,10340,420
449,"Jonny Ragga - One Way Ticket - New Ethiopian Music - ( Official Audio ) by Awtar TV 1 year ago 4 minutes, 33 seconds 23,902 views",Awtar TV,23902,24455,553
450,"Jonny Ragga - Old Enough - New Ethiopian Music - ( Official Audio ) by Awtar TV 1 year ago 5 minutes 20,484 views",Awtar TV,20484,21186,702
451,"Jonny Ragga - Fire Version - New Ethiopian Music - ( Official Audio ) by Awtar TV 1 year ago 1 minute, 30 seconds 5,154 views",Awtar TV,5154,5339,185
452,"Jonny Ragga - Give me the key - New Ethiopian Music - ( Official Audio ) by Awtar TV 1 year ago 4 minutes, 3 seconds 21,071 views",Awtar TV,21071,21551,480
453,"Jonny Ragga - Shuck & Tuss - New Ethiopian Music - ( Official Audio ) by Awtar TV 1 year ago 4 minutes, 9 seconds 24,711 views",Awtar TV,24711,26382,1671
454,"Jonny Ragga - Mama - New Ethiopian Music - ( Official Audio ) by Awtar TV 1 year ago 4 minutes, 50 seconds 16,927 views",Awtar TV,16927,17387,460
455,"Jonny Ragga - Shashemene - New Ethiopian Music - (Official Audio ) by Awtar TV 1 year ago 3 minutes, 56 seconds 10,798 views",Awtar TV,10798,11403,605
456,"Jonny Ragga - Pick it up  - New Ethiopian Music - ( Official Audio ) by Awtar TV 1 year ago 3 minutes, 56 seconds 77,490 views",Awtar TV,77490,80388,2898
457,"Jonny Ragga - Get the devil out - New Ethiopian Music - ( Official Audio ) by Awtar TV 1 year ago 4 minutes, 30 seconds 8,658 views",Awtar TV,8658,8928,270
458,"Jonny Ragga - Melke Melkam -  New Ethiopian Music - ( Official Audio ) by Awtar TV 1 year ago 4 minutes, 32 seconds 46,943 views",Awtar TV,46943,47659,716
459,"Jonny Ragga - Hello Addis Abeba - New Ethiopian Music - ( Official Audio ) by Awtar TV 1 year ago 4 minutes, 45 seconds 21,827 views",Awtar TV,21827,22416,589
460,"Ashebir Belay - Welelaw Gojam |  ወለላው ጎጃም - New Ethiopian Music 2021 (Official Music Video) by Awtar TV 1 year ago 6 minutes, 33 seconds 460,778 views",Awtar TV,460778,462026,1248
461,"Meselu Fantahun - Wey Limta Wey Mita | ወይ ልምጣ ወይ ምጣ - New Ethiopian Music 2021 - (Official Video) by Awtar TV 1 year ago 5 minutes, 13 seconds 2,779,219 views",Awtar TV,2779219,2832835,53616
462,"Meselu Fantahun - Woy Limta Woy Mita - New Ethiopian Music 2021 - Coming Soon by Awtar TV 1 year ago 44 seconds 17,341 views",Awtar TV,17341,17396,55
463,"ኃይሌ ሩትስ (Haile Roots)   - ላይቻል የለም (Laychal Yelem) l New Ethiopian Music 2020 (Official Video) by Awtar TV 1 year ago 4 minutes, 1 second 467,037 views",Awtar TV,467037,470132,3095
464,"ኃይሌ ሩትስ - ላይቻል የለም የሙዚቃ ቪዲዮ በቅርብ ቀን / Haile Roots - Laychal Yelem Official Music Video Coming Soon by Awtar TV 1 year ago 19 seconds 3,353 views",Awtar TV,3353,3354,1
465,"ሔኖክ ተስፋዬ (Henok Tesfaye) l ሲራራው ነጋዴ -  (Siraraw Negade) - New Ethiopian Music 2020 (Official Video) by Awtar TV 1 year ago 6 minutes, 23 seconds 9,117 views",Awtar TV,9117,9209,92
466,"አውታር ወግ - ብስራት ሀ/ማርያም (ቤሪ) / Awtar Weg - Bisrat H/Mariam (Berry) by Awtar TV 1 year ago 18 minutes 4,328 views",Awtar TV,4328,4367,39
467,"ቅምሻ ከመሰሉ ፋንታሁን አዲስ አልበም - አትሽሺ  ጀምበር / New Ethiopian Music 2020 by Awtar TV 1 year ago 4 minutes, 58 seconds 13,328 views",Awtar TV,13328,13446,118
468,"ቅምሻ ከሃይሌ ሩትስ አዲስ አልበም - የታመነ / New Ethiopian Music 2020 by Awtar TV 1 year ago 4 minutes, 49 seconds 17,815 views",Awtar TV,17815,17928,113
469,"Awtar Tv ወግ - Interview with Ethiopian artist - Moges Teka - Talk Show by Awtar TV 1 year ago 35 minutes 2,383 views",Awtar TV,2383,2390,7
470,"እንዳለ ሽፈራው l የትዬሌሌ - New Ethiopian Music 2020 (Official Video) by Awtar TV 1 year ago 5 minutes, 25 seconds 7,513 views",Awtar TV,7513,7647,134
471,"Awtar Tv ወግ  -  Interview with Ethiopian artist -  Betty G - Talk Show by Awtar TV 1 year ago 25 minutes 5,184 views",Awtar TV,5184,5216,32
472,"አውታር ወግ - አቤል ሙሉጌታ / Awtar Weg - Abel Mulugeta by Awtar TV 1 year ago 23 minutes 4,238 views",Awtar TV,4238,4257,19
473,"Dj Wish feat. Teddy Yo l የታለ - New Ethiopian Music 2020 (Official Video) by Awtar TV 1 year ago 4 minutes, 40 seconds 129,974 views",Awtar TV,129974,130528,554
474,"አውታር ወግ - አስቴር ከበደ / Awtar Weg - Aster Kebede by Awtar TV 1 year ago 15 minutes 3,933 views",Awtar TV,3933,3981,48
475,"ሰማኸኝ በለው l ግባ በለው - New Ethiopian Music 2020 (Official Video) by Awtar TV 1 year ago 6 minutes, 24 seconds 957,189 views",Awtar TV,957189,964303,7114
476,"አውታር ወግ - ታደለ ሮባ / Awtar Weg - Tadele Roba - Part 3 by Awtar TV 1 year ago 35 minutes 4,196 views",Awtar TV,4196,4254,58
477,"አውታር ወግ - ታደለ ሮባ / Awtar Weg - Tadele Roba - Part 2 by Awtar TV 1 year ago 29 minutes 3,543 views",Awtar TV,3543,3597,54
478,"አውታር ወግ - ታደለ ሮባ / Awtar Weg - Tadele Roba - Part 1 by Awtar TV 1 year ago 16 minutes 8,276 views",Awtar TV,8276,8397,121
479,"Jah Lude  - Ethiopia l ኢትዮጵያ - New Ethiopian Music 2020 (Official Video) by Awtar TV 1 year ago 3 minutes, 52 seconds 189,159 views",Awtar TV,189159,191000,1841
480,"ናልኝ የኔ ገላ - መሰሉ ፋንታሁን | New Ethiopian Music by Awtar TV 1 year ago 6 minutes, 35 seconds 146,702 views",Awtar TV,146702,147409,707
481,"Jalud - Ethiopian - New Ethiopia Music 2021- ( Official Audio ) by Awtar TV 1 year ago 3 minutes, 55 seconds 60,378 views",Awtar TV,60378,61598,1220
482,"How to send your favorite song as a gift / የሚወዱትን ሙዚቃ በስጦታ መልክ እንዴት መላክ ይችላሉ by Awtar TV 1 year ago 56 seconds 1,469 views",Awtar TV,1469,1498,29
483,"How to download music from Awtar mobile App / በአውታር ሞባይል መተግበሪያ እንዴት ዘፈን መጫን እንችላለን by Awtar TV 1 year ago 56 seconds 2,567 views",Awtar TV,2567,2621,54
484,"How to download Awtar Ethiopian Music App/ አውታር የሞባይል መተግበሪያ እንዴት መጫን እንችላለን by Awtar TV 1 year ago 1 minute, 22 seconds 6,469 views",Awtar TV,6469,6558,89
485,"New Ethiopian Oromo music Haaloo Borana stega performance Baandii Biftuu Oromiyaa garee Aadaa by Ayyaantummaa Entertainment 1 month ago 3 minutes, 6 seconds 69 views",Ayyaantummaa Entertainment,69,75,6
486,"New Ethiopian Oromo music Hellama Toofik stega performance Baandii Biftuu Oromiyaa garee Aadaa by Ayyaantummaa Entertainment 1 month ago 3 minutes, 30 seconds 17 views",Ayyaantummaa Entertainment,17,18,1
487,"New Ethiopian Oromo music caaltuu Butoo stega performance Baandii Biftuu Oromiyaa garee Aadaa by Ayyaantummaa Entertainment 1 month ago 3 minutes, 13 seconds 40 views",Ayyaantummaa Entertainment,40,42,2
488,walaaloo Lata Qananii Adda baha jettani nuyi yomiyyuu adda hin banu by ayyaantummaa by Ayyaantummaa Entertainment 1 month ago 48 seconds 30 views,Ayyaantummaa Entertainment,30,32,2
489,"New Ethiopian Oromo music Haacaaluu Hundeessaa jirra jiraa stage performance official music video by Ayyaantummaa Entertainment 1 month ago 6 minutes, 5 seconds 43 views",Ayyaantummaa Entertainment,43,47,4
490,"yaali leenji shubbisa by Ayyaantummaa Entertainment subscribe official YouTube chanale Dece27, 2021 by Ayyaantummaa Entertainment 2 months ago 2 minutes, 23 seconds 66 views",Ayyaantummaa Entertainment,66,70,4
491,yaali leenji shubbisa by Ayyaantummaa Entertainment subscribe official YouTube chanale Decemb 2021 by Ayyaantummaa Entertainment 2 months ago 1 minute 77 views,Ayyaantummaa Entertainment,77,86,9
492,"yaali leenji shubbisa by Ayyaantummaa Entertainment subscribe official YouTube chanale Decemb 2021 by Ayyaantummaa Entertainment 2 months ago 1 minute, 41 seconds 64 views",Ayyaantummaa Entertainment,64,68,4
493,"new Ethiopia Oromo music #micaa xiqqon kun sirba Andu'alem gosaa #by Ayyaantummaa Entertainment by Ayyaantummaa Entertainment 2 months ago 1 minute, 1 second 71 views",Ayyaantummaa Entertainment,71,76,5
494,"yaali leenji shubbisa godina Gujii by Ayyaantummaa Entertainment subscribe official YouTube chanale by Ayyaantummaa Entertainment 2 months ago 2 minutes, 35 seconds 66 views",Ayyaantummaa Entertainment,66,73,7
495,"yaali leenji shubbisa yeroo dhihoti by Ayyaantummaa Entertainment subscribe YouTube chanale Dec2021 by Ayyaantummaa Entertainment 2 months ago 1 minute, 15 seconds 100 views",Ayyaantummaa Entertainment,100,108,8
496,"New Ethiopian #Oromo #music shimalis Tasfayee #Bubbeen Garasii# by Ayyaantummaa Entertainment 2 months ago 4 minutes, 29 seconds 161 views",Ayyaantummaa Entertainment,161,172,11
497,"yaali leenji shubbisa yeroo dhihoti by Ayyaantummaa Entertainment December 10, 2021 by Ayyaantummaa Entertainment 2 months ago 2 minutes, 28 seconds 216 views",Ayyaantummaa Entertainment,216,223,7
498,"New Ethiopian Oromo music Ayyaantummaa Entertainment subscribe our official YouTube chanale 9, 2021 by Ayyaantummaa Entertainment 2 months ago 35 seconds 93 views",Ayyaantummaa Entertainment,93,95,2
499,"Oromo Oromoo Ajjeesu Arguu mannaa Du'ee obbaafachu wayya.jedhe hace hundeessa December 5, 2021 by Ayyaantummaa Entertainment 2 months ago 1 minute, 5 seconds 100 views",Ayyaantummaa Entertainment,100,103,3
500,"Abbabaa Dhugaasaa hinaaftuu new Ethiopian Oromo music Alex Dance Group by Ayyaantummaa Nove 17, 2021 by Ayyaantummaa Entertainment 3 months ago 1 minute, 24 seconds 512 views",Ayyaantummaa Entertainment,512,528,16
501,"New Ethiopian Oromo music Taddasaa Qalbesa stega performance official YouTube chanale Novem 16, 2021 by Ayyaantummaa Entertainment 3 months ago 6 minutes, 35 seconds 89 views",Ayyaantummaa Entertainment,89,90,1
502,"keroogiraafi (7) Eebbaa shubbistoota garee Koo maarti keeti Gammachuu wandimuu November 6, 2021 by Ayyaantummaa Entertainment 3 months ago 3 minutes, 43 seconds 102 views",Ayyaantummaa Entertainment,102,103,1
503,"keroogiraafi (6) Eebbaa shubbistoota garee Koo maarti keeti Gammachuu wandimuu November 6, 2021 by Ayyaantummaa Entertainment 3 months ago 4 minutes, 22 seconds 159 views",Ayyaantummaa Entertainment,159,167,8
504,"keroogiraafi (5) Eebbaa shubbistoota garee Koo maarti keeti Gammachuu wandimuu November 6, 2021 by Ayyaantummaa Entertainment 3 months ago 1 minute, 52 seconds 150 views",Ayyaantummaa Entertainment,150,151,1
505,"keroogiraafi (4)ffaa Eebbaa shubbistoota garee Koo maarti keeti magaala sulultaa November 1, 2021 by Ayyaantummaa Entertainment 3 months ago 4 minutes, 27 seconds 216 views",Ayyaantummaa Entertainment,216,217,1
506,"keroogiraafi (3)ffaa Eebbaa shubbistoota garee Koo maarti keeti magaala sulultaa November 1, 2021 by Ayyaantummaa Entertainment 4 months ago 5 minutes, 57 seconds 165 views",Ayyaantummaa Entertainment,165,166,1
507,"Eebbaa shubbistoota garee Koo maarti keeti Gammachuu wandimuu magaala sulultaa keroo (2)Nove 1, 2021 by Ayyaantummaa Entertainment 4 months ago 2 minutes, 29 seconds 114 views",Ayyaantummaa Entertainment,114,115,1
508,"Eebbaa shubbistoota garee Koo maarti keeti Gammachuu wandimuu magaala sulultaa keroo (1)No 1, 2021 by Ayyaantummaa Entertainment 4 months ago 47 seconds 161 views",Ayyaantummaa Entertainment,161,162,1
509,"New Ethiopian Oromo music #wallaggaa sabbona#Alex Dance Group stega performance present Ayyaantummaa by Ayyaantummaa Entertainment 4 months ago 4 minutes, 43 seconds 265 views",Ayyaantummaa Entertainment,265,285,20
510,"New Ethiopian Oromo music #shaggoyyee# Alex Dance Group stega performance present by Ayyaantummaa by Ayyaantummaa Entertainment 4 months ago 4 minutes, 12 seconds 234 views",Ayyaantummaa Entertainment,234,238,4
511,"malka Sabbata by Ayyaantummaa Entertainment official video subscribe our YouTube chanale by Ayyaantummaa Entertainment 4 months ago 9 minutes, 10 seconds 259 views",Ayyaantummaa Entertainment,259,262,3
512,"irreecha malka Sabbat a by Ayyaantummaa Entertainment official video by Ayyaantummaa Entertainment 4 months ago 4 minutes, 37 seconds 141 views",Ayyaantummaa Entertainment,141,143,2
513,"Do'ii Leemman ""loshantala""stega performance Ethiopian Oromo music official video by Ayyaantummaa Entertainment 4 months ago 2 minutes, 33 seconds 70 views",Ayyaantummaa Entertainment,70,71,1
514,"Caalaa Garoomsa stega performance Ethiopian Oromo music present by Ayyaantummaa Entertainment by Ayyaantummaa Entertainment 4 months ago 4 minutes, 10 seconds 75 views",Ayyaantummaa Entertainment,75,76,1
515,"Mallattoo nageenyaa fi tokkummaa kan ta'e Irreecha harsadi bara 2014 baga geessan by Ayyaantummaa by Ayyaantummaa Entertainment 4 months ago 3 minutes, 43 seconds 96 views",Ayyaantummaa Entertainment,96,98,2
516,"Mallattoo nageenyaa fi tokkummaa kan ta'e Irreecha finfinnee bara 2014 baga geessan! by Ayyaantummaa by Ayyaantummaa Entertainment 4 months ago 5 minutes, 52 seconds 92 views",Ayyaantummaa Entertainment,92,92,0
517,"Bachoo irraa kaanee garaa Iluu Abba Booraa by Ayyaantummaa Entertainment subscribe by Ayyaantummaa Entertainment 5 months ago 1 minute, 33 seconds 225 views",Ayyaantummaa Entertainment,225,227,2
518,"Faaruu meesha waraanaa New #Ethiopian Oromo music#official video by Ayyaantummaa Entertainment 5 months ago 1 minute, 2 seconds 177 views",Ayyaantummaa Entertainment,177,177,0
519,"Do'ii Leemman Rabbii malee namni nijijirama stega performance #Ethiopian Oromo music# official video by Ayyaantummaa Entertainment 5 months ago 4 minutes, 38 seconds 163 views",Ayyaantummaa Entertainment,163,166,3
520,"Caalaa Garoomsa stega performance Ethiopian Oromo music subscribe YouTube chanale by Ayyaantummaa Entertainment 5 months ago 6 minutes, 41 seconds 164 views",Ayyaantummaa Entertainment,164,165,1
521,Alex Dance group Present by Ayyaantummaa Entertainment by Ayyaantummaa Entertainment 5 months ago 2 minutes 184 views,Ayyaantummaa Entertainment,184,186,2
522,"Do'ii Leemman stage performance manni Abbaa Gadaa Mee kamii karaan #Ethiopian Oromo music# by Ayyaantummaa Entertainment 5 months ago 5 minutes, 55 seconds 238 views",Ayyaantummaa Entertainment,238,238,0
523,Alex Dancer present Ayyaantummaa by Ayyaantummaa Entertainment 5 months ago 38 seconds 218 views,Ayyaantummaa Entertainment,218,219,1
524,"Gaddaa Hamdaa maaltu jira stage performance official music video by Ayyaantummaa Entertainment 5 months ago 4 minutes, 23 seconds 206 views",Ayyaantummaa Entertainment,206,206,0
525,Yosan Getahun New Ethiopian Oromo music official video by Ayyaantummaa Entertainment 5 months ago 54 seconds 275 views,Ayyaantummaa Entertainment,275,276,1
526,Dancer By Ayyaantummaa Entertainment subscribe our YouTube chanale by Ayyaantummaa Entertainment 5 months ago 57 seconds 255 views,Ayyaantummaa Entertainment,255,257,2
527,"Abarraa Warquu stage performance Ethiopian Oromo music official video by Ayyaantummaa Entertainment 5 months ago 7 minutes, 26 seconds 208 views",Ayyaantummaa Entertainment,208,208,0
528,"Abarra Warqu stage performance Ethiopian Oromo music official video by Ayyaantummaa Entertainment 5 months ago 7 minutes, 1 second 147 views",Ayyaantummaa Entertainment,147,149,2
529,walaloo senet gizachow beksisaa YouTube ishee official video our YouTube chanale by Ayyaantummaa Entertainment 5 months ago 16 minutes 245 views,Ayyaantummaa Entertainment,245,250,5
530,masqala oromo hagayya 16 official video by Ayyaantummaa Entertainment 6 months ago 25 minutes 220 views,Ayyaantummaa Entertainment,220,220,0
531,"#oromo music# Ayyaantummaa present bay Ayyaantummaa Entertainment subscribe our YouTube chanale by Ayyaantummaa Entertainment 6 months ago 4 minutes, 54 seconds 239 views",Ayyaantummaa Entertainment,239,240,1
532,"Kadijjaa Hajii waltajji Baandii Sabbata waliin by Ayyaantummaa official video August 11, 2021 by Ayyaantummaa Entertainment 6 months ago 12 minutes, 37 seconds 228 views",Ayyaantummaa Entertainment,228,231,3
533,"Taddasaa Qalbeessaa waltajji Baandii Sabbata Aayyoo walin by Ayyaantummaa August 7, 2021 by Ayyaantummaa Entertainment 6 months ago 14 minutes, 47 seconds 157 views",Ayyaantummaa Entertainment,157,159,2
534,"Asaffaa Caalaa waltajii Baandii Sabbata Aayyoo waalin by Ayyaantummaa Entertainment August 7, 2021 by Ayyaantummaa Entertainment 6 months ago 9 minutes, 59 seconds 128 views",Ayyaantummaa Entertainment,128,129,1
535,"Abarra Indalaa waltajii Bandii Sabbata Aayyoo walin by Ayyaantummaa Entertainment 2021 by Ayyaantummaa Entertainment 6 months ago 10 minutes, 3 seconds 169 views",Ayyaantummaa Entertainment,169,172,3
536,"Baandii Biftuu oromiyaa waltajji jajjabina Rayyaa ittis biyyatif qopha'ee official video 2021 by Ayyaantummaa Entertainment 6 months ago 2 minutes, 27 seconds 151 views",Ayyaantummaa Entertainment,151,153,2
537,"new Ethiopian #oromomusic# present by Ayyaantummaa Entertainment subscribe our YouTube chanale 2021 by Ayyaantummaa Entertainment 6 months ago 4 minutes, 29 seconds 83 views",Ayyaantummaa Entertainment,83,83,0
538,"ZEWDUU SILAASHI OFFICIAL VIDEO 2021 by Ayyaantummaa Entertainment 7 months ago 3 minutes, 19 seconds 172 views",Ayyaantummaa Entertainment,172,173,1
539,EEBBA SHUBBISTOOTAA GAREE ALEEKS OFFICIAL VIDEO 2021 by Ayyaantummaa Entertainment 7 months ago 30 minutes 393 views,Ayyaantummaa Entertainment,393,394,1
540,"Abdul Basix Husen by Ayyaantummaa Entertainment 7 months ago 4 minutes, 27 seconds 72 views",Ayyaantummaa Entertainment,72,73,1
541,"ABERA ENDALE MALAN JIRAA STAGE PERFORMANCE OFFICIAL  MUSIC  VIDEO 2021 by Ayyaantummaa Entertainment 7 months ago 11 minutes, 43 seconds 294 views",Ayyaantummaa Entertainment,294,296,2
542,"Qa Qa Qaaq Zawuduu siilashii  Stage performance by Ayyaantummaa Entertainment 7 months ago 2 minutes, 12 seconds 239 views",Ayyaantummaa Entertainment,239,240,1
543,"July 11, 2021 by Ayyaantummaa Entertainment 7 months ago 26 seconds 168 views",Ayyaantummaa Entertainment,168,168,0
544,Taddasaa Qalbessaa by Ayyaantummaa Entertainment 7 months ago 33 seconds 207 views,Ayyaantummaa Entertainment,207,208,1
545,"TADESE KELBESA /SHURAGADA/ STAGE PERFORMANCE OFFICIAL  MUSIC  VIDEO 2021 by Ayyaantummaa Entertainment 7 months ago 7 minutes, 3 seconds 375 views",Ayyaantummaa Entertainment,375,375,0
546,Alex Denca group by Ayyaantummaa Entertainment 7 months ago 57 seconds 284 views,Ayyaantummaa Entertainment,284,285,1
547,"#Ayyaantummaa Entertainment #Dhaadannoo waggaa 1 ffaa Hacaaluuf shubbistootan qopha'ee by Ayyaantummaa Entertainment 8 months ago 3 minutes, 43 seconds 231 views",Ayyaantummaa Entertainment,231,234,3
548,"Taddasaa Qalbessa Baandii sabbata Ayyoo walin by Ayyaantummaa Entertainment 8 months ago 3 minutes, 40 seconds 440 views",Ayyaantummaa Entertainment,440,441,1
549,"new oromo music margitu warqina Burtukanee by Ayyaantummaa Entertainment 8 months ago 4 minutes, 12 seconds 4,889 views",Ayyaantummaa Entertainment,4889,4915,26
550,"Asaffaa caalaa Baandii sabbata Ayyoo walin...... by Ayyaantummaa Entertainment 8 months ago 1 minute, 44 seconds 482 views",Ayyaantummaa Entertainment,482,482,0
551,"wwwww Galaana Gaaromsaa best of best oromo music by Ayyaantummaa Entertainment 8 months ago 37 seconds 1,524 views",Ayyaantummaa Entertainment,1524,1536,12
552,"Caalaa Bultume konsarti Asuukoo irraatii sirbee by Ayyaantummaa Entertainment 9 months ago 3 minutes, 30 seconds 891 views",Ayyaantummaa Entertainment,891,896,5
553,"wwwŵw konsarti asuukoo irrati kan ..... by Ayyaantummaa Entertainment 9 months ago 4 minutes, 5 seconds 599 views",Ayyaantummaa Entertainment,599,601,2
554,"May 23, 2021 by Ayyaantummaa Entertainment 9 months ago 2 minutes, 21 seconds 435 views",Ayyaantummaa Entertainment,435,436,1
555,"May 21, 2021 by Ayyaantummaa Entertainment 9 months ago 1 minute, 2 seconds 304 views",Ayyaantummaa Entertainment,304,304,0
556,"Gabrummaa hundeen buqqifna yoo didee ilmaan itti guddifna official video 2021 by Ayyaantummaa Entertainment 9 months ago 4 minutes, 49 seconds 839 views",Ayyaantummaa Entertainment,839,845,6
557,"Eebbi Shubbistoota garee Aleeks kana fakkaata.Daawwadhaa,ittiin bohaaraa!yaada keessan nuuf qoodaa.2 by Ayyaantummaa Entertainment 10 months ago 15 minutes 1,053 views",Ayyaantummaa Entertainment,1053,1063,10
558,"Eebbi Shubbistoota garee Aleeks kana fakkaata.Daawwadhaa,ittiin bohaaraa!yaada keessan nuuf qoodaa. by Ayyaantummaa Entertainment 10 months ago 14 minutes, 58 seconds 1,226 views",Ayyaantummaa Entertainment,1226,1234,8
559,"MEESHA WARAANAA EEBBA KITAABA SHUBBISAA FI SHUBBISTOOTA ALEX IRRATTI QOPHAA'E OFFICIAL VIDEO 2021 by Ayyaantummaa Entertainment 10 months ago 6 minutes, 3 seconds 803 views",Ayyaantummaa Entertainment,803,808,5
560,"Geetuu Adunyaa Mukitgogan New Oromo Music Video 2021 Official Video by Ayyaantummaa Entertainment 1 year ago 4 minutes, 54 seconds 1,113 views",Ayyaantummaa Entertainment,1113,1118,5
561,"OROMO MUSIC BY AYYAANTUMMA ENTERTAINMENT by Ayyaantummaa Entertainment 1 year ago 29 minutes 1,072 views",Ayyaantummaa Entertainment,1072,1073,1
562,"#SHUBBISA #OROMO MUSIC #AYYAANTUMMAA# by Ayyaantummaa Entertainment 1 year ago 4 minutes, 47 seconds 829 views",Ayyaantummaa Entertainment,829,830,1
563,"Eebba shubbistootaa garee Alamaayyoo Dhaabii Official video 2020 by Ayyaantummaa Entertainment 1 year ago 2 minutes, 46 seconds 969 views",Ayyaantummaa Entertainment,969,970,1
564,"KADIJAA HAJII NEW AFAN OROMO MUSIC OFFICAIL VIDEO 2020 by Ayyaantummaa Entertainment 1 year ago 9 minutes, 13 seconds 7,182 views",Ayyaantummaa Entertainment,7182,7235,53
565,"MARGIITU WARQINA OFFICIAL MUSIC  VIDEO 2020 by Ayyaantummaa Entertainment 1 year ago 5 minutes, 33 seconds 10,761 views",Ayyaantummaa Entertainment,10761,10836,75
566,"EEBBA SHUBBISTOOTAA GAREE ALAMAAYYOO DHAABII PART 2 OFFICIAL VIDEO 2020 by Ayyaantummaa Entertainment 1 year ago 17 minutes 6,473 views",Ayyaantummaa Entertainment,6473,6521,48
567,"CAALAA DAGGAFAA ''KABADA BUZUNASHII MANATTI OLDACHAASE HUNDUMASHII'' OFFICIAL   MUSIC  VIDEO 2020 by Ayyaantummaa Entertainment 1 year ago 10 minutes, 35 seconds 54,968 views",Ayyaantummaa Entertainment,54968,55940,972
568,"MOGOROO JIFAAR ''HARKI HARKA  GANEE'' STAGE MUSIC  OFFICIAL VIDEO 2020 by Ayyaantummaa Entertainment 1 year ago 6 minutes, 25 seconds 10,445 views",Ayyaantummaa Entertainment,10445,10671,226
569,"EEBBA SHUBBISTOOTAA GAREE ALAMAAYYOO DHAABII PART 1 OFFICIAL VIDEO 2020 by Ayyaantummaa Entertainment 1 year ago 13 minutes, 54 seconds 6,013 views",Ayyaantummaa Entertainment,6013,6026,13
570,"Asafaa caala by Ayyaantummaa Entertainment 1 year ago 1 minute, 6 seconds 193 views",Ayyaantummaa Entertainment,193,194,1
571,"baga ayyana irreessa geesaani by Ayyaantummaa Entertainment 1 year ago 1 minute, 27 seconds 1,341 views",Ayyaantummaa Entertainment,1341,1341,0
572,"Jala bultii Irreecha bara 2020 by Ayyaantummaa Entertainment 1 year ago 2 minutes, 1 second 903 views",Ayyaantummaa Entertainment,903,903,0
573,"Awwayyee dawadha by Ayyaantummaa Entertainment 1 year ago 2 minutes, 2 seconds 286 views",Ayyaantummaa Entertainment,286,287,1
574,Aboo tokkumma sirba ijoollee kan siin Affeerera by Ayyaantummaa Entertainment 1 year ago 47 seconds 563 views,Ayyaantummaa Entertainment,563,563,0
575,"keekiyyaa badhaadhaa by Ayyaantummaa Entertainment 1 year ago 1 minute, 27 seconds 758 views",Ayyaantummaa Entertainment,758,760,2
576,"Goobee ykn Argee laallaa 2020 OFFICE by Ayyaantummaa Entertainment 1 year ago 27 seconds 1,239 views",Ayyaantummaa Entertainment,1239,1241,2
577,"Yaadannoo guyyaa 80  Haaceef by Ayyaantummaa Entertainment 1 year ago 1 minute, 14 seconds 118 views",Ayyaantummaa Entertainment,118,119,1
578,"SARBICHA SHERIF ABABUNA FIT CHALTU BUTO NEW MUSIC VIDEO 2020 by Ayyaantummaa Entertainment 1 year ago 4 minutes, 35 seconds 677 views",Ayyaantummaa Entertainment,677,680,3
579,"Naanatii by Ayyaantummaa Entertainment 1 year ago 5 minutes, 21 seconds 665 views",Ayyaantummaa Entertainment,665,665,0
580,"Kadijja hajji by Ayyaantummaa Entertainment 1 year ago 2 minutes, 3 seconds 2,026 views",Ayyaantummaa Entertainment,2026,2052,26
581,"Taddasa qalbessaa by Ayyaantummaa Entertainment 1 year ago 1 minute, 38 seconds 460 views",Ayyaantummaa Entertainment,460,460,0
582,Alex and naba by Ayyaantummaa Entertainment 1 year ago 52 seconds 345 views,Ayyaantummaa Entertainment,345,345,0
