,Posts,Channel,Views_03/03,Views_03/12,view_delta
0,"Ethiopian Music : Dawit Tsige  ዳዊት ፅጌ Yene Zema  (የኔ ዜማ) - New  2020 (Official Video Music) by Cultural Ethiopian Music Channel 1 year ago 4 minutes, 34 seconds 4,593 views",Cultural Ethiopian Music Channel,4593,4644,51
1,"Ethiopian Music : Dawit Tsige ዳዊት ፅጌ Degemo Bezih Lay (ደግሞ በዚህ ላይ) - New 2020 (Official Video Music) by Cultural Ethiopian Music Channel 1 year ago 4 minutes, 39 seconds 3,982 views",Cultural Ethiopian Music Channel,3982,4010,28
2,"Ethiopian Music : Dawit Tsige ዳዊት ፅጌ  Balageru 4  (ባላገሩ 4) -  New 2020 (Official Video Music) by Cultural Ethiopian Music Channel 2 years ago 6 minutes, 49 seconds 3,065 views",Cultural Ethiopian Music Channel,3065,3072,7
3,"Ethiopian Music : Dawit Tsige  ዳዊት ፅጌ Etittu  (እትቱ)  -  New 2020 (Official Video Music) by Cultural Ethiopian Music Channel 2 years ago 4 minutes, 37 seconds 2,234 views",Cultural Ethiopian Music Channel,2234,2244,10
4,"Ethiopian Music : Dawit Tsige ዳዊት ፅጌ Deha Aytala kewiha (ድሀ አይጣላ ከውሀ)-New2020 (Official Video Music) by Cultural Ethiopian Music Channel 2 years ago 6 minutes, 24 seconds 2,055 views",Cultural Ethiopian Music Channel,2055,2100,45
5,"Ethiopian Music : Dawit Teige  ዳዊት ፅጌ Lebe Sew  (ልቤ ሰው) -  New  2020 (Official Video Music) by Cultural Ethiopian Music Channel 2 years ago 5 minutes, 1 second 1,456 views",Cultural Ethiopian Music Channel,1456,1463,7
6,"Ethiopian Music : Dawit Tsige ዳዊት ፅጌ  Asmarino  (አስማሪኖ)  -  New 2020 (Official Video Music) by Cultural Ethiopian Music Channel 2 years ago 6 minutes, 24 seconds 1,200 views",Cultural Ethiopian Music Channel,1200,1202,2
7,"Ethiopian Music : Dawit Teige  ዳዊት ፅጌ Dese Alegn  (ደስ አለኝ) - New 2020 (Official Video Music) by Cultural Ethiopian Music Channel 2 years ago 5 minutes, 22 seconds 1,233 views",Cultural Ethiopian Music Channel,1233,1242,9
8,"Ethiopian Music : Dawit Tsige  ዳዊት ፅጌ  Yene yene ( የኔ የኔ) - New  2020 (Official Video Music) by Cultural Ethiopian Music Channel 2 years ago 4 minutes, 23 seconds 1,762 views",Cultural Ethiopian Music Channel,1762,1786,24
9,"Ethiopian Music : Dawit Tsige ዳዊት ፅጌ Bayew Bayew (ባየው ባየው) - New 2020 (Official Video Music) by Cultural Ethiopian Music Channel 2 years ago 5 minutes, 5 seconds 1,878 views",Cultural Ethiopian Music Channel,1878,1893,15
10,"Ethiopian Music : Dawit Tsige ዳዊት ፅጌ Chale Zendero (ቻለው ዘንድሮ) - New  2020 (Official Video Music) by Cultural Ethiopian Music Channel 2 years ago 3 minutes, 53 seconds 1,650 views",Cultural Ethiopian Music Channel,1650,1661,11
11,"Ethiopian Music : Dawit Tsige ዳዊት ፅጌ Wude Wude (ውዴ ውዴ) -  New 2020 (Official Video Music) by Cultural Ethiopian Music Channel 2 years ago 5 minutes, 35 seconds 2,855 views",Cultural Ethiopian Music Channel,2855,2870,15
12,"Ethiopian Music : Dawit Tsige  ዳዊት ፅጌ  Aschilosh  (አስችሎሽ) -  New  2020 (Official Video Music) by Cultural Ethiopian Music Channel 2 years ago 6 minutes, 50 seconds 1,350 views",Cultural Ethiopian Music Channel,1350,1370,20
13,"Ethiopian Music : Dawit Tsige ዳዊት ፅጌ  Kale Kidan   (ቃል ኪዳን ) - New  2020 (Official Video Music) by Cultural Ethiopian Music Channel 2 years ago 5 minutes, 10 seconds 7,282 views",Cultural Ethiopian Music Channel,7282,7323,41
14,"Ethiopian Music : Mikaya Behailu ሚኪያ በሃይሉ Kebrara (ቀብራራ) - New 1999 (Official Video) by Cultural Ethiopian Music Channel 2 years ago 5 minutes, 31 seconds 1,001 views",Cultural Ethiopian Music Channel,1001,1008,7
15,"Ethiopian Music :  Mikaya Behailu ሚኪያ በሃይሉ Zorie Metahu (ዞሬ መጣሁ) - New 1999 (Official Video) by Cultural Ethiopian Music Channel 2 years ago 6 minutes, 10 seconds 929 views",Cultural Ethiopian Music Channel,929,930,1
16,"Ethiopian Music : Mikaya Behailu ሚኪያ በሃይሉ Delelegne (ደለለኝ) - New 1999 (Official Video) by Cultural Ethiopian Music Channel 2 years ago 5 minutes, 32 seconds 2,917 views",Cultural Ethiopian Music Channel,2917,3160,243
17,"Ethiopian Music : Mikaya Behailu ሚኪያ በሃይሉ Astasgedidegne (አታስገድደኝ)  - New 1999 (Official Video) by Cultural Ethiopian Music Channel 2 years ago 4 minutes, 36 seconds 515 views",Cultural Ethiopian Music Channel,515,517,2
18,"Ethiopian Music : Mikaya Behailu ሚኪያ በሃይሉ Shemametew (ሸማመተው) - New 1999 (Official Video) by Cultural Ethiopian Music Channel 2 years ago 4 minutes, 47 seconds 652 views",Cultural Ethiopian Music Channel,652,655,3
19,"Ethiopian Music :  Mikaya Behailu ሚኪያ በሃይሉ Lemalmh (ለማልምህ) - New 1999 (Official Video) by Cultural Ethiopian Music Channel 2 years ago 5 minutes, 31 seconds 895 views",Cultural Ethiopian Music Channel,895,903,8
20,"Ethiopian Music : Mikaya Behailu ሚኪያ በሃይሉ Honelgne (ሆነልኝ) - New 1999 (Official Video) by Cultural Ethiopian Music Channel 2 years ago 3 minutes, 38 seconds 873 views",Cultural Ethiopian Music Channel,873,876,3
21,"Ethiopian Music :  Mikaya Behailu ሚኪያ በሃይሉ Yenie New (የኔ ነው) - New 1999 (Official Video) by Cultural Ethiopian Music Channel 2 years ago 3 minutes, 43 seconds 3,425 views",Cultural Ethiopian Music Channel,3425,3431,6
22,"Ethiopian Music :  Mikaya Behailu ሚኪያ በሃይሉ Sebeb (ሰበብ) - New 1999 (Official Video) by Cultural Ethiopian Music Channel 2 years ago 7 minutes, 42 seconds 1,319 views",Cultural Ethiopian Music Channel,1319,1365,46
23,"Ethiopian Music : Mikaya Behailu ሚኪያ በሃይሉ Lante Sil (ላንተ ሲል) - New 1999 (Official Video) by Cultural Ethiopian Music Channel 2 years ago 4 minutes, 10 seconds 1,081 views",Cultural Ethiopian Music Channel,1081,1089,8
24,"Ethiopian Music : Mikaya Behailu ሚኪያ በሃይሉ Nafekegne (ናፈቅከኝ) - New 1999 (Official Video) by Cultural Ethiopian Music Channel 2 years ago 5 minutes, 7 seconds 636 views",Cultural Ethiopian Music Channel,636,637,1
25,"Dag Daniel  ዳግ ዳንኤል Melse Ethiopiawi  (መልሴ ኢትዮጵያዊ)  - New Ethiopian Music 2019 (Official Video) by Cultural Ethiopian Music Channel 2 years ago 3 minutes, 49 seconds 623 views",Cultural Ethiopian Music Channel,623,625,2
26,"Dag Daniel  ዳግ ዳንኤል Sew Le Sew Gabcha (ሰው ለ ሰው ጋብቻ)  - New Ethiopian Music 2019 (Official Video) by Cultural Ethiopian Music Channel 2 years ago 4 minutes, 12 seconds 638 views",Cultural Ethiopian Music Channel,638,642,4
27,"Dag Daniel  ዳግ ዳንኤል Yelibe Daget  (የልቤ ዳገት)  - New Ethiopian Music 2019 (Official Video) by Cultural Ethiopian Music Channel 2 years ago 4 minutes, 1 second 1,022 views",Cultural Ethiopian Music Channel,1022,1026,4
28,"Dag Daniel  ዳግ ዳንኤል Alasebkum (ኣላሰብኩም) - New Ethiopian Music 2019 (Official Video) by Cultural Ethiopian Music Channel 2 years ago 4 minutes 1,643 views",Cultural Ethiopian Music Channel,1643,1655,12
29,"Dag Daniel  ዳግ ዳንኤል Monarastaliza  (ሞናራስታሊዛ)  - New Ethiopian Music 2019 (Official Video) by Cultural Ethiopian Music Channel 2 years ago 3 minutes, 41 seconds 1,199 views",Cultural Ethiopian Music Channel,1199,1205,6
30,"Dag Daniel  ዳግ ዳንኤል Stski  (ስትስቂ)   - New Ethiopian Music 2019 (Official Video) by Cultural Ethiopian Music Channel 2 years ago 2 minutes, 50 seconds 5,972 views",Cultural Ethiopian Music Channel,5972,6087,115
31,"Dag Daniel  ዳግ ዳንኤል Tayebsh Kuta  (ታየብሽ ቁጣ) - New Ethiopian Music 2019 (Official Video) by Cultural Ethiopian Music Channel 2 years ago 3 minutes, 56 seconds 660 views",Cultural Ethiopian Music Channel,660,663,3
32,"Dag Daniel  ዳግ ዳንኤል Atgemchi Sew (ኣትገምቺ ሰው)  - New Ethiopian Music 2019 (Official Video) by Cultural Ethiopian Music Channel 2 years ago 4 minutes, 16 seconds 555 views",Cultural Ethiopian Music Channel,555,558,3
33,"Dag Daniel ዳግ ዳንኤል Agegnew Set (ኣገኘሁ ሴት) - New Ethiopian Music 2019 (Official Video) by Cultural Ethiopian Music Channel 2 years ago 4 minutes, 29 seconds 993 views",Cultural Ethiopian Music Channel,993,1005,12
34,"Dag Daniel ዳግ ዳንኤል Bada  (ባዳ) - New Ethiopian Music 2019 (Official Video) by Cultural Ethiopian Music Channel 2 years ago 3 minutes, 40 seconds 997 views",Cultural Ethiopian Music Channel,997,1006,9
35,"Dag Daniel ዳግ ዳንኤል Yebalewa Konjo (የባሌዋ ቆንጆ) - New Ethiopian Music 2019 (Official Video) by Cultural Ethiopian Music Channel 2 years ago 3 minutes, 53 seconds 369 views",Cultural Ethiopian Music Channel,369,374,5
36,"Dag Daniel ዳግ ዳንኤል Sew Alay (ሰው ኣላይ) - New Ethiopian Music 2019 (Official Video) by Cultural Ethiopian Music Channel 2 years ago 3 minutes, 44 seconds 467 views",Cultural Ethiopian Music Channel,467,468,1
37,"Dag Daniel ዳግ ዳንኤል Anchi Nesh (ኣንቺ ነሽ) - New Ethiopian Music 2019 (Official Video) by Cultural Ethiopian Music Channel 2 years ago 3 minutes, 31 seconds 2,170 views",Cultural Ethiopian Music Channel,2170,2205,35
38,"Dag Daniel ዳግ ዳንኤል Meche New Mtmechiwa (መቼ ነው ምትመጪው)   - New Ethiopian Music 2019 (Official Video) by Cultural Ethiopian Music Channel 2 years ago 3 minutes, 19 seconds 952 views",Cultural Ethiopian Music Channel,952,964,12
39,"Dag Daniel  ዳግ ዳንኤል  Habesha  (ሀበሻ)  - New Ethiopian Music 2019 (Official Video) by Cultural Ethiopian Music Channel 2 years ago 3 minutes, 35 seconds 519 views",Cultural Ethiopian Music Channel,519,521,2
40,"Ethiopian Music : Mikiyas Chernet ሚኪያስ ቸርነት Ziyoze (ዚዮዜ) - New 2019 (Official Video) by Cultural Ethiopian Music Channel 2 years ago 5 minutes, 7 seconds 6,423 views",Cultural Ethiopian Music Channel,6423,6449,26
41,"Ethiopian Music : Mikiyas Chernet ሚኪያስ ቸርነት TsafewSemeshen (ፃፈው ስምሽን) - New 2019 (Official Video) by Cultural Ethiopian Music Channel 2 years ago 5 minutes, 2 seconds 4,645 views",Cultural Ethiopian Music Channel,4645,4666,21
42,"Ethiopian Music : Mikiyas Chernet ሚኪያስ ቸርነት Qere Dero (ቀረ ድሮ) - New 2019 (Official Video) by Cultural Ethiopian Music Channel 2 years ago 6 minutes, 20 seconds 3,043 views",Cultural Ethiopian Music Channel,3043,3056,13
43,"Ethiopian Music : Mikiyas Chernet ሚኪያስ ቸርነት QNLb Yashenefal (ቅንልብ ያሸንፋል) - New 2019 (Official Video) by Cultural Ethiopian Music Channel 2 years ago 5 minutes, 29 seconds 6,091 views",Cultural Ethiopian Music Channel,6091,6127,36
44,"Ethiopian Music : Mikiyas Chernet ሚኪያስ ቸርነት Meche new (መቼ ነው) - New 2019 (Official Video) by Cultural Ethiopian Music Channel 2 years ago 5 minutes, 24 seconds 10,347 views",Cultural Ethiopian Music Channel,10347,10431,84
45,"Ethiopian Music : Mikiyas Chernet ሚኪያስ ቸርነት Kiya (ኪያ) - New 2019 (Official Video) by Cultural Ethiopian Music Channel 2 years ago 5 minutes, 9 seconds 8,034 views",Cultural Ethiopian Music Channel,8034,8076,42
46,"Ethiopian Music : Mikiyas Chernet ሚኪያስ ቸርነት Bella New (ቤላ ነው) - New 2019 (Official Video) by Cultural Ethiopian Music Channel 2 years ago 5 minutes, 28 seconds 7,456 views",Cultural Ethiopian Music Channel,7456,7516,60
47,"Ethiopian Music : Mikiyas Chernet ሚኪያስ ቸርነት Bekalcho (በካልቾ) - New 2019 (Official Video) by Cultural Ethiopian Music Channel 2 years ago 4 minutes, 51 seconds 11,141 views",Cultural Ethiopian Music Channel,11141,11260,119
48,"Ethiopian Music : Mikiyas Chernet ሚኪያስ ቸርነት Baba Hode (ባባ ሆዴ) - New 2019 (Official Video) by Cultural Ethiopian Music Channel 2 years ago 5 minutes, 2 seconds 6,022 views",Cultural Ethiopian Music Channel,6022,6092,70
49,"Ethiopian Music : Mikiyas Chernet ሚኪያስ ቸርነት Aser Ke Aser (10 ከ10) - New 2019 (Official Video) by Cultural Ethiopian Music Channel 2 years ago 6 minutes, 11 seconds 7,142 views",Cultural Ethiopian Music Channel,7142,7181,39
50,"Ethiopian Music : Mikiyas Chernet ሚኪያስ ቸርነት And New Demachn (አንድ ነው ደማችን) - New 2019(Official Video) by Cultural Ethiopian Music Channel 2 years ago 5 minutes, 31 seconds 2,021 views",Cultural Ethiopian Music Channel,2021,2034,13
51,"Ethiopian Music : Mikiyas Chernet ሚኪያስ ቸርነት Ale Kenewezu (አለ ከነወዙ) - New 2019 (Official Video) by Cultural Ethiopian Music Channel 2 years ago 6 minutes, 25 seconds 3,239 views",Cultural Ethiopian Music Channel,3239,3263,24
52,"Ethiopian Music : Mikiyas Chernet ሚኪያስ ቸርነት Ahun Gebagn (አሁን ገባኝ) - New 2019 (Official Video) by Cultural Ethiopian Music Channel 2 years ago 6 minutes, 20 seconds 3,558 views",Cultural Ethiopian Music Channel,3558,3572,14
53,"Ethiopian Music : Mikiyas Chernet ሚኪያስ ቸርነት Turi Nafa (ቱሪ ናፍ) - New 2019 (Official Video) by Cultural Ethiopian Music Channel 2 years ago 4 minutes, 37 seconds 9,555 views",Cultural Ethiopian Music Channel,9555,9647,92
