,Posts,Channel,Views_03/03,Views_03/12,view_delta
0,Ethiopian music non stop | by Dj daniel Derso by Dj Daniel 1 month ago 32 minutes 33 views,DJ Daniel,33,38,5
1,"ethiopia new music 2022 | Mix by Dj Daniel Derso by Dj Daniel 1 month ago 1 hour, 4 minutes 79 views",DJ Daniel,79,84,5
2,ETHIOPIAN full MIX BEST MUSIC by Dj Daniel Derso by Dj Daniel 2 months ago 53 minutes 58 views,DJ Daniel,58,59,1
3,"Getnet & Bekalu @bro Embign Ale | እምብኝ አለ by Dj Daniel 2 months ago 5 minutes, 59 seconds 31 views",DJ Daniel,31,33,2
4,"Mngedegaw lbe | Mixes Dj Daniel Derso by Dj Daniel 1 year ago 5 minutes, 46 seconds 153 views",DJ Daniel,153,153,0
5,"Birhan Wubaye | Tenes Belew by Dj Daniel 1 year ago 4 minutes, 43 seconds 84 views",DJ Daniel,84,85,1
6,"Belayneh Fenta | Meta Meta Mix by Dj Daniel Derso by Dj Daniel 1 year ago 4 minutes, 18 seconds 181 views",DJ Daniel,181,183,2
7,"Tade Philo   Ere Marekechign  | ኧረ ማረከችኝ Mix by Dj Daniel Derso by Dj Daniel 1 year ago 6 minutes, 5 seconds 423 views",DJ Daniel,423,430,7
8,"Bazu Man (Ye Dejen Lej) Mixed By Daniel Derso by Dj Daniel 1 year ago 2 minutes, 30 seconds 157 views",DJ Daniel,157,160,3
9,"Hayleyesus Feyssa | ፍቅር ተወደደ Dj Daniel Derso by Dj Daniel 1 year ago 3 minutes, 20 seconds 523 views",DJ Daniel,523,536,13
10,"Yeshiwas Ayana - Melkame Mix By Dj Daniel Derso by Dj Daniel 1 year ago 1 minute, 58 seconds 415 views",DJ Daniel,415,434,19
11,"Mekdes Teshome Embiyew | እምቢየው by Dj Daniel 1 year ago 4 minutes, 8 seconds 155 views",DJ Daniel,155,159,4
12,"Dj daniel Derso ethiopia music by Dj Daniel 1 year ago 6 minutes, 31 seconds 1,401 views",DJ Daniel,1401,1403,2
13,"Saba Mulugeta | Ethiopian New Music | Mix By Dj daniel Derso by Dj Daniel 1 year ago 5 minutes, 38 seconds 206 views",DJ Daniel,206,207,1
14,"Dj Daniel Desro | ዳንኤል ደርሶ by Dj Daniel 1 year ago 4 minutes, 43 seconds 165 views",DJ Daniel,165,167,2
15,"Tesfaye Adugna - Mamarw MIX by Dj dabiel Derso by Dj Daniel 1 year ago 2 minutes, 19 seconds 2,020 views",DJ Daniel,2020,2040,20
16,Birhanu Chala mix by Dj Daniel Derso by Dj Daniel 1 year ago 5 minutes 293 views,DJ Daniel,293,295,2
17,"Ehiopian Best music | Asheber Belay Bel Gitem by Dj Daniel 1 year ago 5 minutes, 2 seconds 280 views",DJ Daniel,280,280,0
18,"Amare Menberu  Abshir Beyign by Dj Daniel 2 years ago 5 minutes, 50 seconds 4,902 views",DJ Daniel,4902,4912,10
19,"Solomon Habte Dj #Daniel Derso by Dj Daniel 2 years ago 5 minutes, 12 seconds 293 views",DJ Daniel,293,295,2
20,"Fisseha Wedaj | Salayesh By Dj Daniel Mix by Dj Daniel 2 years ago 4 minutes, 50 seconds 317 views",DJ Daniel,317,318,1
21,"Dj Danuel derso by Dj Daniel 2 years ago 5 minutes, 7 seconds 175 views",DJ Daniel,175,176,1
22,"Bizuayew Berihun Best ethiopian music 2019 by Dj Daniel 2 years ago 5 minutes, 16 seconds 141 views",DJ Daniel,141,141,0
23,"Tigist Aschilegn - Des Yilegnal |+| Dj Daniel mix by Dj Daniel 2 years ago 2 minutes, 35 seconds 145 views",DJ Daniel,145,145,0
24,"ዲጄ ዳናኤል ደርሶ 058-417-3217 by Dj Daniel 2 years ago 3 minutes, 31 seconds 232 views",DJ Daniel,232,232,0
25,"Semahegn Belew mix by Dj Daniel Derso by Dj Daniel 2 years ago 2 minutes, 53 seconds 697 views",DJ Daniel,697,701,4
26,"Alex Anteneh ከዲጄ ዳኔል by Dj Daniel 2 years ago 2 minutes, 38 seconds 97 views",DJ Daniel,97,103,6
27,"Mekdes Zewdu | Best Raya music by Dj Daniel Derso by Dj Daniel 2 years ago 4 minutes, 51 seconds 1,619 views",DJ Daniel,1619,1660,41
28,"DJ Daniel 058-417-3217 by Dj Daniel 2 years ago 1 minute, 18 seconds 82 views",DJ Daniel,82,82,0
29,Ethiopian best music 2020 by Dj Daniel 2 years ago 3 minutes 131 views,DJ Daniel,131,131,0
30,"Selamawit Yohannes | mix by Dj Daniel Derso by Dj Daniel 3 years ago 2 minutes, 21 seconds 268 views",DJ Daniel,268,269,1
31,"DJ Daniel די ג'יי דניאל ዲጄ ዳንኤል by Dj Daniel 3 years ago 1 minute, 31 seconds 149 views",DJ Daniel,149,149,0
32,"Tesfaye adugna - balaye by Dj Daniel Derso by Dj Daniel 3 years ago 4 minutes, 41 seconds 7,169 views",DJ Daniel,7169,7242,73
33,"Zenebe Worku - Man Zim Yilal | ማን ዝም ይላል by Dj Daniel 3 years ago 4 minutes, 6 seconds 805 views",DJ Daniel,805,805,0
34,"Dj Daniel Derso 058-417-3217 by Dj Daniel 3 years ago 5 minutes, 50 seconds 640 views",DJ Daniel,640,641,1
35,"Baye Speedy - filfilu - ENDURANCE (Main Titles) 1999 - Theodros Tadesse (by John Powell) by DJ SPEEDY ENTERTAINMENT 9 years ago 2 minutes, 31 seconds 33,014 views",DJ SPEEDY ENTERTAINMENT,33014,33138,124
36,"Baye Speedy - filfilu - Qine - Yeshi Demelash (Ethiopian Classic Music) by DJ SPEEDY ENTERTAINMENT 9 years ago 4 minutes, 16 seconds 13,932 views",DJ SPEEDY ENTERTAINMENT,13932,13998,66
37,"Baye Speedy - filfilu - Demo Afe (ደሞ አፌ) - Jacky Gosee by DJ SPEEDY ENTERTAINMENT 9 years ago 4 minutes, 30 seconds 46,539 views",DJ SPEEDY ENTERTAINMENT,46539,46890,351
38,"Baye Speedy - filfilu - Abejehu - Betelhem Bekele by DJ SPEEDY ENTERTAINMENT 9 years ago 5 minutes, 8 seconds 24,219 views",DJ SPEEDY ENTERTAINMENT,24219,24570,351
39,"Baye Speedy - filfilu - Tileye Ababiye - Helen Tilahun Gessesse by DJ SPEEDY ENTERTAINMENT 9 years ago 4 minutes, 7 seconds 168,996 views",DJ SPEEDY ENTERTAINMENT,168996,169037,41
40,"Baye Speedy - filfilu - Moten Bayne Endalay (Yebizuye Mastawosha) - Kuku Sebsibe by DJ SPEEDY ENTERTAINMENT 9 years ago 4 minutes, 50 seconds 7,810 views",DJ SPEEDY ENTERTAINMENT,7810,7840,30
41,"Baye Speedy - filfilu - MAN NEBER - Girma Tefera Kassa fet. Mahamud Ahmed by DJ SPEEDY ENTERTAINMENT 9 years ago 4 minutes, 54 seconds 19,549 views",DJ SPEEDY ENTERTAINMENT,19549,19584,35
42,"Baye Speedy - filfilu - Sawa Sawalegn (The Ethiopian Version) - Ziggy Zaga (Kenu) fet.Teddy Yo by DJ SPEEDY ENTERTAINMENT 9 years ago 3 minutes, 30 seconds 8,975 views",DJ SPEEDY ENTERTAINMENT,8975,9011,36
43,"Baye Speedy * filfilu * Gondergna (ጎንደርኛ) * MC Mike & Yoni Yoye ft Filfilu * by DJ SPEEDY ENTERTAINMENT 9 years ago 5 minutes, 41 seconds 10,485 views",DJ SPEEDY ENTERTAINMENT,10485,10513,28
44,"Baye Speedy - filfilu - Coupe' de'cale' (LEBEA) -Nhatty ft Betty and G.Stephane by DJ SPEEDY ENTERTAINMENT 10 years ago 4 minutes, 46 seconds 18,227 views",DJ SPEEDY ENTERTAINMENT,18227,18390,163
45,"Baye Speedy - filfilu - Yebereha Sidetegna - Kuku Sebsibe fet. Teddy Afro by DJ SPEEDY ENTERTAINMENT 10 years ago 4 minutes, 56 seconds 14,069 views",DJ SPEEDY ENTERTAINMENT,14069,14087,18
46,"Baye Speedy - filfilu - New Ukown Dance With Tigregna Music :) by DJ SPEEDY ENTERTAINMENT 10 years ago 3 minutes, 47 seconds 23,783 views",DJ SPEEDY ENTERTAINMENT,23783,23822,39
47,"Baye Speedy - filfilu - Helen Berhe live in Calgary Saturday, August 6th 2011 by DJ SPEEDY ENTERTAINMENT 10 years ago 59 seconds 84,718 views",DJ SPEEDY ENTERTAINMENT,84718,84768,50
48,"Baye Speedy - filfilu - Yandu Ken - Eruk Abiy by DJ SPEEDY ENTERTAINMENT 10 years ago 5 minutes, 32 seconds 15,858 views",DJ SPEEDY ENTERTAINMENT,15858,15897,39
49,"Baye Speedy - filfilu - Hasabun Mesreke - Sayat Demissie by DJ SPEEDY ENTERTAINMENT 10 years ago 5 minutes, 36 seconds 3,746 views",DJ SPEEDY ENTERTAINMENT,3746,3756,10
50,"Baye Speedy - filfilu - BEQA - Nati Halie (official music video) by DJ SPEEDY ENTERTAINMENT 10 years ago 1 minute 4,406 views",DJ SPEEDY ENTERTAINMENT,4406,4413,7
51,"Baye Speedy - filfilu - GirGir - Sajin Dokillie by DJ SPEEDY ENTERTAINMENT 10 years ago 12 minutes, 25 seconds 14,190 views",DJ SPEEDY ENTERTAINMENT,14190,14226,36
52,"Baye Speedy - filfilu - Spanesen Battery - filfilu & Oh My Kiristos (E.T.V Add) by DJ SPEEDY ENTERTAINMENT 10 years ago 46 seconds 4,646 views",DJ SPEEDY ENTERTAINMENT,4646,4670,24
53,"Baye Speedy - filfilu - AWASH - Filflu and Betelhem by DJ SPEEDY ENTERTAINMENT 10 years ago 8 minutes, 3 seconds 82,196 views",DJ SPEEDY ENTERTAINMENT,82196,82222,26
54,"Baye Speedy - filfilu - Abreham G/Medehin @ Teddy Mak - STUDIO 10 by DJ SPEEDY ENTERTAINMENT 10 years ago 6 minutes, 20 seconds 10,799 views",DJ SPEEDY ENTERTAINMENT,10799,11024,225
55,"Baye Speedy - filfilu - Na Na Neyi Neyi - Tigisit Woyiso by DJ SPEEDY ENTERTAINMENT 10 years ago 6 minutes, 40 seconds 17,127 views",DJ SPEEDY ENTERTAINMENT,17127,17144,17
56,"Baye Speedy - filfilu - Yewnetuan Naw - Eyob Mekonnen (Eliyas Melka) by DJ SPEEDY ENTERTAINMENT 10 years ago 5 minutes, 7 seconds 4,420 views",DJ SPEEDY ENTERTAINMENT,4420,4434,14
57,"Baye Speedy - filfilu - KUCHITEN BE ESKISTA (4 ABAY) - Tadele Roba & Mesfen Bekele (KAMUZU KASSA) by DJ SPEEDY ENTERTAINMENT 10 years ago 5 minutes, 53 seconds 12,719 views",DJ SPEEDY ENTERTAINMENT,12719,12739,20
58,"Baye Speedy - filfilu - YeSILTEWA KONJO -  የስልጤዋ ቆንጆ (New Ethiopian hot song) by DJ SPEEDY ENTERTAINMENT 10 years ago 3 minutes, 55 seconds 4,209 views",DJ SPEEDY ENTERTAINMENT,4209,4215,6
59,"Baye Speedy - filfilu - Tigregna be Gurragie (Niehnishe Gere) - Melkau Bireda by DJ SPEEDY ENTERTAINMENT 10 years ago 5 minutes, 4 seconds 16,468 views",DJ SPEEDY ENTERTAINMENT,16468,16481,13
60,"Baye Speedy - filfilu - Twist be Gurragie - Melaku Bireda by DJ SPEEDY ENTERTAINMENT 10 years ago 5 minutes, 20 seconds 6,467 views",DJ SPEEDY ENTERTAINMENT,6467,6480,13
61,"Baye Speedy - filfilu - Melaku Bireda's - Yimar Band by DJ SPEEDY ENTERTAINMENT 10 years ago 46 seconds 5,555 views",DJ SPEEDY ENTERTAINMENT,5555,5559,4
62,"Baye Speedy - filfilu - Melaku Bireda's Twist be Gurragie - New Album ADV. by DJ SPEEDY ENTERTAINMENT 10 years ago 44 seconds 6,241 views",DJ SPEEDY ENTERTAINMENT,6241,6251,10
63,"Baye Speedy - filfilu - Happy 122th BirthDay Charlie Chaplin by Google by DJ SPEEDY ENTERTAINMENT 10 years ago 2 minutes, 8 seconds 3,097 views",DJ SPEEDY ENTERTAINMENT,3097,3099,2
64,"Baye Speedy - filfilu - Nanahi - Saliha Sami by DJ SPEEDY ENTERTAINMENT 10 years ago 5 minutes, 12 seconds 43,228 views",DJ SPEEDY ENTERTAINMENT,43228,43246,18
65,"Baye Speedy - filfilu - Des Yibelegne - NHATTY - MAN - Natnael Ayalew by DJ SPEEDY ENTERTAINMENT 10 years ago 5 minutes, 8 seconds 18,731 views",DJ SPEEDY ENTERTAINMENT,18731,18745,14
66,"Baye Speedy - filfilu- BREAKING NEWS 2 - TESHOME - finally comes down after 7 months by DJ SPEEDY ENTERTAINMENT 10 years ago 2 minutes, 9 seconds 9,026 views",DJ SPEEDY ENTERTAINMENT,9026,9058,32
67,"Baye Speedy - filfilu - BREAKING NEWS 1 - TESHOME - refuses to come down from a tree branch by DJ SPEEDY ENTERTAINMENT 10 years ago 3 minutes, 6 seconds 3,879 views",DJ SPEEDY ENTERTAINMENT,3879,3885,6
68,"Baye Speedy - filfilu - Chirash - Gosee ( Jacky ) by DJ SPEEDY ENTERTAINMENT 10 years ago 4 minutes, 10 seconds 20,339 views",DJ SPEEDY ENTERTAINMENT,20339,20357,18
69,"Baye Speedy - filfilu - Japan Earthquake and Tsunami - Friday, March 11, 2011 ( NEW VIDEO) by DJ SPEEDY ENTERTAINMENT 10 years ago 5 minutes, 45 seconds 3,479 views",DJ SPEEDY ENTERTAINMENT,3479,3484,5
70,"Baye Speedy - filfilu - The Four Cleaners - IZY production by DJ SPEEDY ENTERTAINMENT 10 years ago 3 minutes, 11 seconds 5,116 views",DJ SPEEDY ENTERTAINMENT,5116,5119,3
71,"Baye Speedy - filfilu- REGGAE KEMISE - Semere (Seme-X) fet. Hailu by DJ SPEEDY ENTERTAINMENT 10 years ago 5 minutes, 14 seconds 8,260 views",DJ SPEEDY ENTERTAINMENT,8260,8281,21
72,"Baye Speedy - filfilu - KeBeir Chaf - Abebayehu Tadesse's Interview by DJ SPEEDY ENTERTAINMENT 10 years ago 7 minutes, 33 seconds 3,534 views",DJ SPEEDY ENTERTAINMENT,3534,3536,2
73,"Baye Speedy - filfilu - Melkie - Nhatty - Natnael Ayalew by DJ SPEEDY ENTERTAINMENT 10 years ago 3 minutes, 54 seconds 6,019 views",DJ SPEEDY ENTERTAINMENT,6019,6025,6
74,"Baye Speedy - filfilu - MaN - Nhatty - Natnael Ayalew by DJ SPEEDY ENTERTAINMENT 11 years ago 3 minutes, 51 seconds 50,720 views",DJ SPEEDY ENTERTAINMENT,50720,50728,8
75,"Baye Speedy - filfilu - Kefitret Yekeresh - Tadele Roba (Lafonatine) by DJ SPEEDY ENTERTAINMENT 11 years ago 4 minutes, 53 seconds 269,594 views",DJ SPEEDY ENTERTAINMENT,269594,270620,1026
76,"Baye Speedy - filfilu - LibbiE - Abiy yilma,Tokichaw, Mulualem siferaw (MessengerS) by DJ SPEEDY ENTERTAINMENT 11 years ago 5 minutes, 16 seconds 10,890 views",DJ SPEEDY ENTERTAINMENT,10890,10909,19
77,"Baye Speedy - filfilu - Ethiopian Dud Dance Group by DJ SPEEDY ENTERTAINMENT 11 years ago 8 minutes, 43 seconds 338,437 views",DJ SPEEDY ENTERTAINMENT,338437,338445,8
78,"Baye Speedy - filfilu -  Ene Negne Yale - Ashebir Belay (GoJaM) by DJ SPEEDY ENTERTAINMENT 11 years ago 5 minutes, 24 seconds 31,604 views",DJ SPEEDY ENTERTAINMENT,31604,31622,18
79,"Baye Speedy - filfilu - Mike Tyson's Best Interview Reply by DJ SPEEDY ENTERTAINMENT 11 years ago 1 minute, 5 seconds 2,765 views",DJ SPEEDY ENTERTAINMENT,2765,2766,1
80,"filfilu- Cairo, Egypt - Diplomatic White Van Runs Over Crowd & Kills More Than 20 PPL by DJ SPEEDY ENTERTAINMENT 11 years ago 3 minutes, 29 seconds 2,228 views",DJ SPEEDY ENTERTAINMENT,2228,2230,2
81,"Baye Speedy - filfilu - TIZIBIT NAW - reMiX - Abresh z Get ( Kennedy Mengesha ) by DJ SPEEDY ENTERTAINMENT 11 years ago 4 minutes, 49 seconds 39,122 views",DJ SPEEDY ENTERTAINMENT,39122,39162,40
82,"Baye Speedy - filfilu - Man Naw Tew Yemilegne - Birhanu Tezera ft Tsegaye Dendena by DJ SPEEDY ENTERTAINMENT 11 years ago 4 minutes, 25 seconds 10,012 views",DJ SPEEDY ENTERTAINMENT,10012,10026,14
83,"Baye Speedy - filfilu - TEGA BEY TEGA - Gojam - Eskedar Amsalu by DJ SPEEDY ENTERTAINMENT 11 years ago 6 minutes, 46 seconds 72,300 views",DJ SPEEDY ENTERTAINMENT,72300,72356,56
84,"Baye Speedy - filfilu - Himemie - Tsedenya G/Markos by DJ SPEEDY ENTERTAINMENT 11 years ago 4 minutes, 46 seconds 15,426 views",DJ SPEEDY ENTERTAINMENT,15426,15455,29
85,"Baye Speedy - filfilu - Yegeberie Lij - Geter Wubet Allew - Selamnesh Zemene by DJ SPEEDY ENTERTAINMENT 11 years ago 5 minutes, 3 seconds 63,668 views",DJ SPEEDY ENTERTAINMENT,63668,63898,230
86,"Baye Speedy - filfilu - AS KOOTU, ASIN JIIRRA - Abbitoo Kabbadaa's - Nigussuu Taammiraat by DJ SPEEDY ENTERTAINMENT 11 years ago 4 minutes, 36 seconds 819,243 views",DJ SPEEDY ENTERTAINMENT,819243,819875,632
87,"Baye Speedy - filfilu - ZUMBARRA  (BENISHANGUL) Dimonde Melkamu fe. Asne Abate by DJ SPEEDY ENTERTAINMENT 11 years ago 4 minutes, 25 seconds 8,230 views",DJ SPEEDY ENTERTAINMENT,8230,8236,6
88,"BAYE SPEEDY - filfilu - Selel - Tadesse Alemu (Tigregna Wedding Song) by DJ SPEEDY ENTERTAINMENT 11 years ago 7 minutes, 45 seconds 51,644 views",DJ SPEEDY ENTERTAINMENT,51644,51659,15
89,"BAYE SPEDDY - filfilu - GAMAKUM - TSEGAZEAB G/SILASSIE by DJ SPEEDY ENTERTAINMENT 11 years ago 7 minutes, 2 seconds 3,958 views",DJ SPEEDY ENTERTAINMENT,3958,3961,3
90,"Baye Speedy - filfilu - Tigrigna wedding song - Aziz Hagos by DJ SPEEDY ENTERTAINMENT 11 years ago 7 minutes, 29 seconds 5,527 views",DJ SPEEDY ENTERTAINMENT,5527,5618,91
91,"Baye Speedy - filfilu - * LITTLE ETHIOPIA * Washington DC - CNN.COM by DJ SPEEDY ENTERTAINMENT 11 years ago 4 minutes, 9 seconds 12,759 views",DJ SPEEDY ENTERTAINMENT,12759,12764,5
92,"Baye Speedy - filfilu - Dessie - Maritu Legesse by DJ SPEEDY ENTERTAINMENT 11 years ago 5 minutes, 20 seconds 58,513 views",DJ SPEEDY ENTERTAINMENT,58513,58676,163
93,"Baye Speedy - filfilu - Gezana - Solomon Haile by DJ SPEEDY ENTERTAINMENT 11 years ago 5 minutes, 15 seconds 36,318 views",DJ SPEEDY ENTERTAINMENT,36318,36327,9
94,"Baye Speedy - filfilu - YIGERMENILO - Solomon Haile by DJ SPEEDY ENTERTAINMENT 11 years ago 5 minutes, 27 seconds 13,413 views",DJ SPEEDY ENTERTAINMENT,13413,13422,9
95,"Baye Speedy - filfilu - Liwamey - Solomon Haile by DJ SPEEDY ENTERTAINMENT 11 years ago 5 minutes, 18 seconds 21,088 views",DJ SPEEDY ENTERTAINMENT,21088,21130,42
96,"Baye Speedy - Chaw Chaw - Tadelle Roba / Hunante Mullu [New Amharic Animation] by DJ SPEEDY ENTERTAINMENT 11 years ago 5 minutes, 33 seconds 14,364 views",DJ SPEEDY ENTERTAINMENT,14364,14452,88
97,"Baye Speedy - filfilu - YAWEWE - Mewded Kebru by DJ SPEEDY ENTERTAINMENT 11 years ago 8 minutes, 3 seconds 16,281 views",DJ SPEEDY ENTERTAINMENT,16281,16281,0
98,"Baye Speedy - filfilu - TIZITA 2010 - Michael Belayneh by DJ SPEEDY ENTERTAINMENT 11 years ago 7 minutes, 6 seconds 349,639 views",DJ SPEEDY ENTERTAINMENT,349639,349654,15
99,"Baye Speedy - filfilu - Lucy Boyz by DJ SPEEDY ENTERTAINMENT 11 years ago 3 minutes, 37 seconds 7,596 views",DJ SPEEDY ENTERTAINMENT,7596,7612,16
100,"Baye Speddy - filfilu - TEW TEW - Teddy Yo by DJ SPEEDY ENTERTAINMENT 11 years ago 4 minutes, 33 seconds 3,602 views",DJ SPEEDY ENTERTAINMENT,3602,3606,4
101,"Baye Speedy - filfilu - Arada Larada - Faf Crazzy by DJ SPEEDY ENTERTAINMENT 11 years ago 4 minutes, 13 seconds 9,424 views",DJ SPEEDY ENTERTAINMENT,9424,9432,8
102,"Baye Speedy - filfilu - UNE, ULY - Dereje Haile (comedy) by DJ SPEEDY ENTERTAINMENT 11 years ago 2 minutes, 3 seconds 45,334 views",DJ SPEEDY ENTERTAINMENT,45334,45343,9
103,"Baye Speedy - filfilu - MULULEGNE P.2 - DEREGE HAILE comedy by DJ SPEEDY ENTERTAINMENT 11 years ago 1 minute, 2 seconds 29,760 views",DJ SPEEDY ENTERTAINMENT,29760,29769,9
104,"Baye Speedy - filfilu - NUZAZIE - FILFILU NEW september 2010 by DJ SPEEDY ENTERTAINMENT 11 years ago 12 minutes, 32 seconds 464,296 views",DJ SPEEDY ENTERTAINMENT,464296,464480,184
105,"Baye Speedy - filfilu - LEBE - Helen Berhe (Halle Berry) by DJ SPEEDY ENTERTAINMENT 11 years ago 5 minutes, 5 seconds 61,240 views",DJ SPEEDY ENTERTAINMENT,61240,61260,20
106,"Baye Speedy - filfilu - CHIFERRAW DERRA - Henok Abebe fet, Nhatty (Natnael Ayelew) by DJ SPEEDY ENTERTAINMENT 11 years ago 4 minutes, 42 seconds 3,552 views",DJ SPEEDY ENTERTAINMENT,3552,3563,11
107,"Baye Speedy * filfilu * BEQA * Nati Haile (new song with lyrics) by DJ SPEEDY ENTERTAINMENT 11 years ago 4 minutes, 19 seconds 23,026 views",DJ SPEEDY ENTERTAINMENT,23026,23037,11
108,"Baye Speedy * filfilu * ADDIS ALEM * Teddy Afro (FIKIR ESKE MEKABIR) by DJ SPEEDY ENTERTAINMENT 11 years ago 5 minutes, 13 seconds 7,771 views",DJ SPEEDY ENTERTAINMENT,7771,7774,3
109,"Baye Speedy * filfilu * Empire State Of Mind * Alicia Keys & Jay Z (Brit Awards 2010) by DJ SPEEDY ENTERTAINMENT 11 years ago 4 minutes, 46 seconds 1,451 views",DJ SPEEDY ENTERTAINMENT,1451,1454,3
110,"Baye Speedy * filfilu * Chamballalla Reggae Ethiopia * Masinko remix by DJ SPEEDY ENTERTAINMENT 11 years ago 4 minutes, 54 seconds 7,472 views",DJ SPEEDY ENTERTAINMENT,7472,7476,4
111,"Baye Speedy * speedy * Ere Na Gobezu * Asrat Bossenna by DJ SPEEDY ENTERTAINMENT 11 years ago 4 minutes, 27 seconds 20,811 views",DJ SPEEDY ENTERTAINMENT,20811,20821,10
112,"Baye speedy - filfilu - Negen Layew - Eyob Mekonen by DJ SPEEDY ENTERTAINMENT 11 years ago 5 minutes, 33 seconds 1,695 views",DJ SPEEDY ENTERTAINMENT,1695,1701,6
113,"Baye Speedy - filfilu - Belomi Benna - Mahmoud Ahmed & badumes band by DJ SPEEDY ENTERTAINMENT 11 years ago 6 minutes, 55 seconds 1,439 views",DJ SPEEDY ENTERTAINMENT,1439,1442,3
114,"Baye Speedy - filfilu - Yewoyin Haregitwa - Alemayehu Eshete & badume's band by DJ SPEEDY ENTERTAINMENT 11 years ago 7 minutes, 59 seconds 2,113 views",DJ SPEEDY ENTERTAINMENT,2113,2117,4
115,"Baye Speedy - filfilu - Tizita - mahmoud ahmed & badume's band by DJ SPEEDY ENTERTAINMENT 11 years ago 6 minutes, 6 seconds 9,011 views",DJ SPEEDY ENTERTAINMENT,9011,9014,3
116,"Baye Speedy - filfilu - Mella Mella - Mahmoud Ahmed & badume's band by DJ SPEEDY ENTERTAINMENT 11 years ago 8 minutes, 28 seconds 28,822 views",DJ SPEEDY ENTERTAINMENT,28822,28823,1
117,"Baye Speedy - filfilu - Chaf Woraj Alle - DJ Same ft. Teddy Yo by DJ SPEEDY ENTERTAINMENT 11 years ago 4 minutes, 15 seconds 7,277 views",DJ SPEEDY ENTERTAINMENT,7277,7289,12
118,"Baye Speedy - filfilu - No Games - Serani by DJ SPEEDY ENTERTAINMENT 11 years ago 3 minutes, 15 seconds 4,341 views",DJ SPEEDY ENTERTAINMENT,4341,4347,6
119,"Baye Speedy - filfilu - Na Na Na - Bethlehem TekleMariyam by DJ SPEEDY ENTERTAINMENT 11 years ago 4 minutes, 38 seconds 18,409 views",DJ SPEEDY ENTERTAINMENT,18409,18421,12
120,"Baye Speedy - filfilu - Tegga Bey - Teddy Yo ft. Marry by DJ SPEEDY ENTERTAINMENT 11 years ago 3 minutes, 58 seconds 4,860 views",DJ SPEEDY ENTERTAINMENT,4860,4895,35
121,"Baye Speedy - filfilu -  Dafii Kootu - Jambo Jote JJ by DJ SPEEDY ENTERTAINMENT 11 years ago 4 minutes, 42 seconds 6,275 views",DJ SPEEDY ENTERTAINMENT,6275,6293,18
122,"Baye Speedy - filfilu - LIYU - Henok Abebe - DJ Fatsu by DJ SPEEDY ENTERTAINMENT 11 years ago 3 minutes, 35 seconds 3,286 views",DJ SPEEDY ENTERTAINMENT,3286,3291,5
123,"Baye Speedy - filfilu - Bey Isti - Beysti - Henok Abebe by DJ SPEEDY ENTERTAINMENT 11 years ago 3 minutes, 28 seconds 12,245 views",DJ SPEEDY ENTERTAINMENT,12245,12251,6
124,"Baye Speedy - filfilu - Fikir Yizogne - Bethlehem TekleMariyam by DJ SPEEDY ENTERTAINMENT 11 years ago 4 minutes, 54 seconds 328,045 views",DJ SPEEDY ENTERTAINMENT,328045,328102,57
125,"Baye Speedy - filfilu - SABA SABINA Re-mix - Hameru (A.J) by DJ SPEEDY ENTERTAINMENT 11 years ago 5 minutes, 16 seconds 3,444 views",DJ SPEEDY ENTERTAINMENT,3444,3452,8
126,"Baye Speedy - filfilu - she is mine - YENE NAT - Jonny Ragga feat. k'alyn by DJ SPEEDY ENTERTAINMENT 11 years ago 4 minutes, 44 seconds 9,160 views",DJ SPEEDY ENTERTAINMENT,9160,9166,6
127,"Baye Speedy - filfilu - HISAB / CHEMESTRY - Alex Olompiya by DJ SPEEDY ENTERTAINMENT 11 years ago 5 minutes, 3 seconds 14,930 views",DJ SPEEDY ENTERTAINMENT,14930,14932,2
128,"Baye Speedy - filfilu - LIBBIE - NATI - Nhatty new single by DJ SPEEDY ENTERTAINMENT 11 years ago 4 minutes, 39 seconds 29,897 views",DJ SPEEDY ENTERTAINMENT,29897,29903,6
129,"Baye Speedy - filfilu - BYE BYE - Netsanet Melesse - NEW BALAGERU by DJ SPEEDY ENTERTAINMENT 11 years ago 7 minutes, 6 seconds 28,243 views",DJ SPEEDY ENTERTAINMENT,28243,28379,136
130,"Baye Speedy - filfilu - Ethiopian idol in the memory of Tilahun Gessesse by DJ SPEEDY ENTERTAINMENT 11 years ago 10 minutes, 9 seconds 16,092 views",DJ SPEEDY ENTERTAINMENT,16092,16107,15
131,"Baye Speedy - filfilu - MENGEDEGNA - GIGI LIVE - Ejigayehu Shibabaw fet. Tabla Beat Science by DJ SPEEDY ENTERTAINMENT 11 years ago 10 minutes, 53 seconds 142,601 views",DJ SPEEDY ENTERTAINMENT,142601,143077,476
132,"Baye Speedy - filfilu - CHAT, KHAT YAMEREKINAL - HARARA by DJ SPEEDY ENTERTAINMENT 11 years ago 6 minutes, 51 seconds 24,408 views",DJ SPEEDY ENTERTAINMENT,24408,24424,16
133,"Baye Speedy - filfilu - Tikus Dinich - Amharic comedy - funny by DJ SPEEDY ENTERTAINMENT 11 years ago 6 minutes, 13 seconds 155,122 views",DJ SPEEDY ENTERTAINMENT,155122,155272,150
134,"Baye Speedy - filfilu - Ende Rasish - Behailu Tafese (ZIGI MAN) by DJ SPEEDY ENTERTAINMENT 12 years ago 4 minutes, 53 seconds 4,627 views",DJ SPEEDY ENTERTAINMENT,4627,4629,2
135,"Baye Speedy - filfilu - Kamisee - Jambboo Jottie - Wello-Oromo by DJ SPEEDY ENTERTAINMENT 12 years ago 5 minutes, 57 seconds 19,294 views",DJ SPEEDY ENTERTAINMENT,19294,19297,3
136,"Baye Speedy - filfilu - Girra Gebagne - Daniel Fessehaye (Amharic blues) by DJ SPEEDY ENTERTAINMENT 12 years ago 5 minutes, 31 seconds 33,127 views",DJ SPEEDY ENTERTAINMENT,33127,33182,55
137,"Baye Speedy - filfilu - Alebsise - Zemma Sabawiyan by DJ SPEEDY ENTERTAINMENT 12 years ago 4 minutes, 42 seconds 12,856 views",DJ SPEEDY ENTERTAINMENT,12856,12869,13
138,"Baye Speedy - filfilu - Konjo - Dagmawi Ali on z Bass by DJ SPEEDY ENTERTAINMENT 12 years ago 4 minutes, 1 second 10,431 views",DJ SPEEDY ENTERTAINMENT,10431,10444,13
139,"Baye Speedy - filfilu - Gedamu - Yezina Negash by DJ SPEEDY ENTERTAINMENT 12 years ago 5 minutes, 4 seconds 41,528 views",DJ SPEEDY ENTERTAINMENT,41528,41553,25
140,"Baye Speedy - filfilu - Sora Sorra - Kassahun Taye by DJ SPEEDY ENTERTAINMENT 12 years ago 6 minutes, 25 seconds 89,455 views",DJ SPEEDY ENTERTAINMENT,89455,89472,17
141,"Baye Speedy - filfilu -Ethiopian music documentary part 2 by DJ SPEEDY ENTERTAINMENT 12 years ago 8 minutes, 42 seconds 33,659 views",DJ SPEEDY ENTERTAINMENT,33659,33706,47
142,"Baye Speedy - filfilu -Ethiopian music documentary part 1 by DJ SPEEDY ENTERTAINMENT 12 years ago 8 minutes, 42 seconds 29,548 views",DJ SPEEDY ENTERTAINMENT,29548,29562,14
143,"Baye Speedy - filfilu -Ethiopian music documentary part 3 by DJ SPEEDY ENTERTAINMENT 12 years ago 8 minutes, 47 seconds 10,660 views",DJ SPEEDY ENTERTAINMENT,10660,10672,12
144,"Baye Speedy - filfilu -Ethiopian music documentary part 4 by DJ SPEEDY ENTERTAINMENT 12 years ago 9 minutes, 10 seconds 20,112 views",DJ SPEEDY ENTERTAINMENT,20112,20122,10
145,"Baye Speedy-filfilu-Ethiopian music documentary part 5 by DJ SPEEDY ENTERTAINMENT 12 years ago 8 minutes, 27 seconds 11,950 views",DJ SPEEDY ENTERTAINMENT,11950,11959,9
146,"Baye Speedy-filfilu- Ethiopian music documentary part 7 by DJ SPEEDY ENTERTAINMENT 12 years ago 6 minutes, 40 seconds 15,760 views",DJ SPEEDY ENTERTAINMENT,15760,15773,13
147,"Baye Speedy-filfilu-Ethiopian music documentary part 6 by DJ SPEEDY ENTERTAINMENT 12 years ago 8 minutes, 27 seconds 9,602 views",DJ SPEEDY ENTERTAINMENT,9602,9607,5
148,"Baye Speedy - filfilu - "" FILFILU as a ZOO GUIDE "" by DJ SPEEDY ENTERTAINMENT 12 years ago 4 minutes, 18 seconds 940,834 views",DJ SPEEDY ENTERTAINMENT,940834,942099,1265
149,"Baye Speedy - filfilu - FUNNY SHIRO COOKING ( CHEF ASMEROM) by DJ SPEEDY ENTERTAINMENT 12 years ago 8 minutes, 48 seconds 82,758 views",DJ SPEEDY ENTERTAINMENT,82758,82773,15
150,"Baye Speedy - filfilu - FUNNY ETHIOPIAN SOCCER TALK SHOW - 1 by DJ SPEEDY ENTERTAINMENT 12 years ago 9 minutes, 25 seconds 13,217 views",DJ SPEEDY ENTERTAINMENT,13217,13222,5
151,"Baye Speedy - filfilu - FUNNY ETHIOPIAN SOCCER TALK SHOW - 2 by DJ SPEEDY ENTERTAINMENT 12 years ago 4 minutes, 29 seconds 18,504 views",DJ SPEEDY ENTERTAINMENT,18504,18530,26
152,"Baye Speedy - filfilu - Erikum Dinbulka by DJ SPEEDY ENTERTAINMENT 12 years ago 4 minutes, 49 seconds 18,449 views",DJ SPEEDY ENTERTAINMENT,18449,18521,72
153,"Baye Speedy - filfilu - Desse Lai Naw Betua - Dinbulka by DJ SPEEDY ENTERTAINMENT 12 years ago 5 minutes, 38 seconds 49,817 views",DJ SPEEDY ENTERTAINMENT,49817,49900,83
154,"Baye Speedy - filfilu - Maleda - Dinbulka by DJ SPEEDY ENTERTAINMENT 12 years ago 4 minutes, 11 seconds 85,498 views",DJ SPEEDY ENTERTAINMENT,85498,85568,70
155,"Baye Speedy - filfilu - Erikum - Tadesse Alemu by DJ SPEEDY ENTERTAINMENT 12 years ago 6 minutes, 34 seconds 5,992 views",DJ SPEEDY ENTERTAINMENT,5992,6002,10
156,"Baye Speedy - filfilu - Minew Knojo Balhonesh - Samvod new Video by DJ SPEEDY ENTERTAINMENT 12 years ago 6 minutes, 39 seconds 105,154 views",DJ SPEEDY ENTERTAINMENT,105154,105162,8
157,"Baye Speedy - filfilu - Diaspora II - Alex Diaspora by DJ SPEEDY ENTERTAINMENT 12 years ago 4 minutes, 50 seconds 3,953 views",DJ SPEEDY ENTERTAINMENT,3953,3959,6
158,"Baye Speedy - filfilu - Ere Tey - Besu by DJ SPEEDY ENTERTAINMENT 12 years ago 5 minutes, 20 seconds 2,113 views",DJ SPEEDY ENTERTAINMENT,2113,2122,9
159,"Baye Speedy - filfilu - Noro Noro -  Munit Mesfin & Jorg by DJ SPEEDY ENTERTAINMENT 12 years ago 4 minutes, 26 seconds 19,610 views",DJ SPEEDY ENTERTAINMENT,19610,19615,5
160,"Baye Speedy - filfilu - You Can Win - Ashenafi Mulugeta feat Sean Augestin by DJ SPEEDY ENTERTAINMENT 12 years ago 5 minutes, 39 seconds 2,843 views",DJ SPEEDY ENTERTAINMENT,2843,2848,5
161,"Baye Speedy - filfilu - Keber cha cha - Henok, Alemayehu & Andualem by DJ SPEEDY ENTERTAINMENT 12 years ago 6 minutes, 7 seconds 18,425 views",DJ SPEEDY ENTERTAINMENT,18425,18459,34
162,"Baye Speedy - filfilu - football arts by DJ SPEEDY ENTERTAINMENT 12 years ago 5 minutes, 22 seconds 1,353 views",DJ SPEEDY ENTERTAINMENT,1353,1355,2
163,"Baye Speedy - filfilu -  semigne - Abinet Agonafir by DJ SPEEDY ENTERTAINMENT 12 years ago 6 minutes, 10 seconds 17,439 views",DJ SPEEDY ENTERTAINMENT,17439,17452,13
164,"Baye Speedy - filfilu - bati enna bluz - Tadele Robba by DJ SPEEDY ENTERTAINMENT 12 years ago 5 minutes, 5 seconds 7,427 views",DJ SPEEDY ENTERTAINMENT,7427,7440,13
165,"Baye Speedy - filfilu - IDGET BEANDINET - TADESSE MEKETE by DJ SPEEDY ENTERTAINMENT 12 years ago 8 minutes, 32 seconds 11,460 views",DJ SPEEDY ENTERTAINMENT,11460,11469,9
166,"Baye Speedy - filfilu - NABELEGNENA - ALEX OLOMPIA NEW MUSIC by DJ SPEEDY ENTERTAINMENT 12 years ago 5 minutes, 33 seconds 33,331 views",DJ SPEEDY ENTERTAINMENT,33331,33355,24
167,"final 2 by DJ SPEEDY ENTERTAINMENT 12 years ago 1 minute, 29 seconds 327 views",DJ SPEEDY ENTERTAINMENT,327,327,0
168,"final 1 by DJ SPEEDY ENTERTAINMENT 12 years ago 1 minute, 14 seconds 475 views",DJ SPEEDY ENTERTAINMENT,475,476,1
169,Baye Speedy - filfilu - Ayasiquim - tv add by DJ SPEEDY ENTERTAINMENT 12 years ago 31 seconds 718 views,DJ SPEEDY ENTERTAINMENT,718,718,0
170,"DJ SPEEDY ENTERTAINMENT by DJ SPEEDY ENTERTAINMENT 12 years ago 53 seconds 22,565 views",DJ SPEEDY ENTERTAINMENT,22565,22566,1
171,"Baye Speedy - filfilu - አሆ ! SELFU ሠልፉ - ( RALLY TIME ) by DJ SPEEDY ENTERTAINMENT 12 years ago 3 minutes, 59 seconds 1,407 views",DJ SPEEDY ENTERTAINMENT,1407,1407,0
172,"Baye Speedy - filfilu - Behig Amlak - Amsal Mitikie by DJ SPEEDY ENTERTAINMENT 12 years ago 5 minutes, 42 seconds 6,822 views",DJ SPEEDY ENTERTAINMENT,6822,6822,0
173,"Baye Speedy - filfilu - ENDURANCE 6 - HAILE GEBRESELASSIE by DJ SPEEDY ENTERTAINMENT 12 years ago 5 hours, 58 minutes 40,905 views",DJ SPEEDY ENTERTAINMENT,40905,40908,3
174,"Baye Speedy - filfilu - ENDURANCE 8 - HAILE GEBRESELASSIE by DJ SPEEDY ENTERTAINMENT 12 years ago 10 minutes, 9 seconds 53,790 views",DJ SPEEDY ENTERTAINMENT,53790,53813,23
175,"Baye Speedy - filfilu - ENDURANCE 7 - HAILE GEBRESELASSIE by DJ SPEEDY ENTERTAINMENT 12 years ago 9 minutes, 58 seconds 32,736 views",DJ SPEEDY ENTERTAINMENT,32736,32742,6
176,"Baye Speedy - filfilu - ENDURANCE 5 - HAILE GEBRESELASSIE by DJ SPEEDY ENTERTAINMENT 12 years ago 9 minutes, 58 seconds 30,866 views",DJ SPEEDY ENTERTAINMENT,30866,30874,8
177,"Baye Speedy - filfilu - ENDURANCE 4 - HAILE GEBRESELASSIE by DJ SPEEDY ENTERTAINMENT 12 years ago 9 minutes, 59 seconds 32,212 views",DJ SPEEDY ENTERTAINMENT,32212,32219,7
178,"Baye Speedy - filfilu - ENDURANCE 3 - HAILE GEBRESELASSIE by DJ SPEEDY ENTERTAINMENT 12 years ago 9 minutes, 59 seconds 33,751 views",DJ SPEEDY ENTERTAINMENT,33751,33752,1
179,"Baye Speedy - filfilu - ENDURANCE 2 - HAILE GEBRESELASSIE by DJ SPEEDY ENTERTAINMENT 12 years ago 9 minutes, 54 seconds 50,624 views",DJ SPEEDY ENTERTAINMENT,50624,50626,2
180,"Baye Speedy - filfilu - High & Low Class Sudden Pregnancy - ETHIOPIAN COMEDY by DJ SPEEDY ENTERTAINMENT 12 years ago 5 minutes, 27 seconds 71,218 views",DJ SPEEDY ENTERTAINMENT,71218,71222,4
181,"Baye Speedy - filfilu - Ney Samigna - Abel Mulgeta by DJ SPEEDY ENTERTAINMENT 12 years ago 4 minutes, 33 seconds 36,261 views",DJ SPEEDY ENTERTAINMENT,36261,36298,37
182,"Baye Speedy - filfilu - Yefikir Tiyake by DJ SPEEDY ENTERTAINMENT 12 years ago 4 minutes, 56 seconds 6,757 views",DJ SPEEDY ENTERTAINMENT,6757,6760,3
183,"Baye Speedy - filfilu - Ney Ney - RasJany by DJ SPEEDY ENTERTAINMENT 12 years ago 4 minutes, 29 seconds 9,569 views",DJ SPEEDY ENTERTAINMENT,9569,9575,6
184,"Baye Speedy - filfilu - Mecheneku Yibka - Mahider fet Syiamregne by DJ SPEEDY ENTERTAINMENT 12 years ago 4 minutes, 25 seconds 16,804 views",DJ SPEEDY ENTERTAINMENT,16804,16816,12
185,"Baye Speedy - filfilu - Elle Yabba, Addis Ababa 2 - Birhanu,Mamila,Kichini by DJ SPEEDY ENTERTAINMENT 12 years ago 5 minutes, 5 seconds 30,188 views",DJ SPEEDY ENTERTAINMENT,30188,30336,148
186,"Baye Speedy - filfilu - Chembelala 1 - Yohanese Bekele ( Tokichaw) by DJ SPEEDY ENTERTAINMENT 12 years ago 5 minutes, 21 seconds 36,461 views",DJ SPEEDY ENTERTAINMENT,36461,36472,11
187,"Baye Speedy - filfilu - Chembelala 2 - Yohanese Bekele ( Tokichaw) by DJ SPEEDY ENTERTAINMENT 12 years ago 3 minutes, 40 seconds 20,352 views",DJ SPEEDY ENTERTAINMENT,20352,20362,10
188,"Baye Speedy - filfilu - Bati by Josi's Mude by DJ SPEEDY ENTERTAINMENT 12 years ago 5 minutes, 20 seconds 14,169 views",DJ SPEEDY ENTERTAINMENT,14169,14173,4
189,"Baye Speedy - filfilu - Afar (Agabuyo) - Tadele Roba - Lafonaten & Hussen Ali by DJ SPEEDY ENTERTAINMENT 12 years ago 6 minutes, 12 seconds 1,266,333 views",DJ SPEEDY ENTERTAINMENT,1266333,1275733,9400
190,"Baye Speedy - filfilu - YITBAREK - BIRHANU - SERG by DJ SPEEDY ENTERTAINMENT 12 years ago 5 minutes, 20 seconds 67,582 views",DJ SPEEDY ENTERTAINMENT,67582,67591,9
191,"Baye Speedy - filfilu - Wofcho Wured Wued - TESHOME DEMISSIE by DJ SPEEDY ENTERTAINMENT 12 years ago 4 minutes, 55 seconds 126,691 views",DJ SPEEDY ENTERTAINMENT,126691,126934,243
192,"Baye speedy - filfilu - Muwannu Yechenena - BIRHANU - SERG by DJ SPEEDY ENTERTAINMENT 12 years ago 6 minutes, 30 seconds 9,314 views",DJ SPEEDY ENTERTAINMENT,9314,9317,3
193,"Baye Speedy - filfilu - ARADA - ZINASH TSEGAYE by DJ SPEEDY ENTERTAINMENT 12 years ago 5 minutes, 41 seconds 46,366 views",DJ SPEEDY ENTERTAINMENT,46366,46393,27
194,"Baye Speedy - filfilu - Sidetegnash Negne - BIRHANU - SERG by DJ SPEEDY ENTERTAINMENT 12 years ago 6 minutes, 22 seconds 26,232 views",DJ SPEEDY ENTERTAINMENT,26232,26246,14
195,"Baye Speedy - filfilu - Adarashu Bettie - Teshome Demissie by DJ SPEEDY ENTERTAINMENT 12 years ago 5 minutes, 51 seconds 691,679 views",DJ SPEEDY ENTERTAINMENT,691679,693518,1839
196,"Baye Speddy - filfilu - Enjalegne - ZINASH TSEGAYE by DJ SPEEDY ENTERTAINMENT 12 years ago 6 minutes, 6 seconds 33,590 views",DJ SPEEDY ENTERTAINMENT,33590,33618,28
197,"Baye Speedy - filfilu - AYASIQUIM - 2009 Amharic comedy movie coming soon July 5 to Calgary,AB by DJ SPEEDY ENTERTAINMENT 12 years ago 32 seconds 7,471 views",DJ SPEEDY ENTERTAINMENT,7471,7472,1
198,"Baye Speedy - filfilu - Yetizitaye Ennat - Tilahun Gessesse by DJ SPEEDY ENTERTAINMENT 12 years ago 5 minutes, 22 seconds 31,004 views",DJ SPEEDY ENTERTAINMENT,31004,31212,208
199,"Baye Speedy - filfilu - yehiwote hiwot - Tilahun Gessesse by DJ SPEEDY ENTERTAINMENT 12 years ago 2 minutes, 54 seconds 17,435 views",DJ SPEEDY ENTERTAINMENT,17435,17474,39
200,"Baye Speedy - filfilu - ke-kimmem dinbilal - Tilahun Gessesse by DJ SPEEDY ENTERTAINMENT 12 years ago 5 minutes, 5 seconds 3,731 views",DJ SPEEDY ENTERTAINMENT,3731,3735,4
201,"Baye Speedy - filfilu - eyuat sitnafikegne - Tlahun Gessesse by DJ SPEEDY ENTERTAINMENT 12 years ago 4 minutes, 27 seconds 36,415 views",DJ SPEEDY ENTERTAINMENT,36415,36545,130
202,"Baye Speedy - filfilu - ewodish nebere - Tlahun Gessesse by DJ SPEEDY ENTERTAINMENT 12 years ago 5 minutes, 1 second 6,249 views",DJ SPEEDY ENTERTAINMENT,6249,6266,17
203,"Baye Speedy - filfilu - chir balew lelit (short) - Tlahun Gessesse by DJ SPEEDY ENTERTAINMENT 12 years ago 1 minute, 45 seconds 3,727 views",DJ SPEEDY ENTERTAINMENT,3727,3767,40
204,"Baye Speedy - filfilu - Wogen Alegne - Tilahun Gessesse by DJ SPEEDY ENTERTAINMENT 12 years ago 4 minutes, 30 seconds 8,245 views",DJ SPEEDY ENTERTAINMENT,8245,8259,14
205,"Baye Speedy - filfilu - anisiyada - Tilahun Gessesse by DJ SPEEDY ENTERTAINMENT 12 years ago 5 minutes, 34 seconds 4,743 views",DJ SPEEDY ENTERTAINMENT,4743,4750,7
206,"Baye Speedy - filfilu - anchi ketto gid yeleshim - Tilahun Gessesse by DJ SPEEDY ENTERTAINMENT 12 years ago 3 minutes, 32 seconds 17,591 views",DJ SPEEDY ENTERTAINMENT,17591,17635,44
207,"Baye Speedy - filfilu - Hallo Hallo - Anteneh Worash / DJ Danny by DJ SPEEDY ENTERTAINMENT 12 years ago 4 minutes, 44 seconds 22,948 views",DJ SPEEDY ENTERTAINMENT,22948,22953,5
208,"Baye Speedy - filfilu - OBAMA - Chombe Seleshi ( DEJEN ) by DJ SPEEDY ENTERTAINMENT 12 years ago 5 minutes, 24 seconds 5,826 views",DJ SPEEDY ENTERTAINMENT,5826,5826,0
209,"Baye Speedy - filfilu - My Pants Saggin - RASSELAS by DJ SPEEDY ENTERTAINMENT 12 years ago 3 minutes, 43 seconds 2,016 views",DJ SPEEDY ENTERTAINMENT,2016,2017,1
210,"Baye Speedy - filfilu - MAMUSH - B.MASTRO by DJ SPEEDY ENTERTAINMENT 12 years ago 5 minutes, 28 seconds 11,836 views",DJ SPEEDY ENTERTAINMENT,11836,11838,2
211,"Baye Speedy - filfilu - TEW MANEH - SAYAT DEMISSIE by DJ SPEEDY ENTERTAINMENT 12 years ago 4 minutes, 30 seconds 16,153 views",DJ SPEEDY ENTERTAINMENT,16153,16164,11
212,"Baye Speedy - filfilu - TEBEB - Gamo Boys by DJ SPEEDY ENTERTAINMENT 12 years ago 4 minutes, 51 seconds 7,946 views",DJ SPEEDY ENTERTAINMENT,7946,7965,19
213,"Baye Speedy - filfilu - Yagere Lij - Ze Blak Nothe Stars by DJ SPEEDY ENTERTAINMENT 12 years ago 2 minutes, 45 seconds 4,533 views",DJ SPEEDY ENTERTAINMENT,4533,4537,4
214,Baye Speedy - filfilu - My Bro's Bini's Video Intro by DJ SPEEDY ENTERTAINMENT 12 years ago 7 seconds 844 views,DJ SPEEDY ENTERTAINMENT,844,846,2
215,"Baye Speedy - filfilu - Amanuel Yilma - James Bond by DJ SPEEDY ENTERTAINMENT 12 years ago 59 seconds 3,164 views",DJ SPEEDY ENTERTAINMENT,3164,3169,5
216,"Baye Speedy - filfilu - St. George Beer & Josi's Sofan Free by DJ SPEEDY ENTERTAINMENT 12 years ago 1 minute, 49 seconds 7,575 views",DJ SPEEDY ENTERTAINMENT,7575,7577,2
217,"Baye Speedy - filfilu - And Nen - Layne MataBirhan - new amharic music video by DJ SPEEDY ENTERTAINMENT 12 years ago 3 minutes, 52 seconds 12,515 views",DJ SPEEDY ENTERTAINMENT,12515,12517,2
218,"Baye Speedy - filfilu - Lebaye Nesh - Yong Same & Fikadu - new Amharic music video by DJ SPEEDY ENTERTAINMENT 12 years ago 5 minutes, 59 seconds 21,007 views",DJ SPEEDY ENTERTAINMENT,21007,21049,42
219,"Baye Speedy - filfilu - 904 - Tegga Bey - TEDDY YO - New Amharic Music Video by DJ SPEEDY ENTERTAINMENT 12 years ago 3 minutes, 12 seconds 52,568 views",DJ SPEEDY ENTERTAINMENT,52568,52731,163
220,"Baye Speedy - filfilu - Marringgae Cha cha - TEDDY YO - new Amharic music video by DJ SPEEDY ENTERTAINMENT 12 years ago 4 minutes, 36 seconds 17,940 views",DJ SPEEDY ENTERTAINMENT,17940,17940,0
221,"Baye Speedy - filfilu - SebSeb Bellu - Dagi - New Amharic music video by DJ SPEEDY ENTERTAINMENT 12 years ago 5 minutes, 15 seconds 49,626 views",DJ SPEEDY ENTERTAINMENT,49626,49630,4
222,"Baye Speedy - filfilu new - Zemenu 2009 by DJ SPEEDY ENTERTAINMENT 12 years ago 7 minutes, 50 seconds 57,363 views",DJ SPEEDY ENTERTAINMENT,57363,57423,60
223,"Baye Speedy - filfilu new - Kitibat 2009 by DJ SPEEDY ENTERTAINMENT 12 years ago 5 minutes, 7 seconds 87,437 views",DJ SPEEDY ENTERTAINMENT,87437,87515,78
224,"Baye Speedy - filfilu new - Cheguarra 2009 by DJ SPEEDY ENTERTAINMENT 12 years ago 5 minutes, 50 seconds 473,543 views",DJ SPEEDY ENTERTAINMENT,473543,474910,1367
225,"Baye Speedy - filfilu new 5 - YEMOGNE MENDER 2009 by DJ SPEEDY ENTERTAINMENT 12 years ago 8 minutes, 5 seconds 316,233 views",DJ SPEEDY ENTERTAINMENT,316233,316424,191
226,"Baye Speedy - filfilu new 4 - YEMOGNE MENDER 2009 by DJ SPEEDY ENTERTAINMENT 12 years ago 8 minutes, 47 seconds 325,845 views",DJ SPEEDY ENTERTAINMENT,325845,327020,1175
227,"Baye Speedy - filfilu new 3 - YEMOGNE MENDER 2009 by DJ SPEEDY ENTERTAINMENT 12 years ago 7 minutes, 50 seconds 44,486 views",DJ SPEEDY ENTERTAINMENT,44486,44626,140
228,"Baye Speedy - filfilu new 2 - YEMOGNE MENDER 2009 by DJ SPEEDY ENTERTAINMENT 12 years ago 9 minutes, 22 seconds 71,273 views",DJ SPEEDY ENTERTAINMENT,71273,71510,237
229,"Baye Speedy - filfilu new 1 - YEMOGNE MENDER 2009 by DJ SPEEDY ENTERTAINMENT 12 years ago 8 minutes, 34 seconds 200,782 views",DJ SPEEDY ENTERTAINMENT,200782,201275,493
230,"Baye Speedy - filfilu - ELIYAS MELKA GOOD JOB WITH ZERITU by DJ SPEEDY ENTERTAINMENT 12 years ago 5 minutes, 42 seconds 11,622 views",DJ SPEEDY ENTERTAINMENT,11622,11678,56
231,"Baye Speedy - filfilu - AndAnd Egna Enna AndAnd Enesu - Kibebew Gedda by DJ SPEEDY ENTERTAINMENT 12 years ago 4 minutes, 20 seconds 11,617 views",DJ SPEEDY ENTERTAINMENT,11617,11618,1
232,"Baye Speedy - filfilu - Gudegnaw Getemegne by DJ SPEEDY ENTERTAINMENT 12 years ago 6 minutes, 40 seconds 94,509 views",DJ SPEEDY ENTERTAINMENT,94509,94524,15
233,"Baye Speedy - filfilu - Tesfaye Kassa 6 by DJ SPEEDY ENTERTAINMENT 12 years ago 1 minute, 27 seconds 39,652 views",DJ SPEEDY ENTERTAINMENT,39652,39680,28
234,"Baye Speedy - filfilu - Tesfaye Kassa 3 by DJ SPEEDY ENTERTAINMENT 12 years ago 6 minutes, 51 seconds 57,907 views",DJ SPEEDY ENTERTAINMENT,57907,57915,8
235,"Baye Speedy - filfilu -Ttesfaye Kassa 5 by DJ SPEEDY ENTERTAINMENT 12 years ago 33 seconds 6,321 views",DJ SPEEDY ENTERTAINMENT,6321,6322,1
236,"Baye Speedy - filfilu - Tesfaye Kassa 4 by DJ SPEEDY ENTERTAINMENT 12 years ago 1 minute, 2 seconds 10,164 views",DJ SPEEDY ENTERTAINMENT,10164,10169,5
237,"Baye Speedy - filfilu - BATTI - Fikir Be Masinko - Azmari by DJ SPEEDY ENTERTAINMENT 12 years ago 5 minutes, 36 seconds 503,304 views",DJ SPEEDY ENTERTAINMENT,503304,506168,2864
238,"Baye Speedy - filfilu - AMBASSEL - Fikir BeMasinko - AZMARI by DJ SPEEDY ENTERTAINMENT 12 years ago 8 minutes 104,037 views",DJ SPEEDY ENTERTAINMENT,104037,104073,36
239,"Baye Speedy - filfilu - Eshee - Aster Girma by DJ SPEEDY ENTERTAINMENT 12 years ago 5 minutes, 28 seconds 3,866 views",DJ SPEEDY ENTERTAINMENT,3866,3869,3
240,"Baye Speedy - filfilu - Norku EskeAhun - Aster Girma by DJ SPEEDY ENTERTAINMENT 12 years ago 4 minutes, 2 seconds 217,236 views",DJ SPEEDY ENTERTAINMENT,217236,217633,397
241,"Baye Speedy - filfilu - Yematibella Wof - Rock by DJ SPEEDY ENTERTAINMENT 12 years ago 3 minutes, 12 seconds 9,210 views",DJ SPEEDY ENTERTAINMENT,9210,9212,2
242,"Baye Speedy - filfilu - Lebbie Kabba Lebso - Abdu Kiar New video by DJ SPEEDY ENTERTAINMENT 12 years ago 5 minutes, 17 seconds 39,420 views",DJ SPEEDY ENTERTAINMENT,39420,39421,1
243,"Baye speedy - filfilu - Walk-Ethi Out - by ZIM ENT ( ዝም አዝናኝ ) by DJ SPEEDY ENTERTAINMENT 12 years ago 3 minutes, 2 seconds 4,010 views",DJ SPEEDY ENTERTAINMENT,4010,4010,0
244,"Baye Speedy - filfilu - Yesira Limid 2 - kibebew by DJ SPEEDY ENTERTAINMENT 12 years ago 8 minutes, 13 seconds 107,181 views",DJ SPEEDY ENTERTAINMENT,107181,107538,357
245,"Baye Speedy - filfilu - Yesira Limid 3 - kibebew Gedda by DJ SPEEDY ENTERTAINMENT 12 years ago 6 minutes, 22 seconds 148,071 views",DJ SPEEDY ENTERTAINMENT,148071,148653,582
246,"Baye Speedy - filfilu - Yesira Limid 1 - kibebew by DJ SPEEDY ENTERTAINMENT 12 years ago 7 minutes, 42 seconds 572,344 views",DJ SPEEDY ENTERTAINMENT,572344,573498,1154
247,"Baye Speedy - filfilu - Askallu - Ttilahun ilfineh by DJ SPEEDY ENTERTAINMENT 12 years ago 6 minutes, 56 seconds 136,644 views",DJ SPEEDY ENTERTAINMENT,136644,136655,11
248,"Baye Speedy - filfilu - Sansur - Asres by DJ SPEEDY ENTERTAINMENT 12 years ago 9 minutes, 55 seconds 107,065 views",DJ SPEEDY ENTERTAINMENT,107065,107079,14
249,"Baye Speedy - filfilu - yebet sirra - Kibebew by DJ SPEEDY ENTERTAINMENT 12 years ago 9 minutes, 36 seconds 274,818 views",DJ SPEEDY ENTERTAINMENT,274818,275594,776
250,"Baye Speedy - filfilu - Romeo Must Die in Amaharic by DJ SPEEDY ENTERTAINMENT 12 years ago 2 minutes, 49 seconds 22,403 views",DJ SPEEDY ENTERTAINMENT,22403,22403,0
251,"Baye Speedy - filfilu - Findataw got an ass kick by 2 chicks by DJ SPEEDY ENTERTAINMENT 12 years ago 3 minutes, 7 seconds 3,880 views",DJ SPEEDY ENTERTAINMENT,3880,3880,0
252,"Baye Speedy - filfilu - Sem ena WorQ - AZMARI by DJ SPEEDY ENTERTAINMENT 13 years ago 5 minutes, 56 seconds 5,825 views",DJ SPEEDY ENTERTAINMENT,5825,5832,7
253,"Baye Speedy - filfilu - ya'abay dar kateama - AZMARI by DJ SPEEDY ENTERTAINMENT 13 years ago 5 minutes, 19 seconds 14,487 views",DJ SPEEDY ENTERTAINMENT,14487,14491,4
254,"Baye Speedy - filfilu - Welo gora belu - AZMARI by DJ SPEEDY ENTERTAINMENT 13 years ago 6 minutes, 10 seconds 6,586 views",DJ SPEEDY ENTERTAINMENT,6586,6589,3
255,"Baye Speedy - filfilu - Yene Abeba - Yitayew Dagnie - AZMARI by DJ SPEEDY ENTERTAINMENT 13 years ago 5 minutes, 59 seconds 19,926 views",DJ SPEEDY ENTERTAINMENT,19926,19927,1
256,"Baye Speedy - filfilu - Gojam - AZMARI by DJ SPEEDY ENTERTAINMENT 13 years ago 6 minutes, 6 seconds 25,687 views",DJ SPEEDY ENTERTAINMENT,25687,25758,71
257,"Baye Speedy - filfilu - እንደፍላጎቴ Serategna - T.V Commercial by DJ SPEEDY ENTERTAINMENT 13 years ago 1 minute, 51 seconds 13,547 views",DJ SPEEDY ENTERTAINMENT,13547,13549,2
258,"Baye Speedy - filfilu - Yewollo Tembelel - Manaye Tilahun - AZMARI by DJ SPEEDY ENTERTAINMENT 13 years ago 5 minutes, 37 seconds 10,461 views",DJ SPEEDY ENTERTAINMENT,10461,10465,4
259,"Baye Speedy - filfilu -  Shega Bicha - Manalebesh Dibbo - AZMARI by DJ SPEEDY ENTERTAINMENT 13 years ago 7 minutes, 11 seconds 21,640 views",DJ SPEEDY ENTERTAINMENT,21640,21645,5
260,"Baye Speedy - filfilu - Askalu - Tilahun & Nigisit by DJ SPEEDY ENTERTAINMENT 13 years ago 6 minutes, 50 seconds 6,422 views",DJ SPEEDY ENTERTAINMENT,6422,6423,1
261,"Baye Speedy - filfilu - TIKUR SET by DJ SPEEDY ENTERTAINMENT 13 years ago 4 minutes, 54 seconds 7,109 views",DJ SPEEDY ENTERTAINMENT,7109,7111,2
262,"Baye Speedy - filfilu - Min Ladirgish - Surafel Abebe by DJ SPEEDY ENTERTAINMENT 13 years ago 5 minutes 129,624 views",DJ SPEEDY ENTERTAINMENT,129624,131131,1507
263,"Baye Speedy - filfilu - Bogiye - Abonesh & Tilahun AZMARI by DJ SPEEDY ENTERTAINMENT 13 years ago 4 minutes, 37 seconds 8,823 views",DJ SPEEDY ENTERTAINMENT,8823,8838,15
264,"Baye Speedy - filfilu - Hip Hop AZMARI by DJ SPEEDY ENTERTAINMENT 13 years ago 32 seconds 7,538 views",DJ SPEEDY ENTERTAINMENT,7538,7539,1
265,"Baye Speedy - filfilu - Arada - AZMARI by DJ SPEEDY ENTERTAINMENT 13 years ago 7 minutes, 11 seconds 4,564 views",DJ SPEEDY ENTERTAINMENT,4564,4565,1
266,"Baye Speedy = filfilu - Azmari Song 2 by DJ SPEEDY ENTERTAINMENT 13 years ago 8 minutes, 10 seconds 111,851 views",DJ SPEEDY ENTERTAINMENT,111851,112182,331
267,"Baye Speedy - filfilu - Endalkachew 2pac - AZMARI by DJ SPEEDY ENTERTAINMENT 13 years ago 5 minutes, 1 second 109,791 views",DJ SPEEDY ENTERTAINMENT,109791,109851,60
268,"Baye Speedy - filfilu - Azmari Song by DJ SPEEDY ENTERTAINMENT 13 years ago 6 minutes, 15 seconds 158,583 views",DJ SPEEDY ENTERTAINMENT,158583,158605,22
269,"Baye speedy - filfilu - Abatachin Hoy, Besemay Yemitinor ... Abbaye Santim setegne ? by DJ SPEEDY ENTERTAINMENT 13 years ago 40 seconds 4,191 views",DJ SPEEDY ENTERTAINMENT,4191,4192,1
270,"Baye Speedy - filfilu - Gossaye, Tadele, Haileye, Abdu Kiar, Birhanu, Tsedeniya, Abenet by DJ SPEEDY ENTERTAINMENT 13 years ago 3 minutes, 52 seconds 29,480 views",DJ SPEEDY ENTERTAINMENT,29480,29652,172
271,"Baye speedy - filfilu - Mela Mela - Ethio Jazz by DJ SPEEDY ENTERTAINMENT 13 years ago 5 minutes, 49 seconds 3,079 views",DJ SPEEDY ENTERTAINMENT,3079,3081,2
272,"Baye Speedy - filfilu - Keber Cha Cha - HENOK ABEBE by DJ SPEEDY ENTERTAINMENT 13 years ago 6 minutes, 7 seconds 3,569 views",DJ SPEEDY ENTERTAINMENT,3569,3571,2
273,"Baye Speedy - filfilu - Libishima - Matiyas by DJ SPEEDY ENTERTAINMENT 13 years ago 6 minutes, 24 seconds 26,506 views",DJ SPEEDY ENTERTAINMENT,26506,26553,47
274,"Baye Speddy - filfilu - Yemeder Dershaya - Eyob Mekonen by DJ SPEEDY ENTERTAINMENT 13 years ago 6 minutes, 10 seconds 3,179 views",DJ SPEEDY ENTERTAINMENT,3179,3181,2
275,"Eyob Mekonen 2 by DJ SPEEDY ENTERTAINMENT 13 years ago 5 minutes, 5 seconds 2,457 views",DJ SPEEDY ENTERTAINMENT,2457,2459,2
276,"Baye Speedy - filfilu - Bati Na Bluz -  Tadele Roba and Fanta by DJ SPEEDY ENTERTAINMENT 13 years ago 5 minutes, 5 seconds 1,434 views",DJ SPEEDY ENTERTAINMENT,1434,1436,2
277,"Baye Speedy - filfilu - Bati - Yosef Gebre by DJ SPEEDY ENTERTAINMENT 13 years ago 5 minutes, 26 seconds 968 views",DJ SPEEDY ENTERTAINMENT,968,969,1
278,"Baye Speedy - filfilu - Hagern alresam - Teddy Afro live by DJ SPEEDY ENTERTAINMENT 13 years ago 8 minutes, 35 seconds 4,445 views",DJ SPEEDY ENTERTAINMENT,4445,4458,13
279,"Baye Speedy - filfilu - migibey live by DJ SPEEDY ENTERTAINMENT 13 years ago 8 minutes, 37 seconds 2,212 views",DJ SPEEDY ENTERTAINMENT,2212,2214,2
280,"Baye Speedy - filfilu - samegne by DJ SPEEDY ENTERTAINMENT 13 years ago 10 minutes, 47 seconds 60,927 views",DJ SPEEDY ENTERTAINMENT,60927,60946,19
281,"Ryan Giggs FA Cup Semi Final Replay 1999 by DJ SPEEDY ENTERTAINMENT 13 years ago 32 seconds 3,818 views",DJ SPEEDY ENTERTAINMENT,3818,3819,1
282,"Baye Speedy - filfilu - Gamachuu - Ali Birra by DJ SPEEDY ENTERTAINMENT 13 years ago 4 minutes, 26 seconds 2,098 views",DJ SPEEDY ENTERTAINMENT,2098,2098,0
283,"Baye Speedy - filfilu - MedihaniAlem - Teddy Afro Mezmur by DJ SPEEDY ENTERTAINMENT 13 years ago 6 minutes, 1 second 2,132 views",DJ SPEEDY ENTERTAINMENT,2132,2132,0
284,"Baye Speedy - filfilu - ALIKEFAM - REMIX - Zeritu by DJ SPEEDY ENTERTAINMENT 13 years ago 3 minutes, 59 seconds 2,038 views",DJ SPEEDY ENTERTAINMENT,2038,2040,2
285,"Baye Speedy - filfilu - Bahirdar Yaleshiew 2 - Mesfin Bekele by DJ SPEEDY ENTERTAINMENT 13 years ago 6 minutes, 16 seconds 12,939 views",DJ SPEEDY ENTERTAINMENT,12939,12939,0
286,"filfilu - መሃያ ብዬ ፣ እኔስ ለቴዲ አፍሮዬ ዬ ዬ ዬ - Free Teddy Afro ! by DJ SPEEDY ENTERTAINMENT 13 years ago 29 seconds 2,044 views",DJ SPEEDY ENTERTAINMENT,2044,2044,0
287,"Baye Speedy - filfilu - Konjo Nesh - Jossy Gebre by DJ SPEEDY ENTERTAINMENT 13 years ago 4 minutes, 45 seconds 5,962 views",DJ SPEEDY ENTERTAINMENT,5962,5966,4
288,"Baye Speedy - filfilu - GIZZIE ALEW - TIGISIT FANTAHUN by DJ SPEEDY ENTERTAINMENT 13 years ago 5 minutes, 8 seconds 61,705 views",DJ SPEEDY ENTERTAINMENT,61705,61711,6
289,"Baye Speedy - filfilu - EWEDISHALEHU BELEGNE - TIGISIT FANTAHUN by DJ SPEEDY ENTERTAINMENT 13 years ago 4 minutes, 25 seconds 215,956 views",DJ SPEEDY ENTERTAINMENT,215956,216057,101
290,"Baye Speedy - filfilu - Sidet - Tibebeu workiye by DJ SPEEDY ENTERTAINMENT 13 years ago 6 minutes, 17 seconds 3,819 views",DJ SPEEDY ENTERTAINMENT,3819,3820,1
291,"Baye Speedy - filfilu - MINIM SALAWUK AWEKUH - ABEBBA DESALEGNE by DJ SPEEDY ENTERTAINMENT 13 years ago 5 minutes, 15 seconds 40,203 views",DJ SPEEDY ENTERTAINMENT,40203,40209,6
292,"Baye Speedy-filfilu - LETANASHUA LISGA (full) -  GOSSAYE by DJ SPEEDY ENTERTAINMENT 13 years ago 6 minutes, 27 seconds 12,974 views",DJ SPEEDY ENTERTAINMENT,12974,12985,11
293,"Baye Speedy - filfilu - TEDDY ቴ ቴ ቴ ዲ ስማ - New song 4 Teddy Afro by DJ SPEEDY ENTERTAINMENT 13 years ago 5 minutes, 31 seconds 57,456 views",DJ SPEEDY ENTERTAINMENT,57456,57467,11
294,"Baye Speedy - filfilu - "" AFRALEHU "" - Teddy Afro NEW 2009 by DJ SPEEDY ENTERTAINMENT 13 years ago 6 minutes, 39 seconds 198,674 views",DJ SPEEDY ENTERTAINMENT,198674,198687,13
295,"Baye Speedy - filfilu - Gurragie Tune Cartoon by DJ SPEEDY ENTERTAINMENT 13 years ago 4 minutes, 6 seconds 2,482 views",DJ SPEEDY ENTERTAINMENT,2482,2482,0
296,"Baye Speedy - filfilu - Anchi Fikir - Ahimed Teshome by DJ SPEEDY ENTERTAINMENT 13 years ago 5 minutes, 34 seconds 7,798 views",DJ SPEEDY ENTERTAINMENT,7798,7801,3
297,"Baye Speedy - filfilu - andandie endih new - zewdu bekele by DJ SPEEDY ENTERTAINMENT 13 years ago 4 minutes, 52 seconds 9,423 views",DJ SPEEDY ENTERTAINMENT,9423,9433,10
298,"Baye Speedy - filfilu - Idget BeAndinet - Tadesse Mekete by DJ SPEEDY ENTERTAINMENT 13 years ago 8 minutes, 31 seconds 53,029 views",DJ SPEEDY ENTERTAINMENT,53029,53037,8
299,"Baye Speedy - filfilu - Kobeley - Tirihas Tareque by DJ SPEEDY ENTERTAINMENT 13 years ago 7 minutes, 8 seconds 15,729 views",DJ SPEEDY ENTERTAINMENT,15729,15736,7
300,"Baye Speedy - filfilu - Fiyori - Aziz Hagos by DJ SPEEDY ENTERTAINMENT 13 years ago 6 minutes, 44 seconds 107,223 views",DJ SPEEDY ENTERTAINMENT,107223,107967,744
301,"Baye Speedy - filfilu - Gossaye - Letanashiwa Lisga by DJ SPEEDY ENTERTAINMENT 13 years ago 3 minutes, 43 seconds 14,925 views",DJ SPEEDY ENTERTAINMENT,14925,14925,0
302,"Baye Speedy - filfilu - Elle Yaba Addis Ababa - Birhanu Tezera fet Mamila & Kinchini by DJ SPEEDY ENTERTAINMENT 13 years ago 5 minutes, 29 seconds 500,181 views",DJ SPEEDY ENTERTAINMENT,500181,500922,741
303,"Baye Speedy - filfilu - Lante sil new Lante - ላንተ ስል ነው፤ ላንተ - Kuku Sebsebe by DJ SPEEDY ENTERTAINMENT 13 years ago 5 minutes, 31 seconds 7,060 views",DJ SPEEDY ENTERTAINMENT,7060,7068,8
304,"Baye Speedy - filfilu - Sab Sam - ሳብ ሳም - Tsehaye Yohannes by DJ SPEEDY ENTERTAINMENT 13 years ago 4 minutes, 27 seconds 13,684 views",DJ SPEEDY ENTERTAINMENT,13684,13744,60
305,"Baye Speedy - filfilu - Nani - ናኒ ፲፯ - Manchester United's # 17 (ማንቼ) by DJ SPEEDY ENTERTAINMENT 13 years ago 13 seconds 12,723 views",DJ SPEEDY ENTERTAINMENT,12723,12725,2
306,"Baye Speedy - filfilu - Ama-le-le - አማሌሌ - Ali Birra & Mahmood Ahimed by DJ SPEEDY ENTERTAINMENT 13 years ago 5 minutes 111,310 views",DJ SPEEDY ENTERTAINMENT,111310,111559,249
307,"Baye.Speedy.filfilu.Alikefam.(LIVE).አልከፋም.ዘሪቱ እና ናቲ.Zeritu.&.Nati by DJ SPEEDY ENTERTAINMENT 13 years ago 4 minutes, 29 seconds 2,036 views",DJ SPEEDY ENTERTAINMENT,2036,2043,7
308,"Baye Speedy - filfilu - KOBELLE 2 - ኮበሌ ፪ - እንዳመሌ - ጥላሁን እልፍነህ by DJ SPEEDY ENTERTAINMENT 13 years ago 8 minutes, 33 seconds 159,971 views",DJ SPEEDY ENTERTAINMENT,159971,160337,366
309,"Baye Speedy - filfilu - CHACHATW 2 - እውዋይ ! ቡጥቡጥ - ጫጫታ - ፪ - kibebew by DJ SPEEDY ENTERTAINMENT 13 years ago 9 minutes, 16 seconds 360,341 views",DJ SPEEDY ENTERTAINMENT,360341,367937,7596
310,"Baye Speedy - filfilu - CHACHATW 1 - እውዋይ ! ቡጥቡጥ - ጫጫታ -፩- kibebew by DJ SPEEDY ENTERTAINMENT 13 years ago 8 minutes, 42 seconds 669,831 views",DJ SPEEDY ENTERTAINMENT,669831,670818,987
311,"Baye Speedy - filfilu - AQUARACH - # 2 - አቑአራጭ - ክፍል ፪ - Kebebew Geda by DJ SPEEDY ENTERTAINMENT 13 years ago 7 minutes, 52 seconds 624,745 views",DJ SPEEDY ENTERTAINMENT,624745,626461,1716
312,"Baye Speedy - filfilu - AQUARACH - # 1 - አቑአራጭ - ክፍል ፩ - Kebebew Geda by DJ SPEEDY ENTERTAINMENT 13 years ago 6 minutes, 57 seconds 1,813,094 views",DJ SPEEDY ENTERTAINMENT,1813094,1820347,7253
313,"Baye Speedy - filfilu - SHIBIRRU 1 - ሽብሩ እና ሳጅን ፩- Kibebew Geda by DJ SPEEDY ENTERTAINMENT 13 years ago 8 minutes, 47 seconds 224,279 views",DJ SPEEDY ENTERTAINMENT,224279,224436,157
314,"Baye Speedy - filfilu - SHIBIRRU 2 - ሽብሩ እና ሳጅን ፪- Kibebew Geda by DJ SPEEDY ENTERTAINMENT 13 years ago 9 minutes, 12 seconds 185,667 views",DJ SPEEDY ENTERTAINMENT,185667,185752,85
315,"Baye Speedy - filfilu - DIBIDIBU - ድብድቡ - Kibebew Geda by DJ SPEEDY ENTERTAINMENT 13 years ago 7 minutes, 40 seconds 117,984 views",DJ SPEEDY ENTERTAINMENT,117984,118201,217
316,"Baye Speedy - filfilu - GASH FOLISU - ጋሽ ፎሊሱ - Kibebew Gedda by DJ SPEEDY ENTERTAINMENT 13 years ago 6 minutes, 28 seconds 117,444 views",DJ SPEEDY ENTERTAINMENT,117444,117628,184
317,"Baye Speedy - filfilu - Mama Mia - Chameleone by DJ SPEEDY ENTERTAINMENT 13 years ago 4 minutes, 7 seconds 25,731 views",DJ SPEEDY ENTERTAINMENT,25731,25736,5
318,"Baye - Speedy - filfilu - FOYAY - indashaw negash by DJ SPEEDY ENTERTAINMENT 13 years ago 5 minutes, 25 seconds 1,629 views",DJ SPEEDY ENTERTAINMENT,1629,1632,3
319,"Baye - Speedy - filfilu - LEMIN YELEGNIM ALSH ? - TAMERAT by DJ SPEEDY ENTERTAINMENT 13 years ago 4 minutes, 55 seconds 1,010 views",DJ SPEEDY ENTERTAINMENT,1010,1013,3
320,"Baye - Speedy - filfilu - ANGEL EYES - reghav ft. jussy & fr by DJ SPEEDY ENTERTAINMENT 13 years ago 3 minutes, 19 seconds 2,064 views",DJ SPEEDY ENTERTAINMENT,2064,2068,4
321,"Baye Speedy - filfilu - AM HABESHA - NATI by DJ SPEEDY ENTERTAINMENT 13 years ago 5 minutes, 17 seconds 3,078 views",DJ SPEEDY ENTERTAINMENT,3078,3082,4
322,"Baye Speedy - filfilu - NEY MATTA MATTA - ABEL by DJ SPEEDY ENTERTAINMENT 13 years ago 4 minutes, 24 seconds 72,130 views",DJ SPEEDY ENTERTAINMENT,72130,72139,9
323,"Baye Speedy - filfilu - Gebagne Ahun Genna - Tibebeu Workiye by DJ SPEEDY ENTERTAINMENT 13 years ago 5 minutes, 17 seconds 6,679 views",DJ SPEEDY ENTERTAINMENT,6679,6681,2
324,"Baye Speedy - filfilu - Mama Adina - Henny fet. Mahy, Mc AB by DJ SPEEDY ENTERTAINMENT 13 years ago 4 minutes, 22 seconds 12,051 views",DJ SPEEDY ENTERTAINMENT,12051,12059,8
325,"Baye Speedy - filfilu - Zare Anten Alatam - Nestanet Ayele by DJ SPEEDY ENTERTAINMENT 13 years ago 5 minutes, 55 seconds 15,977 views",DJ SPEEDY ENTERTAINMENT,15977,15992,15
326,"Baye Speedy - filfilu - Beyilugneta - Netsanet Ayele by DJ SPEEDY ENTERTAINMENT 13 years ago 6 minutes, 8 seconds 16,107 views",DJ SPEEDY ENTERTAINMENT,16107,16126,19
327,"Baye Speedy - filfilu - Salaminibet - Bisrat Garedew by DJ SPEEDY ENTERTAINMENT 13 years ago 5 minutes, 9 seconds 131,496 views",DJ SPEEDY ENTERTAINMENT,131496,132324,828
328,"Baye Speedy - filfilu - kerbo sitay new -ZemmaSabawiyan by DJ SPEEDY ENTERTAINMENT 13 years ago 3 minutes, 53 seconds 9,566 views",DJ SPEEDY ENTERTAINMENT,9566,9570,4
329,"Baye Speedy - filfilu - IQenalehu - Mahilet Demere by DJ SPEEDY ENTERTAINMENT 13 years ago 3 minutes, 55 seconds 301,982 views",DJ SPEEDY ENTERTAINMENT,301982,302028,46
330,"Baye Speedy - filfilu - AROGGIE ARADA - አሮጌ አራዳ - QAQO by DJ SPEEDY ENTERTAINMENT 13 years ago 5 minutes 981,448 views",DJ SPEEDY ENTERTAINMENT,981448,994169,12721
331,"Baye Speedy - filfilu -Bahiru Kagne # 1 by DJ SPEEDY ENTERTAINMENT 13 years ago 6 minutes, 28 seconds 91,738 views",DJ SPEEDY ENTERTAINMENT,91738,92121,383
332,"Baye Speedy - filfilu - WUDDEN YIZESHIEW - Yihune Belay by DJ SPEEDY ENTERTAINMENT 13 years ago 6 minutes, 37 seconds 7,846 views",DJ SPEEDY ENTERTAINMENT,7846,7852,6
333,"Baye Speedy - filfilu - MAMAYE - Elias Tebabal by DJ SPEEDY ENTERTAINMENT 13 years ago 5 minutes, 17 seconds 3,085 views",DJ SPEEDY ENTERTAINMENT,3085,3086,1
334,"Baye Speedy - filfilu - WOY ADDIS ABABA - Zuriyash Abeyu by DJ SPEEDY ENTERTAINMENT 13 years ago 5 minutes, 52 seconds 29,671 views",DJ SPEEDY ENTERTAINMENT,29671,29781,110
335,"Baye Speedy - filfilu - ALEM ALEMIYE - Abonesh Adinew by DJ SPEEDY ENTERTAINMENT 13 years ago 2 minutes, 16 seconds 21,962 views",DJ SPEEDY ENTERTAINMENT,21962,22013,51
336,"Baye Speedy - filfilu - HOYA HOYE - Chachi Tadesse by DJ SPEEDY ENTERTAINMENT 13 years ago 4 minutes, 4 seconds 16,023 views",DJ SPEEDY ENTERTAINMENT,16023,16027,4
337,"Baye Speedy - filfilu - BAHILAWIW WINDOW-XP - grexeffx (my bro) by DJ SPEEDY ENTERTAINMENT 13 years ago 3 minutes, 36 seconds 29,165 views",DJ SPEEDY ENTERTAINMENT,29165,29165,0
338,"Baye Speedy - filfilu - WHO AM I ? - PART 2 by DJ SPEEDY ENTERTAINMENT 13 years ago 9 minutes, 42 seconds 168,443 views",DJ SPEEDY ENTERTAINMENT,168443,168635,192
339,"Baye Speedy - filfilu - BELLENE - TSEHAY YOHANIS by DJ SPEEDY ENTERTAINMENT 13 years ago 5 minutes, 27 seconds 35,383 views",DJ SPEEDY ENTERTAINMENT,35383,35395,12
340,"Baye Speedy - filfilu - WHO AM I ? - PART 1 by DJ SPEEDY ENTERTAINMENT 13 years ago 9 minutes, 45 seconds 167,212 views",DJ SPEEDY ENTERTAINMENT,167212,167289,77
341,"Baye Speedy - filfilu - YE- FILFILU MIT - PART 2 by DJ SPEEDY ENTERTAINMENT 13 years ago 8 minutes, 8 seconds 338,048 views",DJ SPEEDY ENTERTAINMENT,338048,338475,427
342,"Baye Speedy - filfilu - YE- FILFILU MIT - PART 1 by DJ SPEEDY ENTERTAINMENT 13 years ago 6 minutes, 23 seconds 131,682 views",DJ SPEEDY ENTERTAINMENT,131682,131717,35
343,"Baye Speedy - filfilu - WONDIEMEN - OH MY BRO ! PART 2 by DJ SPEEDY ENTERTAINMENT 13 years ago 7 minutes, 46 seconds 85,821 views",DJ SPEEDY ENTERTAINMENT,85821,85867,46
344,"Baye Speedy - filfilu - WONDEMEN - OH MY BRO ! Part 1 by DJ SPEEDY ENTERTAINMENT 13 years ago 6 minutes, 29 seconds 128,161 views",DJ SPEEDY ENTERTAINMENT,128161,128229,68
345,"Baye Speedy - filfilu - ALFERAM - ZERAFF by DJ SPEEDY ENTERTAINMENT 13 years ago 10 minutes, 13 seconds 498,626 views",DJ SPEEDY ENTERTAINMENT,498626,500724,2098
346,"Baye Speedy - filfilu - BET AKERAYU by DJ SPEEDY ENTERTAINMENT 13 years ago 9 minutes, 20 seconds 268,011 views",DJ SPEEDY ENTERTAINMENT,268011,268878,867
347,"Baye Speedy - filfilu - ZEGEYE by DJ SPEEDY ENTERTAINMENT 13 years ago 5 minutes, 41 seconds 267,399 views",DJ SPEEDY ENTERTAINMENT,267399,267846,447
348,"Baye Speedy - filfilu - ADDISU FITESHA - BRAND NEW DAY by DJ SPEEDY ENTERTAINMENT 13 years ago 6 minutes, 56 seconds 496,359 views",DJ SPEEDY ENTERTAINMENT,496359,497086,727
349,"Baye Speedy - filfilu - LIYU MESTENGIDO - DENBEGNA KIBUR NEW by DJ SPEEDY ENTERTAINMENT 13 years ago 9 minutes, 11 seconds 384,023 views",DJ SPEEDY ENTERTAINMENT,384023,384791,768
350,"Baye Speedy - filfilu - MEAZZA - KoSH KoSH by DJ SPEEDY ENTERTAINMENT 13 years ago 7 minutes, 52 seconds 53,401 views",DJ SPEEDY ENTERTAINMENT,53401,53403,2
351,"Baye Speedy - filfilu - BIRD FLU - YE-DORRO BIN LADEN by DJ SPEEDY ENTERTAINMENT 13 years ago 9 minutes, 11 seconds 409,251 views",DJ SPEEDY ENTERTAINMENT,409251,412024,2773
352,"Byae Speedy - filfilu - YE-13 WER TSEGA - TILAHUN GESSESSE by DJ SPEEDY ENTERTAINMENT 13 years ago 5 minutes, 24 seconds 31,310 views",DJ SPEEDY ENTERTAINMENT,31310,31311,1
353,"Baye Speedy - filfilu - GOJAM AZENE - DAMTEW AYELE by DJ SPEEDY ENTERTAINMENT 13 years ago 6 minutes, 50 seconds 28,039 views",DJ SPEEDY ENTERTAINMENT,28039,28056,17
354,"Baye Speedy - filfilu - EMBI BEL - GENET MASRESHA by DJ SPEEDY ENTERTAINMENT 13 years ago 6 minutes, 51 seconds 175,913 views",DJ SPEEDY ENTERTAINMENT,175913,176478,565
355,"Baye Speedy - filfilu - AWDE AMET - DAMTEW AYELE by DJ SPEEDY ENTERTAINMENT 13 years ago 4 minutes, 49 seconds 59,666 views",DJ SPEEDY ENTERTAINMENT,59666,59675,9
356,"Baye Speedy - filfilu - BABAJALEW - GENET MASRESHA by DJ SPEEDY ENTERTAINMENT 13 years ago 4 minutes, 52 seconds 51,149 views",DJ SPEEDY ENTERTAINMENT,51149,51167,18
357,"Baye Speedy - filfilu - YIWODAL - GEDAYE # 2 by DJ SPEEDY ENTERTAINMENT 13 years ago 4 minutes, 40 seconds 66,923 views",DJ SPEEDY ENTERTAINMENT,66923,67022,99
358,"Baye Speedy - filfilu - YIWODAL - ALEBACHEW TEKKA (R.I.P) by DJ SPEEDY ENTERTAINMENT 13 years ago 4 minutes, 32 seconds 492,915 views",DJ SPEEDY ENTERTAINMENT,492915,493733,818
359,"Baye Speedy - filfilu - YIWODAL - GEDAYE # 1 by DJ SPEEDY ENTERTAINMENT 13 years ago 3 minutes, 33 seconds 71,186 views",DJ SPEEDY ENTERTAINMENT,71186,71352,166
360,"BAYE SPEEDY - filfilu - STAND UP COMEDY - PART - 3 by DJ SPEEDY ENTERTAINMENT 13 years ago 2 minutes, 22 seconds 172,071 views",DJ SPEEDY ENTERTAINMENT,172071,172106,35
361,"BAYE SPEEDY - filfilu - ABUSH - YELIJ Al-Qaeda by DJ SPEEDY ENTERTAINMENT 13 years ago 7 minutes, 30 seconds 520,101 views",DJ SPEEDY ENTERTAINMENT,520101,520303,202
362,"BAYE SPEEDY - filfilu - STAND UP COMEDY - PART - 4 by DJ SPEEDY ENTERTAINMENT 13 years ago 1 minute, 16 seconds 69,758 views",DJ SPEEDY ENTERTAINMENT,69758,69780,22
363,"BAYE SPEEDY - filfilu - YE- IJJ WUHA - GURSHAW by DJ SPEEDY ENTERTAINMENT 13 years ago 1 minute, 1 second 132,392 views",DJ SPEEDY ENTERTAINMENT,132392,132404,12
364,"BAYE SPEEDY - filfilu - TEQUESSEGNE by DJ SPEEDY ENTERTAINMENT 13 years ago 1 minute, 20 seconds 128,348 views",DJ SPEEDY ENTERTAINMENT,128348,128358,10
365,"BAYE SPEEDY - filfilu - STAND UP COMEDY - PART - 2 by DJ SPEEDY ENTERTAINMENT 13 years ago 1 minute, 48 seconds 437,835 views",DJ SPEEDY ENTERTAINMENT,437835,438143,308
366,"BAYE SPEEDY - filfilu - STAND UP COMEDY - PART - 1 by DJ SPEEDY ENTERTAINMENT 13 years ago 1 minute, 14 seconds 138,489 views",DJ SPEEDY ENTERTAINMENT,138489,138535,46
367,"Baye Speedy - filfilu - AWO BEL - ABEBBA LAKEW by DJ SPEEDY ENTERTAINMENT 13 years ago 5 minutes, 37 seconds 22,554 views",DJ SPEEDY ENTERTAINMENT,22554,22554,0
368,"Baye Speedy - filfilu - DIRRE - BIRHANU TEZERA by DJ SPEEDY ENTERTAINMENT 13 years ago 5 minutes, 46 seconds 21,469 views",DJ SPEEDY ENTERTAINMENT,21469,21472,3
369,"Baye Speedy - filfilu - OROMIFA - RE-MIX BY Saliha Sami by DJ SPEEDY ENTERTAINMENT 13 years ago 5 minutes, 7 seconds 201,345 views",DJ SPEEDY ENTERTAINMENT,201345,201681,336
370,"Baye Speedy - filfilu - WEDET WEDET NEW - HAB INGIDAW by DJ SPEEDY ENTERTAINMENT 13 years ago 4 minutes, 19 seconds 13,165 views",DJ SPEEDY ENTERTAINMENT,13165,13178,13
371,"Baye Speedy - filfilu - BALAGERU PART 3 - EPHREM & GOSSAYE by DJ SPEEDY ENTERTAINMENT 13 years ago 8 minutes, 4 seconds 55,933 views",DJ SPEEDY ENTERTAINMENT,55933,55952,19
372,"Baye Speedy - filfilu - KEMESHE METAH - HIBISIT TIRUNEH by DJ SPEEDY ENTERTAINMENT 13 years ago 5 minutes, 39 seconds 9,588 views",DJ SPEEDY ENTERTAINMENT,9588,9590,2
373,"Baye Speedy - filfilu - KEF KEF - BIRHANU TEZERA by DJ SPEEDY ENTERTAINMENT 13 years ago 6 minutes, 20 seconds 23,810 views",DJ SPEEDY ENTERTAINMENT,23810,23816,6
374,"Baye Speedy - filfilu - INIDESET - TAMERAT DESTA by DJ SPEEDY ENTERTAINMENT 13 years ago 4 minutes, 30 seconds 83,101 views",DJ SPEEDY ENTERTAINMENT,83101,83124,23
375,"Baye Speedy - filfilu - ALDELATIM - LALI HABESHA - by DJ SPEEDY ENTERTAINMENT 13 years ago 5 minutes, 58 seconds 87,067 views",DJ SPEEDY ENTERTAINMENT,87067,87099,32
376,"Baye Speedy - filfilu - ZENGENNA - YIHUNE BELAY by DJ SPEEDY ENTERTAINMENT 13 years ago 6 minutes, 19 seconds 34,911 views",DJ SPEEDY ENTERTAINMENT,34911,34917,6
377,"Baye Speedy - filfilu - OLA - ABEBBA LAKEW by DJ SPEEDY ENTERTAINMENT 13 years ago 4 minutes, 37 seconds 35,055 views",DJ SPEEDY ENTERTAINMENT,35055,35055,0
378,"Baye Speedy - filfilu - YENE KONJO - BIZUAYEHU DEMISSIE by DJ SPEEDY ENTERTAINMENT 13 years ago 5 minutes, 45 seconds 303,907 views",DJ SPEEDY ENTERTAINMENT,303907,307436,3529
379,"Baye Speedy - filfilu - NAHOM'S GREATEST DVD VOL-4 - INTRO by DJ SPEEDY ENTERTAINMENT 13 years ago 2 minutes, 31 seconds 1,848 views",DJ SPEEDY ENTERTAINMENT,1848,1849,1
380,"Baye Speedy - filfilu - AYTHAZULEY - ASHENAFI ABAY by DJ SPEEDY ENTERTAINMENT 13 years ago 7 minutes, 8 seconds 17,511 views",DJ SPEEDY ENTERTAINMENT,17511,17557,46
381,"Baye Speedy - LOVE & DANCE - SIYAMREGNE FET. MAHIDER by DJ SPEEDY ENTERTAINMENT 13 years ago 4 minutes, 23 seconds 4,638 views",DJ SPEEDY ENTERTAINMENT,4638,4641,3
382,"Baye Speedy - filfilu - GELLA - TG. Fet. DAVIDSON by DJ SPEEDY ENTERTAINMENT 13 years ago 3 minutes, 55 seconds 7,470 views",DJ SPEEDY ENTERTAINMENT,7470,7480,10
383,"Baye Speedy - filfilu - MARINGE CHA - DJ SAME by DJ SPEEDY ENTERTAINMENT 13 years ago 4 minutes, 52 seconds 61,338 views",DJ SPEEDY ENTERTAINMENT,61338,61374,36
384,"Baye Speedy - LEMINBICHA EYITA - ALEX FET TEDDY YO by DJ SPEEDY ENTERTAINMENT 13 years ago 3 minutes, 18 seconds 7,553 views",DJ SPEEDY ENTERTAINMENT,7553,7557,4
385,"Baye Speedy - filfilu - SEKOTTA by DJ SPEEDY ENTERTAINMENT 13 years ago 7 minutes, 54 seconds 786,698 views",DJ SPEEDY ENTERTAINMENT,786698,792274,5576
386,"Baye Speedy - filfilu - GONDER by DJ SPEEDY ENTERTAINMENT 13 years ago 6 minutes, 13 seconds 1,087,355 views",DJ SPEEDY ENTERTAINMENT,1087355,1087783,428
387,"Baye Speedy - filfilu - SHEW BEL by DJ SPEEDY ENTERTAINMENT 13 years ago 4 minutes, 37 seconds 313,589 views",DJ SPEEDY ENTERTAINMENT,313589,314741,1152
388,"Baye Speedy - filfilu - ENDEYERUSALEM by DJ SPEEDY ENTERTAINMENT 13 years ago 5 minutes, 32 seconds 124,819 views",DJ SPEEDY ENTERTAINMENT,124819,125419,600
389,"Baye Speedy - filfilu - MALEDA by DJ SPEEDY ENTERTAINMENT 13 years ago 4 minutes, 34 seconds 246,974 views",DJ SPEEDY ENTERTAINMENT,246974,247834,860
390,"Baye Speedy - HUALA ENDAYKOCHISH - EPHREM TAMERU by DJ SPEEDY ENTERTAINMENT 13 years ago 7 minutes, 26 seconds 331,987 views",DJ SPEEDY ENTERTAINMENT,331987,350114,18127
391,"Baye Speedy - filfilu - BALAGER - TSEGAYE SIMMIE - GURAGIE by DJ SPEEDY ENTERTAINMENT 13 years ago 5 minutes, 7 seconds 20,491 views",DJ SPEEDY ENTERTAINMENT,20491,20647,156
392,"Baye Speedy - filfilu - ESEHURRO - DEMISSIE TEKA - GURAGIE by DJ SPEEDY ENTERTAINMENT 13 years ago 5 minutes, 31 seconds 46,832 views",DJ SPEEDY ENTERTAINMENT,46832,46878,46
393,"Baye Speedy - filfilu - YE WOLLO LIJ - DAMTEW AYALEW by DJ SPEEDY ENTERTAINMENT 13 years ago 5 minutes, 13 seconds 265,326 views",DJ SPEEDY ENTERTAINMENT,265326,265473,147
394,"Baye Speedy - filfilu - GAALGALLA - TUJUDIN AHIMED - OROMIFA by DJ SPEEDY ENTERTAINMENT 13 years ago 4 minutes, 49 seconds 13,886 views",DJ SPEEDY ENTERTAINMENT,13886,13891,5
395,"Baye Speedy - filfilu - DAGIM BE WUHA ATIKTAN - KAKI TESFAYE by DJ SPEEDY ENTERTAINMENT 13 years ago 5 minutes, 42 seconds 60,756 views",DJ SPEEDY ENTERTAINMENT,60756,60920,164
396,"Baye Speedy - filfilu - BAHIR DAR YALESHIEW - MESFIN BEKELE by DJ SPEEDY ENTERTAINMENT 13 years ago 5 minutes, 31 seconds 3,664 views",DJ SPEEDY ENTERTAINMENT,3664,3667,3
397,"Baye Speedy - filfilu - ETHIOPIA - MISIKIR AWOL by DJ SPEEDY ENTERTAINMENT 13 years ago 24 minutes 130,714 views",DJ SPEEDY ENTERTAINMENT,130714,131071,357
398,"Baye Speedy - filfilu - GENNA GUD YISEMAL - ABABA DESALEGNE by DJ SPEEDY ENTERTAINMENT 13 years ago 4 minutes, 51 seconds 3,966 views",DJ SPEEDY ENTERTAINMENT,3966,3967,1
399,"Baye Speedy - filfilu - DELELEGNE - MAKIYA by DJ SPEEDY ENTERTAINMENT 13 years ago 5 minutes, 22 seconds 17,759 views",DJ SPEEDY ENTERTAINMENT,17759,17773,14
400,"Baye Speedy - filfilu - GOMEN BETENNA - TSEHAYE YOHSNIS by DJ SPEEDY ENTERTAINMENT 13 years ago 4 minutes, 2 seconds 5,330 views",DJ SPEEDY ENTERTAINMENT,5330,5339,9
401,"Baye Speedy - filfilu - DIASPORA - PART 2 - ALEX OLIMPIA by DJ SPEEDY ENTERTAINMENT 13 years ago 6 minutes, 19 seconds 16,500 views",DJ SPEEDY ENTERTAINMENT,16500,16502,2
402,"Baye Speedy - filfilu - YAWEZAWUZATAL - ALEX OLIMPIA by DJ SPEEDY ENTERTAINMENT 13 years ago 5 minutes, 29 seconds 35,970 views",DJ SPEEDY ENTERTAINMENT,35970,35976,6
403,"Baye Speedy - filfilu - DABOSH ( እንዳማረኝ ) - ABEBE FEKADE by DJ SPEEDY ENTERTAINMENT 13 years ago 5 minutes, 52 seconds 71,405 views",DJ SPEEDY ENTERTAINMENT,71405,71655,250
404,"filfilu - YETEFETUT KELDOCH & SEWOCHU MIN YILALU - Part 12 by DJ SPEEDY ENTERTAINMENT 13 years ago 10 minutes, 9 seconds 37,703 views",DJ SPEEDY ENTERTAINMENT,37703,37706,3
405,"filfilu - YETEFETUT KELDOCH & SEWOCHU MIN YILALU - Part 14 by DJ SPEEDY ENTERTAINMENT 13 years ago 3 minutes, 18 seconds 55,800 views",DJ SPEEDY ENTERTAINMENT,55800,55804,4
406,"filfilu - SEW ALLE ! - TEKMATAM & DIRKETAM by DJ SPEEDY ENTERTAINMENT 13 years ago 3 minutes, 14 seconds 102,701 views",DJ SPEEDY ENTERTAINMENT,102701,102701,0
407,"filfilu - YETEFETUT KELDOCH & SEWOCHU MIN YILALU - Part 11 by DJ SPEEDY ENTERTAINMENT 13 years ago 6 minutes, 50 seconds 21,834 views",DJ SPEEDY ENTERTAINMENT,21834,21839,5
408,"filfilu - 50 Birr - ERE YEGEDELEW ! - DEREGE & HABTE by DJ SPEEDY ENTERTAINMENT 13 years ago 5 minutes, 59 seconds 1,084,128 views",DJ SPEEDY ENTERTAINMENT,1084128,1092817,8689
409,"filfilu - ABETARIEW - TILAHUN ILFINEH by DJ SPEEDY ENTERTAINMENT 13 years ago 4 minutes, 58 seconds 15,545 views",DJ SPEEDY ENTERTAINMENT,15545,15554,9
410,"filfilu - YETEFETUT KELDOCH & SEWOCHU MIN YILALU - Part 10 by DJ SPEEDY ENTERTAINMENT 13 years ago 5 minutes, 38 seconds 23,046 views",DJ SPEEDY ENTERTAINMENT,23046,23053,7
411,"filfilu - YETEFETUT KELDOCH & SEWOCHU MIN YILALU - Part 9 by DJ SPEEDY ENTERTAINMENT 13 years ago 5 minutes, 18 seconds 18,770 views",DJ SPEEDY ENTERTAINMENT,18770,18771,1
412,"filfilu - YETEFETUT KELDOCH & SEWOCHU MIN YILALU - Part 8 by DJ SPEEDY ENTERTAINMENT 13 years ago 5 minutes, 22 seconds 26,842 views",DJ SPEEDY ENTERTAINMENT,26842,26845,3
413,"filfilu - YETEFETUT KELDOCH & SEWOCHU MIN YILALU - Part 7 by DJ SPEEDY ENTERTAINMENT 13 years ago 1 minute, 38 seconds 19,916 views",DJ SPEEDY ENTERTAINMENT,19916,19923,7
414,"filfilu - YETEFETUT KELDOCH & SEWOCHU MIN YILALU - Part 3 by DJ SPEEDY ENTERTAINMENT 13 years ago 6 minutes, 25 seconds 48,439 views",DJ SPEEDY ENTERTAINMENT,48439,48444,5
415,"filfilu - YETEFETUT KELDOCH & SEWOCHU MIN YILALU - Part 4 by DJ SPEEDY ENTERTAINMENT 13 years ago 3 minutes, 41 seconds 36,397 views",DJ SPEEDY ENTERTAINMENT,36397,36401,4
416,"filfilu - YETEFETUT KELDOCH & SEWOCHU MIN YILALU - Part 6 by DJ SPEEDY ENTERTAINMENT 13 years ago 4 minutes 34,216 views",DJ SPEEDY ENTERTAINMENT,34216,34225,9
417,"filfilu - YETEFETUT KELDOCH & SEWOCHU MIN YILALU - Part 5 by DJ SPEEDY ENTERTAINMENT 13 years ago 2 minutes, 40 seconds 21,660 views",DJ SPEEDY ENTERTAINMENT,21660,21661,1
418,"filfilu - YETEFETUT KELDOCH & SEWOCHU MIN YILALU - Part 2 by DJ SPEEDY ENTERTAINMENT 13 years ago 2 minutes, 43 seconds 28,829 views",DJ SPEEDY ENTERTAINMENT,28829,28837,8
419,"filfilu - YETEFETUT KELDOCH & SEWOCHU MIN YILALU - Part 1 by DJ SPEEDY ENTERTAINMENT 13 years ago 1 minute, 48 seconds 40,447 views",DJ SPEEDY ENTERTAINMENT,40447,40453,6
420,"filfilu - LAMBADINA - TEDDY AFRO FET. RAY CHARLES by DJ SPEEDY ENTERTAINMENT 13 years ago 4 minutes, 54 seconds 2,852 views",DJ SPEEDY ENTERTAINMENT,2852,2855,3
421,"Baye Speedy - filfilu - YEKEDEME - AHIMED by DJ SPEEDY ENTERTAINMENT 13 years ago 5 minutes, 34 seconds 9,190 views",DJ SPEEDY ENTERTAINMENT,9190,9192,2
422,"Baye Speedy - filfilu - KEAYIN YERAKE - GEREMEW by DJ SPEEDY ENTERTAINMENT 13 years ago 5 minutes, 53 seconds 93,527 views",DJ SPEEDY ENTERTAINMENT,93527,93534,7
423,"Baye Speedy - filfilu - CHEKOLAT - WILLA ALI & ABEL RAGGA by DJ SPEEDY ENTERTAINMENT 13 years ago 3 minutes, 51 seconds 6,313 views",DJ SPEEDY ENTERTAINMENT,6313,6328,15
424,"Baye Speedy - filfilu - MINJAR - BIIRHANU by DJ SPEEDY ENTERTAINMENT 13 years ago 5 minutes, 25 seconds 18,156 views",DJ SPEEDY ENTERTAINMENT,18156,18165,9
425,"Baye Speedy - filfilu - ALAMIN - TEDDY AFRO by DJ SPEEDY ENTERTAINMENT 13 years ago 4 minutes, 3 seconds 23,162 views",DJ SPEEDY ENTERTAINMENT,23162,23173,11
426,"Baye Speedy - filfilu - YENEM AYIN AYITUAL  - ZERITU by DJ SPEEDY ENTERTAINMENT 13 years ago 4 minutes, 43 seconds 27,127 views",DJ SPEEDY ENTERTAINMENT,27127,27135,8
427,"Baye Speedy - filfilu - LIJINETUA - NATI by DJ SPEEDY ENTERTAINMENT 13 years ago 5 minutes, 19 seconds 56,544 views",DJ SPEEDY ENTERTAINMENT,56544,56554,10
428,"Baye Speedy - filfilu - ATNEKAKAGNE - AMSAL MITIKIE by DJ SPEEDY ENTERTAINMENT 13 years ago 6 minutes, 53 seconds 1,024,515 views",DJ SPEEDY ENTERTAINMENT,1024515,1024844,329
429,"Baye Speedy - filfilu - YAMBULLE - BIRHANU & TOKICHAW by DJ SPEEDY ENTERTAINMENT 13 years ago 5 minutes, 28 seconds 50,957 views",DJ SPEEDY ENTERTAINMENT,50957,51059,102
430,"Baye Speedy - filfilu - BOY LE BOY - FASIL DEMOZ by DJ SPEEDY ENTERTAINMENT 13 years ago 5 minutes, 17 seconds 265,945 views",DJ SPEEDY ENTERTAINMENT,265945,266682,737
431,"Baye Speedy - filfilu - TAGESSEGNE - HIBISIT TIRUNEH by DJ SPEEDY ENTERTAINMENT 13 years ago 4 minutes, 21 seconds 19,007 views",DJ SPEEDY ENTERTAINMENT,19007,19019,12
432,"Baye Speedy - filfilu - GIZZIE LE KULU  - TEDDY AFRO by DJ SPEEDY ENTERTAINMENT 13 years ago 5 minutes, 23 seconds 42,149 views",DJ SPEEDY ENTERTAINMENT,42149,42161,12
433,"Baye Speedy - filfilu - BALAGERU - PART 3 - EPHREM & GOSSAYE by DJ SPEEDY ENTERTAINMENT 13 years ago 6 minutes, 40 seconds 90,371 views",DJ SPEEDY ENTERTAINMENT,90371,90411,40
434,"Baye Speedy - HANQEWTA - AMHARIC VERSION - ABREHAM G/MEDIHIN by DJ SPEEDY ENTERTAINMENT 13 years ago 5 minutes, 32 seconds 34,848 views",DJ SPEEDY ENTERTAINMENT,34848,35060,212
435,"Baye Speedy - filfilu - AWEY GUDDIE - GEDION DANIEL by DJ SPEEDY ENTERTAINMENT 14 years ago 4 minutes, 44 seconds 512,008 views",DJ SPEEDY ENTERTAINMENT,512008,515007,2999
436,"Baye Speedy - filfilu - SEGAHUBEH - MEAZA YIMER by DJ SPEEDY ENTERTAINMENT 14 years ago 3 minutes, 56 seconds 5,895 views",DJ SPEEDY ENTERTAINMENT,5895,5901,6
437,"Baye Speedy - filfilu - BANCHIE MEJEN - DERIB ZENEBE by DJ SPEEDY ENTERTAINMENT 14 years ago 5 minutes, 13 seconds 11,206 views",DJ SPEEDY ENTERTAINMENT,11206,11207,1
438,"Baye Speedy - filfilu - T I Z I T A - TEDDY AFRO by DJ SPEEDY ENTERTAINMENT 14 years ago 6 minutes, 6 seconds 8,546 views",DJ SPEEDY ENTERTAINMENT,8546,8549,3
439,"Baye Speedy - filfilu - KEAAYIN YERAKE - GEREMEW ASEFA by DJ SPEEDY ENTERTAINMENT 14 years ago 6 minutes, 9 seconds 9,686 views",DJ SPEEDY ENTERTAINMENT,9686,9692,6
440,"Baye Speedy - filfilu - BALAGERU PART 2  - DESALEGNE MELKU by DJ SPEEDY ENTERTAINMENT 14 years ago 6 minutes, 52 seconds 216,345 views",DJ SPEEDY ENTERTAINMENT,216345,216359,14
441,"Baye Speedy - filfilu - BEHONKUGNE GOJAMMIE - FIKADU GIRMA by DJ SPEEDY ENTERTAINMENT 14 years ago 6 minutes, 10 seconds 30,177 views",DJ SPEEDY ENTERTAINMENT,30177,30190,13
442,"Baye Speedy - filfilu - MUSHIRAYE KERRE - ABEBA DESALEGNE by DJ SPEEDY ENTERTAINMENT 14 years ago 6 minutes, 27 seconds 1,245,341 views",DJ SPEEDY ENTERTAINMENT,1245341,1246300,959
443,"Baye Speedy - filfilu - YAMBULLE - BIRHANU & TOKICHAW by DJ SPEEDY ENTERTAINMENT 14 years ago 5 minutes, 28 seconds 28,080 views",DJ SPEEDY ENTERTAINMENT,28080,28094,14
444,"Baye Speedy - filfilu - BEYNEY TERIFE - MAHILET G/GORGISS by DJ SPEEDY ENTERTAINMENT 14 years ago 6 minutes, 18 seconds 16,334 views",DJ SPEEDY ENTERTAINMENT,16334,16342,8
445,"Baye Speedy - filfilu - SHAMBBA - KAMMER YOSEF by DJ SPEEDY ENTERTAINMENT 14 years ago 3 minutes, 39 seconds 22,790 views",DJ SPEEDY ENTERTAINMENT,22790,22798,8
446,"Baye Speedy - filfilu - YEMINJAR LIJ - ZURIYASH ABIYU by DJ SPEEDY ENTERTAINMENT 14 years ago 6 minutes, 25 seconds 19,154 views",DJ SPEEDY ENTERTAINMENT,19154,19179,25
447,"Baye Speedy - filfilu - MEGGALLO  - KEBEBUSH NEGASH (MIMI) by DJ SPEEDY ENTERTAINMENT 14 years ago 6 minutes, 8 seconds 144,598 views",DJ SPEEDY ENTERTAINMENT,144598,145002,404
448,"Baye Speedy - filfilu - OSSIE BASSA - TSEGAYE SEMMIE by DJ SPEEDY ENTERTAINMENT 14 years ago 5 minutes, 10 seconds 35,766 views",DJ SPEEDY ENTERTAINMENT,35766,35779,13
449,"Baye Speedy - filfilu - BOY LEBOY - FASIL DEMWOZ by DJ SPEEDY ENTERTAINMENT 14 years ago 5 minutes, 58 seconds 43,752 views",DJ SPEEDY ENTERTAINMENT,43752,43765,13
450,"Baye Speedy - filfilu - SHEGNUGNE LEHID - Geremewu by DJ SPEEDY ENTERTAINMENT 14 years ago 4 minutes, 34 seconds 11,510 views",DJ SPEEDY ENTERTAINMENT,11510,11514,4
451,"Baye Speedy - filfilu - libesh lela asebe woi ?  zerihun ali by DJ SPEEDY ENTERTAINMENT 14 years ago 4 minutes, 34 seconds 35,565 views",DJ SPEEDY ENTERTAINMENT,35565,35579,14
452,"Baye Speedy - LALI HABESHA - ZIM ILLALEHU - Binyam Asefa by DJ SPEEDY ENTERTAINMENT 14 years ago 5 minutes, 39 seconds 46,765 views",DJ SPEEDY ENTERTAINMENT,46765,46776,11
453,"Baye Speedy - filfilu - LEKEM YALESH - yitagesu getachew by DJ SPEEDY ENTERTAINMENT 14 years ago 4 minutes, 39 seconds 27,095 views",DJ SPEEDY ENTERTAINMENT,27095,27098,3
454,"Baye Speedy - LALI HABESHA - TEW YILEGNAL - fafi by DJ SPEEDY ENTERTAINMENT 14 years ago 5 minutes, 35 seconds 104,731 views",DJ SPEEDY ENTERTAINMENT,104731,104771,40
455,"Baye Speedy - filfilu - WOW ! AZMARI - Yehune Muluken by DJ SPEEDY ENTERTAINMENT 14 years ago 6 minutes, 7 seconds 468,332 views",DJ SPEEDY ENTERTAINMENT,468332,469916,1584
456,"Baye Speedy - filfilu - BANCHIEW MEJEN - Derib Zenebe by DJ SPEEDY ENTERTAINMENT 14 years ago 5 minutes, 13 seconds 12,935 views",DJ SPEEDY ENTERTAINMENT,12935,12940,5
457,"Baye Speedy - filfilu - WETATU, SINIBIT - Zeritu by DJ SPEEDY ENTERTAINMENT 14 years ago 5 minutes, 8 seconds 1,438,457 views",DJ SPEEDY ENTERTAINMENT,1438457,1439026,569
458,"Baye Speedy - filfilu - COME IN DIASPORA - Alex olompia by DJ SPEEDY ENTERTAINMENT 14 years ago 4 minutes, 16 seconds 687,874 views",DJ SPEEDY ENTERTAINMENT,687874,689884,2010
459,"Baye Speedy - filfilu - SELAM - Zinash Wubbie by DJ SPEEDY ENTERTAINMENT 14 years ago 4 minutes, 53 seconds 25,602 views",DJ SPEEDY ENTERTAINMENT,25602,25615,13
460,"Baye Speedy - filfilu - tamagne nesh - Reggae by DJ SPEEDY ENTERTAINMENT 14 years ago 4 minutes, 20 seconds 7,083 views",DJ SPEEDY ENTERTAINMENT,7083,7088,5
461,"Baye Speedy - filfilu - HOYA HOYE - Abel rasta by DJ SPEEDY ENTERTAINMENT 14 years ago 3 minutes, 14 seconds 25,392 views",DJ SPEEDY ENTERTAINMENT,25392,25404,12
462,"Baye Speedy - filfilu - welayita - tsehaye & zewdu by DJ SPEEDY ENTERTAINMENT 14 years ago 8 minutes, 23 seconds 18,841 views",DJ SPEEDY ENTERTAINMENT,18841,18850,9
463,"Baye Speedy - filfilu - selam yager sew - birhanu & madingo by DJ SPEEDY ENTERTAINMENT 14 years ago 6 minutes, 46 seconds 338,056 views",DJ SPEEDY ENTERTAINMENT,338056,338152,96
464,"Baye Speedy - filfilu - sekotta - Fanta Belay by DJ SPEEDY ENTERTAINMENT 14 years ago 4 minutes, 15 seconds 571,522 views",DJ SPEEDY ENTERTAINMENT,571522,572730,1208
465,"Baye Speedy - filfilu - ESSA ESSO - Guragigna by DJ SPEEDY ENTERTAINMENT 14 years ago 4 minutes, 48 seconds 9,961 views",DJ SPEEDY ENTERTAINMENT,9961,9964,3
466,"Baye Speedy - filfilu - debot inisra - semahegne belew by DJ SPEEDY ENTERTAINMENT 14 years ago 5 minutes, 21 seconds 119,375 views",DJ SPEEDY ENTERTAINMENT,119375,119403,28
467,"Baye Speedy - filfilu - wegen tesebsebu - GOSSAYE by DJ SPEEDY ENTERTAINMENT 14 years ago 7 minutes, 47 seconds 56,144 views",DJ SPEEDY ENTERTAINMENT,56144,56161,17
468,"Baye Speedy - filfilu - alem alemeye - wagnew & kukush by DJ SPEEDY ENTERTAINMENT 14 years ago 6 minutes, 14 seconds 423,174 views",DJ SPEEDY ENTERTAINMENT,423174,423495,321
469,"Baye Speedy - filfilu - konjo moltual - NEBERO ZEKZEKIE by DJ SPEEDY ENTERTAINMENT 14 years ago 4 minutes, 23 seconds 64,456 views",DJ SPEEDY ENTERTAINMENT,64456,64479,23
470,"Baye Speedy - filfilu - KIN KIN - azmari by DJ SPEEDY ENTERTAINMENT 14 years ago 5 minutes, 38 seconds 161,588 views",DJ SPEEDY ENTERTAINMENT,161588,161719,131
471,"Baye Speedy - filfilu - chewata - dereje,dani,habete & asres by DJ SPEEDY ENTERTAINMENT 14 years ago 4 minutes, 5 seconds 214,066 views",DJ SPEEDY ENTERTAINMENT,214066,215261,1195
472,"Baye Speedy - filfilu - KOBELLE - tilahun ilifneh by DJ SPEEDY ENTERTAINMENT 14 years ago 7 minutes, 2 seconds 1,247,097 views",DJ SPEEDY ENTERTAINMENT,1247097,1248054,957
473,"Baye Speedy - lafontain fet. jhony ragga - bob nesta marley by DJ SPEEDY ENTERTAINMENT 14 years ago 4 minutes, 19 seconds 10,302 views",DJ SPEEDY ENTERTAINMENT,10302,10321,19
474,"Baye Speedy - filfilu - haimanot girma - kezira new bette by DJ SPEEDY ENTERTAINMENT 14 years ago 5 minutes, 14 seconds 55,436 views",DJ SPEEDY ENTERTAINMENT,55436,55461,25
475,"Baye Speedy - filfilu - jhony ragga - habeshawi by DJ SPEEDY ENTERTAINMENT 14 years ago 3 minutes, 49 seconds 5,155 views",DJ SPEEDY ENTERTAINMENT,5155,5156,1
476,"Baye Speedy - filfilu - kebebush negash - zenuba by DJ SPEEDY ENTERTAINMENT 14 years ago 5 minutes, 32 seconds 20,794 views",DJ SPEEDY ENTERTAINMENT,20794,21060,266
477,"Baye Speedy - filfilu - kebede lemma- andie by DJ SPEEDY ENTERTAINMENT 14 years ago 3 minutes, 41 seconds 37,778 views",DJ SPEEDY ENTERTAINMENT,37778,37786,8
478,"Baye Speedy - filfilu - tibebu - ligaba by DJ SPEEDY ENTERTAINMENT 14 years ago 5 minutes, 5 seconds 48,100 views",DJ SPEEDY ENTERTAINMENT,48100,48147,47
479,"Baye Speedy - filfilu - gammo - maossie by DJ SPEEDY ENTERTAINMENT 14 years ago 4 minutes, 19 seconds 8,814 views",DJ SPEEDY ENTERTAINMENT,8814,8819,5
480,"Baye Speedy - filfilu - josi - enjaye by DJ SPEEDY ENTERTAINMENT 14 years ago 5 minutes, 37 seconds 14,799 views",DJ SPEEDY ENTERTAINMENT,14799,14808,9
481,"Baye Speedy - filfilu - tigisit weyiso - kochegne by DJ SPEEDY ENTERTAINMENT 14 years ago 5 minutes, 42 seconds 79,066 views",DJ SPEEDY ENTERTAINMENT,79066,79160,94
482,"Baye Speedy - filfilu - abreham g. - migebey by DJ SPEEDY ENTERTAINMENT 14 years ago 5 minutes, 14 seconds 143,437 views",DJ SPEEDY ENTERTAINMENT,143437,143448,11
483,"Baye Speedy - filfilu - manalebesh - awde amet by DJ SPEEDY ENTERTAINMENT 14 years ago 7 minutes, 9 seconds 319,417 views",DJ SPEEDY ENTERTAINMENT,319417,319424,7
484,"Baye Speedy - filfilu - manalebesh - gonder by DJ SPEEDY ENTERTAINMENT 14 years ago 6 minutes, 28 seconds 2,490,562 views",DJ SPEEDY ENTERTAINMENT,2490562,2490802,240
485,"Baye Speedy - filfilu - teddy afro - seleme seleme by DJ SPEEDY ENTERTAINMENT 14 years ago 4 minutes, 56 seconds 128,871 views",DJ SPEEDY ENTERTAINMENT,128871,129779,908
486,"Baye Speedy - filfilu - teddy afro - bob marley by DJ SPEEDY ENTERTAINMENT 14 years ago 5 minutes, 55 seconds 4,932 views",DJ SPEEDY ENTERTAINMENT,4932,4949,17
487,"Baye Speedy - filfilu - teddy afro - lambadina by DJ SPEEDY ENTERTAINMENT 14 years ago 4 minutes, 58 seconds 15,135 views",DJ SPEEDY ENTERTAINMENT,15135,15151,16
