,Posts,Channel,Views_03/03,Views_03/12,view_delta
0,"ela tv - Haileab Gebreluul - Kemaki'ye New Eritrean Music 2022 - (Official Music Video) by ELLA RECORDS 4 days ago 5 minutes, 59 seconds 9,169 views",ELLA RECORDS,9169,13590,4421
1,"ela tv - Tesfalem Zeray - ማዕዶ ረኣዪ - New Eritrean Music 2022 - ( official Music video ) by ELLA RECORDS 1 month ago 4 minutes, 59 seconds 23,360 views",ELLA RECORDS,23360,24493,1133
2,"ela tv - Dawit Yemane - Luley Kalyo - New Eritrean Music 2021 - ( Official Music Video ) by ELLA RECORDS 2 months ago 4 minutes, 27 seconds 14,069 views",ELLA RECORDS,14069,14359,290
3,"ela tv - Sied Salm - Wedi Salm - Kubuda - New Eritrean Music 2021 - ( Official Video) - Tigre Music by ELLA RECORDS 2 months ago 6 minutes, 37 seconds 53,867 views",ELLA RECORDS,53867,55359,1492
4,"ela tv - Miriam Mulgeta - Mary - Nmker - New Eritrean Music 2021 - ( Official Music Video ) by ELLA RECORDS 2 months ago 5 minutes, 14 seconds 82,382 views",ELLA RECORDS,82382,83390,1008
5,"ela tv - Romodan Shifa | Wedi Shifa - Asmara | ኣስመራ - New Eritrean Music 2021 - (Official Video) by ELLA RECORDS 2 months ago 5 minutes, 37 seconds 67,054 views",ELLA RECORDS,67054,67768,714
6,"ela tv - Efrem G/hiwet - Kinrakeb Ena - New Eritrean Music 2021 - ( Official Music Video ) by ELLA RECORDS 2 months ago 5 minutes 37,359 views",ELLA RECORDS,37359,37746,387
7,"ela tv - Salh Mohammed - Neju - New Eritrean Music 2021 - ( Official Music Video ) by ELLA RECORDS 2 months ago 6 minutes, 21 seconds 21,869 views",ELLA RECORDS,21869,21989,120
8,"ela tv - Million Eshetu - Klamedo - New Tigrinia Music 2021 - ( Official Music Video ) by ELLA RECORDS 3 months ago 6 minutes, 54 seconds 487,563 views",ELLA RECORDS,487563,501076,13513
9,"ela tv - Million Eshetu - Klamedo - ሚሊዮን እሸቱ - ክላመዶ - New Tigrinia Music 2021 - Coming Soon by ELLA RECORDS 3 months ago 1 minute, 32 seconds 29,756 views",ELLA RECORDS,29756,29888,132
10,"ela tv - Hermon Argay - Haba - Qne Beli - New Eritrean Music 2021 - ( Official Music Video ) by ELLA RECORDS 3 months ago 6 minutes, 21 seconds 22,579 views",ELLA RECORDS,22579,22702,123
11,"ela tv - Tesfit T/brhan | Brchle - Wehoy Belyo - New Eritrean Music 2021 - ( Official Music Video ) by ELLA RECORDS 3 months ago 5 minutes, 20 seconds 7,669 views",ELLA RECORDS,7669,7739,70
12,"ela tv - Murad Fshaye - Menkor'ta - New Eritrean Music 2021 - ( Official Music Video ) by ELLA RECORDS 3 months ago 6 minutes, 20 seconds 12,302 views",ELLA RECORDS,12302,12361,59
13,"ela tv - Ykalo Beyn - Korya - Gila Fikri - New Eritrean Music 2021 - ( Official Music Video ) by ELLA RECORDS 3 months ago 5 minutes, 38 seconds 38,634 views",ELLA RECORDS,38634,38794,160
14,"ela tv - Msgna Desale - Montorbo - Welelay - New Eritrean Music 2021 - ( Official Music Video ) by ELLA RECORDS 4 months ago 4 minutes, 33 seconds 16,712 views",ELLA RECORDS,16712,16785,73
15,"ela tv - Daniel Fikare - Lela - New Eritrean Music 2021 - ( Official Music Video ) by ELLA RECORDS 4 months ago 4 minutes, 22 seconds 45,356 views",ELLA RECORDS,45356,45781,425
16,"ela tv - Hana Getachew - Hany G - Endet Chalkew - New Ethiopian Music 2021 - (Official Music Video) by ELLA RECORDS 4 months ago 4 minutes, 11 seconds 39,278 views",ELLA RECORDS,39278,40235,957
17,"ela tv - Tigist Anteneh - Sayih - New Ethiopian Music 2021 - ( Official Music Video ) by ELLA RECORDS 4 months ago 4 minutes, 5 seconds 25,725 views",ELLA RECORDS,25725,26097,372
18,"ela tv - Noad Andemariam - Aytdkem - New Eritrean Music 2021 - ( Official Music Video ) by ELLA RECORDS 5 months ago 4 minutes, 57 seconds 23,104 views",ELLA RECORDS,23104,23149,45
19,"ela tv - Yonas Yohannes - Debae - Bado - New Eritrean Music 2021 - ( Official Music Video ) by ELLA RECORDS 5 months ago 4 minutes, 9 seconds 71,170 views",ELLA RECORDS,71170,85370,14200
20,"ela tv - Abdela Mohammed - Yba  - Delina - New Eritrean Music 2021 - ( Official Music Video ) by ELLA RECORDS 5 months ago 3 minutes, 41 seconds 18,306 views",ELLA RECORDS,18306,18401,95
21,"ela tv - Mussie Berhe - Mberwel - Kethall - New Eritrean Music 2021 - Remix with English subtitle by ELLA RECORDS 5 months ago 7 minutes, 9 seconds 28,812 views",ELLA RECORDS,28812,28864,52
22,"ela tv - Wegahta Brhane - Mnasey Gn Adey - New Eritrean Music 2021 - (Official Music Video) by ELLA RECORDS 5 months ago 5 minutes, 14 seconds 50,814 views",ELLA RECORDS,50814,50958,144
23,"ela tv - Japan G/hiwet ft - Bereket Meles - Nlale - New Eritrean Music 2021 -   ( Official Video ) by ELLA RECORDS 5 months ago 6 minutes, 15 seconds 58,728 views",ELLA RECORDS,58728,58896,168
24,"ela tv - Amanuel G/medhin - Amazon - New Eritrean Music 2021 - ( Official Music Video ) by ELLA RECORDS 5 months ago 6 minutes, 17 seconds 385,029 views",ELLA RECORDS,385029,388091,3062
25,"ela tv - Tesfit G/eyesus - Zbaney - New Eritrean Music 2021 - ( Official Music Video ) by ELLA RECORDS 5 months ago 5 minutes, 42 seconds 12,188 views",ELLA RECORDS,12188,12239,51
26,"ela tv - Haben Kflay - Kxbe'ye | ኽጽበ' የ - New Eritrean Music 2021 - ( Official Music Video ) by ELLA RECORDS 5 months ago 5 minutes, 2 seconds 19,089 views",ELLA RECORDS,19089,19225,136
27,"ela tv - Resom Mebrahtu - Ayregmekn - New Eritrean Music 2021 - ( Official Music Video ) by ELLA RECORDS 6 months ago 6 minutes, 22 seconds 21,877 views",ELLA RECORDS,21877,21948,71
28,"ela tv - Teklit Kidane  | ስንጥቅ ኢለ - Aynitelalem | ኣይንጠላለም - New Eritrean Music 2021 by ELLA RECORDS 6 months ago 4 minutes, 45 seconds 15,811 views",ELLA RECORDS,15811,15849,38
29,"ela tv - Silvana Mehari - Tsilaley - New Eritrean Music 2021 - ( Official Music Video ) by ELLA RECORDS 6 months ago 4 minutes, 18 seconds 486,296 views",ELLA RECORDS,486296,490155,3859
30,"ela tv - Tesfit Emeha - Faye - Tsmwa | ጽምዋ - New Eritrean Music 2021 - ( Official Music Video ) by ELLA RECORDS 6 months ago 5 minutes, 14 seconds 47,747 views",ELLA RECORDS,47747,47823,76
31,"ela tv - Mengs Mangato - Fegeg Tehasimki - New Eritrean Music 2021    ( Official Music Video ) by ELLA RECORDS 6 months ago 5 minutes, 52 seconds 34,667 views",ELLA RECORDS,34667,34716,49
32,"ela tv - Silvana Mehari - Tsilaley - New Eritrean Music 2021 - Coming Soon by ELLA RECORDS 6 months ago 43 seconds 81,907 views",ELLA RECORDS,81907,81963,56
33,"ela tv - Henok Mehari - Zewdnat - New Ethiopian Music 2021 - ( Official Music Video ) by ELLA RECORDS 6 months ago 4 minutes, 4 seconds 44,615 views",ELLA RECORDS,44615,44839,224
34,"Robel G/mariam - Robi - Lomi Nabey - New Eritrean Music 2021 - (Official Video) - Tigrinia Music by ELLA RECORDS 6 months ago 5 minutes, 33 seconds 207,474 views",ELLA RECORDS,207474,208549,1075
35,"Yohanna Solomon - Rubi -  feat. Sani Alem - Mexyu Gziey - New Eritrean Music 2021 - (Official Video) by ELLA RECORDS 6 months ago 4 minutes, 40 seconds 184,196 views",ELLA RECORDS,184196,184477,281
36,"ela tv - Santo Michael - Adey - New Eritrean Music 2021 - ( Official Music Video ) by ELLA RECORDS 6 months ago 3 minutes, 20 seconds 35,097 views",ELLA RECORDS,35097,35180,83
37,"ela tv - Salina Tekle - Nxemem - New Eritrean Music 2021 - ( Official Music Video ) by ELLA RECORDS 6 months ago 4 minutes, 37 seconds 53,920 views",ELLA RECORDS,53920,54006,86
38,"ela tv - Abel Melake - Beqem - Zendo - New Eritrean Music 2021 - (Official  Video ) - Tigrinia Music by ELLA RECORDS 6 months ago 5 minutes, 15 seconds 205,422 views",ELLA RECORDS,205422,205782,360
39,"ela tv - Abraham Alem - Abi - Menina - New Eritrean Music 2021 - (Official  Video) -Tigrigna music by ELLA RECORDS 6 months ago 5 minutes, 9 seconds 240,259 views",ELLA RECORDS,240259,240662,403
40,"ela tv - Yonas H/michael - Baru - Aykelon'ye - New Eritrean Music 2021  - ( Official Music Video ) by ELLA RECORDS 6 months ago 4 minutes, 36 seconds 30,645 views",ELLA RECORDS,30645,30676,31
41,"ela tv - Awet Tekie | Tina - Wela Aykeseb - New Eritrean Music 2021 - ( Official Music Video ) by ELLA RECORDS 6 months ago 4 minutes, 21 seconds 102,498 views",ELLA RECORDS,102498,102722,224
42,"ela tv - Rahel Kibreab - Aytegurhani - New Eritrean Music 2021 - (Official  Video) - Tigrinia Music by ELLA RECORDS 6 months ago 5 minutes, 17 seconds 160,174 views",ELLA RECORDS,160174,160456,282
43,"ela tv - Helen Meles - Kemey ele - New Eritrean Music 2021 - ( Official Video ) - Tigrinya Music by ELLA RECORDS 6 months ago 5 minutes, 56 seconds 1,723,911 views",ELLA RECORDS,1723911,1762119,38208
44,"ela tv - Brhane Yemane - Warsay - Sebeney - New Eritrean Music 2021    ( Official Music Video ) by ELLA RECORDS 6 months ago 6 minutes, 16 seconds 29,483 views",ELLA RECORDS,29483,29564,81
45,"Ethiopian Music 2021 - Rahel Gebremedhn - Tadelhal - New Ethiopian Music 2021 - (Official Video) by ELLA RECORDS 7 months ago 4 minutes, 3 seconds 101,658 views",ELLA RECORDS,101658,101805,147
46,"Eritrean Music 2021 - Sadat Ahmed - Shibo - New Eritrean Music 2021 - [ Official Music Video ] - by ELLA RECORDS 7 months ago 5 minutes, 12 seconds 275,659 views",ELLA RECORDS,275659,276278,619
47,"ela tv - Filmon Fshaye - Filawi - Nay - New Eritrean Music 2021 - ( Official Music Video ) by ELLA RECORDS 7 months ago 5 minutes, 33 seconds 34,764 views",ELLA RECORDS,34764,34827,63
48,"ela tv - Henok Mehari feat Chellina - Yhe qen - New Ethiopian Music 2021 - [Official Audio] by ELLA RECORDS 7 months ago 3 minutes, 50 seconds 12,270 views",ELLA RECORDS,12270,12391,121
49,"ela tv - Henok Mehari - Ewnet - New Ethiopian Music 2021 - [ Official Audio ] by ELLA RECORDS 7 months ago 3 minutes, 47 seconds 4,027 views",ELLA RECORDS,4027,4065,38
50,"ela tv - Henok Mehari - Tibeb - New Ethiopian Music 2021 - [ Official Audio ] by ELLA RECORDS 7 months ago 4 minutes, 2 seconds 3,975 views",ELLA RECORDS,3975,4026,51
51,"ela tv - Henok Mehari - Ayderegim - New Ethiopian Music 2021 - [ Official Audio ] by ELLA RECORDS 7 months ago 4 minutes, 5 seconds 3,273 views",ELLA RECORDS,3273,3294,21
52,"ela tv - Henok Mehari - Zewd Nat- New Ethiopian Music 2021 - [ Official Audio ] by ELLA RECORDS 7 months ago 3 minutes, 34 seconds 4,748 views",ELLA RECORDS,4748,4812,64
53,"ela tv - Henok Mehari - Yemister wedaj - New Ethiopian Music 2021 - [ Official Audio ] by ELLA RECORDS 7 months ago 3 minutes, 23 seconds 3,352 views",ELLA RECORDS,3352,3375,23
54,"ela tv - Henok Mehari ft Gilad & Qritiqal - Kukulu   - New Ethiopian Music 2021 - [ Official Audio ] by ELLA RECORDS 7 months ago 4 minutes, 14 seconds 3,426 views",ELLA RECORDS,3426,3462,36
55,"ela tv - Henok Mehari - Kulun - New Ethiopian Music 2021 - [ Official Audio ] by ELLA RECORDS 7 months ago 3 minutes, 22 seconds 2,492 views",ELLA RECORDS,2492,2506,14
56,"ela tv - Henok Mehari - Yene Konjo - New Ethiopian Music 2021 - [ Official Audio ] by ELLA RECORDS 7 months ago 3 minutes, 25 seconds 3,753 views",ELLA RECORDS,3753,3793,40
57,"ela tv - Henok Mehari - Tamrialesh - New Ethiopian Music 2021 - [ Official Audio ] by ELLA RECORDS 7 months ago 3 minutes, 57 seconds 2,908 views",ELLA RECORDS,2908,2937,29
58,"ela tv - Henok Mehari - Fikir Hager Yelewm - New Ethiopian Music 2021 - [ Official Audio ] by ELLA RECORDS 7 months ago 3 minutes, 39 seconds 3,355 views",ELLA RECORDS,3355,3385,30
59,"ela tv - Henok Mehari - Yelib Awka - New Ethiopian Music 2021 - [ Official Audio ] by ELLA RECORDS 7 months ago 3 minutes, 36 seconds 3,835 views",ELLA RECORDS,3835,3862,27
60,"ela tv - Henok Mehari - Shekla Seriwn - New Ethiopian Music 2021 - [ Official Audio ] by ELLA RECORDS 7 months ago 3 minutes, 55 seconds 4,573 views",ELLA RECORDS,4573,4601,28
61,"ela tv - Sadat Ahmed - Shibo - New Eritrean Music 2021 - Coming Soon ! by ELLA RECORDS 7 months ago 50 seconds 18,269 views",ELLA RECORDS,18269,18292,23
62,"Teklit Kidane - Ayntalalem - New Eritrean Music 2021 - Short Interview    Coming Soon by ELLA RECORDS 7 months ago 5 minutes, 58 seconds 6,558 views",ELLA RECORDS,6558,6564,6
63,"ela tv - Mulue Habte - Muler - Halimelki - New Eritrean Music 2021 - ( Official Music Video ) by ELLA RECORDS 7 months ago 4 minutes, 46 seconds 31,769 views",ELLA RECORDS,31769,31834,65
64,"ela tv - Mulugeta Medhanie - China - Aydeln - New Eritrean Music 2021-    (Official Music Video) by ELLA RECORDS 7 months ago 5 minutes, 11 seconds 58,756 views",ELLA RECORDS,58756,58839,83
65,"ela tv - Sinbirat ta sidra - New Eritrean Movie 2021 - Film by Brother Teame Gebreyohans - Part 5 by ELLA RECORDS 7 months ago 43 minutes 4,925 views",ELLA RECORDS,4925,4951,26
66,"ela tv - Sinbirat ta sidra - New Eritrean Movie 2021 - Film by Brother - Teame Gebreyohans - Part 4 by ELLA RECORDS 7 months ago 27 minutes 3,288 views",ELLA RECORDS,3288,3303,15
67,"ela tv - Michael Teweldebrhan - Ykun Beli - New Eritrean Music 2021 - ( Official Music Video ) by ELLA RECORDS 7 months ago 5 minutes, 3 seconds 37,987 views",ELLA RECORDS,37987,38062,75
68,"ela tv - Issak Okbay - Luley - New Eritrean Music 2021 - ( Official Music Video ) - Tigrigna music by ELLA RECORDS 8 months ago 5 minutes, 36 seconds 250,372 views",ELLA RECORDS,250372,250940,568
69,"ela tv - Issak Okbay - Luley - New Eritrean Music 2021 - ( Teaser ) by ELLA RECORDS 8 months ago 1 minute, 10 seconds 29,678 views",ELLA RECORDS,29678,29714,36
70,"ela tv - Fifi - Wana Eza Mdri - ዋና እዛ ምድሪ -  New Eritrean Music 2021 -  Reupload by ELLA RECORDS 8 months ago 5 minutes, 26 seconds 15,682 views",ELLA RECORDS,15682,15732,50
71,"ela tv - Afomiya Betru | Affi - Alew Neger - New Ethiopian Music 2021 - ( Official Music Video ) by ELLA RECORDS 8 months ago 5 minutes, 45 seconds 83,675 views",ELLA RECORDS,83675,83782,107
72,"ela tv - Tedros Mengtu - Teddy Kef - Romay Do Taesa - New Eritrean Music 2021 - (Official Video) by ELLA RECORDS 8 months ago 4 minutes, 28 seconds 49,327 views",ELLA RECORDS,49327,49379,52
73,"ela tv - Henok Tekle - Keghdo'ye - New Eritrean Music 2021 - ( Official Music Video ) by ELLA RECORDS 9 months ago 4 minutes, 22 seconds 59,590 views",ELLA RECORDS,59590,59638,48
74,"ela tv - Mussie Berhe | Mberwel - Sebki'ye - New Eritrean Music 2021 - (Official Music Video) by ELLA RECORDS 9 months ago 6 minutes, 48 seconds 45,900 views",ELLA RECORDS,45900,45974,74
75,"ela tv - Surafel Solomon  - Shelemata - New Ethiopian Music 2021 - ( Official Music Video ) by ELLA RECORDS 9 months ago 3 minutes, 58 seconds 46,170 views",ELLA RECORDS,46170,46209,39
76,"ela tv - Amine T/slasie | Wedi Shawsh - Naxinet Tsihay yu | ናጽነት ጽሓይ እዩ - New Eritrean Music 2021 by ELLA RECORDS 9 months ago 4 minutes, 55 seconds 28,604 views",ELLA RECORDS,28604,28720,116
77,"ela tv - Wegahta Tesfay - Adi Beyney | ዓዲ በይነይ - New Eritrean Music 2021 - (Official Music Video) by ELLA RECORDS 9 months ago 5 minutes, 37 seconds 31,267 views",ELLA RECORDS,31267,31351,84
78,"ela tv - Teklit Zeru - Zyada Million - New Eritrean Music 2021 - (Official Music Video) by ELLA RECORDS 9 months ago 4 minutes, 24 seconds 30,577 views",ELLA RECORDS,30577,30697,120
79,"ela tv - Brhane Tesfealem | Arag - Zanta Gedli - New Eritrean Music 2021 -(Official Music Video) by ELLA RECORDS 9 months ago 5 minutes, 53 seconds 7,841 views",ELLA RECORDS,7841,7849,8
80,"ela tv - Mulgeta Melake - Tesfa - New Eritrean Music 2021 - ( Official Music Video ) by ELLA RECORDS 9 months ago 6 minutes 147,884 views",ELLA RECORDS,147884,148009,125
81,"ela tv - Tomas Dainom - Aybezihen Do - New Eritrean Music 2021 - ( Official Audio ) by ELLA RECORDS 9 months ago 6 minutes, 30 seconds 29,357 views",ELLA RECORDS,29357,29390,33
82,"ela tv - Bisrat Aregay - Teleale - New Eritrean Music 2021 - [ Official  Video ] - Tigrigna music by ELLA RECORDS 9 months ago 5 minutes, 33 seconds 316,800 views",ELLA RECORDS,316800,317061,261
83,"ela tv - ዕላል ምስ ድምጻዊ ሙልጌታ መልኣከ ስድራቤቱን - ምሉጌታ ስንክልናኡ ዓጊትዎ ድዩ? Eritrean Singer Mulgeta Melake by ELLA RECORDS 9 months ago 22 minutes 99,747 views",ELLA RECORDS,99747,99791,44
84,"ela tv - Haileab Gebreluel - Kisanet Libey - New Eritrean Music 2021 - (Official Music Video ) by ELLA RECORDS 9 months ago 5 minutes, 53 seconds 47,048 views",ELLA RECORDS,47048,47206,158
85,"ela tv - Hanibal Alem - Natey - New Eritrean Music 2021 - ( Official Music Video ) - Tigrigna music by ELLA RECORDS 9 months ago 5 minutes, 15 seconds 2,584,433 views",ELLA RECORDS,2584433,2608228,23795
86,"ela tv - Amine Beyn - (Wedi Beyn) - Tsnat Fkri - New Eritrean Music 2021 - ( Official Music Video) by ELLA RECORDS 9 months ago 6 minutes, 36 seconds 43,184 views",ELLA RECORDS,43184,43200,16
87,"ela tv - Melghaw H/mariyam - Anchi Seat - New Ethiopian Music 2021 - (Official Music Video) by ELLA RECORDS 9 months ago 4 minutes, 13 seconds 58,968 views",ELLA RECORDS,58968,59250,282
88,"ela tv - Hanibal Alem - Natey - New Eritrean Music 2021 - Coming Soon by ELLA RECORDS 10 months ago 2 minutes, 29 seconds 90,071 views",ELLA RECORDS,90071,90164,93
89,"ela tv - Tesfalem Zeray- Ed Sdedi - New Eritrean Music 2021 - ( Official Music Video ) by ELLA RECORDS 10 months ago 4 minutes, 29 seconds 35,645 views",ELLA RECORDS,35645,35692,47
90,"ela tv - Ephrem Amare - Eloma - Tigrinia Music 2021 - [ Official Lyric Video ] by ELLA RECORDS 10 months ago 5 minutes, 14 seconds 3,409,499 views",ELLA RECORDS,3409499,3457192,47693
91,"ela tv - Yared Toshome - Essayas Okubay  - Sidet - New Eritrean Music 2021 - Ethiopian Music 2021 by ELLA RECORDS 11 months ago 5 minutes, 55 seconds 19,325 views",ELLA RECORDS,19325,19346,21
92,"ela tv - Temesgen Ermias - Teme  - Temelesni - New Eritrean Music 2021    (Official Music Video) by ELLA RECORDS 1 year ago 5 minutes, 27 seconds 49,411 views",ELLA RECORDS,49411,49462,51
93,"ela tv - Eskedar Wedaj - Zare Ayehu - New Ethiopian Music 2021 - [Official Music Video] by ELLA RECORDS 1 year ago 5 minutes, 10 seconds 95,454 views",ELLA RECORDS,95454,95613,159
94,"ela tv - Michael Melaku - Myko - My Baby - New Ethiopian Music 2021 - [ Official Music Video ] by ELLA RECORDS 1 year ago 3 minutes, 49 seconds 1,480,612 views",ELLA RECORDS,1480612,1484433,3821
95,"ela tv - Michael Melaku - Myko - My Baby - New Ethiopian Music 2021 - [ Official Music Video ] by ELLA RECORDS 1 year ago 3 minutes, 49 seconds 291,908 views",ELLA RECORDS,291908,292101,193
96,"ela tv - Zenawi Werede - Zico - Adey - New Eritrean Music 2021 - Republished in 2021 by ELLA RECORDS 1 year ago 5 minutes, 15 seconds 54,042 views",ELLA RECORDS,54042,54076,34
97,"ela tv - Yikre n men - ይቕረ ንመን - New Eritrean Movie 2021- Ariam Weldeab - Trailer - Coming Soon by ELLA RECORDS 1 year ago 5 minutes, 20 seconds 29,487 views",ELLA RECORDS,29487,29529,42
98,"ela tv - Robel Amanuel - Bemnet - Erey do kbl - New Eritrean Music 2021 - [Official Music Video] by ELLA RECORDS 1 year ago 5 minutes, 26 seconds 86,996 views",ELLA RECORDS,86996,87049,53
99,"ela tv - Sied Salm - Kassala - Lbye Eariema | ልብዬ ኢኣሬማ  - New Eritrean Music 2021 - Tigre Music by ELLA RECORDS 1 year ago 7 minutes, 6 seconds 107,164 views",ELLA RECORDS,107164,107462,298
100,"ela tv - Mehari Kidane - Segen - Akalsni - New Eritrean Music 2021 - ( Official Music Video ) by ELLA RECORDS 1 year ago 6 minutes, 7 seconds 46,222 views",ELLA RECORDS,46222,46247,25
101,"ela tv - Sinbirat ta sidra - New Eritrean Movie 2021 - Film by Brother Teame Gebreyohans - Part 3 by ELLA RECORDS 1 year ago 27 minutes 10,023 views",ELLA RECORDS,10023,10052,29
102,"ela tv - Michael Teklezgi - Niksen - Yqre Belley - New Eritrean Music 2021 - (Official  Video) by ELLA RECORDS 1 year ago 3 minutes, 47 seconds 62,217 views",ELLA RECORDS,62217,62239,22
103,"ela tv - Jaefer Kielay - Gonomagode - New Eritrean Music 2021 - Kunama Music by ELLA RECORDS 1 year ago 5 minutes, 25 seconds 77,959 views",ELLA RECORDS,77959,78737,778
104,"ela tv - Simon Abraham - Ayteqlblen | ኣይተቕልብለን - New Eritrean Music 2021 - ( Official  Video ) by ELLA RECORDS 1 year ago 5 minutes, 19 seconds 63,754 views",ELLA RECORDS,63754,63853,99
105,"ela tv - Dejen Beyene - Jacky - Kemey ele mo - New Eritrean Music 2021    ( Official Music Video ) by ELLA RECORDS 1 year ago 5 minutes, 21 seconds 81,956 views",ELLA RECORDS,81956,82114,158
106,"ela tv - Merhawi Tekste - Mekobaeti - Wuba | ዉባ - New Eritrean Music 2021 - Eritrean Comedy 2021 by ELLA RECORDS 1 year ago 4 minutes, 6 seconds 76,914 views",ELLA RECORDS,76914,76969,55
107,"ela tv - Sami Ezra - Beautiful - New Eritrean Music 2021 ( Official Lyric Video) by ELLA RECORDS 1 year ago 4 minutes, 13 seconds 58,344 views",ELLA RECORDS,58344,58380,36
108,"ela tv - Ha Geez - Hello Hello - New Tigrinia Music 2020 - ( Official Video) - Tigrinia Music by ELLA RECORDS 1 year ago 5 minutes, 13 seconds 30,230 views",ELLA RECORDS,30230,30238,8
109,"ela tv - Michael Yacob | Chapiko  - Fanus Esele - New Eritrean Music 2020 - Hot Guyla by ELLA RECORDS 1 year ago 5 minutes, 40 seconds 191,732 views",ELLA RECORDS,191732,191888,156
110,"ela tv - Nahom Gebremesqel - Hrmetey - New Eritrean Music 2021 - [Official Video] - Tigrigna music by ELLA RECORDS 1 year ago 4 minutes, 14 seconds 553,542 views",ELLA RECORDS,553542,555092,1550
111,"ela tv - Filimon Estifanos - Beyney - New Eritrean Music 2020 - ( Official Video ) - Tigrinia Music by ELLA RECORDS 1 year ago 4 minutes, 50 seconds 37,336 views",ELLA RECORDS,37336,37363,27
112,"ela tv - Filimon Estifanos - Beyney - New Eritrean Music 2020 - Coming Soon by ELLA RECORDS 1 year ago 59 seconds 4,623 views",ELLA RECORDS,4623,4628,5
113,"ela tv - Npsehm Zerom - NP - Adey - New Eritrean Music 2020 - ( Official Music Video ) by ELLA RECORDS 1 year ago 5 minutes, 36 seconds 26,344 views",ELLA RECORDS,26344,26376,32
114,"ela tv - Brhane Kuhlay | Wedi Kuhulay - Ayksenekin'ye - New Eritrean Music 2020 - (Official Video) by ELLA RECORDS 1 year ago 5 minutes, 5 seconds 57,687 views",ELLA RECORDS,57687,57736,49
115,"ela tv - Wegahta Tesfay - Aye Seb - New Eritrean Music 2020 - (Official Music Video) by ELLA RECORDS 1 year ago 5 minutes, 41 seconds 49,728 views",ELLA RECORDS,49728,49801,73
116,"ela tv - Munir Ali ( Wedi Moya ) - New Eritrean Music Video 2018 - this weekend on ela tv - by ELLA RECORDS 3 years ago 25 seconds 16,575 views",ELLA RECORDS,16575,16611,36
117,"ela tv - Tedalo - Sidi | ስዲ - New Eritrean Music 2020 - [Official Video] - Tigrigna music by ELLA RECORDS 1 year ago 4 minutes, 16 seconds 1,966,354 views",ELLA RECORDS,1966354,1983260,16906
118,"ela tv - Tomas Solomon - MJ -  Hileley | ሒለለይ - New Eritrean Music 2020   - ( Official Music Video ) by ELLA RECORDS 1 year ago 5 minutes, 46 seconds 65,547 views",ELLA RECORDS,65547,65621,74
119,"ela tv - Feruz Tesfealem - Lmanoy - New Eritrean Music 2020 - (Official  Video) - Tigrigna Music by ELLA RECORDS 1 year ago 5 minutes, 26 seconds 404,781 views",ELLA RECORDS,404781,405916,1135
120,"ela tv - Sadat Ahmed - ( Wedi Mazu ) - Aleku bel - New Eritrean Music 2020    ( Official Video ) by ELLA RECORDS 1 year ago 5 minutes, 31 seconds 533,790 views",ELLA RECORDS,533790,534405,615
121,"ela tv - Abel Belay - Terakibna | ተራኺብና - New Eritrean Music 2020 - (Official Music Video) by ELLA RECORDS 1 year ago 5 minutes, 44 seconds 78,809 views",ELLA RECORDS,78809,78833,24
122,"ela tv - Yohannes Habteab (Wedi Kerin) - Seb yu Hager |  ሰብ ዩ ሃገር - New Eritrean Music 2020 by ELLA RECORDS 1 year ago 5 minutes, 39 seconds 342,348 views",ELLA RECORDS,342348,342713,365
123,"Yohannes Habteab (Wedi Kerin) - Seb eyu Hager | ሰብ እዩ ሃገር - New Eritrean Music 2020- Coming Soon by ELLA RECORDS 1 year ago 55 seconds 32,664 views",ELLA RECORDS,32664,32687,23
124,"ela tv - Sinbirat ta sidra - New Eritrean Movie 2020 - Film by Brother Teame Gebreyohans - Part 2 by ELLA RECORDS 1 year ago 25 minutes 14,244 views",ELLA RECORDS,14244,14269,25
125,"ela tv -  Sinbirat ta sidra - New Eritrean Movie 2020 - Film by Brother Teame Gebreyohans - Part 1 by ELLA RECORDS 1 year ago 21 minutes 19,880 views",ELLA RECORDS,19880,19918,38
126,"ela tv - Sirak Tekeste  X Afro  Ft  Betty JJ - Miselu- New Eritrean Music 2020 - (Official Video ) by ELLA RECORDS 1 year ago 3 minutes, 12 seconds 50,871 views",ELLA RECORDS,50871,50884,13
127,"ela tv - Mulualem Slasie - Tnqsh - New Ethiopian Music 2020 - (Official Video) Tigrinia Music 2020 by ELLA RECORDS 1 year ago 4 minutes, 56 seconds 68,231 views",ELLA RECORDS,68231,68277,46
128,"ela tv - Mewael Wedaj - Hrumey | ሕሩመይ  - New Ethiopian Music 2020 - Tigrinia Music 2020 by ELLA RECORDS 1 year ago 5 minutes, 21 seconds 62,327 views",ELLA RECORDS,62327,62379,52
129,"ela tv - Henok Mokonen - Ndagem - New Eritrean Music 2020 - (Official Video ) - Tigrigna Music by ELLA RECORDS 1 year ago 5 minutes, 21 seconds 66,163 views",ELLA RECORDS,66163,66214,51
130,"ela tv - Niat Tesfaldet ( Nitu ) - Temelise - New Eritrean Music 2020 - ( Official Music Video ) by ELLA RECORDS 1 year ago 6 minutes 66,802 views",ELLA RECORDS,66802,66893,91
131,"ela tv - Mussie Tsegay | Chegora - Nebari Yelen - New Eritrean Music 2020    (Official Music Video) by ELLA RECORDS 1 year ago 5 minutes, 39 seconds 51,670 views",ELLA RECORDS,51670,51674,4
132,"ela tv - Mussie Berhe - Emberwel - Kethal'l - ከጣልል - New Eritrean Music 2020 - ( Official Video ) by ELLA RECORDS 1 year ago 7 minutes, 21 seconds 147,357 views",ELLA RECORDS,147357,147511,154
133,"ela tv - Filimon Bekele - Yibidma'ye - New Ethiopian Music 2020 - ( Official Music Video ) by ELLA RECORDS 1 year ago 4 minutes, 38 seconds 887,992 views",ELLA RECORDS,887992,893681,5689
134,"ela tv - New Eritrean Movie 2020 - ጽላሎት'ቲ እምነት - ኣብ ሆላንድ ኣስመራን ዝፈረየት ናይ ትግርኛ ፊልም ብ የማነ ይርጋኣለም by ELLA RECORDS 1 year ago 3 minutes, 23 seconds 16,242 views",ELLA RECORDS,16242,16250,8
135,"ela tv - Robel Angesom - Shersharito - New Ethiopian Music 2020 - Tigrinia Music by ELLA RECORDS 1 year ago 4 minutes, 19 seconds 33,113 views",ELLA RECORDS,33113,33124,11
136,"ela tv - Haftom Gereziher  - Emoke | እሞ'ኸ - New Ethiopian Music 2020 - Tigrinia Music 2020 by ELLA RECORDS 1 year ago 4 minutes, 14 seconds 51,438 views",ELLA RECORDS,51438,51501,63
137,"ela tv - Sami Zerihun - Habeshawit - New Eritrean Music 2020 - ( Official Music Video ) by ELLA RECORDS 1 year ago 4 minutes, 2 seconds 610,058 views",ELLA RECORDS,610058,611239,1181
138,"ela tv - Mebrie Adunia - Fkri Hayal - New Eritrean Music 2020 - (Official Music Video) by ELLA RECORDS 1 year ago 5 minutes, 50 seconds 406,593 views",ELLA RECORDS,406593,406821,228
139,"ela tv - Amanuel Goitom - Hub - Lilo Semay - New Eritrean Music 2020 - [Official Video] - Hot Guayla by ELLA RECORDS 1 year ago 5 minutes, 38 seconds 346,733 views",ELLA RECORDS,346733,347058,325
140,"ela tv - Kibrom Birhane - Mulu - New Ethiopian Music 2020 - (Official Music Video) - Tigrigna music by ELLA RECORDS 1 year ago 4 minutes, 47 seconds 875,572 views",ELLA RECORDS,875572,878671,3099
141,"ela tv - Danial Nebiat - Frhi Kemay | ፍርሒ ከማይ - New Eritrean Music 2020 - (Official Muisc Video) by ELLA RECORDS 1 year ago 5 minutes, 34 seconds 52,797 views",ELLA RECORDS,52797,52838,41
142,"ela tv - Samsom Gebrerufael - Nafike Alemey - New Eritrean Music 2020 -  (Official Music Video) by ELLA RECORDS 1 year ago 6 minutes, 7 seconds 59,412 views",ELLA RECORDS,59412,59479,67
143,"ela tv - Zenawi Werede - Zico - Ngerwa - New Eritrean Music 2020 - ( Official Music Video ) by ELLA RECORDS 1 year ago 6 minutes, 1 second 135,883 views",ELLA RECORDS,135883,135921,38
144,"ela tv - Sertsebirhan Tadesse - Halal Meret - Tigrinia Music 2020 - [ Official Music Video ] by ELLA RECORDS 1 year ago 8 minutes, 22 seconds 3,167,833 views",ELLA RECORDS,3167833,3197278,29445
145,"ela tv - Mezgebe K/mariam  ( Asena ) - Selamey - New Ethiopian Music 2020    - Tigrinia Music by ELLA RECORDS 1 year ago 4 minutes, 42 seconds 46,534 views",ELLA RECORDS,46534,46565,31
146,"ela tv - Azeb Teshome - Ayhasebkan Beay - New Eritrean Music 2020 - ( Official Music Video ) by ELLA RECORDS 1 year ago 4 minutes, 54 seconds 58,564 views",ELLA RECORDS,58564,58580,16
147,"ela tv - Rahel Ethiopia - Yekenyeley Fkri - New Ethiopian Music 2020 - ( Official Music Video ) by ELLA RECORDS 1 year ago 5 minutes, 32 seconds 122,809 views",ELLA RECORDS,122809,122873,64
148,"ela tv - Blien Ghetahun - Halime - New Ethiopian Music 2020 - (Official Music Video) by ELLA RECORDS 1 year ago 5 minutes, 6 seconds 62,952 views",ELLA RECORDS,62952,62978,26
149,"ela tv - Heri ft  Samri - Kab lbey - New Ethiopian Music 2020 - ( Official Music Video ) by ELLA RECORDS 1 year ago 6 minutes, 1 second 145,980 views",ELLA RECORDS,145980,146041,61
150,"ela tv - Million Girmay - Halal Ftret - New Eritrean Music 2020 - ( Official Music Video ) by ELLA RECORDS 1 year ago 5 minutes, 30 seconds 47,693 views",ELLA RECORDS,47693,47752,59
151,"ela tv - Aman Ferede - Yrdeakum Ykown - New Eritrean Music 2020 - (Official Music Video) by ELLA RECORDS 1 year ago 5 minutes, 44 seconds 136,317 views",ELLA RECORDS,136317,136411,94
152,"ela tv - Shumay Gebrihiwet ( Joli ) - Harer - New Eritrean Music 2020 - (Official Music Video) by ELLA RECORDS 1 year ago 5 minutes, 25 seconds 1,151,306 views",ELLA RECORDS,1151306,1152799,1493
153,"ela tv - Issak Okbay - Bleney | ብሌነይ - New Eritrean Music 2020 - (Official Music Video) by ELLA RECORDS 1 year ago 4 minutes, 21 seconds 203,959 views",ELLA RECORDS,203959,204140,181
154,"ela tv - Yemane Destalem - Bnueusey | ብኑኡሰይ - New Eritrean Music 2020 - (Official Music Video) by ELLA RECORDS 1 year ago 4 minutes, 57 seconds 88,986 views",ELLA RECORDS,88986,89085,99
155,"ela tv - Solomon Sancho - Lwamey | ልዋመይ - New Eritrean Music 2020 - ( Official Music Video ) by ELLA RECORDS 1 year ago 5 minutes, 58 seconds 81,412 views",ELLA RECORDS,81412,81439,27
156,"ela tv - Saleh Ibrahim - Norit - New Eritrean Music 2020 - ( Official Music Video ) - Tigre Music by ELLA RECORDS 1 year ago 6 minutes, 56 seconds 188,148 views",ELLA RECORDS,188148,188477,329
157,"ela tv - Michael Berhane ft Luwam Mengsteab - Nsle Tsebah - New Eritrean Music 2020 by ELLA RECORDS 1 year ago 6 minutes, 28 seconds 39,577 views",ELLA RECORDS,39577,39582,5
158,"ela tv - Yohannes Tsegay - Aytkeyid'eya - New Eritrean Music 2020 - ( Official Music Video ) by ELLA RECORDS 1 year ago 4 minutes, 25 seconds 77,613 views",ELLA RECORDS,77613,77625,12
159,"ela tv - Robel Luel - Hto Fkri - ሕቶ ፍቅሪ - New Eritrean Music 2020 - ( Official Music Video ) by ELLA RECORDS 1 year ago 5 minutes, 15 seconds 140,222 views",ELLA RECORDS,140222,140235,13
160,"ela tv - M-Sisters - Kbra Mesfn - Kumelay - New Eritrean Music 2020 -  ( Official Music Video ) by ELLA RECORDS 1 year ago 4 minutes, 29 seconds 143,014 views",ELLA RECORDS,143014,143044,30
161,"ela tv - Various Artists  - Abshr - New Eritrean Music 2020 -( Official Music Video ) by ELLA RECORDS 1 year ago 3 minutes, 44 seconds 77,963 views",ELLA RECORDS,77963,77973,10
162,"ela tv - Yohannes Tesfay - Mtsi | ምጺ - New Eritrean Music 2020 - ( Official Music Video ) by ELLA RECORDS 1 year ago 5 minutes, 8 seconds 106,720 views",ELLA RECORDS,106720,106797,77
163,"ela tv - Eyob Russom ( Azan ) - Halwley - New Eritrean Music 2020 - ( Official Music Video ) by ELLA RECORDS 1 year ago 6 minutes, 6 seconds 342,892 views",ELLA RECORDS,342892,343242,350
164,"ela tv - Bemnet Goitom - Mhretka Afsselna - New Eritrean Music 2020    ( Official Music Video ) by ELLA RECORDS 1 year ago 5 minutes, 57 seconds 19,872 views",ELLA RECORDS,19872,19894,22
165,"ela tv - Various Artists - Demna - ደምና - New Eritrean Music 2020 - ( Official Music Video ) by ELLA RECORDS 1 year ago 5 minutes, 32 seconds 94,824 views",ELLA RECORDS,94824,94849,25
166,"ela tv - Bereket Ogbamichael (Beramu) - Lul Tedros - Thzuley'do - New Eritrean Music 2020 by ELLA RECORDS 1 year ago 4 minutes, 12 seconds 366,611 views",ELLA RECORDS,366611,367702,1091
167,"ela tv - Hayleab Yoseph | Wedi Yoseph - Seferkum Genet'yu - New Eritrean Music 2020 - Martyrs Song by ELLA RECORDS 1 year ago 6 minutes, 27 seconds 83,719 views",ELLA RECORDS,83719,83735,16
168,"ela tv - Shshay Mussie - Aytseari - New Eritrean Music 2020 - ( Official Music Video ) by ELLA RECORDS 1 year ago 4 minutes, 37 seconds 72,824 views",ELLA RECORDS,72824,72840,16
169,"ela tv - Berhan Tesfay - Wedi Tesfay - Xhftoy - New Eritrean Music 2020 ( Official Music Video ) by ELLA RECORDS 1 year ago 5 minutes, 51 seconds 65,225 views",ELLA RECORDS,65225,65274,49
170,"ela tv - New Ethiopian Movie 2020 - Tsewar Libi  - Tigrinia Movie 2020-  With Amharic Subtitle by ELLA RECORDS 1 year ago 2 minutes, 21 seconds 24,601 views",ELLA RECORDS,24601,24616,15
171,"ela tv - Temesgen Ermias - Natey Enbeba - New Eritrean Music 2020 - ( Official Music Video ) by ELLA RECORDS 1 year ago 5 minutes, 56 seconds 49,190 views",ELLA RECORDS,49190,49220,30
172,"ela tv - Fsaha Abraham - Tsehay Brak - New Eritrean Music 2020 - ( Official Music Video ) by ELLA RECORDS 1 year ago 5 minutes, 11 seconds 44,157 views",ELLA RECORDS,44157,44178,21
173,"ela tv - Mogos Kahsay - Zeytzazi - New Ethiopian Music 2020 - ( Official Music Video ) by ELLA RECORDS 1 year ago 4 minutes, 51 seconds 84,373 views",ELLA RECORDS,84373,84436,63
174,"ela tv - Yakiem Alemseged - Asey - New Eritrean Music 2020 - ( Official Music Video ) by ELLA RECORDS 1 year ago 5 minutes, 1 second 116,521 views",ELLA RECORDS,116521,116547,26
175,"ela tv - Amanuel Brhane - Aykonetin nisa - New Eritrean Music 2020 - ( Official Music Video ) by ELLA RECORDS 1 year ago 5 minutes, 34 seconds 215,858 views",ELLA RECORDS,215858,215933,75
176,"ela tv - Selam Eyasu - Sele - Semiruley - New Eritrean Music 2020 - ( Official Music Video ) by ELLA RECORDS 1 year ago 4 minutes, 57 seconds 78,465 views",ELLA RECORDS,78465,78501,36
177,"ela tv - Okbay Haile | Warsay - Nenbeynuyu - New Eritrean Music 2020 (  Official Music Video ) by ELLA RECORDS 1 year ago 6 minutes, 21 seconds 82,848 views",ELLA RECORDS,82848,82869,21
178,"ela tv - Seare Buጤ - Tqashemi'do - New Eritrean Music 2020 - ( Official Music Video ) by ELLA RECORDS 1 year ago 6 minutes, 8 seconds 208,808 views",ELLA RECORDS,208808,208995,187
179,"ela tv - Aram Fshation - Tegagiki - New Eritrean Music 2020 - (Official Music Video) by ELLA RECORDS 1 year ago 6 minutes, 20 seconds 767,671 views",ELLA RECORDS,767671,768332,661
180,"ela tv - Yanki - Gegana - New Ethiopian Music 2020 - ( Official Music Video ) by ELLA RECORDS 1 year ago 3 minutes, 50 seconds 61,699 views",ELLA RECORDS,61699,61715,16
181,"ela tv - Abel Hadgu | Abi - Kal Kidan Kibur eyu - New Eritrean Music 2020  ( Official Music Video ) by ELLA RECORDS 1 year ago 5 minutes, 32 seconds 78,555 views",ELLA RECORDS,78555,78689,134
182,"ela tv - New Eritrean Music 2020 - various artists - First Eritrean & Ethiopian live streaming party by ELLA RECORDS Streamed 1 year ago 2 hours, 13 minutes 39,730 views",ELLA RECORDS,39730,39757,27
183,"ela tv - Filmon Fikare - Eritrawi'ye | ኤርትራዊ'የ  - New Eritrean Music 2020 - (Official Music Video) by ELLA RECORDS 1 year ago 5 minutes, 24 seconds 287,710 views",ELLA RECORDS,287710,287953,243
184,"ela tv - Awet Tekie | Tina - Kumeley - New Eritrean Music 2020 - (Official Music Video) by ELLA RECORDS 1 year ago 5 minutes, 25 seconds 165,454 views",ELLA RECORDS,165454,165529,75
185,"ela tv - Fili Major ft Lidya - Ajoka | ኣጆኻ - New Ethiopian Music 2020 - ( Official Music ) | Hip hop by ELLA RECORDS 1 year ago 4 minutes, 19 seconds 57,953 views",ELLA RECORDS,57953,57972,19
186,"ela tv - Filmon Tesfalem - Helu - New Eritrean Music 2020 - (Official Music Video) by ELLA RECORDS 1 year ago 5 minutes, 17 seconds 172,986 views",ELLA RECORDS,172986,173182,196
187,"ela tv - Immortal - Nafkot Zema - New Ethiopian Music 2020 - ( Official Music Video ) by ELLA RECORDS 1 year ago 4 minutes, 14 seconds 41,001 views",ELLA RECORDS,41001,41011,10
188,"ela tv - Efream Welday - Shilaney - New Ethiopian Music 2020 - ( Offcial Music Video ) by ELLA RECORDS 1 year ago 5 minutes, 8 seconds 54,456 views",ELLA RECORDS,54456,54507,51
189,"ela tv - Solomon Weldegergish - Shita Leminey - New Eritrean Music 2020 - ( Official Music Video ) by ELLA RECORDS 1 year ago 4 minutes, 57 seconds 91,556 views",ELLA RECORDS,91556,91596,40
190,"ela tv - Mussie Berhe - Xret Edinan Libinan | ጽሬት ኢድናን ልብናን - New Eritrean Music 2020 by ELLA RECORDS 1 year ago 6 minutes 55,977 views",ELLA RECORDS,55977,55999,22
191,"ela tv - Anbesagr Eyob | Wedi Eyob - Ykreta Nkalo - New Eritrean Music 2020 - (Official Music Video) by ELLA RECORDS 1 year ago 7 minutes, 51 seconds 73,951 views",ELLA RECORDS,73951,73973,22
192,"ela tv - Nahom Yohannes - Meste - Mhret Nlemn | ምሕረት ንለምን - New Eritrean Music 2020 by ELLA RECORDS 1 year ago 4 minutes, 28 seconds 262,796 views",ELLA RECORDS,262796,263012,216
193,"ela tv - Halewat Hagos - Enishesheg - New Ethiopian Music 2020 - ( Official Music Video ) by ELLA RECORDS 1 year ago 3 minutes, 34 seconds 51,607 views",ELLA RECORDS,51607,51634,27
194,"ela tv - Yoni Habitz - Tribute to Nipsey Hussle - Inspire -  Hip Hop Music by ELLA RECORDS 1 year ago 3 minutes, 3 seconds 70,899 views",ELLA RECORDS,70899,71110,211
195,"ela tv - Rahwa Mehari - Degagimeley - New Ethiopian Music 2020 - (Official Music Video) by ELLA RECORDS 2 years ago 4 minutes, 13 seconds 54,217 views",ELLA RECORDS,54217,54237,20
196,"ela tv - Tsiyon Michael & Shewit Okubamichael - ሰነደይ  Eritrean Music 2020 (Sened Senadu Soundtrack) by ELLA RECORDS 2 years ago 4 minutes, 12 seconds 153,620 views",ELLA RECORDS,153620,153679,59
197,"ela tv - Robel Okubay - Almazey - New Eritrean Music 2020 - ( Official Music Video) by ELLA RECORDS 2 years ago 4 minutes, 30 seconds 96,986 views",ELLA RECORDS,96986,97075,89
198,"ela tv - Fsaha Abraham (Wedi Trfe) - Tizkrwo""do - New Eritrean Music 2020 - (Official Music Video) by ELLA RECORDS 2 years ago 5 minutes, 25 seconds 64,350 views",ELLA RECORDS,64350,64390,40
199,"ela tv - Bereket G/hiwet (Hubi) - Hatitelki |ሓቲተልኪ| - New Eritrean Music 2020 - (Official Video) by ELLA RECORDS 2 years ago 5 minutes, 27 seconds 99,125 views",ELLA RECORDS,99125,99199,74
200,"ela tv - Meron Teklay (Frisky) - Fkri Maedo - New Ethiopian Music 2020 - (Official Music) by ELLA RECORDS 2 years ago 4 minutes, 4 seconds 135,381 views",ELLA RECORDS,135381,135450,69
201,"ela tv - Hagos Zeresenay (Abi) - Ayfalkn - New Eritrean Music 2020 - (Official Music) by ELLA RECORDS 2 years ago 4 minutes, 57 seconds 71,896 views",ELLA RECORDS,71896,71918,22
202,"ela tv - Yonas Kidane - Meshaqelit - New Eritrean Music 2020 - (Official Music) by ELLA RECORDS 2 years ago 5 minutes, 29 seconds 124,796 views",ELLA RECORDS,124796,124883,87
203,"ela tv - Awel Aman - Meqira |መቂራ| New Eritrean Music 2020 - (Official Music Video) by ELLA RECORDS 2 years ago 4 minutes, 44 seconds 136,674 views",ELLA RECORDS,136674,136752,78
204,"ela tv - Micky Shewa & Nahome Mekuriya - Zora - New Ethiopian Music 2020 - (Official Music Video) by ELLA RECORDS 2 years ago 4 minutes, 21 seconds 355,186 views",ELLA RECORDS,355186,355436,250
205,"ela tv- Haftom Gebremichael - Sehakley |ስሓቕለይ| - New Ethiopian Music 2020 (Official Music Video) by ELLA RECORDS 2 years ago 4 minutes, 51 seconds 185,309 views",ELLA RECORDS,185309,185446,137
206,"ela tv - Samuel Melse - Tetkoneley|ተትኮንለይ| - New Eritrean Music 2020 - (Official Music Video) by ELLA RECORDS 2 years ago 6 minutes, 36 seconds 238,521 views",ELLA RECORDS,238521,238575,54
207,"ela tv - Michael Yemane - Yohana - New Eritrean Music 2020 - (Official Music Video) by ELLA RECORDS 2 years ago 5 minutes, 1 second 106,829 views",ELLA RECORDS,106829,106885,56
208,"ela tv - Michael Sium - Kokah - New Eritrean Song 2020 - (Official Music Video) by ELLA RECORDS 2 years ago 4 minutes, 50 seconds 101,183 views",ELLA RECORDS,101183,101205,22
209,"ela tv - Dawit Tesfatsion - Metselel |መጸለል| -  New Eritrean Music 2020 - (Official Music Video) by ELLA RECORDS 2 years ago 4 minutes, 39 seconds 88,796 views",ELLA RECORDS,88796,88834,38
210,"ela tv - Elias Beyene(Wezegiea) - Ane |ኣነ| -  New Eritrean Music 2020 - (Official Music Video) by ELLA RECORDS 2 years ago 6 minutes, 54 seconds 82,914 views",ELLA RECORDS,82914,82931,17
211,"ela tv - S. I.N - Mesgeno |መስገኖ| - New Ethiopian  Hip Hop  Music 2020 - (Official Music Video) by ELLA RECORDS 2 years ago 3 minutes, 25 seconds 66,211 views",ELLA RECORDS,66211,66226,15
212,"ela tv - Ermias Kiflezghi - Yzkr | ይዝክር - New Eritrean Music 2020 - ( Official Music Video ) by ELLA RECORDS 2 years ago 5 minutes, 27 seconds 4,400,127 views",ELLA RECORDS,4400127,4412551,12424
213,"ela tv - Sami Ezra & Skales - Shedada - New Eritrean Music 2020 - ( Official Music Video ) by ELLA RECORDS 2 years ago 3 minutes, 29 seconds 335,835 views",ELLA RECORDS,335835,336016,181
214,"ela tv - Danait Afewerki - Aya Beyene - New Eritrean Music 2020 - ( Official Music Video ) by ELLA RECORDS 2 years ago 5 minutes, 31 seconds 420,582 views",ELLA RECORDS,420582,420701,119
215,"ela tv - Lela Keflom - Teameteley - New Eritrean Music 2020 - (Official Music Video) by ELLA RECORDS 2 years ago 5 minutes, 27 seconds 180,286 views",ELLA RECORDS,180286,180367,81
216,"ela tv - Issey Afewerki - N'e |ንዒ| - New Eritrean Music 2020 - (Official Music Video) by ELLA RECORDS 2 years ago 4 minutes, 38 seconds 97,198 views",ELLA RECORDS,97198,97232,34
217,"ela tv - Kald Osman - Girmet Aman - New Eritrean Music 2020 - Tigre Music - ( Official Music Video ) by ELLA RECORDS 2 years ago 5 minutes, 23 seconds 89,827 views",ELLA RECORDS,89827,89903,76
218,"ela tv - Zenawi Werede (Zico) - Beli Senay - New Eritrean Music 2020 - (Official Music Video) by ELLA RECORDS 2 years ago 4 minutes, 28 seconds 280,676 views",ELLA RECORDS,280676,280702,26
219,"ela tv - Merhawi T/medhin ( Wedi Haleka ) - Ageb - New Eritrean Music 2020 - (Official Music Video) by ELLA RECORDS 2 years ago 6 minutes, 32 seconds 586,625 views",ELLA RECORDS,586625,586815,190
220,"ela tv - Bsrat Aregay - Bezihu Aber | በዚሑ ኣበር - New Eritrean Music 2020 - ( Official Music Video ) by ELLA RECORDS 2 years ago 5 minutes, 28 seconds 1,173,646 views",ELLA RECORDS,1173646,1175760,2114
221,"ela tv - Embza Tadese - Maedot - New Ethiopian Music 2020 - ( Official Music Video ) by ELLA RECORDS 2 years ago 5 minutes, 23 seconds 6,370,860 views",ELLA RECORDS,6370860,6428194,57334
222,"ela tv - Kisanet Angosom - Kuhuley - New Eritrean Music 2020 - (Official Music Video) by ELLA RECORDS 2 years ago 4 minutes, 5 seconds 172,359 views",ELLA RECORDS,172359,172427,68
223,"ela tv - Fifi - Wana Eza Mdri - | ዋና እዛ ምድሪ - New Eritrean Music 2020 - [ Official Music Video ] by ELLA RECORDS 2 years ago 5 minutes, 26 seconds 88,739 views",ELLA RECORDS,88739,88760,21
224,"ela tv - Brhane T/medhin - Wedi Haleka - Khaysh Yu - New Eritrean Music 2020 - [Official Video] by ELLA RECORDS 2 years ago 5 minutes 207,333 views",ELLA RECORDS,207333,207552,219
225,"ela tv - Alula G/amalck - Abet - New Ethiopian Music 2020 - ( Official Music Video ) by ELLA RECORDS 2 years ago 5 minutes, 29 seconds 191,277 views",ELLA RECORDS,191277,192375,1098
226,"ela tv - Rae Band - Zenebesh  - New Eritrean Music 2020 - ( Official Music Video ) by ELLA RECORDS 2 years ago 5 minutes, 58 seconds 100,540 views",ELLA RECORDS,100540,100563,23
227,"ela tv - Abrhet - ( Gual Ankere ) - Senay Zemen - New Eritrean Music 2020 - ( Official Music Video ) by ELLA RECORDS 2 years ago 6 minutes, 24 seconds 1,263,498 views",ELLA RECORDS,1263498,1268281,4783
228,"ela tv - Nahom Yohannes ( Meste ) - Freweini - New Eritrean Music 2020 - [ Official Music Video ] by ELLA RECORDS 2 years ago 4 minutes, 50 seconds 1,822,596 views",ELLA RECORDS,1822596,1828445,5849
229,"ela tv - Jacky Gosee - Ende Amoraw - New Ethiopian Music 2020 - ( Official Music Video ) by ELLA RECORDS 2 years ago 4 minutes, 29 seconds 13,366,824 views",ELLA RECORDS,13366824,13447318,80494
230,"ela tv - Filmon Gebretinsae - Keshat - Aleki do - New Eritrean Music 2019 - ( Official Music Video ) by ELLA RECORDS 2 years ago 5 minutes, 43 seconds 937,955 views",ELLA RECORDS,937955,940097,2142
231,"ela tv - Amanuel G/medhin - Difae - Lemideki - New Eritrean Music 2019 - (Official Music Video) by ELLA RECORDS 2 years ago 5 minutes, 20 seconds 191,584 views",ELLA RECORDS,191584,191675,91
232,"ela tv - Mussie Gebrehans - Ataisuki Do - New Eritrean Music 2019 - ( Official Music Video ) by ELLA RECORDS 2 years ago 4 minutes, 42 seconds 196,653 views",ELLA RECORDS,196653,196689,36
233,"ela tv - G Mesay Kebede - Aymeslushm | አይመስሉሽም - New Ethiopian Music 2019 - ( Official Music Video ) by ELLA RECORDS 2 years ago 3 minutes, 27 seconds 700,933 views",ELLA RECORDS,700933,704355,3422
234,"ela tv - Semhar Yohannes - Quno | ቁኖ - New Eritrean Music 2019 - ( Official Music Video ) by ELLA RECORDS 2 years ago 5 minutes, 5 seconds 1,500,799 views",ELLA RECORDS,1500799,1503367,2568
235,"ela tv - Hermon Beraki - Ruhus Gama - New Eritrean Music 2019 - ( Official Music Video ) by ELLA RECORDS 2 years ago 6 minutes, 26 seconds 1,242,403 views",ELLA RECORDS,1242403,1244297,1894
236,"ela tv - Amanuel Araya ( Luwam ) - Khgos'ye - New Eritrean Music 2019 - ( Official Music Video ) by ELLA RECORDS 2 years ago 4 minutes, 42 seconds 162,639 views",ELLA RECORDS,162639,162670,31
237,"ela tv - Metkel Mebrahtu - Nay Znab Xhay - New Eritrean Music 2019 - ( Official Music Video ) by ELLA RECORDS 2 years ago 5 minutes, 28 seconds 86,658 views",ELLA RECORDS,86658,86660,2
238,"ela tv - Saleh Abdela - Azab Sham - New Eritrean Music 2019 - Tigre Music (Official Music Video) by ELLA RECORDS 2 years ago 6 minutes, 11 seconds 119,927 views",ELLA RECORDS,119927,119987,60
239,"ela tv - Huruy Ghirmay - Kemey Kelato |ከመይ ክኢላቶ - New Eritrean Music 2019 - ( Official Music Video ) by ELLA RECORDS 2 years ago 4 minutes, 57 seconds 70,168 views",ELLA RECORDS,70168,70178,10
240,"ela tv - Amanuel Goitiom - Gele Eki Gerkiley - New Eritrean Music 2019 - (Official Music Video) by ELLA RECORDS 2 years ago 6 minutes, 18 seconds 117,299 views",ELLA RECORDS,117299,117338,39
241,"ela tv - Yared Negu & Nina Girma - Yetale Aleqa - New Ethiopian Music 2019 - (Official Music Video) by ELLA RECORDS 2 years ago 3 minutes, 36 seconds 2,678,804 views",ELLA RECORDS,2678804,2691831,13027
242,"ela tv - Temesgen Tewelde - Gamey |ጋመይ| - New Eritrean Music 2019 - (Official Music Video) by ELLA RECORDS 2 years ago 5 minutes, 28 seconds 54,026 views",ELLA RECORDS,54026,54050,24
243,"ela tv - Daniel Fikare - Serihkley | ሰሪሕክለይ - New Eritrean Music 2019 - (Official Music Video) by ELLA RECORDS 2 years ago 5 minutes, 37 seconds 84,269 views",ELLA RECORDS,84269,84289,20
244,"ela tv - Efream Tsegay - Leltey | ልእልተይ - New Eritrean Music 2019 - ( Official Music Video ) by ELLA RECORDS 2 years ago 5 minutes, 46 seconds 347,653 views",ELLA RECORDS,347653,347803,150
245,"ela tv - Amanuel Yemane - Amanay | ኣማናይ -  Tigrinia Music 2019 - [ Official Music Video ] by ELLA RECORDS 2 years ago 4 minutes, 44 seconds 5,126,872 views",ELLA RECORDS,5126872,5160548,33676
246,"ela tv - Kisanet Berhane - tribute - መዘከርታ ን' ቅሳነት ብርሃነ - New Eritrean Music 2019 - Part 4 Last by ELLA RECORDS 2 years ago 36 minutes 153,830 views",ELLA RECORDS,153830,153926,96
247,"ela tv - Kisanet Berhane - tribute - መዘከርታ ን' ቅሳነት ብርሃነ - New Eritrean Music 2019 - Part 3 by ELLA RECORDS 2 years ago 22 minutes 61,708 views",ELLA RECORDS,61708,61736,28
248,"ela tv - Kisanet Berhane - tribute - መዘከርታ ን' ቅሳነት ብርሃነ - New Eritrean Music 2019 - Part 2 by ELLA RECORDS 2 years ago 23 minutes 83,656 views",ELLA RECORDS,83656,83683,27
249,"ela tv - Kisanet Berhane - tribute - መዘከርታ ን' ቅሳነት ብርሃነ - New Eritrean Music 2019 - Part 1 by ELLA RECORDS 2 years ago 22 minutes 52,239 views",ELLA RECORDS,52239,52274,35
250,"ela tv - Kisanet Berhane -  tribute  - መዘከርታ ን' ቅሳነት ብርሃነ -  New Eritrean Music 2019 - Documentary by ELLA RECORDS 2 years ago 1 hour, 33 minutes 94,527 views",ELLA RECORDS,94527,94554,27
251,"ela tv - Tirhas Haddish - Krebeni |ቅረበኒ| New Eritrean Music 2019 - (Official Music Video) by ELLA RECORDS 2 years ago 4 minutes, 1 second 45,233 views",ELLA RECORDS,45233,45251,18
252,"ela tv - Ermias Kiflezgi - Ane Asmara - New Eritrean Music 2019 - (Official Music Video) by ELLA RECORDS 2 years ago 5 minutes, 50 seconds 1,229,368 views",ELLA RECORDS,1229368,1231840,2472
253,"ela tv - Saba Lemelem - Beluley | በሉለይ| - New Eritrean Music 2019 - (Official Music Video) by ELLA RECORDS 2 years ago 5 minutes, 10 seconds 519,425 views",ELLA RECORDS,519425,520424,999
254,"ela tv - Bereket Teklay (Berie) - |Gual Adey| - New Eritrean Music 2019 - ( Official Music Video) by ELLA RECORDS 2 years ago 5 minutes, 34 seconds 117,775 views",ELLA RECORDS,117775,117825,50
255,"ela tv - Alexsander Kahsay (Sandro) - Arkey|ዓርከይ| - New Eritrean Music 2019 - (Official Music Video) by ELLA RECORDS 2 years ago 6 minutes, 21 seconds 588,431 views",ELLA RECORDS,588431,589366,935
256,"ela tv - Kidane Habtom (Ajay) - Kehenkqeki Eyi - New Eritrean Music 2019 - (Official Music Video) by ELLA RECORDS 2 years ago 4 minutes, 39 seconds 39,856 views",ELLA RECORDS,39856,39863,7
257,"ela tv - Nguse Abadi - Taga | ታጋ - New Ethiopian Music 2019 - (Official Music Video) by ELLA RECORDS 2 years ago 8 minutes, 19 seconds 3,816,677 views",ELLA RECORDS,3816677,3822825,6148
258,"ela tv - Sandro Tsegay (San) - Zeykoneley - New Eritrean Music 2019 (Offical Music Video) by ELLA RECORDS 2 years ago 4 minutes, 38 seconds 55,597 views",ELLA RECORDS,55597,55610,13
259,"ela tv - Alexsander Kahsay ( Sandro ) - Merina Show - Arkey  - New Eritrean Music 2019 - Coming Soon by ELLA RECORDS 2 years ago 24 minutes 52,379 views",ELLA RECORDS,52379,52390,11
260,"ela tv - Jacky Gosee - Balambaras - New Ethiopian Music 2019 [ Official Lyric Video ] by ELLA RECORDS 2 years ago 5 minutes, 11 seconds 1,410,321 views",ELLA RECORDS,1410321,1417390,7069
261,"ela tv - Jacky Gosee - Norshal Endee - New Ethiopian Music 2019 - [ Official Audio ] by ELLA RECORDS 2 years ago 5 minutes, 30 seconds 425,695 views",ELLA RECORDS,425695,427558,1863
262,"ela tv - Jacky Gosee - Amnalew - New Ethiopian Music 2019 - [ Official Music Video ] by ELLA RECORDS 2 years ago 5 minutes, 31 seconds 1,036,825 views",ELLA RECORDS,1036825,1044042,7217
263,"ela tv - Jacky Gosee - Yenoh Zemen - New Ethiopian Music 2019 - [Official Audio] by ELLA RECORDS 2 years ago 4 minutes, 48 seconds 370,592 views",ELLA RECORDS,370592,371513,921
264,"ela tv - Jacky Gosee - Kixibe Eye - New Ethiopian Music 2019 - [ Official Music Video ] by ELLA RECORDS 2 years ago 4 minutes, 24 seconds 2,519,017 views",ELLA RECORDS,2519017,2528993,9976
265,"ela tv - Jacky Gosee - Arodion - New Ethiopian Music 2019 - [Official Audio] by ELLA RECORDS 2 years ago 5 minutes, 7 seconds 633,446 views",ELLA RECORDS,633446,636955,3509
266,"ela tv - Jacky Gosee - Yaa Dammee Tiyya - New Ethiopian Oromo Music 2019 - [ Official Lyric Video ] by ELLA RECORDS 2 years ago 4 minutes, 41 seconds 791,283 views",ELLA RECORDS,791283,794474,3191
267,"ela tv - Jacky Gosee - Kedamawit - New Ethiopian Music 2019 - [ Official Lyric Video ] by ELLA RECORDS 2 years ago 4 minutes, 1 second 285,507 views",ELLA RECORDS,285507,286307,800
268,"ela tv - Jacky Gosee - Ende Kelal - New Ethiopian Music 2019 - [ Official Lyric Video ] by ELLA RECORDS 2 years ago 6 minutes, 5 seconds 1,189,657 views",ELLA RECORDS,1189657,1194874,5217
269,"ela tv - Jacky Gosee - Enda Amerawu - New Ethiopian Music 2019 - [ Official Lyric Video ] by ELLA RECORDS 2 years ago 4 minutes, 5 seconds 1,165,441 views",ELLA RECORDS,1165441,1166818,1377
270,"ela tv - Jacky Gosee - Hilm Ayew - New Ethiopian Music 2019 - [ Official Audio ] by ELLA RECORDS 2 years ago 4 minutes, 3 seconds 1,963,518 views",ELLA RECORDS,1963518,1973409,9891
271,"ela tv - Jacky Gosee - Hiyaw - New Ethiopian Music 2019 - [ Official Lyric Video ] by ELLA RECORDS 2 years ago 5 minutes, 34 seconds 724,960 views",ELLA RECORDS,724960,726278,1318
272,"ela tv - Jacky Gosee - Endegena - New Ethiopian Music 2019 [ Official Audio ] by ELLA RECORDS 2 years ago 4 minutes, 53 seconds 921,735 views",ELLA RECORDS,921735,925645,3910
273,"ela tv - Danait Yohannes - Kab Kone | ካብ ኮነ - New Eritrean Music 2019 - ( Official Music Video ) by ELLA RECORDS 2 years ago 6 minutes, 9 seconds 3,483,014 views",ELLA RECORDS,3483014,3492473,9459
274,"ela tv - Ruftalem Abraham - Gegikani Leka | ገጊኻኒ ለኻ - New Eritrean Music 2019 - ( Official Video ) by ELLA RECORDS 2 years ago 5 minutes, 22 seconds 265,058 views",ELLA RECORDS,265058,265366,308
275,"ela tv - Filmon Solomon - Temelesi | ተመለሲ - New Eritrean Music 2019 - ( Official Music Video ) by ELLA RECORDS 2 years ago 5 minutes, 23 seconds 129,765 views",ELLA RECORDS,129765,129804,39
276,"ela tv - Bsrat G/mariam - Yakleni - New Eritrean Music 2019 - ( Official Music Video ) by ELLA RECORDS 2 years ago 5 minutes, 42 seconds 106,608 views",ELLA RECORDS,106608,106712,104
277,"ela tv - Sami Ezra - Gidey Ygbereley | ጊደይ ይግበረለይ - New Eritrean Music 2019 - (Official Music Video) by ELLA RECORDS 2 years ago 4 minutes, 23 seconds 342,355 views",ELLA RECORDS,342355,342555,200
278,"ela tv - Eseyas Salh ( Rasha ) - Tzkri Do  - New Eritrean Music 2019 - ( Official Music Video ) by ELLA RECORDS 2 years ago 4 minutes, 32 seconds 631,373 views",ELLA RECORDS,631373,631693,320
279,"ela tv - Alexsander Kiros - Mslay Kemay - New Ethiopian Music 2019 - Tigrinia Music 2019 by ELLA RECORDS 2 years ago 5 minutes, 18 seconds 82,816 views",ELLA RECORDS,82816,82841,25
280,"ela tv - Mohamed Ibrahim(Boxer) - Sebah - New Eritrean Music 2019 - Saho Music - (Official Video) by ELLA RECORDS 2 years ago 4 minutes, 14 seconds 121,330 views",ELLA RECORDS,121330,121802,472
281,"ela tv - Eseyas Salh | Rasha - Short Interview - New Eritrean Music 2019 - Tzkri do Coming Soon by ELLA RECORDS 2 years ago 21 minutes 48,115 views",ELLA RECORDS,48115,48125,10
282,"ela tv - Fyori Tsehaye - Ayni Qelay - New Eritrean Music 2019 - ( Official Music Video ) by ELLA RECORDS 2 years ago 6 minutes, 15 seconds 106,555 views",ELLA RECORDS,106555,106645,90
283,"ela tv - Dawit Nega - Che'Chekolata | ቸቸኮላታ - New Ethiopian Music 2019 - ( Official Music Video ) by ELLA RECORDS 2 years ago 4 minutes, 59 seconds 1,671,818 views",ELLA RECORDS,1671818,1675255,3437
284,"ela tv - Asmerom Afewerki | Asi - Meqiruni | መቂሩኒ - New Eritrean Music 2019 - ( Official Music ) by ELLA RECORDS 2 years ago 4 minutes, 24 seconds 76,027 views",ELLA RECORDS,76027,76121,94
285,"ela tv - Million Gebremedhin (Sikay) -  Bedali Fekri - New Eritrean Music 2019 - (Offical Video) by ELLA RECORDS 2 years ago 4 minutes, 47 seconds 86,202 views",ELLA RECORDS,86202,86339,137
286,"ela tv - Metkel Halefom - Gezawit - New Ethiopian Music 2019 - ( Official Music Video ) by ELLA RECORDS 2 years ago 5 minutes, 15 seconds 64,372 views",ELLA RECORDS,64372,64456,84
287,"ela tv - Haftamu H/Slasie - Almedkini | ኣልምድኽኒ - New Ethiopian Music 2019 - ( Official Music Video ) by ELLA RECORDS 2 years ago 6 minutes, 18 seconds 127,617 views",ELLA RECORDS,127617,127661,44
288,"ela tv - Abraham Alem  ( Abi ) - Goney | ጎነይ - New Eritrean Music 2019 - ( Official Music Video ) by ELLA RECORDS 2 years ago 6 minutes, 22 seconds 1,869,678 views",ELLA RECORDS,1869678,1877790,8112
289,"ela tv - Solomon Denbelash (Shelela) - Terakibna' Do mama - New Eritrean music 2019 by ELLA RECORDS 2 years ago 5 minutes, 7 seconds 77,608 views",ELLA RECORDS,77608,77642,34
290,"ela tv - Fana Negash - Awejeku | ኣወጀኹ - New Ethiopian Music 2019 ( Official Video ) - Tigrinia Music by ELLA RECORDS 2 years ago 5 minutes, 10 seconds 382,602 views",ELLA RECORDS,382602,382785,183
291,"ela tv - Gelgele Meskele | ገልገለ መስቀለ - Luwam G/berhan ft Yohana Abera - New Eritrean Music 2019 by ELLA RECORDS 2 years ago 6 minutes, 13 seconds 264,090 views",ELLA RECORDS,264090,264154,64
292,"ela tv - Akberet Abedom - Arha Kuma | ኣርሓ ኩማ  - New Eritrean Music 2019 - ቕዱስ ዮሃንስ Special by ELLA RECORDS 2 years ago 6 minutes, 21 seconds 271,196 views",ELLA RECORDS,271196,271295,99
293,"ela tv - Nahom Yohannes ( Meste ) - Tefelalina Miflilay | ተፈላሊና ምፍልላይ - New Eritrean Music 2019 by ELLA RECORDS 2 years ago 4 minutes, 11 seconds 2,867,396 views",ELLA RECORDS,2867396,2874371,6975
294,"ela tv - New Eritrean Movie 2019 - Meseli Lomi | ምስሊ ሎሚ  - Short Film By Mehari Tsegay by ELLA RECORDS 2 years ago 19 minutes 41,324 views",ELLA RECORDS,41324,41326,2
295,"ela tv - Haben Teklemichael - Ajebulay |ዓጅቡለይ| - New Eritrean Music 2019 - (Offical Music) by ELLA RECORDS 2 years ago 5 minutes, 19 seconds 82,888 views",ELLA RECORDS,82888,82892,4
296,"ela tv - Nahom Yohannes | Meste - New Eritrean Music 2019 - Tefelalina Mfllay - Coming Soon by ELLA RECORDS 2 years ago 1 minute, 38 seconds 149,255 views",ELLA RECORDS,149255,149284,29
297,"ela tv - New Eritrean Movie 2019 - ከመይ ጌርና ብ ካሽን ገዝእ - We looking for agents by ELLA RECORDS 2 years ago 1 minute, 46 seconds 14,964 views",ELLA RECORDS,14964,14975,11
298,"ela tv - New Eritrean Movie 2019 - How to buy ela code Holland Payment Problem by ELLA RECORDS 2 years ago 2 minutes, 59 seconds 13,886 views",ELLA RECORDS,13886,13894,8
299,"ኣብ ሽዉደን ትርከቡ ዓማዊል ኤላ ቲቪ እንታይ ኮይኑ ምክፋል ይ የኣብየኩም -Sweden ela tv Payment Problem - Eritrean Movie 2019 by ELLA RECORDS 2 years ago 1 minute, 48 seconds 6,457 views",ELLA RECORDS,6457,6474,17
300,"ከመይ ጌርና ኣብ ኤላ ቲቪ ኣፕ ንምዝገብ ዘርኢ ቪድዮ-   New Eritrean Movie 2019 - by ELLA RECORDS 2 years ago 3 minutes, 7 seconds 19,603 views",ELLA RECORDS,19603,19612,9
301,"New Eritrean Movie 2019 - ዓቢ ምጉዳል ዋጋ ብ ምክንያት ምምስራት ኤላ ቲቪ ኣፕ - MEKSEB ALEM | KAHTA | ROXORA by ELLA RECORDS 2 years ago 1 minute, 30 seconds 14,337 views",ELLA RECORDS,14337,14360,23
302,"ela tv - Yanki ft Kabila - Ati Gualey - - New Ethiopian Music 2019 - ( Tigrigna Hip-Pop ) by ELLA RECORDS 2 years ago 3 minutes, 13 seconds 75,802 views",ELLA RECORDS,75802,76023,221
303,"ela tv - Yoseph Tsegay - Josi - Ketelya Gama - New Eritrean Music 2019 - ( Official Music ) by ELLA RECORDS 2 years ago 7 minutes, 34 seconds 24,296 views",ELLA RECORDS,24296,24297,1
304,"ela tv - Luel Anmaw - Nski Fashney - New Ethiopian  Music 2019 - ( Offical Music ) by ELLA RECORDS 2 years ago 4 minutes, 52 seconds 48,628 views",ELLA RECORDS,48628,48637,9
305,"ela tv - Emotional Video by Siemawi Jerry - New Eritrean Short Movie 2019 by ELLA RECORDS 2 years ago 2 minutes, 56 seconds 40,426 views",ELLA RECORDS,40426,40456,30
306,"ela tv - Mahder Getahun - Awalido Lomi Ebeda - New Ethiopian Music 2019 - Asheda | ኣሸንዳ by ELLA RECORDS 2 years ago 6 minutes, 1 second 268,483 views",ELLA RECORDS,268483,268660,177
307,"ela tv - Amanuel G/medhin - Enbeba |  ዕንበባ - New Eritrean Music 2019 - (Official Music Video) by ELLA RECORDS 2 years ago 4 minutes, 50 seconds 5,324,620 views",ELLA RECORDS,5324620,5347789,23169
308,"ela tv - Samuel Zerghi ( Esaw ) - Luwa | ሉዋ - New Eritrean Music 2019 - ( Official Video ) by ELLA RECORDS 2 years ago 4 minutes, 50 seconds 951,659 views",ELLA RECORDS,951659,952324,665
309,"Ethiopian Music 2019 - Desu Ayba - Kedawitey | ቀዳዊተይ - Traditional Tigrigna Music  (Official Video) by ELLA RECORDS 2 years ago 6 minutes, 43 seconds 191,519 views",ELLA RECORDS,191519,191673,154
310,"Ethiopian Music 2019 - Estifanos Getahun - Hambof | ሃምቦፍ - (Official Video) - Tigrigna Music 2019 by ELLA RECORDS 2 years ago 6 minutes, 25 seconds 5,201,011 views",ELLA RECORDS,5201011,5228428,27417
311,"ela tv - Tesfealem Tefera - Enemhoy | እነምሆይ - Ethiopian Tigrinia Music 2019 by ELLA RECORDS 2 years ago 4 minutes, 34 seconds 40,883 views",ELLA RECORDS,40883,40886,3
312,"Beautiful Relaxing Instrumental - Ethiopian  Music 2019 - with amazing view by ela tv by ELLA RECORDS 2 years ago 55 minutes 40,034 views",ELLA RECORDS,40034,40256,222
313,"ela tv - Weynishet Brhane - Wedini - New Ethiopian Music 2019 - ( Official Music Video ) by ELLA RECORDS 2 years ago 4 minutes 92,906 views",ELLA RECORDS,92906,93001,95
314,"ela tv - Belay | በላይ - New Eritrean Movie 2019 - Watch Now On ela tv - Trailer by ELLA RECORDS 2 years ago 3 minutes, 12 seconds 51,972 views",ELLA RECORDS,51972,51978,6
315,"ela tv - Biniam Abrham - Huluf Fikri | ሑሉፍ  ፍቅሪ - New Eritrean Music 2019 - ( Offical Music Video) by ELLA RECORDS 2 years ago 4 minutes, 27 seconds 21,525 views",ELLA RECORDS,21525,21541,16
316,"ela tv - New Eritrean Movie 2019 - Sebn Gzien | ሰብን ግዜን - Watch Now on ela tv mobile app by ELLA RECORDS 2 years ago 4 minutes, 17 seconds 30,520 views",ELLA RECORDS,30520,30532,12
317,"ከመይ ጌርና ኣብ ኤላ ቲቪ ፊልም ን ካረ ዘርኢ ሰፊሕ መግለጺ  | ዝኾነ ሕቶ ብዛዕባ ኤላ ቲቪ ኣፕ እንተ ኣለኩም ኣብ ዝሓፉልና by ELLA RECORDS Streamed 2 years ago 1 hour, 21 minutes 9,365 views",ELLA RECORDS,9365,9373,8
318,"ela tv - Michael Sium - Merawi |መርዓዊ - New Eritrean Music 2019 - (Official Music Video) by ELLA RECORDS 2 years ago 5 minutes, 40 seconds 77,616 views",ELLA RECORDS,77616,77644,28
319,"ela tv - Solomon Yohannes - Fiyor - New Eritrean Music 2019 - Bilen Music ( Official Music Video ) by ELLA RECORDS 2 years ago 6 minutes, 36 seconds 128,606 views",ELLA RECORDS,128606,128718,112
320,"Zelalem Gatenat (zola) - Kealit Ameley | ክአሊት አመለይ - New Eritrean Music - (Offical Music Video) by ELLA RECORDS 2 years ago 4 minutes, 53 seconds 89,952 views",ELLA RECORDS,89952,89977,25
321,"ela tv - New Eritrean Movie 2019 - Qntabtab 3 - by Yafet Habtom - New Eritrean Music 2019 - S1-E3 by ELLA RECORDS 2 years ago 17 minutes 551,558 views",ELLA RECORDS,551558,552213,655
322,"ela tv - Maekele Fishaye - Huruyat - New Eritrean Music 2019 - ( Official Music Video ) by ELLA RECORDS 2 years ago 3 minutes, 40 seconds 90,334 views",ELLA RECORDS,90334,90381,47
323,"ela tv - Robel Negede - Halewa Wushtna - New Eritrean Music 2019 - ( Official Video)  Tribute Song by ELLA RECORDS 2 years ago 4 minutes, 18 seconds 38,587 views",ELLA RECORDS,38587,38611,24
324,"ela tv - Tekeste Goitom | Wedi Goitom - Aytqeyemini - New Eritrean Music 2019 - (Official Video) by ELLA RECORDS 2 years ago 5 minutes, 3 seconds 41,375 views",ELLA RECORDS,41375,41422,47
325,"ela tv -  Bilal Jemal - Edley - New Eritrean Music 2019- ( Offical Music Video ) by ELLA RECORDS 2 years ago 5 minutes, 37 seconds 45,183 views",ELLA RECORDS,45183,45197,14
326,"ela tv - Munir Abdella - Gzie ' Gzie endo Habeni - New Eritrean Music 2019 - (Official Music Video) by ELLA RECORDS 2 years ago 7 minutes, 53 seconds 87,489 views",ELLA RECORDS,87489,87975,486
327,"ela tv - Fyori Tsehay - Shenen | ሸነን - New Eritrean Music 2019 - (Offical Music Video) by ELLA RECORDS 2 years ago 6 minutes, 35 seconds 143,524 views",ELLA RECORDS,143524,143570,46
328,"Ethiopian Music 2019 - Henok Seid - Lbey Wesida | ልበይ ወሲዳ  - (Official Video) - Tigrinia Music by ELLA RECORDS 2 years ago 5 minutes, 27 seconds 398,151 views",ELLA RECORDS,398151,398403,252
329,"ela tv - Jacky Gosee - Kedamawit | ቀዳማዊት - New Ethiopian Music 2019 - ( Official Music Video ) by ELLA RECORDS 2 years ago 4 minutes, 46 seconds 5,301,655 views",ELLA RECORDS,5301655,5320561,18906
330,"ela tv - Gezae Gebremeskel ( Gzie ) - Ferihe'ya - New Eritrean Music 2019 - ( Official Music Video ) by ELLA RECORDS 2 years ago 5 minutes, 55 seconds 54,903 views",ELLA RECORDS,54903,54918,15
331,"ela tv - Tesfu Embaye - ( FiFi ) - Kesibe | ከሲበ -  New Eritrean Music 2019 ( Official Music Video ) by ELLA RECORDS 2 years ago 6 minutes, 26 seconds 125,361 views",ELLA RECORDS,125361,125411,50
332,"ela tv - Yonatan Tadesse - Dula - Rekibe | ረኺበ - New Eritrean Music 2019 - ( Official Music Video ) by ELLA RECORDS 2 years ago 6 minutes, 40 seconds 1,290,453 views",ELLA RECORDS,1290453,1292874,2421
333,"ela tv - Robel Redae - Zeyfelteki Natey - New Eritrean Music 2019 - ( Official Music Video ) by ELLA RECORDS 2 years ago 5 minutes, 59 seconds 55,274 views",ELLA RECORDS,55274,55343,69
334,"ela tv - New Eritrean Movie 2019 - Arketey - Abrham Hailemichael ( Ge2 ) - Now available on ela tv by ELLA RECORDS 2 years ago 3 minutes, 21 seconds 39,368 views",ELLA RECORDS,39368,39382,14
335,"ela tv - Orion Salh - Gual Hagerey - New Eritrean Music 2019 - ( Official Music Video ) by ELLA RECORDS 2 years ago 4 minutes, 37 seconds 729,224 views",ELLA RECORDS,729224,731687,2463
336,"ela tv - Tesfealem Mengesteab - Kokob Xibah - New Eritrean Music 2019 - (Official Music Video) by ELLA RECORDS 2 years ago 5 minutes, 27 seconds 123,814 views",ELLA RECORDS,123814,123860,46
337,"ela tv - Semhar Yohannes - Tehasebkayo' Ke - New Eritrean Music 2019 - ( Official Music Video ) by ELLA RECORDS 2 years ago 6 minutes, 12 seconds 2,649,555 views",ELLA RECORDS,2649555,2655188,5633
338,"ela tv - Issak Okbay - Wuney - New Eritrean Music 2019 - [ Official Music Video ] - Hot Guyla by ELLA RECORDS 2 years ago 5 minutes, 48 seconds 2,155,308 views",ELLA RECORDS,2155308,2158087,2779
339,"ela tv - Million Goytom - Kisab Meas - New Eritrean Music 2019 - ( Official Music Video ) by ELLA RECORDS 2 years ago 4 minutes, 56 seconds 138,161 views",ELLA RECORDS,138161,138231,70
340,"ela tv - Yohannes Habteab - ( Wedi Kerin ) - Aleku Ela | ኣለኹ ኢላ - New Eritrean Music 2019 by ELLA RECORDS 2 years ago 6 minutes, 29 seconds 1,474,536 views",ELLA RECORDS,1474536,1477097,2561
341,"ela tv - Mussie Negede - Hewan - New Eritrean Music 2019 - ( Official Music Video ) by ELLA RECORDS 2 years ago 5 minutes, 9 seconds 40,531 views",ELLA RECORDS,40531,40591,60
342,"ela tv - Yohannes Habteab - Wedi Kerin - Aleku Ela | ኣለኹ ኢላ - New Eritrean Music 2019 - Coming Soon by ELLA RECORDS 2 years ago 39 seconds 66,064 views",ELLA RECORDS,66064,66071,7
343,"ela tv - Jacky Gosee - Aye Gize | አዬ ጊዜ - New Ethiopian Music 2019 ( Official Audio )  With Lyrics by ELLA RECORDS 2 years ago 6 minutes, 18 seconds 4,952,713 views",ELLA RECORDS,4952713,4969978,17265
344,"ela tv - Nahom Tesfalem - ( Hubi ) - Meley 2 - New Eritrean Music 2019 - ( Official Music Video ) by ELLA RECORDS 2 years ago 5 minutes, 36 seconds 391,669 views",ELLA RECORDS,391669,391958,289
345,"ela tv - Yohannes Abraha - Jemira Eloma - New Eritrean Music 2019 - ( Official Music Video ) by ELLA RECORDS 2 years ago 6 minutes, 23 seconds 97,182 views",ELLA RECORDS,97182,97263,81
346,"Sami Ezra - K' keyd Aytbelini | ክኸይድ ኣይትበልኒ - New Eritrean Music 2019 - ( Official Music Video ) by ELLA RECORDS 2 years ago 4 minutes, 54 seconds 317,824 views",ELLA RECORDS,317824,318011,187
347,"Saba Lemlem - Sana Kane - New Eritrean Music 2019 - ( Official Music Video )  Saho Music by ELLA RECORDS 2 years ago 5 minutes, 37 seconds 112,074 views",ELLA RECORDS,112074,112275,201
348,"Sami Ezra - K'Keyd Aytbelini - New Eritrean Music 2019   Coming Soon by ELLA RECORDS 2 years ago 40 seconds 20,993 views",ELLA RECORDS,20993,21009,16
349,"Jacky Gosee - Balambaras - Official Album Promo - New Ethiopian Music 2019 by ELLA RECORDS 2 years ago 5 minutes, 49 seconds 253,216 views",ELLA RECORDS,253216,253271,55
350,"ela tv - Wave Slassian ft Ephrem Amare - Embley - New Ethiopian Music 2019 - ( Official Video ) by ELLA RECORDS 2 years ago 5 minutes, 32 seconds 1,255,092 views",ELLA RECORDS,1255092,1256211,1119
351,"ela tv - Wave Slassian FT Ephrem Amare - Embiley - New Ethiopian Music 2019 - Coming Soon by ELLA RECORDS 2 years ago 1 minute, 27 seconds 34,567 views",ELLA RECORDS,34567,34572,5
352,"ela tv - New Eritrean Movie 2019 - Roxora - Film by Essey Tesfagabir - Now AvailableOn ela tv by ELLA RECORDS 2 years ago 3 minutes, 55 seconds 69,592 views",ELLA RECORDS,69592,69606,14
353,"ela tv - Awet Tekie (Tina) - Mekerty - New Eritrean Music 2019 - (Offical Music Video) by ELLA RECORDS 2 years ago 6 minutes, 51 seconds 33,257 views",ELLA RECORDS,33257,33275,18
354,"ela tv - Amanuel Mesfin - Msaki - New Eritrean Music 2019 - (Offical Music Video) by ELLA RECORDS 2 years ago 4 minutes, 58 seconds 25,076 views",ELLA RECORDS,25076,25076,0
355,"ela tv - Black Knights - Endegena - New Eritrean Music 2019 - (Official Music Video) by ELLA RECORDS 2 years ago 4 minutes, 41 seconds 25,840 views",ELLA RECORDS,25840,25842,2
356,"ela tv - Angosom Kebrom (Wedi Haleka) - Ruhus Gama - New Eritrean Music 2019 - (Offical Music Video) by ELLA RECORDS 2 years ago 8 minutes, 47 seconds 19,137 views",ELLA RECORDS,19137,19142,5
357,"ela tv - Merbeb - Brand New Series Movie 2019  - (Official Trailer) by ELLA RECORDS 2 years ago 1 minute, 53 seconds 61,740 views",ELLA RECORDS,61740,61758,18
358,"ela tv - Dejen Kefale - Belni - New Eritrean Music 2019 - (Official Music Video) by ELLA RECORDS 3 years ago 5 minutes, 24 seconds 91,373 views",ELLA RECORDS,91373,91394,21
359,"ela tv - Tedros Tewelde - (Teddy) - Seb Gerkni - New Eritrean Music 2019 - (Offical Music Video) by ELLA RECORDS 3 years ago 9 minutes, 27 seconds 29,778 views",ELLA RECORDS,29778,29783,5
360,"ela tv - Berket Gebreamlak (Chakur) - Kuhulo - New Eritrean Music 2019 - (Official Music Video) by ELLA RECORDS 3 years ago 4 minutes, 29 seconds 31,514 views",ELLA RECORDS,31514,31524,10
361,"ela tv - Semhar Isaias - Kem Zhabeni |ከም ዝሃበኒ - New Eritrean Music 2019 - (Offical Music Video) by ELLA RECORDS 3 years ago 4 minutes, 39 seconds 65,363 views",ELLA RECORDS,65363,65383,20
362,"ela tv - Yosief Habtemichael - Esur Fkri - New Eritrean Music 2019 - (Offical Music Video) by ELLA RECORDS 3 years ago 6 minutes, 24 seconds 79,026 views",ELLA RECORDS,79026,79168,142
363,"ela  tv  - Robel Hadish - Tebelaxit - New Eritrean Music 2019 - (Official Music Video) by ELLA RECORDS 3 years ago 5 minutes, 20 seconds 42,631 views",ELLA RECORDS,42631,42703,72
364,"ela tv - Adonay Goitom (Adoni) - Tesfa - New Eritrean Music 2019 - (Official Music Video) by ELLA RECORDS 3 years ago 7 minutes, 3 seconds 18,695 views",ELLA RECORDS,18695,18697,2
365,"ela tv - Yergalem Getachow (Bururey) - Deki Asmara - New Eritrean Music 2019 - (Offical Music) by ELLA RECORDS 3 years ago 8 minutes, 12 seconds 1,732,633 views",ELLA RECORDS,1732633,1735991,3358
366,"ela tv - Endriyas Tsehaye - Aleku ba Beli - New Eritrean Music 2019 - (Official Music) by ELLA RECORDS 3 years ago 5 minutes, 6 seconds 25,107 views",ELLA RECORDS,25107,25123,16
367,"ela tv - Matwos Weldegergish (Keshi) - Meteabiti - New Eritrean Music 2019 - (Official Music Video) by ELLA RECORDS 3 years ago 4 minutes, 51 seconds 52,970 views",ELLA RECORDS,52970,52992,22
368,"ela tv - Yoni Habitz ft Wedi Tedros - Reach One Teach One - New Eritrean Music 2019 - Official Music by ELLA RECORDS 3 years ago 4 minutes, 21 seconds 19,521 views",ELLA RECORDS,19521,19542,21
369,"ela tv - Samsom Tekste ( Wedi Keshi ) -  Sdetey Axirni - New Eritrean Music 2019 - Official Music by ELLA RECORDS 3 years ago 6 minutes, 43 seconds 34,511 views",ELLA RECORDS,34511,34530,19
370,"ela tv - Kahsay Hayle - Samrawitey - New Eritrean Music 2019 - ( Official Music Video ) by ELLA RECORDS 3 years ago 5 minutes, 3 seconds 48,318 views",ELLA RECORDS,48318,48326,8
371,"ela tv - Merbeb - New Eritrean Movie 2019 - Coming Soon on ela tv Film by Amanuel Tekle by ELLA RECORDS 3 years ago 23 minutes 221,702 views",ELLA RECORDS,221702,221715,13
372,"ela tv - Bereket Issak - ( Wedi Issak ) - Hdget - New Eritrean Music 2019 - ( Official Music Video ) by ELLA RECORDS 3 years ago 4 minutes, 34 seconds 49,594 views",ELLA RECORDS,49594,49634,40
373,"ela tv - Ermise Berki - Kem Libey - New Eritrean Music 2018 - ( Official Music Video ) by ELLA RECORDS 3 years ago 7 minutes, 4 seconds 43,819 views",ELLA RECORDS,43819,43839,20
374,"ela tv - Yoni Habitz - If I Die - New Eritrean Music 2018 - Hip HOP 2018 - ( Official Music Video ) by ELLA RECORDS 3 years ago 3 minutes, 2 seconds 31,891 views",ELLA RECORDS,31891,31902,11
375,"ela tv - Santo Michael - Baeley Telami - New Eritrean Music 2018 - ( Official Music Video ) by ELLA RECORDS 3 years ago 5 minutes, 29 seconds 91,364 views",ELLA RECORDS,91364,91368,4
376,"ela tv - Rezene Alem - Welelay - New Eritrean Music 2018 - ( Official Music Video ) by ELLA RECORDS 3 years ago 5 minutes, 17 seconds 253,284 views",ELLA RECORDS,253284,253876,592
377,"ela tv - Mussie Berhe - Mberwel - Anxar Kulu Mesenaklat - New Eritrean Music 2018 - (Official Video) by ELLA RECORDS 3 years ago 5 minutes, 9 seconds 45,369 views",ELLA RECORDS,45369,45391,22
378,"ela tv - Yosief Teklay | 40 - Tehawike Leku - New Eritrean Music 2018 - ( Official Music Video ) by ELLA RECORDS 3 years ago 5 minutes, 47 seconds 198,711 views",ELLA RECORDS,198711,198804,93
379,"ela tv - Trhas Tekliab - Gual Keren - Mezena Albo - New Eritrean Music 2018 - (Official Music Video) by ELLA RECORDS 3 years ago 5 minutes, 33 seconds 414,985 views",ELLA RECORDS,414985,415292,307
380,"ela tv - Hanibal Tekeste | Hani - Habesha'ye Shikorina - New Eritrean Music 2018 - (Official Video) by ELLA RECORDS 3 years ago 5 minutes, 30 seconds 232,560 views",ELLA RECORDS,232560,232658,98
381,"ela tv - new eritrean music 2018 - Coming soon on ela tv - Gual Keren - Hanibal ( Hani ) - Yosief 40 by ELLA RECORDS 3 years ago 1 minute, 15 seconds 56,837 views",ELLA RECORDS,56837,56872,35
382,"Part 3 - Mary Talk Show about Eritrean Film Industry - with Senay Solomon - Yasin Omer - Yuel Tekle by ELLA RECORDS 3 years ago 57 minutes 26,114 views",ELLA RECORDS,26114,26122,8
383,"Part 1 - Mary Talk Show - Short Interview with Yuel Tekle  - About ela tv mobile application by ELLA RECORDS 3 years ago 19 minutes 28,444 views",ELLA RECORDS,28444,28453,9
384,"Part 4 Final - Mary Talk Show about Eritrean Film Industry - with Senay Solomon - Yasin Omer by ELLA RECORDS 3 years ago 36 minutes 20,445 views",ELLA RECORDS,20445,20447,2
385,"Part 2 - How to Use ela tv mobile App to rent films - ከመይ ጌርና ኣብ ኤላ ቲቪ ፊልም ን ካረ ዘር ኢ ሰፊሕ መግለጺ by ELLA RECORDS 3 years ago 1 hour, 15 minutes 11,323 views",ELLA RECORDS,11323,11327,4
386,"ela tv - Yonatan Tadesse | Dula - Yehmimki Mehweyt - New Eritrean Music 2018 - (Official Video) by ELLA RECORDS 3 years ago 6 minutes, 43 seconds 972,749 views",ELLA RECORDS,972749,977386,4637
387,"ela tv - Mary Talk Show about Eritrean Film Industry - ሰፊሕ ዘተ ብዛዕባ ፊልም ኢንዳስትሪ ሃገርና ካበይ ናበይ፧ by ELLA RECORDS 3 years ago 2 minutes, 1 second 8,910 views",ELLA RECORDS,8910,8910,0
388,"ela tv - Yonatan Tadese | Dula - Yehmimki Mehweyt | የሕሚምኪ መሕወይት - New Eritrean Music 2018 - (Audio) by ELLA RECORDS 3 years ago 6 minutes, 1 second 168,088 views",ELLA RECORDS,168088,168163,75
389,"ela tv - Kibrom Tekle - Nie Dea - New Eritrean Music 2018 - (Official Music Video) by ELLA RECORDS 3 years ago 5 minutes, 33 seconds 21,554 views",ELLA RECORDS,21554,21555,1
390,"ela tv -  Eyob Kiros -  Asmara -  New Eritrea Music 2018  -  ( Offical Music Video) by ELLA RECORDS 3 years ago 5 minutes, 48 seconds 27,726 views",ELLA RECORDS,27726,27730,4
391,"ela tv - Yoni Habitz - Rebel Kings till the end - New Eritrean Music 2018 - Tribute to Sandman Negus by ELLA RECORDS 3 years ago 3 minutes, 25 seconds 27,322 views",ELLA RECORDS,27322,27346,24
392,"ela tv - Munir Ali - ( Wedi Moya ) - Qebzer - New Eritrean Music 2018 - ( Official Music Video ) by ELLA RECORDS 3 years ago 4 minutes, 1 second 265,069 views",ELLA RECORDS,265069,265275,206
393,"ela tv - Adway Teklezgi - Ynafqeki - New Eritrean Music 2018 - ( Official Music Video ) by ELLA RECORDS 3 years ago 4 minutes, 52 seconds 1,382,465 views",ELLA RECORDS,1382465,1384812,2347
394,"ela tv - New Eritrean Movie 2018 - Agoray - Part 2 by ELLA RECORDS 3 years ago 31 minutes 82,365 views",ELLA RECORDS,82365,82440,75
395,"ela tv - New Eritrean Movie 2018 - Agoray Part 3 Final by ELLA RECORDS 3 years ago 45 minutes 84,492 views",ELLA RECORDS,84492,84572,80
396,"ela tv - New Eritrean Movie 2018 - Agoray - Part 1 by ELLA RECORDS 3 years ago 29 minutes 117,672 views",ELLA RECORDS,117672,117781,109
397,"ela tv - Kfle Berhe - ( Wedi Berhe ) - Awura - New Eritrean Music 2018 - ( Official Music Video ) by ELLA RECORDS 3 years ago 6 minutes, 6 seconds 45,142 views",ELLA RECORDS,45142,45166,24
398,"ela tv - Nahom Yohannes ( Meste ) - Aytemrrni - New Eritrean Music 2018 - ( Official Music Video ) by ELLA RECORDS 3 years ago 5 minutes, 4 seconds 4,399,766 views",ELLA RECORDS,4399766,4403430,3664
399,"ela tv - Zemuy Welderufael - Abarqo - Lomanti - New Eritrean Music 2018 - ( Official Music Video ) by ELLA RECORDS 3 years ago 7 minutes, 54 seconds 14,805 views",ELLA RECORDS,14805,14813,8
400,"ela tv - Rizban Goytom - Wedi Endika - New Eritrean Music 2018 ( Official Music Video ) by ELLA RECORDS 3 years ago 6 minutes, 8 seconds 52,216 views",ELLA RECORDS,52216,52222,6
401,"ela tv - Yosief Habtemichael - Kxmem Ye - New Eritrean Music 2018 - ( Official Music Video ) by ELLA RECORDS 3 years ago 6 minutes, 33 seconds 38,477 views",ELLA RECORDS,38477,38577,100
402,"ela tv - Shumay Gebrihiwet - Semere - Filmon Mulue - Sham Zeray - Tezazimu - New Eritrean Music 2018 by ELLA RECORDS 3 years ago 6 minutes, 32 seconds 62,622 views",ELLA RECORDS,62622,62713,91
403,"Eritrean Movie 2018 - ከመይ ጌርና ኤላ ኣፕ ንጥቀመሉ ብ ኸመይ ፊልም ንኻረ - How To use Ela TV App from A to Z Example by ELLA RECORDS 3 years ago 7 minutes, 1 second 25,471 views",ELLA RECORDS,25471,25472,1
404,"ela tv - Abraham Alem | Abi | - Weyney - New Eritrean Music 2018 - ( Official Music Video ) by ELLA RECORDS 3 years ago 5 minutes, 6 seconds 3,422,739 views",ELLA RECORDS,3422739,3435283,12544
405,"Abraham Alem  ( Abi ) - Weyney - New Eritrean Music 2018 - Coming Soon by ELLA RECORDS 3 years ago 55 seconds 39,323 views",ELLA RECORDS,39323,39415,92
406,"ela tv - Sami Wedi Menkr - Senbide - New Eritrean Music 2018 ( Official Music video ) by ELLA RECORDS 3 years ago 5 minutes, 5 seconds 25,965 views",ELLA RECORDS,25965,25977,12
407,"Eritrean Movie 2018 - Download Ela TV Mobile App is live !!! by ELLA RECORDS 3 years ago 1 minute, 13 seconds 14,991 views",ELLA RECORDS,14991,14991,0
408,"Ela TV - Matiwos W/gergsh ( keshi ) - Ayednenknn - New Eritrean Music 2018 - Official Music Video by ELLA RECORDS 3 years ago 7 minutes, 15 seconds 29,950 views",ELLA RECORDS,29950,29953,3
409,"ela tv - Henok Afnin - ( Wedi Efnin ) - Aytfeleyni - New Eritrean Music 2018 -( Official Music Video by ELLA RECORDS 3 years ago 5 minutes, 27 seconds 40,740 views",ELLA RECORDS,40740,40748,8
410,"ela tv - Yoni Habitz - Enough Violence - New Eritrean Music 2018 - ( Official Music Video ) by ELLA RECORDS 3 years ago 3 minutes, 14 seconds 37,210 views",ELLA RECORDS,37210,37262,52
411,"ela tv - New Eritrean Movie 2018 - Qntabtab 2 - by Yafet Habtom - New Eritrean Music 2018 by ELLA RECORDS 3 years ago 15 minutes 526,356 views",ELLA RECORDS,526356,526880,524
412,"ela tv - Metkel Mebrahtu - Ykelo Nigsnetka - New Eritrean Music 2018 - ( Official Music Video ) by ELLA RECORDS 3 years ago 4 minutes, 59 seconds 31,516 views",ELLA RECORDS,31516,31521,5
413,"ela tv - Samuel G/tnsaie - Yxbe Aleku - New Eritrean Music 2018 - ( Official Music Video ) by ELLA RECORDS 3 years ago 5 minutes, 10 seconds 32,912 views",ELLA RECORDS,32912,32921,9
414,"Eritrean Movie 2018 - ela tv brand new application - live from August 24 2018 by ELLA RECORDS 3 years ago 1 minute, 8 seconds 32,924 views",ELLA RECORDS,32924,32924,0
415,"ela tv - Efrem Kapitano - Chare - Geyashi libi - New Eritrean Music 2018 - ( Official Music Video ) by ELLA RECORDS 3 years ago 5 minutes, 46 seconds 59,121 views",ELLA RECORDS,59121,59127,6
416,"ela tv - Tesfay Mehari - Fhira - Hamed Dbe Fqri - New Eritrean Music 2018 - ( Official Music Video ) by ELLA RECORDS 3 years ago 8 minutes, 4 seconds 273,111 views",ELLA RECORDS,273111,273324,213
417,"ela tv - Ablel Teame - Gobezye Teleal - New Eritrean Music 2018 -  Traditional Tigrinia Gauyla Music by ELLA RECORDS 3 years ago 6 minutes, 56 seconds 64,412 views",ELLA RECORDS,64412,64437,25
418,"Ella TV - Matiwos W/gergsh ( keshi ) - Kab Zmneya - New Eritrean Music 2018 - Official Music Video by ELLA RECORDS 3 years ago 6 minutes, 43 seconds 15,686 views",ELLA RECORDS,15686,15692,6
419,"ela tv - Sami Ezra - Lesh Ela - New Eritrean Music 2018 - ( Official Music Video ) by ELLA RECORDS 3 years ago 6 minutes, 1 second 186,208 views",ELLA RECORDS,186208,186335,127
420,"ela tv - Kahsay Berhe - Daerona - New Eritrean Music 2018 - ( Official Audio ) With Lyrics by ELLA RECORDS 3 years ago 6 minutes, 15 seconds 75,095 views",ELLA RECORDS,75095,75137,42
421,"Ella TV - Tomas Daynom - Mexakuki - New Eritrean Music 2018 - ( Official Music Video ) by ELLA RECORDS 3 years ago 5 minutes, 53 seconds 118,161 views",ELLA RECORDS,118161,118193,32
422,"Ella TV - Jacky Gosee - Semalish Wey | ሰማልሽ ወይ - New Ethiopian Music 2018 - ( Official Audio ) by ELLA RECORDS 3 years ago 5 minutes, 23 seconds 3,373,682 views",ELLA RECORDS,3373682,3374377,695
423,"Ella TV - Blsanom - New Eritrean Short Movie 2017 - Tribute to Eritrean Martyrs day by ELLA RECORDS 3 years ago 9 minutes, 37 seconds 44,263 views",ELLA RECORDS,44263,44264,1
424,"Ella TV - Tesfu Embaye  ( Fifi ) - Eguasiyena'lo Menfesom - New Eritrean Music 2018 - Official Music by ELLA RECORDS 3 years ago 5 minutes, 28 seconds 17,205 views",ELLA RECORDS,17205,17208,3
425,"Ella TV - Wegahta Berhane - Ab Mahla Zeytlem - New Eritrean Music 2018 - ( Official Music Video ) by ELLA RECORDS 3 years ago 5 minutes, 52 seconds 21,438 views",ELLA RECORDS,21438,21443,5
426,"Ella TV - Yuel Berhane ( Ella ) - Zelelay - New Eritrean Music 2018 - ( Official Music Video ) by ELLA RECORDS 3 years ago 5 minutes, 47 seconds 123,709 views",ELLA RECORDS,123709,123954,245
427,"Ella TV - Hermon Beraki - Meley - New Eritream Music 2018 - (Official Music Video) - Tigrigna Music by ELLA RECORDS 3 years ago 5 minutes, 27 seconds 315,658 views",ELLA RECORDS,315658,316103,445
428,"Ella TV - Aklilu Kahsay - Ayteksesin’ya Hewan - New Eritrean Music 2018 ( Official video ) by ELLA RECORDS 3 years ago 5 minutes, 45 seconds 19,336 views",ELLA RECORDS,19336,19351,15
429,"Ella TV- Wegahta Berhane - Fqri ele atyeyo - New Eritrean Music 2018 ( Official video ) by ELLA RECORDS 3 years ago 5 minutes, 15 seconds 34,674 views",ELLA RECORDS,34674,34707,33
430,"Ella TV - Tesfalem Abraham ( Ayni ) - Agedasitey - New Eritrean Music 2018 ( Official Video  ) by ELLA RECORDS 3 years ago 6 minutes, 15 seconds 110,916 views",ELLA RECORDS,110916,111030,114
431,"Ella TV - Elsa Teklu - Hadig Zentielet - New Eritrean Music 2018 ( Official Video ) by ELLA RECORDS 3 years ago 5 minutes, 17 seconds 11,858 views",ELLA RECORDS,11858,11860,2
432,"Ella TV - Girmay Max - Mar Melata - New Eritrean Music 2018 ( Official Video ) by ELLA RECORDS 3 years ago 4 minutes, 28 seconds 22,569 views",ELLA RECORDS,22569,22577,8
433,"Ella TV - Fred Haile - Bleney - New Eritrean Music 2018 ( Official Video ) by ELLA RECORDS 3 years ago 5 minutes, 31 seconds 40,600 views",ELLA RECORDS,40600,40609,9
434,"Ella TV - Mikiele Samuel - Welelay - New Eritrean Music 2018 ( Official Video ) by ELLA RECORDS 3 years ago 4 minutes, 22 seconds 35,987 views",ELLA RECORDS,35987,35995,8
435,"Ella TV - Matiwos W/gergsh ( keshi ) - Xemam Semikni - New Eritrean Music 2018 ( Official video ) by ELLA RECORDS 3 years ago 6 minutes, 22 seconds 15,371 views",ELLA RECORDS,15371,15376,5
436,"Ella TV - Mewael Afewerki - Melsi Yelen - New Eritrean Music 2018 ( Official Music Video ) by ELLA RECORDS 3 years ago 5 minutes, 10 seconds 29,538 views",ELLA RECORDS,29538,29540,2
437,"Ella TV - Helen Tesfay - Ab mintay yu xbakeka - New Eritrean Music 2018 - ( Official Music Video ) by ELLA RECORDS 3 years ago 5 minutes, 22 seconds 102,920 views",ELLA RECORDS,102920,102934,14
438,"Ella TV - Kahsay Berhe London - Ella Night - New Eritrean Music 2018 - Hanti Eya Live performance by ELLA RECORDS 3 years ago 7 minutes, 21 seconds 20,347 views",ELLA RECORDS,20347,20350,3
439,"Ella TV - Million Amanuel - Lbi goboz  - New Eritrean Music 2018 ( Official Music Video ) by ELLA RECORDS 3 years ago 5 minutes, 5 seconds 26,590 views",ELLA RECORDS,26590,26598,8
440,"Ella TV - Mobile and Tablet Application Coming soon ! by ELLA RECORDS 3 years ago 2 minutes, 36 seconds 11,178 views",ELLA RECORDS,11178,11180,2
441,"Ella TV - Tesfay Mehari ( Fihira ) - New album - Coming Soon On Ella Records by ELLA RECORDS 3 years ago 3 minutes, 5 seconds 51,259 views",ELLA RECORDS,51259,51261,2
442,"Ella TV - Habtom Tekeste ( Fetshe ) - Diyana - New Eritrean Music 2018 ( Official Music Video ) by ELLA RECORDS 3 years ago 5 minutes, 37 seconds 28,756 views",ELLA RECORDS,28756,28761,5
443,"Ella TV - Ebrahim Bushra - Ntehagos beli - New Eritrean Music 2018 - ( Official Music Video ) by ELLA RECORDS 3 years ago 4 minutes, 52 seconds 50,918 views",ELLA RECORDS,50918,50930,12
444,"Ella TV - Henok Teklay ( Nago ) - Amena Tsebiki - New Eritrean Music 2018 - ( Official Music Video ) by ELLA RECORDS 3 years ago 5 minutes, 57 seconds 311,768 views",ELLA RECORDS,311768,311830,62
445,"Ella TV - Meron ( Maryo ) - Zekiriyo - New Eritrean Music 2018 - ( Official Music Video ) by ELLA RECORDS 3 years ago 5 minutes, 9 seconds 22,389 views",ELLA RECORDS,22389,22392,3
446,"Ella TV - Henok Teklay  ( Nago ) - Amena Tsebiki - New Eritrean Music 2018 ( Coming Soon ) by ELLA RECORDS 3 years ago 29 seconds 21,309 views",ELLA RECORDS,21309,21313,4
447,"Ella TV - Shumay Gebrehiwet - Bkha Konki - New Eritrean Music 2018 ( Official Music Video ) by ELLA RECORDS 3 years ago 6 minutes, 11 seconds 273,129 views",ELLA RECORDS,273129,273536,407
448,"Ella TV - Temesgen Berhane -  Tewaf L'bi -  New Eritrean Music 2018 ( Official Music Video ) by ELLA RECORDS 3 years ago 4 minutes, 8 seconds 24,308 views",ELLA RECORDS,24308,24311,3
449,"Ella TV - Tesfay Mehari ( Fihira ) - New album - Coming Soon On Ella Records by ELLA RECORDS 3 years ago 2 minutes 101,840 views",ELLA RECORDS,101840,101846,6
450,"Ella TV - Habtom Mehari ( Azin ) - Sedra Zmereqo -  New Eritrean Music 2018 ( Official Music Video ) by ELLA RECORDS 3 years ago 5 minutes, 35 seconds 147,879 views",ELLA RECORDS,147879,147993,114
451,"Ella TV - Natnael Mengs  - Xelim Kokb  - New Eritrean Music 2018  -  ( Official Music Video ) by ELLA RECORDS 3 years ago 4 minutes, 31 seconds 25,687 views",ELLA RECORDS,25687,25694,7
452,"Ella TV - Kahsay Berhe - Short Interview - Mary Show - New Eritrean Music 2018 - London Concert by ELLA RECORDS 3 years ago 20 minutes 22,108 views",ELLA RECORDS,22108,22111,3
453,"Ella TV - Tedros Ermias - Das Hawya - New Eritrean Music 2018 - ( Official Music Video ) Historical by ELLA RECORDS 3 years ago 6 minutes, 49 seconds 432,634 views",ELLA RECORDS,432634,433119,485
454,"Ella TV - Helen Meles - Yiakeleni - New Eritrean Music 2018 - ( Official Music Video ) by ELLA RECORDS 3 years ago 6 minutes, 23 seconds 2,760,093 views",ELLA RECORDS,2760093,2761391,1298
455,"Ella TV - Leyon Teklizghi ( Leona RIche ) - Mis Sielki - New Eritrean Music 2018 - (Official Video) by ELLA RECORDS 3 years ago 5 minutes, 17 seconds 155,056 views",ELLA RECORDS,155056,155179,123
456,"Ella TV - Wegahta Berhane - Kulu Nata - New Eritrean Music 2018 - (Official Video) - Tigrigna Music by ELLA RECORDS 3 years ago 5 minutes, 40 seconds 360,681 views",ELLA RECORDS,360681,360760,79
457,"Ella TV - Tedros Ermias - Das hawuya - New Eritrean Music 2018 - ( Coming Soon ) by ELLA RECORDS 3 years ago 49 seconds 27,703 views",ELLA RECORDS,27703,27716,13
458,"Ella TV - Ksanet Angosom - Ftwey - New Eritrean Music 2018 - ( Official Music Video ) by ELLA RECORDS 3 years ago 4 minutes, 8 seconds 311,450 views",ELLA RECORDS,311450,311542,92
459,"Ella TV - Yoseif Teklay 40 - Kem Degeki Entetkoni - New Eritrean Music 2018  - Hot Guayla by ELLA RECORDS 3 years ago 4 minutes, 56 seconds 283,701 views",ELLA RECORDS,283701,283748,47
460,"Ella TV - Yosief Teklay (40) - Kem degeki entetkoni - New Eritrean Music video 2018 - Coming Soon ! by ELLA RECORDS 3 years ago 25 seconds 40,776 views",ELLA RECORDS,40776,40789,13
461,"Ella TV - Kibrom Russom - Wedi Russom - Shelel Beli - New Eritrean Music 2018 - (Official Video) by ELLA RECORDS 3 years ago 4 minutes, 45 seconds 44,839 views",ELLA RECORDS,44839,44849,10
462,"Ella TV - Tekie Gezaei (Daergoe) - Tfelti Do - New Eritrean Music 2018 - Official Music Video by ELLA RECORDS 3 years ago 6 minutes, 41 seconds 46,381 views",ELLA RECORDS,46381,46461,80
463,"Ella TV - Samsom Tekeste - (Wedi Keshi) - Khalf'yu Fkrey - New Eritrean Music 2018 - Ella Records by ELLA RECORDS 3 years ago 5 minutes, 44 seconds 100,389 views",ELLA RECORDS,100389,100493,104
464,"Ella TV - Robel Negede - Edley - Meqenzewitey - New Eritrean Music 2018 - ( Official Music Video) by ELLA RECORDS 4 years ago 4 minutes, 52 seconds 190,491 views",ELLA RECORDS,190491,190690,199
465,"Ella TV- Berhe Hadera - ( Wedi Hadera ) - Gezana - New Eritrean Music 2018 - (Official Music Video) by ELLA RECORDS 4 years ago 6 minutes, 37 seconds 123,489 views",ELLA RECORDS,123489,123530,41
466,"Ella TV - John ( Air Force ) - Mesalley | መሳለልይ - New Eritrean Music 2018 - ( Official Music Video ) by ELLA RECORDS 4 years ago 5 minutes, 3 seconds 46,792 views",ELLA RECORDS,46792,46829,37
467,"Ella TV - Tesfu Embaye ( Fifi ) - ❤️  Valentine Day ❤️  - New Eritrean Music 2018 - (Official Video) by ELLA RECORDS 4 years ago 6 minutes, 31 seconds 58,093 views",ELLA RECORDS,58093,58156,63
468,"Ella TV - Simon Mulugeta - Amora - New Eritrean Music 2018 - ( Official Video ) - Tigrinia Music by ELLA RECORDS 4 years ago 7 minutes, 50 seconds 161,306 views",ELLA RECORDS,161306,161859,553
469,"Ella TV - Riezban Hadiu - Wesn Hadiu - New Eritrean Music 2018 - ( Official Music Video ) by ELLA RECORDS 4 years ago 6 minutes, 37 seconds 35,740 views",ELLA RECORDS,35740,35745,5
470,"Ella TV - Hanna Kahsay - Grmasemay - New Eritrean Music 2018 - ( Official Music Video) - Traditional by ELLA RECORDS 4 years ago 6 minutes, 55 seconds 45,098 views",ELLA RECORDS,45098,45167,69
471,"Ella TV - Mahmud Mohamed - Simbilo - New Eritrean Music 2018 - ( Official Music Video ) - Saho by ELLA RECORDS 4 years ago 5 minutes, 4 seconds 70,004 views",ELLA RECORDS,70004,70394,390
472,"Ella TV - Fanuel Gebrekrkstos - Dissco - Seqetket - New Eritrean Music 2018 - (Official Music Video) by ELLA RECORDS 4 years ago 4 minutes, 28 seconds 29,145 views",ELLA RECORDS,29145,29154,9
473,"Ella TV - Yohannes Fanuel | John - Grmbit - New Eritrean Movie 2018 - ( Official Comedy ) - Part 2 by ELLA RECORDS 4 years ago 15 minutes 100,573 views",ELLA RECORDS,100573,100591,18
474,"Ella TV - Yohannes Fanuel ( John ) - Grmbit - New Eritrean Movie 2018 - ( Official Comedy ) - Part 1 by ELLA RECORDS 4 years ago 19 minutes 95,627 views",ELLA RECORDS,95627,95630,3
475,"Ella TV - Robel Gebremaryam - Mdfara Siene - New Eritrean Music 2018 - ( Official Music Video ) by ELLA RECORDS 4 years ago 5 minutes, 37 seconds 263,525 views",ELLA RECORDS,263525,264290,765
476,"Ella TV - Saba Andemariam - Yiekeleni | ይእከለኒ - New Eritrean Music 2018 - ( Official Music Video ) by ELLA RECORDS 4 years ago 5 minutes, 32 seconds 3,337,338 views",ELLA RECORDS,3337338,3349977,12639
477,"Ella TV - Berhane W/slasie - Brch - Hadigelki - New Eritrean Music 2018 - ( Official Music Video ) by ELLA RECORDS 4 years ago 4 minutes, 59 seconds 32,790 views",ELLA RECORDS,32790,32795,5
478,"Ella TV - Mussie Gebrekrstos - Qanza Fkri - New Eritrean Music 2018 - ( Official Music Video ) by ELLA RECORDS 4 years ago 6 minutes, 19 seconds 162,323 views",ELLA RECORDS,162323,162440,117
479,"Ella TV - Filmon Michael - Enki Fqri - New Eritrean Music 2018 - (Official Music Video) - Hot Guyla by ELLA RECORDS 4 years ago 4 minutes, 56 seconds 77,045 views",ELLA RECORDS,77045,77059,14
480,"Ella TV - Henok Teklay ( Nago ) - Tiebe Ayney - New Eritrean Music 2018 - ( Official Music Video ) by ELLA RECORDS 4 years ago 6 minutes, 46 seconds 466,437 views",ELLA RECORDS,466437,467164,727
481,"Ella TV - Zekaryas G/mariam - Nigeria - Abey Seb - New Eritrean Music 2018 - (Official Music Video) by ELLA RECORDS 4 years ago 5 minutes, 46 seconds 246,544 views",ELLA RECORDS,246544,247857,1313
482,"Ella TV - Tesfaladet Kidane  - Meshala Kodene - New Eritrean Music 2017  - ( Official Music Video ) by ELLA RECORDS 4 years ago 7 minutes, 29 seconds 65,047 views",ELLA RECORDS,65047,65075,28
483,"Ella TV - Kahsay Berhe - Lemlem Das - New Eritrean Music 2017 - ( Official Music Video ) - Remix by ELLA RECORDS 4 years ago 4 minutes, 17 seconds 318,883 views",ELLA RECORDS,318883,319291,408
484,"Ella TV - Kahsay Berhe - New Eritrean Music 2017 - Album Release - ( 5 - Jan - 2018 ) by ELLA RECORDS 4 years ago 4 minutes, 57 seconds 41,071 views",ELLA RECORDS,41071,41087,16
485,"Ella TV - Tareke Tesfahiwet - Dasna - New Eritrean Music 2018 - (Official Music Video) - Hot Gauyla by ELLA RECORDS 4 years ago 7 minutes, 44 seconds 1,682,448 views",ELLA RECORDS,1682448,1687694,5246
486,"Ella TV - Mohamed Ibrahim ( Boxer )  - Beri Barha - New Eritrean Music 2017 - Official Music VIdeo ) by ELLA RECORDS 4 years ago 4 minutes, 55 seconds 60,704 views",ELLA RECORDS,60704,60802,98
487,"Ella TV - Yonatan Tadese | Dula - Hazeki Libey - New Eritrean Music 2017 - ( Official Music Video ) by ELLA RECORDS 4 years ago 5 minutes, 49 seconds 4,487,269 views",ELLA RECORDS,4487269,4494356,7087
488,"Ella TV - Estifanos Michael - Serbieb - New Eritrean Music 2017- (Official Video) - New Tigre Music by ELLA RECORDS 4 years ago 6 minutes, 16 seconds 97,410 views",ELLA RECORDS,97410,97453,43
489,"Ella TV - Henok Mulatu - Nenay - New Eritrean Music 2017 - ( Official Music Video ) by ELLA RECORDS 4 years ago 6 minutes, 14 seconds 144,595 views",ELLA RECORDS,144595,144651,56
490,"Ella TV - Helen Meles  - Tezareb - New Eritrean Music 2017 - ( Official Music Video ) - Hot Guayla by ELLA RECORDS 4 years ago 5 minutes, 49 seconds 2,681,130 views",ELLA RECORDS,2681130,2682009,879
491,"Ella TV - Efream Hdray - Ane Zelekwo - New Eritrean Music 2017 - ( Official Music Video ) by ELLA RECORDS 4 years ago 6 minutes, 36 seconds 62,760 views",ELLA RECORDS,62760,62780,20
492,"Helen Meles - Tazareb | ተዛረብ - New Eritrean Music 2017 - ( Official Video Trailer ) - This Friday by ELLA RECORDS 4 years ago 34 seconds 97,057 views",ELLA RECORDS,97057,97090,33
493,"Ella TV - Aman Haile ( Wedi Haile ) - Dahabey - New Tigrinya  Music 2017 - ( Official Music Video ) by ELLA RECORDS 4 years ago 5 minutes, 43 seconds 101,551 views",ELLA RECORDS,101551,101622,71
494,"Ella TV - Eden Kesete - Hawsi - New Eritrean Music 2017 - ( Official Music Video ) - Tigrigna Music by ELLA RECORDS 4 years ago 5 minutes, 59 seconds 3,849,410 views",ELLA RECORDS,3849410,3855911,6501
495,"Ella TV - Fred Haile - Weni - New Eritrean Music 2017 - ( Official Music Video ) - Hot Guayla by ELLA RECORDS 4 years ago 5 minutes, 48 seconds 384,083 views",ELLA RECORDS,384083,384242,159
496,"Ella TV - Sami Ezra - My name - New Eritrean Music 2017 - ( Official Music Video ) - Hot Dancehall by ELLA RECORDS 4 years ago 2 minutes, 48 seconds 258,339 views",ELLA RECORDS,258339,258519,180
497,"Ella TV - Robel Michael - Wuba - New Eritrean Music 2017 - ( Official Music Video ) - Hot Guayla by ELLA RECORDS 4 years ago 5 minutes, 47 seconds 4,650,090 views",ELLA RECORDS,4650090,4663889,13799
498,"Ella TV - Nahom Tekeste - Adey - New Eritrean Music 2017 - ( Official Music Video ) by ELLA RECORDS 4 years ago 6 minutes, 54 seconds 68,562 views",ELLA RECORDS,68562,68579,17
499,"Ella TV - Michael Yemane ( Fetat ) - Ykelo ye - New Eritrean Music 2017 - ( Official Music Video ) by ELLA RECORDS 4 years ago 4 minutes, 59 seconds 54,681 views",ELLA RECORDS,54681,54736,55
500,"Ella TV - Seb Entay Zeybele - New Eritrean Music 2017 - Desbele Kesete - Instrumental Music by ELLA RECORDS 4 years ago 5 minutes, 51 seconds 234,367 views",ELLA RECORDS,234367,234591,224
501,"Ella TV - Sami Ezra - My Name  - New Eritrean Music 2017 - Coming Soon ( Uganda Music ) - Dancehall by ELLA RECORDS 4 years ago 22 seconds 22,913 views",ELLA RECORDS,22913,22922,9
502,"Ella TV - Filmon Tekleab - Yemekh Dyu Fkri - New Eritrean Music 2017 - [ Official Music Video ] by ELLA RECORDS 4 years ago 7 minutes, 7 seconds 36,129 views",ELLA RECORDS,36129,36135,6
503,"Ella TV - Lidya Teklemariam - Alo Enda Tebahle - New Eritrean Music 2017 - This Friday ON Ella TV by ELLA RECORDS 4 years ago 38 seconds 29,009 views",ELLA RECORDS,29009,29015,6
504,"Ella TV - Yoseph Kebedom - Temelasit Konki - New Eritrean Music 2017 - [ Official Music Video } by ELLA RECORDS 4 years ago 5 minutes, 7 seconds 48,473 views",ELLA RECORDS,48473,48476,3
505,"Ella TV - Dawit - ( Wedi Tazare) - Tumat Laza - New Eritrean Music 2017 - ( Official  Music Video ) by ELLA RECORDS 4 years ago 4 minutes, 56 seconds 58,920 views",ELLA RECORDS,58920,58960,40
506,"Ella TV - Nebyat Hagos - Ksetreka ye - New Eritrean Music 2017- [ Official Music Video ] by ELLA RECORDS 4 years ago 6 minutes, 16 seconds 100,684 views",ELLA RECORDS,100684,100716,32
507,"Ella TV - Negasi Gebrehiwet - Beal Taxi - New Eritrean Music 2017 - [ Official Music Video ] by ELLA RECORDS 4 years ago 5 minutes, 23 seconds 13,949 views",ELLA RECORDS,13949,13955,6
508,"Ella TV - Efream Kahsay - Wedi Quda - New Eritrean Movie 2017 - Monologue - [ Official Movie ] by ELLA RECORDS 4 years ago 14 minutes, 29 seconds 86,512 views",ELLA RECORDS,86512,86564,52
509,"Ella TV - Yoseph Mulue - ( Josi ) - Akabit Fkri - New Eritrean Music 2017 - [ Official Music Video ] by ELLA RECORDS 4 years ago 4 minutes, 35 seconds 45,504 views",ELLA RECORDS,45504,45515,11
510,"Ella TV - Merhawi Solomon ( Serche ) - Mikrtey - New Eritrean Music 2017 - [ Official Music Video ] by ELLA RECORDS 4 years ago 4 minutes, 20 seconds 62,372 views",ELLA RECORDS,62372,62386,14
511,"Ella TV - Robel Negash - Endieta - New Eritrean Music 2017 - [ Official Music Video ] by ELLA RECORDS 4 years ago 6 minutes, 17 seconds 181,229 views",ELLA RECORDS,181229,181347,118
512,"Ella TV - New Eritrean comedy 2017 - Stand Up comedy - Ganta - Tedros Hayle - ( Kenya ) by ELLA RECORDS 4 years ago 2 minutes, 36 seconds 36,799 views",ELLA RECORDS,36799,36814,15
513,"Ella TV - Ashenafi Tadese - Mlat Lbey - New Eritrean Music 2017 - [ Official Music Video ] by ELLA RECORDS 4 years ago 6 minutes, 14 seconds 390,409 views",ELLA RECORDS,390409,390495,86
514,"Ella TV - Biniam O/gabr ( Chapin ) - Jajye - New Eritrean Music 2017 - [ Official Music Video ] by ELLA RECORDS 4 years ago 6 minutes, 40 seconds 123,007 views",ELLA RECORDS,123007,123186,179
515,"Ella TV - Dejen Mebrahtu - Ajoka Belni - New Eritrean Music 2017 - [ Official Music Video ] by ELLA RECORDS 4 years ago 5 minutes, 6 seconds 69,384 views",ELLA RECORDS,69384,69399,15
516,"Ella TV - Filmon Alem - Emnet - New Eritrean Music 2017 - [ Official Music Video ] by ELLA RECORDS 4 years ago 6 minutes, 8 seconds 105,657 views",ELLA RECORDS,105657,105684,27
517,"Ella TV - Semhar Yohannes - Kealo - New Eritrean Music 2017 - [ Official Music Video ] by ELLA RECORDS 4 years ago 5 minutes, 26 seconds 1,701,183 views",ELLA RECORDS,1701183,1703898,2715
518,"Ella TV - Yosief Habtemichael - Luwamey -  New Eritrean Music 2017 - [ Official Music Video ] by ELLA RECORDS 4 years ago 5 minutes, 16 seconds 148,323 views",ELLA RECORDS,148323,148394,71
519,"Ella TV - Mussie Negede - Hayli Fkri - New Eritrean Music 2017 - [ Official Music Video ] by ELLA RECORDS 4 years ago 6 minutes, 9 seconds 46,300 views",ELLA RECORDS,46300,46385,85
520,"Ella TV - Listro - New Eritrean Movie 2017 - [ Official Movie ] - Part 3 Final by ELLA RECORDS 4 years ago 38 minutes 164,093 views",ELLA RECORDS,164093,164121,28
521,"Ella TV - Yonas Feremichael - Ezi Diyu Edey - New Eritrean Music 2017 - [ Official Music Video ] by ELLA RECORDS 4 years ago 5 minutes, 17 seconds 26,011 views",ELLA RECORDS,26011,26012,1
522,"Ella TV - New Eritrean Comedy 2017 - Delay Aysan - Teame Arefayne - [ Official Comedy ] by ELLA RECORDS 4 years ago 16 minutes 571,081 views",ELLA RECORDS,571081,571277,196
523,"Ella TV - Teklit Kidane - Ab Temesigen ye Znebr - New Eritrean Music 2017 - [ Official Music Video ] by ELLA RECORDS 4 years ago 6 minutes, 56 seconds 57,239 views",ELLA RECORDS,57239,57351,112
524,"Ella TV - Kflay Tkabo - Alamdni - New Eritrean Music 2017 - [ Official Music Video ] by ELLA RECORDS 4 years ago 4 minutes, 5 seconds 27,818 views",ELLA RECORDS,27818,27821,3
525,"Ella TV - Orion Salh - Klte Mray - New Eritrean Music 2017 [ Official Music Video ] by ELLA RECORDS 4 years ago 4 minutes, 35 seconds 87,198 views",ELLA RECORDS,87198,87235,37
526,"Ella TV - Semhar Gebereyesus  - Mhirkani - New Eritrean Music 2017 - [ Official Music Video] by ELLA RECORDS 4 years ago 5 minutes, 29 seconds 96,262 views",ELLA RECORDS,96262,96337,75
527,"Ella TV - Sadat Ahmed ( Wedi Mazu ) - Zeyidey - New Eritrean Music 2017 - [ Official Music Video ] by ELLA RECORDS 4 years ago 5 minutes, 28 seconds 131,935 views",ELLA RECORDS,131935,132007,72
528,"Ella TV - Efream Tsegay - Degim Akele - New Eritrean Music 2017 - [ Official Music Video ] by ELLA RECORDS 4 years ago 5 minutes, 47 seconds 44,674 views",ELLA RECORDS,44674,44693,19
529,"Ella TV - Adhanet Balcha - Dwul Ms Abeka - New Eritrean Music 2017 - [ Official Music Video ] by ELLA RECORDS 4 years ago 4 minutes, 54 seconds 98,124 views",ELLA RECORDS,98124,98153,29
530,"Ella TV - Merahwi Tekeste ( Mokbeaeti ) - Kem Sebey Kiderf eye - New Eritrean Comedy 2017 by ELLA RECORDS 4 years ago 6 minutes, 8 seconds 66,796 views",ELLA RECORDS,66796,66832,36
531,"Ella TV - New Eritrean Movie 2017 - GZT | ግዝት - Film by Wegihu Fithaxieyon - [ Official Trailer ] by ELLA RECORDS 4 years ago 1 minute, 42 seconds 63,593 views",ELLA RECORDS,63593,63643,50
532,"Ella TV - Sabur Abdu ( Sabieto )  - Mahlietey - New Eritrean Music 2017 [ Official Music Video ] by ELLA RECORDS 4 years ago 4 minutes, 34 seconds 201,837 views",ELLA RECORDS,201837,202134,297
533,"Ella TV - Temesghen Yared - Wuneshey - New Eritrean Music 2017 - [ Official Music Video ] by ELLA RECORDS 4 years ago 4 minutes, 17 seconds 643,375 views",ELLA RECORDS,643375,643792,417
534,"Ella TV - Yonatan Tekie -Zibelki Belini - New Eritrean Music 2017 - [ Official Music Video ] by ELLA RECORDS 4 years ago 5 minutes, 59 seconds 50,444 views",ELLA RECORDS,50444,50491,47
535,"Ella TV - Nahom Yohannes ( Meste ) - Guya Guya  - New Eritrean Music 2017 - [ Official Lyrics Video] by ELLA RECORDS 4 years ago 6 minutes 345,808 views",ELLA RECORDS,345808,349014,3206
536,"Ella TV - Tesfa Embaye  ( Fifi ) - Fetinkni - New Eritrean Music 2017 - [ Official Music Video ] by ELLA RECORDS 4 years ago 6 minutes, 32 seconds 48,961 views",ELLA RECORDS,48961,48967,6
537,"Ella TV - Listro - New Eritrean Movie 2017 - [ Official Movie ] - Part 2 by ELLA RECORDS 4 years ago 21 minutes 55,181 views",ELLA RECORDS,55181,55191,10
538,"Ella TV - Haben Teklemariam ( Habie ) - Gual Asmara - New Eritrean Music 2017 - [ Official Video ] by ELLA RECORDS 4 years ago 6 minutes, 11 seconds 74,984 views",ELLA RECORDS,74984,74998,14
539,"Ella TV - Haben Negasi - Abey yu adika - New Eritrean Music 2017  [ Official music video ] by ELLA RECORDS 4 years ago 5 minutes, 17 seconds 80,280 views",ELLA RECORDS,80280,80309,29
540,"Ella TV - Samuel Ferezgie | Wedi Ferie  - Kotetie - New Eritrean Music 2017 - [Official Music Video] by ELLA RECORDS 4 years ago 5 minutes, 9 seconds 78,120 views",ELLA RECORDS,78120,78377,257
541,"Ella TV - Hagos Berhane - Tkono lewa - New Eritrean Music 2017 - [ Official Music Video ] by ELLA RECORDS 4 years ago 7 minutes, 58 seconds 159,288 views",ELLA RECORDS,159288,159509,221
542,"Ella TV - Listro - New Eritrean Movie 2017 - [ Official Movie ] - Part 1 by ELLA RECORDS 4 years ago 16 minutes 92,424 views",ELLA RECORDS,92424,92436,12
543,"Ella TV - Merhawi Nur ( Wedi Nur ) - Shakulot - New Eritrean Music 2017 [ Official music Video ] by ELLA RECORDS 4 years ago 5 minutes, 5 seconds 65,087 views",ELLA RECORDS,65087,65091,4
544,"Ella TV - Mussie Asmerom | Echn - B Fqri Nxelel - New Eritrean Music 2017 - [ Official Music Video ] by ELLA RECORDS 4 years ago 4 minutes, 53 seconds 251,129 views",ELLA RECORDS,251129,251455,326
545,"Ella TV - Kibrom Russom - Hayal u Fqrki - New Eritrean Music 2017 -  [ Official Music Video ] by ELLA RECORDS 4 years ago 5 minutes, 53 seconds 46,993 views",ELLA RECORDS,46993,46997,4
546,"Ella TV - Ezana - Film by Sadat  Ahmed - New Eritrean Movie 2017 - [ Official Movie Trailer ] by ELLA RECORDS 4 years ago 1 minute, 19 seconds 53,363 views",ELLA RECORDS,53363,53371,8
547,"Ella TV - Kibrom Maekele - Teum'ye Zekire - New Eritrean Music 2017 - [ Official Music Video ] by ELLA RECORDS 4 years ago 7 minutes 176,424 views",ELLA RECORDS,176424,176559,135
548,"Ella TV - Merahwi Tekeste ( Mokbeaeti ) -  Mesta - New Eritrean Comedy 2017 - [ Official Comedy ] by ELLA RECORDS 4 years ago 12 minutes, 38 seconds 75,517 views",ELLA RECORDS,75517,75519,2
549,"Ella TV - Ella Studio UG Advert - New Audio Recording Studio - Ruhus Beal [ Kudus Yohannes  ] by ELLA RECORDS 4 years ago 4 minutes, 2 seconds 24,745 views",ELLA RECORDS,24745,24745,0
550,"Ella TV - Robel Tewuhibo | China  - Zeytehasbe Megesha - New Eritrean Music 2017- [ Official Music ] by ELLA RECORDS 4 years ago 6 minutes, 37 seconds 124,527 views",ELLA RECORDS,124527,124605,78
551,"Ella TV - Saba Andemariam - Beal Kebero - New Eritrean Music 2017 - [ Official Music Video ] by ELLA RECORDS 4 years ago 4 minutes, 58 seconds 2,225,325 views",ELLA RECORDS,2225325,2228322,2997
552,"Ella TV - Music Promo - Over 50 [ New Eritrean Music 2017 ] - Eritrean comedy 2017 - coming soon by ELLA RECORDS 4 years ago 8 minutes, 9 seconds 65,163 views",ELLA RECORDS,65163,65172,9
553,"Ella TV - Saba Andemariam - Beal Kebero - New Eritrean Music 2017  - [ Trailer ] - Coming Soon by ELLA RECORDS 4 years ago 45 seconds 82,206 views",ELLA RECORDS,82206,82234,28
554,"Ella TV - Mestyat - Eritrean Film by Nahom Abam - New Eritrean Short Movie 2017 - [ Official Movie ] by ELLA RECORDS 4 years ago 18 minutes 637,104 views",ELLA RECORDS,637104,637328,224
555,"Ella TV - Andit Okbay - Mikrtey - New Eritrean Music 2017 - [ Official Music Video ] - Hot Guayla by ELLA RECORDS 4 years ago 7 minutes, 12 seconds 10,027,862 views",ELLA RECORDS,10027862,10041864,14002
556,"Ella TV - Millen Hailu - Mechiuni | መቺኡኒ - New Eritrean Music 2017 - [ Official Music Video ] by ELLA RECORDS 4 years ago 5 minutes, 7 seconds 7,606,828 views",ELLA RECORDS,7606828,7624367,17539
557,"Ella TV - Nahom Yohannes ( Meste ) - Guya Guya  - New Eritrean Music 2017 - [  Official Audio ] by ELLA RECORDS 4 years ago 5 minutes, 54 seconds 12,026,886 views",ELLA RECORDS,12026886,12054233,27347
558,"Ella TV  - Andit Okbay - Mikrtey - New Eritrean Music 2017 - Coming soon on Ella TV by ELLA RECORDS 4 years ago 41 seconds 94,587 views",ELLA RECORDS,94587,94612,25
559,"Ella TV - Asmerom Eyob - Mlmmad yu fikri - New Eritrean Music 2017 - [ Official video ] by ELLA RECORDS 4 years ago 5 minutes, 15 seconds 50,506 views",ELLA RECORDS,50506,50512,6
560,"Ella TV - Weyni Solomon - Nigus Emnet - New Eritrean Music 2017 - Ella Records by ELLA RECORDS 4 years ago 5 minutes, 42 seconds 77,794 views",ELLA RECORDS,77794,77856,62
561,"Ella TV - Nahom Yohannes ( Meste ) - Guya Guya - New Eritrean Music 2017 - Audio Release in 4 days by ELLA RECORDS 4 years ago 21 seconds 161,470 views",ELLA RECORDS,161470,161488,18
562,"Ella TV - Samsom Tekste ( Wedi Keshi ) - Knes ye Giena - New Eritrean Music 2017 - Ella Records by ELLA RECORDS 4 years ago 5 minutes, 6 seconds 245,303 views",ELLA RECORDS,245303,245489,186
563,"Ella TV - Adhanom Medhanie  ( anjebe ) - Mesiliwom ember  - New Eritrean music 2017 - Ella Records by ELLA RECORDS 4 years ago 2 minutes, 49 seconds 16,954 views",ELLA RECORDS,16954,16966,12
564,"Ella TV - Semere Habtemariam - Aynateyn yu | ኣይናተይን'ዩ -  New Eritrean Music 2017 - Ella Records by ELLA RECORDS 4 years ago 6 minutes, 35 seconds 265,175 views",ELLA RECORDS,265175,265400,225
565,"Ella TV - Kflom Tewelde ( Ganfur ) - Mdrawit Wedeb Teseney - New Eritrean Music 2017 - Ella Records by ELLA RECORDS 4 years ago 5 minutes, 20 seconds 49,986 views",ELLA RECORDS,49986,50092,106
566,"Ella TV - Said Berhanu - Hiewaney | ሄዋነይ -  New Eritrean Music 2017 - Ella Records by ELLA RECORDS 4 years ago 5 minutes, 11 seconds 202,529 views",ELLA RECORDS,202529,202655,126
567,"Ella TV - Haben Negasi - Nefkra N Fikiri | ነፍቅራ ንፍቕሪ - New Eritrean Music 2017 - Ella Records by ELLA RECORDS 4 years ago 6 minutes, 51 seconds 40,947 views",ELLA RECORDS,40947,40949,2
568,"Ella TV - Abraham Alem ( Abi ) - Hieru | ሄሩ - New Eritrean Music 2017 - Ella Records by ELLA RECORDS 4 years ago 4 minutes, 47 seconds 4,948,561 views",ELLA RECORDS,4948561,4964184,15623
569,"Ella TV | Solomon Teklya { Mafea } | Mamukey | New Eritrean Music 2017 | Ella Records by ELLA RECORDS 4 years ago 6 minutes, 34 seconds 38,735 views",ELLA RECORDS,38735,38746,11
570,"Ella TV - Isseyas Okbay ( Anko ) - Aykealkun | ኣይከኣልኩን - New Eritrean Music 2017 - Ella Records by ELLA RECORDS 4 years ago 3 minutes, 19 seconds 33,873 views",ELLA RECORDS,33873,33886,13
571,"Ella TV - Haileab G/tnsaie ( Daru ) - Tekesielki | ተቐጺዐልኪ - New Eritrean Music 2017 - Ella Records by ELLA RECORDS 4 years ago 5 minutes, 39 seconds 177,130 views",ELLA RECORDS,177130,177349,219
572,"Ella TV - Selam Demoz - Fekar Aykebtsin yu | ፈቃር ኣይቀብጽን ዩ - New Eritrean Music 2017 - Ella Records by ELLA RECORDS 4 years ago 6 minutes, 1 second 147,689 views",ELLA RECORDS,147689,147776,87
573,"Ella TV - Robel Negash - Tshfto | ጽሕፍቶ - New Eritrean Music 2017 - Ella Records by ELLA RECORDS 4 years ago 4 minutes, 19 seconds 48,867 views",ELLA RECORDS,48867,48908,41
574,"Ella TV - Feven Redae - Bedileka | በዲለካ - New Eritrean Music 2017 - Ella Records by ELLA RECORDS 4 years ago 4 minutes, 29 seconds 63,880 views",ELLA RECORDS,63880,63910,30
575,"Ella TV - Awet Hagos ( Estala ) - Gualey | ጓለይ - New Eritrean Music 2017 - Ella Records by ELLA RECORDS 4 years ago 4 minutes, 24 seconds 42,004 views",ELLA RECORDS,42004,42015,11
576,"Ella TV - Haben Teklemariam (Habie ) - Helena | ሄለና - New Eritrean Music 2017 - Ella Records by ELLA RECORDS 4 years ago 7 minutes, 6 seconds 88,192 views",ELLA RECORDS,88192,88212,20
577,"Ella TV - Feruz Yoseph - Handebet Megesha | ሓንደበት መንገሻ - New Eritrean Music 2017 - Ella Records by ELLA RECORDS 4 years ago 6 minutes, 28 seconds 28,553 views",ELLA RECORDS,28553,28560,7
578,"Ella TV - Ghide Yohannes ( Johni ) - Demki | ደምኪ - New Eritrean Music 2017 - Ella Records by ELLA RECORDS 4 years ago 6 minutes, 5 seconds 53,461 views",ELLA RECORDS,53461,53470,9
579,"Ella TV - Yoni Habitz - Number One - New Eritrean Music 2017 { Hip Hop Music } - Ella Records by ELLA RECORDS 4 years ago 3 minutes, 27 seconds 100,775 views",ELLA RECORDS,100775,100842,67
580,"Ella TV - Daniel Tekeste ( Chapiko ) - Wanaki | ዋናኺ - New Eritrean Music 2017 - Ella Records by ELLA RECORDS 4 years ago 5 minutes, 21 seconds 128,991 views",ELLA RECORDS,128991,129207,216
581,"Ella TV - Shumay Gebrihiwet ( Sham ) - Joli | ጆሊ - New Eritrean Music 2017 - Ella Records by ELLA RECORDS 4 years ago 7 minutes, 23 seconds 1,030,232 views",ELLA RECORDS,1030232,1033704,3472
582,"Ella TV - Million Eshetu - Natka ZIbela - ናትካ ዝበላ - New Eritrean Music 2017 - Ella Records by ELLA RECORDS 4 years ago 5 minutes, 20 seconds 214,509 views",ELLA RECORDS,214509,214707,198
583,"Ella TV - Over 10 - New Music VIdeos Coming Soon - On Ella Records by ELLA RECORDS 4 years ago 3 minutes, 43 seconds 30,290 views",ELLA RECORDS,30290,30293,3
584,"Ella TV - Haben Negasi - Fitihiley Libki | ፍትሕለይ ልብኺ - New Eritrean Music 2017 - Ella Records by ELLA RECORDS 4 years ago 7 minutes, 9 seconds 67,901 views",ELLA RECORDS,67901,67907,6
585,"Ella TV - Tareke Tesfahiwet - Ruhus Timket | ርሑስ ጥምቀት - New Eritrean Music 2017 - Ella Records by ELLA RECORDS 4 years ago 7 minutes, 40 seconds 45,944 views",ELLA RECORDS,45944,46037,93
586,"Ella TV - Dawit Haile - Shege | ሸገ - New Eritrean Music 2017 - Ella Records by ELLA RECORDS 4 years ago 6 minutes, 15 seconds 51,366 views",ELLA RECORDS,51366,51369,3
587,"Ella TV - Brhane Andom ( Wedi Mama ) - Searit Tsmwa | ሰዓሪት ጽምዋ - New Eritrean Music 2017 by ELLA RECORDS 4 years ago 7 minutes, 35 seconds 24,361 views",ELLA RECORDS,24361,24364,3
588,"Ella TV  - Melake Abraham -  Welet Barka | ወለት ባርካ - New Eritrean Music 2017 - { Hot Tigre Music } by ELLA RECORDS 4 years ago 5 minutes, 24 seconds 538,077 views",ELLA RECORDS,538077,539357,1280
589,"Ella TV - Shumay G/hiwet - Joli | ጆሊ - New Eritrean Music 2017 - Coming Soon - Ella Records by ELLA RECORDS 4 years ago 1 minute, 11 seconds 36,789 views",ELLA RECORDS,36789,36814,25
590,"Ella TV - Tesfalidet Mesfin ( Wedi Mesfin ) - Weriduni Zelo - ወሪዱኒ ዘሎ - New Eritrean Music 2017 - by ELLA RECORDS 4 years ago 5 minutes, 10 seconds 301,445 views",ELLA RECORDS,301445,301665,220
591,"Ella TV - Solomon Teklia ( Mefa ) - Selabitey | ሰላቢተይ - New Eritrean Music - Ella Records by ELLA RECORDS 4 years ago 4 minutes, 53 seconds 101,428 views",ELLA RECORDS,101428,101436,8
592,"Ella TV - Sami Ezra - Kokobey | ኮኮበይ - New Eritrean Music 2017 - Ella Records by ELLA RECORDS 4 years ago 4 minutes, 55 seconds 133,432 views",ELLA RECORDS,133432,133464,32
593,"Ella TV - Mathios W/gergsh ( Keshi ) - Teadile | ተዓዲለ - New Eritrean Music 2017 - Ella Records by ELLA RECORDS 4 years ago 6 minutes, 17 seconds 32,016 views",ELLA RECORDS,32016,32027,11
594,"Ella TV - Lidia Tareke - Kuhley | ኩሕለይ - New Eritrean Music 2017 - Ella Records by ELLA RECORDS 4 years ago 4 minutes, 51 seconds 110,153 views",ELLA RECORDS,110153,110246,93
595,"Ella TV - Beraki Gebremedhin -Tarik eyu Snqey | ታሪኽ ዩ ስንቀይ - New Eritrean Music 2017 - Ella Records by ELLA RECORDS 4 years ago 6 minutes, 8 seconds 151,491 views",ELLA RECORDS,151491,151648,157
596,"Ella TV - Nahom Tesfealem ( Hubi ) - Meley | መለይ - New Eritrean Music 2017 - Ella Records by ELLA RECORDS 4 years ago 4 minutes, 57 seconds 775,458 views",ELLA RECORDS,775458,776468,1010
597,"Ella TV - Filmon Zekarias - Teawitlki | ተዓዊትልኪ - New Eritrean Music 2017 - Ella Records by ELLA RECORDS 4 years ago 5 minutes, 57 seconds 113,566 views",ELLA RECORDS,113566,113591,25
598,"Ella TV - Robi Habtu  ( Kanari ) - Mruk Nay Fkrki | ምሩኽ ናይ ፍቕርኺ - New Eritrean Music 2017 - Remix by ELLA RECORDS 4 years ago 4 minutes, 24 seconds 173,737 views",ELLA RECORDS,173737,174030,293
599,"Ella TV - Issey Afewerki - Kihiskini | ክሒስኪኒ - New Eritrean Music 2017 - Ella Records by ELLA RECORDS 4 years ago 7 minutes, 26 seconds 143,544 views",ELLA RECORDS,143544,143573,29
600,"Ella TV - Angesom Kbrom (Wedi Haleka) - Aykemun | ኣይከምኡን - New Eritrean Music 2017 - Ella Records by ELLA RECORDS 4 years ago 5 minutes, 37 seconds 68,313 views",ELLA RECORDS,68313,68321,8
601,"Ella TV - Issey Afewerki - Kihisikini - New Eritrean Music 2017 - Friday at 5PM On - Ella Records by ELLA RECORDS 4 years ago 32 seconds 17,184 views",ELLA RECORDS,17184,17184,0
602,"Ella TV - Finan Shimbahri - Girmawitey | ግርማዊተይ - New Eritrean Music 2017 - Ella Records by ELLA RECORDS 4 years ago 4 minutes, 44 seconds 41,781 views",ELLA RECORDS,41781,41790,9
603,"Ella TV - Rezene Alem - Tselamey | ጸላመይ - New Eritrean Music 2017 - Ella Records by ELLA RECORDS 4 years ago 4 minutes, 42 seconds 129,293 views",ELLA RECORDS,129293,129356,63
604,"Ella TV - New Music Videos Coming soon - Rezene | Nahom | Wedi Mesfn | Melake by ELLA RECORDS 4 years ago 2 minutes, 13 seconds 37,973 views",ELLA RECORDS,37973,37973,0
605,"Ella TV - Yohannes Qelit ( Wedi Qelit ) - Wana - New Eritrean Music 2017 - Hot Guayla - Ella Records by ELLA RECORDS 4 years ago 5 minutes, 13 seconds 225,512 views",ELLA RECORDS,225512,225593,81
606,"Ella TV - Yohannes Habteab ( Wedi Kerin ) Aytehmemuwa  - New Eritrean Music 2017 - Ella Records by ELLA RECORDS 4 years ago 5 minutes 924,735 views",ELLA RECORDS,924735,928685,3950
607,"Ella TV - Ngsti Tsegay ( Titi ) - Gol Werede - New Eritrean Music 2017 - Ella Records by ELLA RECORDS 4 years ago 5 minutes, 50 seconds 88,135 views",ELLA RECORDS,88135,88160,25
608,"Ella TV - Adhanom Medhanie ( ኣጅንበ ) - Ykeyd Aleku - New Eritrean Music 2017 - Ella Records by ELLA RECORDS 4 years ago 7 minutes, 57 seconds 63,332 views",ELLA RECORDS,63332,63344,12
609,"Ella TV - Matiwos W/gergsh ( Keshi ) - Zerhake eyu Znafek - New Eritrean Music 2017 - Ella Records by ELLA RECORDS 4 years ago 5 minutes, 28 seconds 37,339 views",ELLA RECORDS,37339,37340,1
610,"Ella TV - Yoseph Genetu ( Jossy ) - Kola Shawuley - New Eritrean Music 2017 - Ella Records by ELLA RECORDS 4 years ago 5 minutes, 45 seconds 152,031 views",ELLA RECORDS,152031,152053,22
611,"Ella TV - Hagos Suzinino - Sean Lisan | ሰኣን ልሳን - New Eritrean Comedy 2017  - Eritrean Movie 2017 by ELLA RECORDS 4 years ago 19 minutes 894,520 views",ELLA RECORDS,894520,895714,1194
612,"Ella TV - Sami Ezra - Asey | ኣሰይ - New Eritrean Music 2017 | Hot Traditional Music | - Ella Records by ELLA RECORDS 4 years ago 5 minutes, 40 seconds 176,003 views",ELLA RECORDS,176003,176148,145
613,"Ella TV - Temesghen Yared - Lilo | ሊሎ - New Eritrean Music 2017 - Engineer Asgedom - ( Remix ) by ELLA RECORDS 4 years ago 4 minutes, 16 seconds 7,520,424 views",ELLA RECORDS,7520424,7540837,20413
614,"Ella TV - Genet Teklehaimanot - Nebsi - New Eritrean Music 2017 - Ella Records by ELLA RECORDS 4 years ago 4 minutes, 47 seconds 182,502 views",ELLA RECORDS,182502,182557,55
615,"Ella TV - Quali Band - Interview - Ella Show - New Eritrean Music 2017 - Ella Records by ELLA RECORDS 4 years ago 53 minutes 58,792 views",ELLA RECORDS,58792,58794,2
616,"Ella TV - Nebi - Mana Zekaryas - New Eritrean Music 2017 - Ella Records  ( Based on True Story ) by ELLA RECORDS 4 years ago 5 minutes, 7 seconds 116,757 views",ELLA RECORDS,116757,116766,9
617,"Ella TV - Feruz Adl - Sensolomay - New Eritrean Music 2017 - Ella Records by ELLA RECORDS 4 years ago 5 minutes, 59 seconds 105,625 views",ELLA RECORDS,105625,105696,71
618,"Ella TV - Yonas Fessehaye ( Logo ) - Awudeamet - New Eritrean Music 2017 - Ella Records by ELLA RECORDS 4 years ago 6 minutes, 33 seconds 42,075 views",ELLA RECORDS,42075,42116,41
619,"Ella TV - Ftsum Mobae - Tetalila - New Eritrean Music 2017 - Ella Records by ELLA RECORDS 4 years ago 6 minutes, 33 seconds 115,108 views",ELLA RECORDS,115108,115223,115
620,"Ella TV - Tedros Kesete - Sudanawit - New Eritrean Music 2017 - Ella Records by ELLA RECORDS 4 years ago 6 minutes, 30 seconds 99,194 views",ELLA RECORDS,99194,99266,72
621,"Ella TV - Esseyas Yukuno ( Wedi Yukuno ) - Ayreseaken eye - New Eritrean Music 2017 - Ella Records by ELLA RECORDS 4 years ago 5 minutes, 57 seconds 85,757 views",ELLA RECORDS,85757,85777,20
622,"Ella TV - Abel Mussie ( Wedi Jome ) - Nafkot - New Eritrean Music 2017 - Ella Records by ELLA RECORDS 4 years ago 7 minutes, 20 seconds 63,900 views",ELLA RECORDS,63900,63920,20
623,"Ella TV - Negasi G/hiwet - Fitih eyu eti fitah - New Eritrean Music 2017 - Ella Records by ELLA RECORDS 4 years ago 8 minutes, 10 seconds 75,846 views",ELLA RECORDS,75846,75850,4
624,"Ella TV - Filmon Fikare - Emenela | እመነላ - New Eritrean Music 2017 - Ella Records by ELLA RECORDS 4 years ago 5 minutes, 32 seconds 472,615 views",ELLA RECORDS,472615,473054,439
625,"New Eritrean Music 2017 - Coming soon on Ella TV by ELLA RECORDS 4 years ago 7 minutes, 1 second 64,819 views",ELLA RECORDS,64819,64821,2
626,"John ( Air Force ) - Beja Asmara | በጃ ኣስመራ - New Eritrean Music 2017 - Ella Records by ELLA RECORDS 4 years ago 8 minutes, 17 seconds 319,888 views",ELLA RECORDS,319888,320206,318
627,"Qudus Bahta - Marakit | ማራኺት - New Eritrean Music 2017 - Ella Records by ELLA RECORDS 4 years ago 5 minutes, 38 seconds 19,447 views",ELLA RECORDS,19447,19452,5
628,"Gidewon Beraki - Ouf Meskel | ዑፍ መስቐል - New Eritrean Music 2017 - Ella Records by ELLA RECORDS 4 years ago 6 minutes, 28 seconds 35,319 views",ELLA RECORDS,35319,35332,13
629,"Tesfay Tekie - Libi eyu Zrei | ልቢ'ዩ ዝርኢ - New Eritrean Music 2017 - Trailer by ELLA RECORDS 5 years ago 1 minute, 3 seconds 25,021 views",ELLA RECORDS,25021,25024,3
630,"Ella TV - Tesfay Tekie - Libi eyu Zrei - New Eritrean Music 2017 - Ella Records by ELLA RECORDS 5 years ago 5 minutes, 26 seconds 57,467 views",ELLA RECORDS,57467,57474,7
631,"Ella TV - Efrem Kapitano ( Chare ) - Aminey | ኣሚነይ - New Eritrean Music 2017 - Ella records by ELLA RECORDS 5 years ago 4 minutes, 17 seconds 193,518 views",ELLA RECORDS,193518,193535,17
632,"Ella TV - Matios W/mariam - Keshi - Welolo | New Eritrean Music 2017 |  Ella Records by ELLA RECORDS 5 years ago 7 minutes, 31 seconds 34,409 views",ELLA RECORDS,34409,34410,1
633,"Ella TV - Helen Tesfay - Fkri | ፍቕሪ - New Eritrean Music 2017 - Ella Records by ELLA RECORDS 5 years ago 6 minutes, 7 seconds 96,420 views",ELLA RECORDS,96420,96437,17
634,"Ella TV - Daniel Mogos ( Reggae ) | Yalaka - New Eritrean Music 2017 | Ella Records by ELLA RECORDS 5 years ago 4 minutes, 49 seconds 1,108,768 views",ELLA RECORDS,1108768,1110925,2157
635,"Ella TV - Samuel Tekie (Shabay)- Gudletey | New Eritrean Music 2017 - Ella Records by ELLA RECORDS 5 years ago 6 minutes, 44 seconds 91,620 views",ELLA RECORDS,91620,91626,6
636,"Ella TV - Daniel Mogos (Reggae) - Yalaka | ያላኻ -  New Eritrean Music 2017 - Advert by ELLA RECORDS 5 years ago 54 seconds 23,432 views",ELLA RECORDS,23432,23448,16
637,"Ella TV - Matiwos W/gergsh ( Keshi ) - Aytedengxni - New Eritrean Music 2017 - Ella Records by ELLA RECORDS 5 years ago 6 minutes, 35 seconds 111,051 views",ELLA RECORDS,111051,111054,3
638,"Ella TV - Millon Eshetu - Nebait - New Eritrean Music 2017 - Ella Records by ELLA RECORDS 5 years ago 5 minutes, 26 seconds 92,512 views",ELLA RECORDS,92512,92549,37
639,"Ella TV - Eden Kesete - Gzie Lo | ግዜ ሎ - New Eritrean Music 2017 - Ella Records by ELLA RECORDS 5 years ago 5 minutes, 22 seconds 2,226,287 views",ELLA RECORDS,2226287,2231819,5532
640,"Ella TV - New Eritrean Music 2017 Eden Kesete - Gzie Lo  -  Eritreean Music - Ella Records by ELLA RECORDS 5 years ago 37 seconds 64,992 views",ELLA RECORDS,64992,65013,21
641,"Ella TV - ከመይ ጌርና ፊልም ንካረ ካብ ኤላ ቲቪ - How to rent movies from Ella TV by ELLA RECORDS 5 years ago 8 minutes, 45 seconds 22,762 views",ELLA RECORDS,22762,22763,1
642,"Ella TV - New Eritrean Movie 2016- Salh Saed -Tesfa-  Now on Ella TV - Ella Records by ELLA RECORDS 5 years ago 2 minutes, 7 seconds 84,710 views",ELLA RECORDS,84710,84721,11
643,"Ella TV - Salem Welday - Abraham | ኣብርሃም - New Eritrean Music 2017 - Ella Records by ELLA RECORDS 5 years ago 6 minutes, 32 seconds 1,987,749 views",ELLA RECORDS,1987749,1988514,765
644,"Ella TV - Salem Welday - Abraham | ኣብርሃም - New Eritrean Music 2017 - Coming soon on  Ella Records by ELLA RECORDS 5 years ago 46 seconds 70,186 views",ELLA RECORDS,70186,70208,22
645,"Ella TV - Filmon Alem - Meley | መለይ - New Eritrean Music 2017  Ella Records by ELLA RECORDS 5 years ago 6 minutes, 20 seconds 179,730 views",ELLA RECORDS,179730,179767,37
646,"Ella TV - New Eritrean Movie 2017 - Kahta | ቃሕታ - Nahom Abraham -  Now On Ella TV by ELLA RECORDS 5 years ago 1 minute, 50 seconds 55,617 views",ELLA RECORDS,55617,55738,121
647,"Ella TV - FIlmon Alem - Meley | መለይ - New Eritrean Music 2017 -  Ella Records - Music Trailer by ELLA RECORDS 5 years ago 1 minute, 33 seconds 23,929 views",ELLA RECORDS,23929,23933,4
648,"Ella TV - New Eritrean Short Movie by Nahom Abam is now available on Ella TV by ELLA RECORDS 5 years ago 57 seconds 172,858 views",ELLA RECORDS,172858,172872,14
649,"Ella TV - New Traditional Eritrean Movie 2017 -  Now Available on Ella TV by ELLA RECORDS 5 years ago 1 minute, 30 seconds 107,841 views",ELLA RECORDS,107841,107869,28
650,"Ella TV - Millon Eshetu - Gor Beyney - New Eritrean Music 2017 - Ella Records by ELLA RECORDS 5 years ago 6 minutes, 56 seconds 159,332 views",ELLA RECORDS,159332,159423,91
651,"Ella TV - New Eritrean Movie 2017- Kalsi Kal - Part 4 - Ella Movies by ELLA RECORDS 5 years ago 31 minutes 323,517 views",ELLA RECORDS,323517,323744,227
652,"Ella TV - New Eritrean Movie 2017 - Kalsi Kal - Part 3 - Ella Movies by ELLA RECORDS 5 years ago 51 minutes 529,050 views",ELLA RECORDS,529050,529393,343
653,"Ella TV - New Eritrean movie 2017 - Kalsi Kal - Part 2 - Ella movies by ELLA RECORDS 5 years ago 48 minutes 411,723 views",ELLA RECORDS,411723,412056,333
654,"New Eritrean movie 2017 - Kalsi Kal - Part 1 - Ella Movies by ELLA RECORDS 5 years ago 25 minutes 480,788 views",ELLA RECORDS,480788,481159,371
655,"Hanna Tewelde - Wusedeni | ዉሰደኒ - New Eritrean Music 2017 - Ella Records by ELLA RECORDS 5 years ago 4 minutes, 5 seconds 118,642 views",ELLA RECORDS,118642,118655,13
656,"Semhar Hadsh - Abey Nerika | ኣበይ ኔርካ - New Eritrean Music 2017 - Ella Records by ELLA RECORDS 5 years ago 4 minutes, 52 seconds 471,612 views",ELLA RECORDS,471612,471799,187
657,"Helen Pawlos - Feresena | ፈረሰኛ - New Eritrean Music 2017 - Ella Records by ELLA RECORDS 5 years ago 6 minutes, 50 seconds 650,773 views",ELLA RECORDS,650773,651123,350
658,"Tesfaldet Simon - Teadile | ተዓዲለ -  New Eritrean Music 2017 - Ella Records by ELLA RECORDS 5 years ago 5 minutes, 31 seconds 169,806 views",ELLA RECORDS,169806,170712,906
659,"Helen Pawlos - Feresena | ፈረሰኛ  - New Eritrean Music 2017 - This Week on Ella Records by ELLA RECORDS 5 years ago 36 seconds 64,122 views",ELLA RECORDS,64122,64142,20
660,"Top 20 - Ella Records  production 2016 - New Eritrean Music 2017 - Ella Records by ELLA RECORDS 5 years ago 54 minutes 196,838 views",ELLA RECORDS,196838,197121,283
661,"T/brhan Sereke - Haben Adebo | ሓበን ዓደቦ - New Eritrean Music 2016 - Traditional music -Ella Records by ELLA RECORDS 5 years ago 5 minutes, 15 seconds 47,523 views",ELLA RECORDS,47523,47535,12
662,"Matiwos W/gergsh ( Keshi ) - Adey'ke entay Ktbl - New Eritrean Music 2016 - Ella Records by ELLA RECORDS 5 years ago 7 minutes, 1 second 33,595 views",ELLA RECORDS,33595,33599,4
663,"Temesgen Bereketab - Senbetey awija | ሰንበተይ ኣዊጀ - New Eritrean Music 2016 - Ella Records by ELLA RECORDS 5 years ago 5 minutes, 27 seconds 56,688 views",ELLA RECORDS,56688,56690,2
664,"Michael G/Krstos ( Nikiya ) - Gaul Hanetay | ጓል ሓኔታይ  - New Eritrean Music 2016 - Ella Records by ELLA RECORDS 5 years ago 7 minutes, 33 seconds 26,597 views",ELLA RECORDS,26597,26600,3
665,"Sami Ezra - Anti Tefetawit | ኣንቲ ተፈታዊት - New Eritrean Music 2016 - Ella Records by ELLA RECORDS 5 years ago 5 minutes, 22 seconds 293,857 views",ELLA RECORDS,293857,294223,366
666,"Meron Teages - Qaw Qaw | ቃዉ ቃዉ  - New Eritrean Comedy 2016 - Ella Records by ELLA RECORDS 5 years ago 13 minutes, 56 seconds 95,813 views",ELLA RECORDS,95813,95820,7
667,"Abraham Alem ( Abi ) - Mahazay| ማሓዛይ - New Eritrean Music 2016 - Ella Records by ELLA RECORDS 5 years ago 5 minutes, 29 seconds 3,297,304 views",ELLA RECORDS,3297304,3306236,8932
668,"Millon Eshetu - Mrchana yu | ምርጫና'ዩ - New Eritrean Music 2016 - Ella Records by ELLA RECORDS 5 years ago 6 minutes, 36 seconds 177,189 views",ELLA RECORDS,177189,177496,307
669,"Ella Records - New Eritrean Music 2016  - Ella Awards 2016 by ELLA RECORDS 5 years ago 3 minutes, 13 seconds 16,386 views",ELLA RECORDS,16386,16395,9
670,"Top 4 - New Eritrean Music 2016 - Coming this week - Ella Records by ELLA RECORDS 5 years ago 1 minute, 42 seconds 30,345 views",ELLA RECORDS,30345,30353,8
671,"Filmon Gebretinsae (Keshat) - Shanet | ሻነት - New Eritrean Music 2016 - Ella Records by ELLA RECORDS 5 years ago 4 minutes, 19 seconds 259,649 views",ELLA RECORDS,259649,259775,126
672,"Abraham Alem (Abi) - Mehazay | ማሓዛይ - New Eritrean Music 2016 -Trailer - Ella Records by ELLA RECORDS 5 years ago 24 seconds 56,123 views",ELLA RECORDS,56123,56155,32
673,"Hermon Kibrom - Yekenyeley Fikri | የቐንየለይ ፍቕሪ - New Eritrean Music 2016 - Ella Records by ELLA RECORDS 5 years ago 6 minutes, 1 second 85,193 views",ELLA RECORDS,85193,85200,7
674,"Hermon Beraki - Entay Kbla | እንታይ ክብላ - New Eritrean Music 2016 - Ella Records by ELLA RECORDS 5 years ago 5 minutes, 51 seconds 146,758 views",ELLA RECORDS,146758,146823,65
675,"Helen Meles - Tsigabey | ጽጋበይ - New Eritrean Music 2016 - Ella Records by ELLA RECORDS 5 years ago 6 minutes, 10 seconds 3,952,010 views",ELLA RECORDS,3952010,3955097,3087
676,"Kibrom Russom (Wedi Russom) - Kal Kidan | ቃል ኪዳን - New Eritrean Music 2016 - Ella Records by ELLA RECORDS 5 years ago 7 minutes, 3 seconds 55,704 views",ELLA RECORDS,55704,55712,8
677,"Robel Girmay - Awedeni Elaley | ኣወድእኒ ዕላለይ - New Eritrean Music 2016 - Ella Records by ELLA RECORDS 5 years ago 5 minutes, 26 seconds 53,984 views",ELLA RECORDS,53984,53989,5
678,"Helen Meles - Tsigabey | ጽጋበይ - This week on Ella Records - New Eritrean Music 2016 - Ella Records by ELLA RECORDS 5 years ago 28 seconds 89,819 views",ELLA RECORDS,89819,89845,26
679,"Nahom Yohannes ft. Teme  - Alena do - live at  Ella show - New Eritrean Music 2016 - Ella Records by ELLA RECORDS 5 years ago 2 minutes, 14 seconds 54,834 views",ELLA RECORDS,54834,54895,61
680,"Nahom Yohannes (Meste) - Seb | ሰብ - New Eritrean Music 2016 - ( Remix )- Ella Records by ELLA RECORDS 5 years ago 4 minutes, 59 seconds 321,807 views",ELLA RECORDS,321807,322093,286
681,"Nahom Yohannes ( Meste ) - Hanti eya Sigdaney  - New Eritrean Music 2016 - Ella Records by ELLA RECORDS 5 years ago 4 minutes, 58 seconds 443,879 views",ELLA RECORDS,443879,444305,426
682,"Nahom Yohannes ( Meste ) - Zeyedbti Live at Ella Show - New Eritrean Music 2016 - Ella Records by ELLA RECORDS 5 years ago 5 minutes, 18 seconds 135,210 views",ELLA RECORDS,135210,135382,172
683,"Ella Show - Nahom Yohannes (Meste) - Live Interview - Ella Show - New Eritrean Music 2016 by ELLA RECORDS 5 years ago 56 minutes 916,395 views",ELLA RECORDS,916395,916751,356
684,"Saba Andemariam - Mrchay | ምርጫይ - New Eritrean Music 2016 - Ella Records by ELLA RECORDS 5 years ago 7 minutes, 50 seconds 2,186,393 views",ELLA RECORDS,2186393,2191284,4891
685,"Nahom Yohannes (Meste)  ft. Teme Hip Hop- Alena Do | ኣለና'ዶ - New Eritrean Music 2016 - Ella Records by ELLA RECORDS 5 years ago 4 minutes, 25 seconds 736,788 views",ELLA RECORDS,736788,737963,1175
686,"Eseyas Salh (Rasha) - Fikri Tedebesi | ፍቕሪ ተደበሲ - New Eritrean Music 2016 - Ella Records by ELLA RECORDS 5 years ago 5 minutes, 12 seconds 1,448,186 views",ELLA RECORDS,1448186,1448945,759
687,"Pitiyas Issac - Nafike | ናፊቐ - New Eritrean Music 2016 - Ella Records by ELLA RECORDS 5 years ago 3 minutes, 51 seconds 20,576 views",ELLA RECORDS,20576,20584,8
688,"Silvana Mehari - Nezi  Diyu Neyru | ነዚ'ድዩ ኔይሩ - New Eritrean Music 2016 - Ella Records by ELLA RECORDS 5 years ago 5 minutes, 58 seconds 828,350 views",ELLA RECORDS,828350,829341,991
689,"Nahom Yohannes ft Teme (Hip Pop) - Alena Do ! ኣለና ዶ! - New Eritrean Music 2016 -  (Afro Beats) by ELLA RECORDS 5 years ago 23 seconds 43,539 views",ELLA RECORDS,43539,43558,19
690,"Millen Hailu - Afkirka Kealo | ኣፍቂርካ ክኣሎ - New Eritrean Music 2016  - Ella Records by ELLA RECORDS 5 years ago 5 minutes, 17 seconds 6,723,427 views",ELLA RECORDS,6723427,6732328,8901
691,"Nahom Yohannes - Interview and Live concert - Ella Show - Trailer by ELLA RECORDS 5 years ago 2 minutes, 9 seconds 116,747 views",ELLA RECORDS,116747,116867,120
692,"Welcome to Ella Tv !!! Subscribe by ELLA RECORDS 5 years ago 6 seconds 24,536 views",ELLA RECORDS,24536,24537,1
693,"Temesigen Fishaye (Temawi) - Raymona | ራይሞና - New Eritrean Music 2016 - Ella Records by ELLA RECORDS 5 years ago 5 minutes, 49 seconds 38,883 views",ELLA RECORDS,38883,38900,17
694,"Feven Redae - Ankseni | ኣንክሰኒ - New Eritrean Music 2016 - Ella Records by ELLA RECORDS 5 years ago 6 minutes, 12 seconds 65,878 views",ELLA RECORDS,65878,65898,20
695,"Robel Hadish - Aytihaziley | ኣይትሓዝለይ - New Eritrean Music 2016 - Ella Records by ELLA RECORDS 5 years ago 7 minutes, 49 seconds 117,562 views",ELLA RECORDS,117562,117694,132
696,"Millen Hailu - Afikirika Kealo | ኣፍቂርካ ክኣሎ - New Eritrean Music 2016- Ella Records- Offical Trailer by ELLA RECORDS 5 years ago 34 seconds 76,851 views",ELLA RECORDS,76851,76875,24
697,"Michael Abraham (Shetu) - Beal Beles | በዓል በለስ - New Eritrean Music 2016 - Ella Records by ELLA RECORDS 5 years ago 6 minutes, 19 seconds 65,118 views",ELLA RECORDS,65118,65186,68
698,"Yoseph Tsegay (Josi)- Wintana | ዊንታና - New Eritrean Music 2016- Ella Records by ELLA RECORDS 5 years ago 7 minutes, 29 seconds 82,655 views",ELLA RECORDS,82655,82661,6
699,"Million Eshetu - Kexaliyeki'ye | ከጻልየኪ እየ- New Eritrean Music 2016- Ella Records by ELLA RECORDS 5 years ago 7 minutes, 19 seconds 475,552 views",ELLA RECORDS,475552,475922,370
700,"Daniel T/mariam (Awulietay) - Nieni Zendo | ንዕኒ ዘንዶ - New Eritrean Music 2016 - Ella Records by ELLA RECORDS 5 years ago 5 minutes, 10 seconds 93,024 views",ELLA RECORDS,93024,93060,36
701,"Micheal G/kiristos (Nikiya)- Mezhalitey | መዝሓሊተይ - New Eritrean Music 2016 - Ella Records by ELLA RECORDS 5 years ago 6 minutes, 21 seconds 33,035 views",ELLA RECORDS,33035,33035,0
702,"Over 10 (TEN) - New Eritrean Music Clip 2016  - coming soon on- Ella Records by ELLA RECORDS 5 years ago 45 seconds 6,225 views",ELLA RECORDS,6225,6226,1
703,"Gujle Bahli Hidri - Zikri alona | ዝኽሪ ኣሎና - New Eritrean Music 2016 - Ella Records by ELLA RECORDS 5 years ago 4 minutes, 53 seconds 122,125 views",ELLA RECORDS,122125,122143,18
704,"Millen Hailu - Mejemerya Fikri | መጀመርያ ፍቕሪ - New Eritrean Music 2016 - Ella Records by ELLA RECORDS 5 years ago 3 minutes, 32 seconds 364,273 views",ELLA RECORDS,364273,364617,344
705,"Robel Luel   - Egbetey | ዕግበተይ - New Eritrean Music 2016 - Ella Records by ELLA RECORDS 5 years ago 5 minutes, 59 seconds 97,288 views",ELLA RECORDS,97288,97300,12
706,"Kesete Hadera (Wedi Hadera) - Aytgshi |ኣይትግሺ - New Eritrean Music 2016 - Ella Records by ELLA RECORDS 5 years ago 7 minutes, 20 seconds 83,358 views",ELLA RECORDS,83358,83369,11
707,"Meron Fshaye - Tselayki Ynbae | ጸላኢኺ ይንባዕ - New Eritrean Music 2016 - Ella Records by ELLA RECORDS 5 years ago 5 minutes, 38 seconds 105,049 views",ELLA RECORDS,105049,105100,51
708,"Million Eshetu - Anafakit seeli | ኣናፋቒት ስእሊ- New Eritrean Music 2016- Ella Records by ELLA RECORDS 5 years ago 5 minutes, 57 seconds 111,012 views",ELLA RECORDS,111012,111056,44
709,"Aleksander Gebrengus (VanderB) Resikani Aytbeli ረሲዕካኒ ኣይትበሊ New Eritrean Music 2016 - Ella Records by ELLA RECORDS 5 years ago 6 minutes, 32 seconds 30,779 views",ELLA RECORDS,30779,30781,2
710,"Samuel Tekie(Shabay) - Amore | ኣሞረ - New Eritrean Music 2016 - Ella Records by ELLA RECORDS 5 years ago 4 minutes, 58 seconds 15,026 views",ELLA RECORDS,15026,15029,3
711,"Meron Tesfamichael - Kber Eluni | ክበር ኢሉኒ - New Eritrean Music 2016 - Ella Records by ELLA RECORDS 5 years ago 5 minutes, 55 seconds 60,163 views",ELLA RECORDS,60163,60167,4
712,"Alexsander Kahsay (Sandro) - Tebarabire | ተበራቢረ - New Eritrean Music 2016 - Ella Records by ELLA RECORDS 5 years ago 7 minutes, 42 seconds 1,103,135 views",ELLA RECORDS,1103135,1107809,4674
713,"Sirak (Afro) feat Steve Colombo - Monaliza | ሞናሊዛ - New Eritrean Music 2016- Ella Records by ELLA RECORDS 5 years ago 4 minutes, 34 seconds 59,602 views",ELLA RECORDS,59602,59613,11
714,"Danait Afewerki - Wedeboy Zemede | ወደቦይ ዘመደ - New Eritrean Music 2016- Ella Records by ELLA RECORDS 5 years ago 4 minutes, 44 seconds 64,357 views",ELLA RECORDS,64357,64364,7
715,"Abraham Alem (Abi) - Mekununey | መቑንነይ - New Eritrean Music 2016 - Ella Records by ELLA RECORDS 5 years ago 6 minutes, 11 seconds 7,780,648 views",ELLA RECORDS,7780648,7806782,26134
716,"Sami Ezra - Ata Aytibelini | ኣታ ኣይቲበሊኒ - New Eritrean Music 2016 - Ella Records {Hot Tigrigna Music} by ELLA RECORDS 5 years ago 7 minutes, 5 seconds 2,304,889 views",ELLA RECORDS,2304889,2305342,453
717,"Million Eshetu - Tikoni Do kemgele | ትኮኒ ዶ ከምገለ- New Eritrean Music 2016- Ella Records by ELLA RECORDS 5 years ago 7 minutes, 25 seconds 1,820,280 views",ELLA RECORDS,1820280,1821656,1376
718,"Sami Ezra - Ata Aytibelini | ኣታ ኣይትበሊኒ -  New Eritrean Music 2016 - Advert- Ella Records by ELLA RECORDS 5 years ago 38 seconds 13,258 views",ELLA RECORDS,13258,13262,4
719,"Double G - Gold - New Nigerian Music 2016- (New Hip Pop Music 2016 ) -African Rapper by ELLA RECORDS 5 years ago 3 minutes, 29 seconds 230,101 views",ELLA RECORDS,230101,230101,0
720,"Eritrean Music 2016- Negassi Tesfamariam - Taesaki'diyu -New Eritrean Music 2016-Ella Records by ELLA RECORDS 5 years ago 5 minutes, 50 seconds 129,137 views",ELLA RECORDS,129137,129366,229
721,"Abraham Alem (Abi) - Mequnney | መቑንነይ - official Video trailer- New Eritrean Music 2016-Ellarecords by ELLA RECORDS 5 years ago 36 seconds 18,372 views",ELLA RECORDS,18372,18378,6
722,"Eritrean Music 2016 - Million Isshetu- Seb Ydeli | ሰብ ይደሊ - New Eritrean Music 2016 - Ella Records by ELLA RECORDS 5 years ago 6 minutes, 40 seconds 222,269 views",ELLA RECORDS,222269,222390,121
723,"Eritrean Music 2016- Mihretab Gebru - Arkeni |ዓርከኒ - New Eritrean Music 2016- Ella Records by ELLA RECORDS 5 years ago 6 minutes, 1 second 251,254 views",ELLA RECORDS,251254,251638,384
724,"Eritrean Music 2016 - DVD Album Release- Million Isshetu- Seb ydeli- New Eritrean Album 2016- by ELLA RECORDS 5 years ago 2 minutes, 41 seconds 55,514 views",ELLA RECORDS,55514,55516,2
725,"Eritrea movie 2015 -Yasin Omer- Bilen Hiwet | ብሌን ሂወት- New Eritrean/Ethiopian Movie 2015(Part 2) by ELLA RECORDS 5 years ago 1 hour, 5 minutes 274,013 views",ELLA RECORDS,274013,274064,51
726,"Eritrean Music 2016- Nebay Issak (Nebi) - Emnet | እምነት - New Eritrean Music 2016- Ella Records by ELLA RECORDS 5 years ago 6 minutes, 4 seconds 160,558 views",ELLA RECORDS,160558,160784,226
727,"Ruhus beal eid kab Ella Records Team- ርሑስ በዓል ዒድ ካብ ኤላ ሬኮርድስ ኣባላት- Ella Advert by ELLA RECORDS 5 years ago 2 minutes, 45 seconds 7,084 views",ELLA RECORDS,7084,7084,0
728,"Eritrean Music 2016 - Denden TekleMichael - Bkedamay - ብቐዳማይ - New Tigrigna Music 2016- Ella Records by ELLA RECORDS 5 years ago 7 minutes, 28 seconds 240,358 views",ELLA RECORDS,240358,240394,36
729,"Eritrean Music 2016 - Millen Hailu - Nifato Ena - ንፋቶ ኢና - New Tigrigna  Music 2016 - Ella Records by ELLA RECORDS 5 years ago 5 minutes, 42 seconds 2,032,547 views",ELLA RECORDS,2032547,2035596,3049
730,"Eritrean Music 2016 - Yohannes Habtiab (Wedi Kerin) - Misay Kuni - ምሳይ ኩኒ - New Tigrigna Music 2016 by ELLA RECORDS 5 years ago 6 minutes, 41 seconds 2,115,331 views",ELLA RECORDS,2115331,2116344,1013
731,"Eritrean Music 2016- Filmon Erimias (Mandela)- Newuri | ነዉሪ - New Eritrean Music 2016- Ella Records by ELLA RECORDS 5 years ago 4 minutes 56,750 views",ELLA RECORDS,56750,56754,4
732,"Eritrean Music 2016- Gual Kentiba | ጓል ከንቲባ - Tesfu Kiflay- New Eritrean music 2016 by ELLA RECORDS 5 years ago 5 minutes, 29 seconds 98,157 views",ELLA RECORDS,98157,98185,28
733,"Eritrean Music 2016- Tomas Daynom (Grow) - Ayaminin ye | ኣይኣምንንየ  - New Eritrean Music 2016 by ELLA RECORDS 5 years ago 6 minutes, 44 seconds 95,517 views",ELLA RECORDS,95517,95526,9
734,"Eritrean Music 2016- Haben Negasi- Sehaki | ሰሓቅኪ - New Eritrean Music 2016 by ELLA RECORDS 5 years ago 7 minutes, 13 seconds 119,133 views",ELLA RECORDS,119133,119136,3
735,"Nahom Yohannes - Tekolifki | ተኾሊፍኪ - New Eritrean Music 2016 - Ella Records by ELLA RECORDS 5 years ago 6 minutes 1,221,928 views",ELLA RECORDS,1221928,1222850,922
736,"Eritrean Music 2016 - Nahom Yohannes (Meste) - Zeyedbti | ዘይእድብቲ - New Eritrean Music 2016 by ELLA RECORDS 5 years ago 7 minutes, 14 seconds 6,866,746 views",ELLA RECORDS,6866746,6875720,8974
737,"Eritrean song 2016 - Bajet Mehari - Fkri Keygudae | ፍቕሪ ከይጉዳእ - New Eritrean Music 2016 by ELLA RECORDS 5 years ago 6 minutes, 21 seconds 732,109 views",ELLA RECORDS,732109,733074,965
738,"Eritrean Music 2016- Mengsteab G/gergsh -Kowwa | ኮዋ - New Eritrean music 2016 [Hot Kunama Music] by ELLA RECORDS 5 years ago 5 minutes, 3 seconds 169,465 views",ELLA RECORDS,169465,169570,105
739,"Eritrean song 2016 - Bajet Mehari - Ntehalale | ንተሓላለ- New Eritrean Music 2016 by ELLA RECORDS 5 years ago 5 minutes, 5 seconds 173,411 views",ELLA RECORDS,173411,173427,16
740,"Eritrean Music 2016- Temesgen Berhane(Zazu)-Wueletki | ዉዕለትኪ - New Eritrean Music 2016 by ELLA RECORDS 5 years ago 6 minutes, 44 seconds 16,921 views",ELLA RECORDS,16921,16928,7
741,"Eritrean Music 2016- Weldetinsae T/mariam- Kordebdeb | ኮርደብደብ - New Eritrean Music 2016 by ELLA RECORDS 5 years ago 6 minutes 51,677 views",ELLA RECORDS,51677,51681,4
742,"Eritrean Music 2016- Micheale Seyoum - Bmesta Keytgdei(Chil)- ብመስጣ ከይትግድዒ - New Eritrean Music 2016 by ELLA RECORDS 5 years ago 5 minutes, 55 seconds 103,213 views",ELLA RECORDS,103213,103235,22
743,"Eritrean Music 2016- Frezgi Kidanu- ሕርይቲ' ያ ንሳ | Hriti eya nsa- New Eritrean Music 2016 by ELLA RECORDS 5 years ago 6 minutes, 45 seconds 108,759 views",ELLA RECORDS,108759,108770,11
744,"Eritrean Music 2016- Amet Yedgemena | ዓመት ይድገመና- Mussie Hadsh | ሙሴ ሓድሽ- New Eritrean Music 2016 by ELLA RECORDS 5 years ago 7 minutes, 10 seconds 82,135 views",ELLA RECORDS,82135,82151,16
745,"Yohannes Habteab | Wedi Kerin - Misay Kuni |ምሳይ ኩኒ- official Video trailer- New Eritrean Music 2016 by ELLA RECORDS 5 years ago 1 minute, 12 seconds 111,904 views",ELLA RECORDS,111904,111942,38
746,"Eritrean Music 2016- Amanuel (WediMare) - Ane do Ykewun | ኣነ'ዶ ይኸዉን - New Eritrean Music 2016 by ELLA RECORDS 5 years ago 7 minutes, 31 seconds 122,435 views",ELLA RECORDS,122435,122503,68
747,"Eritrean Music 2016- Nebay Issak (Nebi) - Fekar | ፈቃር  - New Eritrean Music 2016 by ELLA RECORDS 5 years ago 6 minutes, 45 seconds 320,086 views",ELLA RECORDS,320086,320411,325
748,"Eritrean Music 2016- Sabur Abdu-Muna | ሙና - New Eritrean Music 2016 (Remix) by ELLA RECORDS 5 years ago 8 minutes, 11 seconds 2,383,127 views",ELLA RECORDS,2383127,2397987,14860
749,"Eritrean Music 2016- Dilo Bdilo | ድሎ ብድሎ - Abraham T/mariam(Abimo) New Eritrean Music 2016 by ELLA RECORDS 5 years ago 5 minutes, 27 seconds 212,826 views",ELLA RECORDS,212826,212832,6
750,"Eritrean Music 2016- Dannata gooda | ዳናታ ጎዳ -  Mengsteab G/gergsh- New Eritrean  Kunama music 2016 by ELLA RECORDS 5 years ago 5 minutes, 25 seconds 301,463 views",ELLA RECORDS,301463,302095,632
751,"Eritrean music 2016 - Awet Hagos - Deki Adey | ደቂ ዓደይ - New Eritrean Music 2016 by ELLA RECORDS 5 years ago 6 minutes, 25 seconds 183,595 views",ELLA RECORDS,183595,183679,84
752,"Eritrean Music 2016- Wedi Mama - Mama | ማማ - New Eritrean music 2016 by ELLA RECORDS 5 years ago 6 minutes, 24 seconds 151,747 views",ELLA RECORDS,151747,152324,577
753,"Eritrean music 2016 - Mulugeta Weldetisae- Sileki Ele | ሲለኺ'ለ - New Eritrean Music 2016 by ELLA RECORDS 5 years ago 6 minutes, 41 seconds 33,075 views",ELLA RECORDS,33075,33077,2
754,"Eritrean Music 2016 - Efrem T/michael- Bedalitey | በዳሊተይ - New Eritrean Music 2016 by ELLA RECORDS 5 years ago 6 minutes, 12 seconds 35,063 views",ELLA RECORDS,35063,35067,4
755,"New Eritrean Music 2016 - Habtiab Teame - Negesitat Ena - ነገስታት ኢና by ELLA RECORDS 6 years ago 5 minutes, 20 seconds 23,457 views",ELLA RECORDS,23457,23462,5
756,"Eritrean Music 2016 - Tewodros Gebremedhn  -AYTESTEMASLI | ኣይተስተማስሊ - New Eritrean Music 2016 by ELLA RECORDS 6 years ago 5 minutes, 29 seconds 101,645 views",ELLA RECORDS,101645,101670,25
757,"Eritrean Music 2016 - Sami Mebrahtom - Fkri Aytelmekn | ፍቕሪ ኣይጠለመክን - New Eritrean Music 2016 by ELLA RECORDS 6 years ago 6 minutes, 24 seconds 287,999 views",ELLA RECORDS,287999,288168,169
758,"New Eritrean Music 2016 - Kibrom H/mariam (kobra) feat Zersenay weldu - Gal Hagereseb | ጓል ሃገረሰብ | by ELLA RECORDS 6 years ago 6 minutes, 38 seconds 115,915 views",ELLA RECORDS,115915,115933,18
759,"Eritrean music 2016 - Solomon Tekliya (Mafa) - Hiray Konka ba keybuluni - New Eritrean Music 2016 by ELLA RECORDS 6 years ago 7 minutes, 19 seconds 144,101 views",ELLA RECORDS,144101,144114,13
760,"Andit Okbay | Beka | በቃ (Official Audio Video) by ELLA RECORDS 6 years ago 7 minutes, 5 seconds 578,844 views",ELLA RECORDS,578844,579704,860
761,"Andit Okbay |  Dehay Sidedi | ደሃይ ሲደዲ(Official Audio Video) by ELLA RECORDS 6 years ago 7 minutes, 10 seconds 1,058,020 views",ELLA RECORDS,1058020,1059234,1214
762,"Andit Okbay | Yiqre beli | ይቅረ በሊ(Official Audio Video) by ELLA RECORDS 6 years ago 7 minutes, 5 seconds 329,996 views",ELLA RECORDS,329996,330353,357
763,"Andit Okbay | Sebey | ሰበይ (Official Audio Video) by ELLA RECORDS 6 years ago 7 minutes, 14 seconds 344,813 views",ELLA RECORDS,344813,345302,489
764,"New Eritrean Comedy 2016 - Hagos Suzinino - lete Kristina | ለተ ክሪስቲና - Eritrean Movie 2016 by ELLA RECORDS 6 years ago 10 minutes, 8 seconds 1,495,972 views",ELLA RECORDS,1495972,1498378,2406
765,"Eritrea- Yasin Omer - Bilen Hiwet | ብሌን ሂወት- New Eritrean Movie 2015 part 1 New Ethiopian Movie 2015 by ELLA RECORDS 6 years ago 1 hour 321,085 views",ELLA RECORDS,321085,321167,82
766,"Eritrean music 2016 - Kibrom H/maryam - Arki Hiwetey | ዓርኪ ሂወተይ - New Eritrean Music 2016 by ELLA RECORDS 6 years ago 6 minutes, 42 seconds 121,692 views",ELLA RECORDS,121692,121756,64
767,"New Eritrean Comedy 2015-Suzinino  - Lete Cristiana | ለተ ክሪስትና -official trailer by ELLA RECORDS 6 years ago 5 minutes, 38 seconds 178,104 views",ELLA RECORDS,178104,178146,42
768,"New Eritrean Movie 2015 - Bilen Hiwet |ብሌን ሂወት-Yasin Omer-Coming soon! by ELLA RECORDS 6 years ago 5 minutes, 39 seconds 24,450 views",ELLA RECORDS,24450,24451,1
769,"Eritrea - Filmon Gebrehiwet-Tim Yihsheki | ቲም ይሕሸኪ - New Eritrean Music 2015 by ELLA RECORDS 6 years ago 5 minutes, 25 seconds 20,861 views",ELLA RECORDS,20861,20869,8
770,"Eritrean music - Andit Okbay - Zesani | ዘሳኒ - New Eritrean music 2015 (Official audio) by ELLA RECORDS 6 years ago 7 minutes, 26 seconds 292,943 views",ELLA RECORDS,292943,293324,381
771,"Eritrean music - Andit Okbay - Sanditey | ሳንዲተይ - New Eritrean music 2015 (Official audio) by ELLA RECORDS 6 years ago 7 minutes, 40 seconds 412,736 views",ELLA RECORDS,412736,413898,1162
772,"Eritrea - Ambesa Zemere - Siye Kumeta | ስየ ቁመታ - New Eritrean Music 2015 by ELLA RECORDS 6 years ago 6 minutes, 46 seconds 32,036 views",ELLA RECORDS,32036,32042,6
773,"New Eritrean Movie 2015 - Mahxi | ማህጺ - Part 5 Last Part - (Official Eritrean movie) by ELLA RECORDS 6 years ago 19 minutes 147,722 views",ELLA RECORDS,147722,147866,144
774,"Short Message from Hagos Weldegebriel (Suzinino) 2015 by ELLA RECORDS 6 years ago 4 minutes, 49 seconds 328,648 views",ELLA RECORDS,328648,328678,30
775,"New Eritrean Movie 2015 - Mahxi | ማህጺ - Part 4 - (Official Eritrean movie) by ELLA RECORDS 6 years ago 15 minutes 184,404 views",ELLA RECORDS,184404,184544,140
776,"Ella Entertainment by ELLA RECORDS 6 years ago 4 minutes, 54 seconds 30,422 views",ELLA RECORDS,30422,30422,0
777,"New Eritrean Movie 2015 - Mahxi | ማህጺ - Part 3 - (Official Eritrean movie) by ELLA RECORDS 6 years ago 28 minutes 236,871 views",ELLA RECORDS,236871,237029,158
778,"New Eritrean Movie 2015 - Mahxi | ማህጺ - Part 2 - (Official Eritrean movie) by ELLA RECORDS 6 years ago 30 minutes 292,486 views",ELLA RECORDS,292486,292651,165
779,"New Eritrean music 2015 -Mehazay| Biniam W/mariam(feat Yhdega) -(Official Audio Video) by ELLA RECORDS 6 years ago 5 minutes, 3 seconds 11,727 views",ELLA RECORDS,11727,11732,5
780,"New Eritrean Movie 2015 - Mahxi | ማህጺ -  (Official Eritrean movie) by ELLA RECORDS 6 years ago 30 minutes 591,226 views",ELLA RECORDS,591226,591587,361
781,"New eritrean movie 2015 Mahxi Official Trailer #1  | ማህጺ 2015 by ELLA RECORDS 6 years ago 3 minutes, 5 seconds 71,808 views",ELLA RECORDS,71808,71815,7
782,"New Eritrean Movie 2015 | Movie Advert | Mahxi | ማህጺ by ELLA RECORDS 6 years ago 1 minute, 52 seconds 45,448 views",ELLA RECORDS,45448,45461,13
783,"New Nigerian Music 2016 - XSQUAD - BIG BUM BUM (Official Video) AfroBeat 2016 [West African music] by ELLA RECORDS 6 years ago 4 minutes, 47 seconds 24,097 views",ELLA RECORDS,24097,24103,6
784,"New Eritrean music 2015 | Biniam W/mariam-Kilte Chafat -(Official Audio Video) ክልተ ጫፋት by ELLA RECORDS 6 years ago 4 minutes, 15 seconds 7,122 views",ELLA RECORDS,7122,7127,5
785,"New Eritrean music 2015 | Biniam W/mariam-Adey-(Official Audio Video) by ELLA RECORDS 6 years ago 5 minutes, 48 seconds 4,950 views",ELLA RECORDS,4950,4954,4
786,"Eritrea Music 2015- Sami Ezra - Betey | ቤተይ - (Official video) New Eritrean Music 2015 by ELLA RECORDS 6 years ago 4 minutes, 47 seconds 298,543 views",ELLA RECORDS,298543,298662,119
787,"New Eritrean music 2012-Sami ft Dr.-Jose- Chameleon - Beauty by ELLA RECORDS 6 years ago 3 minutes, 14 seconds 12,994 views",ELLA RECORDS,12994,13016,22
788,"New Eritrean- Ugandan non stop music- Sami Ezira 2014 (Official music video) by ELLA RECORDS 6 years ago 26 minutes 29,058 views",ELLA RECORDS,29058,29069,11
789,"New Eritrean- Ugandan music 2014- Sami- Long time by ELLA RECORDS 7 years ago 4 minutes, 22 seconds 241,423 views",ELLA RECORDS,241423,241789,366
790,"New Eritrean- Ugandan music- Sami- Feat Jackie 2011- For All  time by ELLA RECORDS 7 years ago 4 minutes, 23 seconds 70,965 views",ELLA RECORDS,70965,71159,194
791,"New Eritrean-Ugandan music- Sami Ezra 2015- Let me know by ELLA RECORDS 7 years ago 4 minutes, 6 seconds 92,067 views",ELLA RECORDS,92067,92167,100
792,"New Eritrean-Ugandan music-2013- Sami Ezra-Fitawey by ELLA RECORDS 7 years ago 5 minutes, 51 seconds 114,626 views",ELLA RECORDS,114626,114823,197
793,"New Eritrean- Ugandan music 2011- Sami feat -Dr.Jose Chameleone -KEBEBUWA by ELLA RECORDS 7 years ago 4 minutes, 30 seconds 579,018 views",ELLA RECORDS,579018,582343,3325
794,"NEW ERITREAN CLASSICAL MUSIC 2015 by ELLA RECORDS 7 years ago 8 minutes, 3 seconds 110,465 views",ELLA RECORDS,110465,110573,108
