,Posts,Channel,Views_03/03,Views_03/12,view_delta
0,"EBC Prime Minister Hailemariam Desalegn has Resigned ሰበር ዜና  ጠ ሚ ኃይለማርያም ደሳለኝ ከኢህአዴግ ሊቀመንበርነትና ከጠቅላይ by ethio channel 4 years ago 7 minutes, 22 seconds 6,484 views",ethio channel,6484,6484,0
1,"Natnael Tesfaye new 2014 music ""Dancha"" by ethio channel 7 years ago 5 minutes, 48 seconds 399 views",ethio channel,399,399,0
2,"Fikadu Tasew (Aze) - Weyne-New 2014 Amharic Song by ethio channel 7 years ago 4 minutes, 22 seconds 1,956 views",ethio channel,1956,1963,7
3,"Kaleb Araya (Afarye Haye) 2014 New Ethiopian Music by ethio channel 7 years ago 9 minutes 7,843 views",ethio channel,7843,7846,3
4,"Siti Pawlos  Lusi  Hot New Ethiopian Music  2014 Wey Na Na, by ethio channel 7 years ago 4 minutes, 18 seconds 963 views",ethio channel,963,963,0
5,"New 2014 Ethiopian Music - When you smile by Sossi by ethio channel 8 years ago 4 minutes, 45 seconds 1,094 views",ethio channel,1094,1094,0
6,"New 2014 Ethiopian Music - (ማንዴላ) Mandela - Micky Zerihun (micky z) by ethio channel 8 years ago 4 minutes, 44 seconds 1,121 views",ethio channel,1121,1122,1
7,"AKURI DEGEFA -ENKA TEBYE ETHIOPIAN 2005 NEW MUSIC by ethio channel 8 years ago 4 minutes, 31 seconds 1,659 views",ethio channel,1659,1662,3
8,"Tsehaye Welde and Anteneh Worku-Yibka sidet, New 2013 song by ethio channel 8 years ago 4 minutes, 19 seconds 1,999 views",ethio channel,1999,1999,0
9,"Demelash Niguse (Deme Lula) VCD Advert by ethio channel 8 years ago 1 minute, 8 seconds 2,116 views",ethio channel,2116,2116,0
10,"Temesgen G/Egziabher live concert in Berut by ethio channel 8 years ago 7 minutes, 48 seconds 131,983 views",ethio channel,131983,132052,69
11,"""Tilahun Elfeneh "" New 2013 Commedy Music ""Ancherecheregn"" by ethio channel 8 years ago 6 minutes, 25 seconds 4,506 views",ethio channel,4506,4508,2
12,"atklti by ethio channel 8 years ago 5 minutes, 24 seconds 1,126 views",ethio channel,1126,1126,0
13,"Bezawit Getachew-New 2005 - Shelmegn-(Official Music Video) by ethio channel 9 years ago 4 minutes, 59 seconds 8,125 views",ethio channel,8125,8136,11
14,"Tewodros Demisse (Teddy Fiesta) (Ale Yemilew) (Official Music Video) by ethio channel 9 years ago 5 minutes, 4 seconds 495 views",ethio channel,495,495,0
15,"ATAKLTI AMARE - CHAHEMAYE( NEW DEC 2012 release) by ethio channel 9 years ago 5 minutes, 35 seconds 10,981 views",ethio channel,10981,11024,43
16,"Tewodros Demisse (Teddy Fiesta)-New 2012- (Ye-Wello Lije) (Official Music Video) by ethio channel 9 years ago 5 minutes, 6 seconds 1,683 views",ethio channel,1683,1683,0
17,"Selamawit Gebru New-2012 - Sew Mewded-(Official Music Video) by ethio channel 9 years ago 11 minutes, 5 seconds 2,379 views",ethio channel,2379,2379,0
18,"Bole Senior Secondary High School 2012's Prom King and Queen by ethio channel 9 years ago 7 minutes, 54 seconds 26,569 views",ethio channel,26569,26603,34
19,"Meaza Alemseged New 2012 - Nona (Official Music Video) by ethio channel 9 years ago 5 minutes, 8 seconds 1,170 views",ethio channel,1170,1171,1
20,"Bole Senior Secondary High School Prom Night June 11, 2012 @ Club Voltage by ethio channel 9 years ago 2 minutes, 52 seconds 11,149 views",ethio channel,11149,11161,12
21,"Gbilgn Nuradis Seid Jarigama 2013 NEW ETHIOPIAN MUSIC by Ethio melodies 8 years ago 6 minutes, 12 seconds 605,102 views",Ethio Melodies,605102,606714,1612
22,"Gbilgn Nuradis Jarigam by Ethio melodies 8 years ago 3 minutes, 25 seconds 15,616 views",Ethio Melodies,15616,15711,95
23,"From Risk to Action - Part 4 of 4 by EthioVideos.Com 14 years ago 9 minutes, 45 seconds 21,697 views",EthioVideos.Com,21697,21709,12
24,"From Risk to Action - Part 3 of 4 by EthioVideos.Com 14 years ago 9 minutes, 46 seconds 15,828 views",EthioVideos.Com,15828,15837,9
25,"From Risk to Action - Part 2 of 4 by EthioVideos.Com 14 years ago 9 minutes, 53 seconds 24,797 views",EthioVideos.Com,24797,24802,5
26,"From Risk to Action - Part 1 of 4 by EthioVideos.Com 14 years ago 9 minutes, 57 seconds 131,673 views",EthioVideos.Com,131673,131677,4
27,"Breaking the Silence - Part 3 of 3 by EthioVideos.Com 14 years ago 7 minutes, 29 seconds 8,473 views",EthioVideos.Com,8473,8474,1
28,"Breaking the Silence - Part 2 of 3 by EthioVideos.Com 14 years ago 8 minutes, 38 seconds 14,847 views",EthioVideos.Com,14847,14848,1
29,"Breaking the Silence - Part 1 of 3 by EthioVideos.Com 14 years ago 9 minutes, 58 seconds 11,669 views",EthioVideos.Com,11669,11672,3
30,"Ethiopian Music - Birhanu Tezera ft. Tokchaw - Yambule by EthioVideos.Com 14 years ago 2 minutes 885,669 views",EthioVideos.Com,885669,886062,393
31,"Ethiopian Music - Mahlet Gebregiorgis - Beyney Terife by EthioVideos.Com 14 years ago 6 minutes, 22 seconds 1,149,794 views",EthioVideos.Com,1149794,1165573,15779
32,"Ethiopian Music - Amsal Mitiku - Zegeyebign by EthioVideos.Com 14 years ago 5 minutes, 31 seconds 222,759 views",EthioVideos.Com,222759,223674,915
33,"Ethiopian Music - Tadesse Alemu - Awde Amet by EthioVideos.Com 14 years ago 5 minutes, 39 seconds 496,034 views",EthioVideos.Com,496034,496099,65
34,"Ethiopian Music - Taddalaa Gammachuu - Raada Raadaa by EthioVideos.Com 14 years ago 5 minutes, 46 seconds 369,872 views",EthioVideos.Com,369872,370178,306
35,"Ethiopian Music - Semahegn Belew - Debot Enisra by EthioVideos.Com 14 years ago 5 minutes, 25 seconds 353,705 views",EthioVideos.Com,353705,354460,755
36,"Ethiopian Music - Hamelmal Abate - Enkuan Aderesachu by EthioVideos.Com 14 years ago 6 minutes, 39 seconds 504,892 views",EthioVideos.Com,504892,505021,129
37,"Ethiopian Music - Meskerem Alemayehu - Balawekuh Noro by EthioVideos.Com 14 years ago 5 minutes, 36 seconds 98,578 views",EthioVideos.Com,98578,98583,5
38,"Ethiopian Music - Juhar Imam - Yeselam Zemari by EthioVideos.Com 14 years ago 4 minutes, 46 seconds 207,026 views",EthioVideos.Com,207026,207053,27
39,"Ethiopian Music - Mary Abebe - Ahun New by EthioVideos.Com 14 years ago 5 minutes, 3 seconds 274,887 views",EthioVideos.Com,274887,274976,89
40,"Ethiopian Music - Zuryash Abyu - Ye Minjar Lej by EthioVideos.Com 14 years ago 6 minutes, 28 seconds 129,394 views",EthioVideos.Com,129394,129472,78
41,"Ethiopian Music - Fiker Addis Nekatibeb - Nama by EthioVideos.Com 14 years ago 6 minutes, 13 seconds 1,435,698 views",EthioVideos.Com,1435698,1439448,3750
42,"Ethiopian Music - Tadesse Alemu - Shir Bela by EthioVideos.Com 14 years ago 9 minutes, 11 seconds 212,567 views",EthioVideos.Com,212567,213753,1186
43,"Ethiopian Music - Derb Zenebe - Banchiw Mejen by EthioVideos.Com 14 years ago 5 minutes, 17 seconds 127,669 views",EthioVideos.Com,127669,127707,38
44,"Sambusa in 6 Easy Steps | Mills Kitchen by Ethiopian Music 1 year ago 7 minutes, 29 seconds 10,329 views",Ethiopian Music,10329,10512,183
45,"Kinfe Gebregergis - Timchiweni by Ethiopian Music 9 years ago 6 minutes, 17 seconds 57,270 views",Ethiopian Music,57270,57325,55
46,"Kinfe Gebregergis - Tilhit Kudadey by Ethiopian Music 9 years ago 5 minutes, 21 seconds 227,361 views",Ethiopian Music,227361,229878,2517
47,"Kinfe Gebregergis - Nihawet by Ethiopian Music 9 years ago 7 minutes, 31 seconds 467,903 views",Ethiopian Music,467903,470386,2483
48,"Kinfe Gebregergis - Lekiyoma by Ethiopian Music 9 years ago 7 minutes, 10 seconds 523,326 views",Ethiopian Music,523326,525874,2548
49,"Kinfe Gebregergis - Awda Amet by Ethiopian Music 9 years ago 8 minutes, 15 seconds 18,381 views",Ethiopian Music,18381,18400,19
50,"Kinfe Gebregergis - Amel by Ethiopian Music 9 years ago 6 minutes, 57 seconds 231,719 views",Ethiopian Music,231719,233402,1683
51,"Kinfe Gebregergis - Adi Anbesa by Ethiopian Music 9 years ago 6 minutes, 59 seconds 86,842 views",Ethiopian Music,86842,87828,986
52,"Reshad Kedir - Miriyamore by Ethiopian Music 9 years ago 6 minutes 72,713 views",Ethiopian Music,72713,73039,326
53,"Teka Asefa - Wegush by Ethiopian Music 9 years ago 4 minutes, 16 seconds 134,072 views",Ethiopian Music,134072,135446,1374
54,"Desalegn Mersha - Ayarsha by Ethiopian Music 9 years ago 5 minutes, 36 seconds 35,518 views",Ethiopian Music,35518,35712,194
55,"Demise Teka - Yewerema Gere by Ethiopian Music 9 years ago 5 minutes, 18 seconds 12,796 views",Ethiopian Music,12796,12816,20
56,"Demise Teka - Yehirm Hirm by Ethiopian Music 9 years ago 4 minutes, 28 seconds 45,440 views",Ethiopian Music,45440,46259,819
57,"Demise Teka - Yab Tadot Bet by Ethiopian Music 9 years ago 4 minutes, 49 seconds 62,300 views",Ethiopian Music,62300,63398,1098
58,"Demise Teka - Tiyarisina by Ethiopian Music 9 years ago 4 minutes, 41 seconds 67,737 views",Ethiopian Music,67737,68164,427
59,"Demise Teka - Nizigidina by Ethiopian Music 9 years ago 8 minutes, 10 seconds 80,696 views",Ethiopian Music,80696,81467,771
60,"Demise Teka - Betena Mura by Ethiopian Music 9 years ago 3 minutes, 59 seconds 66,090 views",Ethiopian Music,66090,66852,762
61,"Demise Teka - Arte Azemena by Ethiopian Music 9 years ago 5 minutes, 12 seconds 163,642 views",Ethiopian Music,163642,164964,1322
62,"Aragaw Belay - Abay Gudal by Ethiopian Music 9 years ago 6 minutes, 48 seconds 478,578 views",Ethiopian Music,478578,478868,290
63,"Yohanes Argaw (Joni) - Eski Ney Leyesh by Ethiopian Music 9 years ago 5 minutes, 15 seconds 27,203 views",Ethiopian Music,27203,27852,649
64,"Ashenafi Kebede - Lebura by Ethiopian Music 9 years ago 6 minutes, 6 seconds 30,294 views",Ethiopian Music,30294,30356,62
65,"Endashaw Negash - Feyay by Ethiopian Music 9 years ago 5 minutes, 24 seconds 11,909 views",Ethiopian Music,11909,12083,174
66,"Braahim Muhaamaadii - Rufaarufaaree by Ethiopian Music 9 years ago 5 minutes, 29 seconds 7,003 views",Ethiopian Music,7003,7031,28
67,"Ashenafi Bogale - Ayn Aykelekel by Ethiopian Music 9 years ago 4 minutes, 59 seconds 15,621 views",Ethiopian Music,15621,15676,55
68,"Ashu Guma - Untitled by Ethiopian Music 9 years ago 4 minutes, 59 seconds 6,777 views",Ethiopian Music,6777,6800,23
69,"Ashenafi Bogale - Goma by Ethiopian Music 9 years ago 4 minutes, 57 seconds 24,746 views",Ethiopian Music,24746,24844,98
70,"Agere Legesse - Ney Likasesh by Ethiopian Music 9 years ago 5 minutes, 49 seconds 16,888 views",Ethiopian Music,16888,16956,68
71,"Agere Legesse - Yefikir Awdina by Ethiopian Music 9 years ago 6 minutes, 18 seconds 17,425 views",Ethiopian Music,17425,17495,70
72,"Agere Legesse - Untitled 2 by Ethiopian Music 9 years ago 6 minutes, 17 seconds 16,793 views",Ethiopian Music,16793,16871,78
73,"Monika Sisay - Yewelo Lij by Ethiopian Music 9 years ago 6 minutes, 2 seconds 140,725 views",Ethiopian Music,140725,142322,1597
74,"Monika Sisay - Yaw Tegegntual by Ethiopian Music 9 years ago 6 minutes, 5 seconds 11,370 views",Ethiopian Music,11370,11478,108
75,"Monika Sisay - Shekshik by Ethiopian Music 9 years ago 6 minutes, 22 seconds 15,526 views",Ethiopian Music,15526,15781,255
76,"Monika Sisay - Libih Lela Lemdo by Ethiopian Music 9 years ago 6 minutes, 2 seconds 77,076 views",Ethiopian Music,77076,77748,672
77,"Monika Sisay - Fikre Temekakren by Ethiopian Music 9 years ago 5 minutes, 31 seconds 50,787 views",Ethiopian Music,50787,51394,607
78,"Dereje Haile ena Habte Mitiku - Min Yilishal by Ethiopian Music 9 years ago 4 minutes, 25 seconds 88,401 views",Ethiopian Music,88401,90930,2529
79,"Dereje Haile ena Habte Mitiku - Zemena by Ethiopian Music 9 years ago 1 minute, 59 seconds 14,471 views",Ethiopian Music,14471,14996,525
80,"Dereje Haile ena Habte Mitiku - Muyash by Ethiopian Music 9 years ago 3 minutes, 54 seconds 45,396 views",Ethiopian Music,45396,46754,1358
81,"Dereje Haile ena Habte Mitiku - Kiray by Ethiopian Music 9 years ago 4 minutes, 14 seconds 42,330 views",Ethiopian Music,42330,43675,1345
82,"Dereje Haile ena Habte Mitiku - Duba by Ethiopian Music 9 years ago 3 minutes, 42 seconds 61,886 views",Ethiopian Music,61886,63244,1358
83,"Dereje Haile ena Habte Mitiku - Arada by Ethiopian Music 9 years ago 3 minutes, 58 seconds 217,962 views",Ethiopian Music,217962,223901,5939
84,"Zelalem Atalay - Balageru by Ethiopian Music 9 years ago 6 minutes, 48 seconds 101,837 views",Ethiopian Music,101837,101966,129
85,"Wala - Kererto by Ethiopian Music 9 years ago 7 minutes, 9 seconds 325,704 views",Ethiopian Music,325704,325855,151
86,"Tizazu Ayalaw - Nay Alem by Ethiopian Music 9 years ago 3 minutes, 56 seconds 477,366 views",Ethiopian Music,477366,478163,797
87,"Shewaye Zewuale - Yizezegna by Ethiopian Music 9 years ago 5 minutes, 38 seconds 33,622 views",Ethiopian Music,33622,33669,47
88,"Miretu Bazu - Shilela by Ethiopian Music 9 years ago 4 minutes, 14 seconds 320,062 views",Ethiopian Music,320062,320222,160
89,"Miretu Bazu - Hedech Alu by Ethiopian Music 9 years ago 5 minutes, 37 seconds 75,407 views",Ethiopian Music,75407,75516,109
90,"Miretu Bazu - Hay Minamuna by Ethiopian Music 9 years ago 9 minutes, 26 seconds 579,468 views",Ethiopian Music,579468,582006,2538
91,"Meseret Jembera - Shilela by Ethiopian Music 9 years ago 5 minutes, 24 seconds 62,910 views",Ethiopian Music,62910,62940,30
92,"Meseret Jembera - Kererto by Ethiopian Music 9 years ago 5 minutes, 32 seconds 49,275 views",Ethiopian Music,49275,49305,30
93,"Meseret Jembera - Kererto 2 by Ethiopian Music 9 years ago 6 minutes, 6 seconds 116,900 views",Ethiopian Music,116900,116979,79
94,"Meseret Jembera - Gondar by Ethiopian Music 9 years ago 5 minutes, 42 seconds 189,928 views",Ethiopian Music,189928,190519,591
95,"Kasahun Werkneh - Shilela by Ethiopian Music 9 years ago 6 minutes, 9 seconds 155,717 views",Ethiopian Music,155717,155808,91
96,"Teshome Wolde - Yeshewa Alemena by Ethiopian Music 9 years ago 5 minutes, 17 seconds 19,822 views",Ethiopian Music,19822,19982,160
97,"Fikiraddis Nekatibeb - Sabalew by Ethiopian Music 9 years ago 6 minutes, 10 seconds 53,652 views",Ethiopian Music,53652,53899,247
98,"Tadese Abraha - Muna by Ethiopian Music 9 years ago 5 minutes, 34 seconds 10,923 views",Ethiopian Music,10923,11013,90
99,"Demere Legesse - Kotu Malo by Ethiopian Music 9 years ago 6 minutes, 53 seconds 59,856 views",Ethiopian Music,59856,60094,238
100,"Meseret Belete - Emamu Geday by Ethiopian Music 9 years ago 4 minutes, 45 seconds 41,148 views",Ethiopian Music,41148,41671,523
101,"Fasil Demoz - Bilakem by Ethiopian Music 9 years ago 8 minutes, 22 seconds 133,477 views",Ethiopian Music,133477,133930,453
102,"Adane Teka - Biharesebachena by Ethiopian Music 9 years ago 4 minutes, 45 seconds 84,078 views",Ethiopian Music,84078,84259,181
103,"Semahegn Belew - Balageru by Ethiopian Music 9 years ago 7 minutes, 27 seconds 98,193 views",Ethiopian Music,98193,99118,925
104,"Derege Degefaw - Altemechednam by Ethiopian Music 9 years ago 6 minutes, 58 seconds 8,880 views",Ethiopian Music,8880,8922,42
105,"Metseba Milinyem by Ethiopian Music 9 years ago 8 minutes, 17 seconds 961 views",Ethiopian Music,961,962,1
106,"Muchay Zerega by Ethiopian Music 9 years ago 6 minutes, 26 seconds 2,357 views",Ethiopian Music,2357,2365,8
107,"Begu by Ethiopian Music 9 years ago 9 minutes, 6 seconds 2,888 views",Ethiopian Music,2888,2900,12
108,"Tadese Alemu - Shir Bela by Ethiopian Music 9 years ago 10 minutes, 24 seconds 5,959 views",Ethiopian Music,5959,6142,183
109,"Tadese Alemu - Sela by Ethiopian Music 9 years ago 7 minutes, 45 seconds 2,646 views",Ethiopian Music,2646,2664,18
110,"Tadese Alemu - Misha Misho by Ethiopian Music 9 years ago 6 minutes, 16 seconds 6,131 views",Ethiopian Music,6131,6261,130
111,"Tadese Alemu - Goje Melegnaw by Ethiopian Music 9 years ago 7 minutes, 11 seconds 16,939 views",Ethiopian Music,16939,17387,448
112,"Tadese Alemu - Eyamaru Gela by Ethiopian Music 9 years ago 8 minutes, 54 seconds 1,693 views",Ethiopian Music,1693,1701,8
113,"Tadese Alemu - Erikum by Ethiopian Music 9 years ago 6 minutes, 37 seconds 7,603 views",Ethiopian Music,7603,7658,55
114,"Tadese Alemu - Emo Yagurasew by Ethiopian Music 9 years ago 6 minutes, 11 seconds 24,844 views",Ethiopian Music,24844,25090,246
115,"Tadese Alemu - Awdamet by Ethiopian Music 9 years ago 5 minutes, 34 seconds 4,323 views",Ethiopian Music,4323,4456,133
116,"Tadese Alemu - Arada by Ethiopian Music 9 years ago 7 minutes, 12 seconds 3,684 views",Ethiopian Music,3684,3852,168
117,"Tadese Alemu - Alamano by Ethiopian Music 9 years ago 6 minutes, 6 seconds 13,902 views",Ethiopian Music,13902,13972,70
118,"Endalekachew  Yeneyhun (2Pac) - Kwas by Ethiopian Music 9 years ago 6 minutes, 21 seconds 18,037 views",Ethiopian Music,18037,18231,194
119,"Endalekachew  Yeneyhun (2Pac) - Masiko by Ethiopian Music 9 years ago 6 minutes, 47 seconds 23,196 views",Ethiopian Music,23196,23370,174
120,"Endalekachew  Yeneyhun (2Pac) - Untitled by Ethiopian Music 9 years ago 5 minutes, 47 seconds 5,178 views",Ethiopian Music,5178,5283,105
121,"Mudade - Gasa by Ethiopian Music 9 years ago 4 minutes, 50 seconds 2,272 views",Ethiopian Music,2272,2286,14
122,"Zuriyash Abiyu - Arada by Ethiopian Music 9 years ago 7 minutes, 55 seconds 2,128 views",Ethiopian Music,2128,2137,9
123,"Tigabu Chernet - Balageru by Ethiopian Music 9 years ago 5 minutes, 7 seconds 2,041 views",Ethiopian Music,2041,2049,8
124,"Tigabu Chernet - Zew Zew by Ethiopian Music 9 years ago 3 minutes, 56 seconds 2,815 views",Ethiopian Music,2815,2828,13
125,"Teferi - Lembo (Sidamo) by Ethiopian Music 9 years ago 4 minutes, 5 seconds 2,468 views",Ethiopian Music,2468,2479,11
126,"Tigabu Chernet - Agewenga by Ethiopian Music 9 years ago 4 minutes, 12 seconds 1,585 views",Ethiopian Music,1585,1588,3
127,"Melaku Chachisa - Erikuma by Ethiopian Music 9 years ago 4 minutes, 57 seconds 3,426 views",Ethiopian Music,3426,3458,32
128,"Fasil Demewoz - Yewesawa by Ethiopian Music 9 years ago 5 minutes, 18 seconds 9,241 views",Ethiopian Music,9241,9257,16
129,"Jimi Wedera Birhanu - Desa Lay by Ethiopian Music 9 years ago 4 minutes, 7 seconds 9,981 views",Ethiopian Music,9981,10076,95
130,"Abonesh Adinew - Guragigna by Ethiopian Music 9 years ago 4 minutes, 19 seconds 75,004 views",Ethiopian Music,75004,75459,455
131,"Fasil Demewoz - Aynuma by Ethiopian Music 9 years ago 6 minutes, 21 seconds 78,725 views",Ethiopian Music,78725,79247,522
132,"Elisabet Meshesha - Awdamet by Ethiopian Music 9 years ago 5 minutes, 19 seconds 957 views",Ethiopian Music,957,960,3
133,"Dimisawiyan - Megibeya Gitim by Ethiopian Music 9 years ago 3 minutes, 49 seconds 1,092 views",Ethiopian Music,1092,1095,3
134,"Yeshi Demelash - Tizita by Ethiopian Music 9 years ago 4 minutes, 20 seconds 75,207 views",Ethiopian Music,75207,75243,36
135,"Yeshi Demelash - Qine by Ethiopian Music 9 years ago 4 minutes, 16 seconds 17,974 views",Ethiopian Music,17974,18017,43
136,"Endeshaw Kasaw - Abay Dar Komeyalehu by Ethiopian Music 9 years ago 5 minutes, 22 seconds 38,757 views",Ethiopian Music,38757,39224,467
137,"Yusef Maga (Josi) - Ebana Ebana by Ethiopian Music 9 years ago 5 minutes, 42 seconds 2,774 views",Ethiopian Music,2774,2775,1
138,"Tigist Adisu - Yewelo Lij Nana by Ethiopian Music 9 years ago 5 minutes, 36 seconds 72,232 views",Ethiopian Music,72232,72351,119
139,"Tigist Adisu - Ya Wegene by Ethiopian Music 9 years ago 5 minutes, 35 seconds 381,593 views",Ethiopian Music,381593,382813,1220
140,"Tigabe Zerihun - Hode Abeba by Ethiopian Music 9 years ago 6 minutes, 39 seconds 55,418 views",Ethiopian Music,55418,56093,675
141,"Maritu Tesema Alew - Sifiligih Keramiku (Shebelaye) by Ethiopian Music 9 years ago 5 minutes, 8 seconds 104,349 views",Ethiopian Music,104349,105174,825
142,"Maritu Tesema Alew - Mekenatan Lifta by Ethiopian Music 9 years ago 6 minutes, 20 seconds 169,084 views",Ethiopian Music,169084,170550,1466
143,"Maritu Tesema Alew - Bat Tehulet Suri by Ethiopian Music 9 years ago 5 minutes, 52 seconds 32,358 views",Ethiopian Music,32358,32505,147
144,"Mareshet Damtaw - Kadele by Ethiopian Music 9 years ago 5 minutes, 26 seconds 20,207 views",Ethiopian Music,20207,20269,62
145,"Habtamu Tedla - Megen Menye by Ethiopian Music 9 years ago 5 minutes, 18 seconds 9,717 views",Ethiopian Music,9717,9777,60
146,"Genene Asefa - Wiletaw Belay by Ethiopian Music 9 years ago 7 minutes, 6 seconds 15,958 views",Ethiopian Music,15958,15973,15
147,"Genene Asefa - Na Belegn by Ethiopian Music 9 years ago 5 minutes, 25 seconds 5,181 views",Ethiopian Music,5181,5196,15
148,"Ertihu Agegnehu - Yeawiwa Lij by Ethiopian Music 9 years ago 5 minutes, 57 seconds 30,053 views",Ethiopian Music,30053,30075,22
149,"Ertihu Agegnehu -  Sorina by Ethiopian Music 9 years ago 5 minutes, 29 seconds 11,316 views",Ethiopian Music,11316,11325,9
150,"Endeshaw Kasaw - Bederaku Lachegn (Shelela) by Ethiopian Music 9 years ago 7 minutes, 2 seconds 274,799 views",Ethiopian Music,274799,275005,206
151,"Belachew Garedu - New Mela by Ethiopian Music 9 years ago 7 minutes, 19 seconds 59,051 views",Ethiopian Music,59051,59404,353
152,"Belachew Garedu - Ashebel Gedawa by Ethiopian Music 9 years ago 5 minutes, 37 seconds 157,272 views",Ethiopian Music,157272,157630,358
153,"Atirisaw Debalike - Ney Ney Yene Abeba by Ethiopian Music 9 years ago 7 minutes, 38 seconds 27,181 views",Ethiopian Music,27181,27547,366
154,"Asmamaw Lema - Yeabay Yetan Lij by Ethiopian Music 9 years ago 4 minutes, 34 seconds 11,715 views",Ethiopian Music,11715,11754,39
155,"Andualem Ayelew - Anchim Dehna Dehna by Ethiopian Music 9 years ago 6 minutes, 48 seconds 13,719 views",Ethiopian Music,13719,13744,25
156,"Alelign Tilahun - Kora Yalew Betu by Ethiopian Music 9 years ago 6 minutes, 38 seconds 227,243 views",Ethiopian Music,227243,230436,3193
157,"Moges Mebratu - Alichalekum by Ethiopian Music 9 years ago 4 minutes, 46 seconds 33,883 views",Ethiopian Music,33883,33895,12
158,"Mikael Solomon - Weleyua by Ethiopian Music 9 years ago 7 minutes, 29 seconds 5,090 views",Ethiopian Music,5090,5136,46
159,"Mesfin Bekele - Bahir Dar Yalashaw by Ethiopian Music 9 years ago 6 minutes, 18 seconds 33,842 views",Ethiopian Music,33842,33905,63
160,"Mahamed Hasan - Gira Gebagna by Ethiopian Music 9 years ago 4 minutes, 53 seconds 3,923 views",Ethiopian Music,3923,3929,6
161,"Degal Mekonen - Set by Ethiopian Music 9 years ago 5 minutes, 47 seconds 4,138 views",Ethiopian Music,4138,4151,13
162,"Bisrat Garedew - Saylawis Afua by Ethiopian Music 9 years ago 4 minutes, 52 seconds 130,486 views",Ethiopian Music,130486,131038,552
163,"Ashanafi Mulugeta - Befikir Tirigna by Ethiopian Music 9 years ago 5 minutes, 6 seconds 4,356 views",Ethiopian Music,4356,4363,7
164,"Anteneh Aynalan - Ayuga by Ethiopian Music 9 years ago 5 minutes 5,991 views",Ethiopian Music,5991,5994,3
165,"Zewditu Asechalew - Yabay Dar Gumare by Ethiopian Music 9 years ago 5 minutes, 1 second 485,190 views",Ethiopian Music,485190,486003,813
166,"Zewditu Asechalew - Sekota by Ethiopian Music 9 years ago 5 minutes, 32 seconds 395,956 views",Ethiopian Music,395956,396244,288
167,"Zemenay Tiliku - Bichana Belay by Ethiopian Music 9 years ago 4 minutes, 30 seconds 36,266 views",Ethiopian Music,36266,36289,23
168,"Werku Andualem - Selam Nesh Gonder by Ethiopian Music 9 years ago 5 minutes, 43 seconds 126,049 views",Ethiopian Music,126049,126381,332
169,"Werku Andualem - Anchi Asesa by Ethiopian Music 9 years ago 6 minutes, 43 seconds 374,267 views",Ethiopian Music,374267,374910,643
170,"Kebebush Gedefaw - Tewelija by Ethiopian Music 9 years ago 5 minutes, 47 seconds 243,314 views",Ethiopian Music,243314,244546,1232
171,"Kebebush Gedefaw - Ara Erya by Ethiopian Music 9 years ago 5 minutes, 47 seconds 116,361 views",Ethiopian Music,116361,116807,446
172,"Banchiamlak Belayneh - Belay by Ethiopian Music 9 years ago 4 minutes, 40 seconds 122,436 views",Ethiopian Music,122436,123299,863
173,"Aragahagn Fikadu - Yegamitidi by Ethiopian Music 9 years ago 5 minutes, 33 seconds 3,644 views",Ethiopian Music,3644,3808,164
174,"Aragahagn Fikadu - Wacho Kebe Yesechu Bedocho by Ethiopian Music 9 years ago 6 minutes, 48 seconds 10,439 views",Ethiopian Music,10439,10648,209
175,"Aragahagn Fikadu - Nazagnu by Ethiopian Music 9 years ago 5 minutes, 7 seconds 33,306 views",Ethiopian Music,33306,34500,1194
176,"Aragahagn Fikadu - Instrumental 2 by Ethiopian Music 9 years ago 5 minutes, 12 seconds 7,297 views",Ethiopian Music,7297,7314,17
177,"Aragahagn Fikadu - Instrumental 1 by Ethiopian Music 9 years ago 4 minutes, 48 seconds 6,577 views",Ethiopian Music,6577,6595,18
178,"Aragahagn Fikadu - Emtede by Ethiopian Music 9 years ago 5 minutes, 29 seconds 3,478 views",Ethiopian Music,3478,3499,21
179,"Aragahagn Fikadu - Bakato Yibalote Yeketo by Ethiopian Music 9 years ago 4 minutes, 18 seconds 7,004 views",Ethiopian Music,7004,7308,304
180,"Aragahagn Fikadu - Atebile by Ethiopian Music 9 years ago 7 minutes, 47 seconds 24,438 views",Ethiopian Music,24438,25663,1225
181,"Aragahagn Fikadu - Ametebalochegna by Ethiopian Music 9 years ago 5 minutes, 33 seconds 6,614 views",Ethiopian Music,6614,6649,35
182,"Tizialu Fante - Emotilatalahu by Ethiopian Music 9 years ago 6 minutes, 31 seconds 895,362 views",Ethiopian Music,895362,896214,852
183,"Silashi Yagizawe - Yemasinko Shufer by Ethiopian Music 9 years ago 7 minutes, 28 seconds 40,959 views",Ethiopian Music,40959,41196,237
184,"Haymanot Sisaye ena Silashi Yagizawe - Egnaw Entarake by Ethiopian Music 9 years ago 6 minutes, 53 seconds 1,675,962 views",Ethiopian Music,1675962,1695947,19985
185,"Getachaw Zewdu - Erikum by Ethiopian Music 9 years ago 6 minutes, 13 seconds 1,650,774 views",Ethiopian Music,1650774,1653814,3040
186,"Getachaw Zewdu - Anbesa Gedaye by Ethiopian Music 9 years ago 5 minutes, 36 seconds 32,811 views",Ethiopian Music,32811,32841,30
187,"Getachaw Zewdu - Aba Kositir by Ethiopian Music 9 years ago 11 minutes, 28 seconds 39,772 views",Ethiopian Music,39772,39800,28
188,"Eyachiw Abuye ena Haymonot Sisaya - Ayale Bezina by Ethiopian Music 9 years ago 6 minutes, 29 seconds 369,708 views",Ethiopian Music,369708,369988,280
189,"Eyachiw Abuye - Tizita by Ethiopian Music 9 years ago 6 minutes, 21 seconds 249,027 views",Ethiopian Music,249027,249186,159
190,"Eyachiw Abuye - Aya Belaw by Ethiopian Music 9 years ago 6 minutes, 45 seconds 456,597 views",Ethiopian Music,456597,458055,1458
191,"Laggasaa Abdii - Untitled by Ethiopian Music 9 years ago 5 minutes, 33 seconds 11,704 views",Ethiopian Music,11704,11743,39
192,"Jireenyaa Dassalee  - Untitled by Ethiopian Music 9 years ago 6 minutes, 25 seconds 4,354 views",Ethiopian Music,4354,4361,7
193,"Jireenyaa Dassalee and Hawin Tazarraa - Untitled by Ethiopian Music 9 years ago 6 minutes, 49 seconds 11,990 views",Ethiopian Music,11990,11998,8
194,"Hawin Tazarraa - Untitled 2 by Ethiopian Music 9 years ago 4 minutes, 34 seconds 13,114 views",Ethiopian Music,13114,13118,4
195,"Hawin Tazarraa - Untitled 1 by Ethiopian Music 9 years ago 3 minutes, 6 seconds 15,808 views",Ethiopian Music,15808,15809,1
196,"Halloo Daawwee - Untitled 2 by Ethiopian Music 9 years ago 6 minutes, 33 seconds 98,185 views",Ethiopian Music,98185,98195,10
197,"Halloo Daawwee - Untitled 1 by Ethiopian Music 9 years ago 6 minutes, 15 seconds 18,989 views",Ethiopian Music,18989,18993,4
198,"Agere Legesse - Untitled by Ethiopian Music 9 years ago 6 minutes, 7 seconds 5,946 views",Ethiopian Music,5946,5953,7
199,"Abdii Ibraahime - Untitled 2 by Ethiopian Music 9 years ago 6 minutes, 45 seconds 10,711 views",Ethiopian Music,10711,10717,6
200,"Abdii Ibraahime - Untitled 1 by Ethiopian Music 9 years ago 5 minutes, 55 seconds 7,917 views",Ethiopian Music,7917,7921,4
201,"Yitayaw Dagne - Yane Ayal by Ethiopian Music 9 years ago 5 minutes, 43 seconds 91,864 views",Ethiopian Music,91864,92208,344
202,"Yitayaw Dagne - Marakee Wibatwa by Ethiopian Music 9 years ago 5 minutes, 30 seconds 383,444 views",Ethiopian Music,383444,384128,684
203,"Yitayaw Dagne - Lewey Lewey by Ethiopian Music 9 years ago 5 minutes, 34 seconds 41,579 views",Ethiopian Music,41579,41917,338
204,"Yitayaw Dagne - Abay Molalish by Ethiopian Music 9 years ago 6 minutes, 3 seconds 36,864 views",Ethiopian Music,36864,37200,336
205,"Mola Satiarge - Wey Wey by Ethiopian Music 9 years ago 5 minutes, 12 seconds 148,808 views",Ethiopian Music,148808,149412,604
206,"Mola Satiarge - Gondar by Ethiopian Music 9 years ago 5 minutes, 37 seconds 14,351 views",Ethiopian Music,14351,14392,41
207,"Mola Satiarge - Dinbilo Abeba by Ethiopian Music 9 years ago 6 minutes, 12 seconds 112,924 views",Ethiopian Music,112924,113318,394
208,"Mola Satiarge - Dena Belaw by Ethiopian Music 9 years ago 5 minutes, 35 seconds 44,258 views",Ethiopian Music,44258,44917,659
209,"Mola Satiarge - Abebaye Nesh by Ethiopian Music 9 years ago 5 minutes, 41 seconds 228,677 views",Ethiopian Music,228677,229062,385
210,"Misiganaw Yitayaw - Yedeman Shama by Ethiopian Music 9 years ago 5 minutes, 26 seconds 491,794 views",Ethiopian Music,491794,492992,1198
211,"Zenebech Taday - Hod Yefajaw by Ethiopian Music 9 years ago 5 minutes, 58 seconds 1,063,658 views",Ethiopian Music,1063658,1067632,3974
212,"Mola Setarege - Yekubat Magado by Ethiopian Music 9 years ago 7 minutes, 12 seconds 520,337 views",Ethiopian Music,520337,522285,1948
213,"Mola Setarege - Yekonjo Leba by Ethiopian Music 9 years ago 5 minutes, 9 seconds 99,174 views",Ethiopian Music,99174,100480,1306
214,"Mola Setarege - Min Amatash by Ethiopian Music 9 years ago 3 minutes, 43 seconds 751,535 views",Ethiopian Music,751535,752954,1419
215,"Mola Setarege - Endet Nesh by Ethiopian Music 9 years ago 5 minutes, 19 seconds 246,617 views",Ethiopian Music,246617,247410,793
216,"Mimi Muluken - Man Semaw by Ethiopian Music 9 years ago 6 minutes, 32 seconds 44,043 views",Ethiopian Music,44043,44556,513
217,"Betelehem Aklilu - Min Alkat by Ethiopian Music 9 years ago 4 minutes, 40 seconds 166,808 views",Ethiopian Music,166808,169509,2701
218,"Mimi Muluken - Ayen Ayenehen by Ethiopian Music 9 years ago 5 minutes, 33 seconds 142,505 views",Ethiopian Music,142505,144206,1701
219,"Betelehem Aklilu - Chawa Neh by Ethiopian Music 9 years ago 4 minutes, 15 seconds 401,964 views",Ethiopian Music,401964,406586,4622
220,"Betelehem Aklilu - Bagar by Ethiopian Music 9 years ago 6 minutes, 43 seconds 3,163,393 views",Ethiopian Music,3163393,3182628,19235
221,"Yenegete Fantahun - Endet Nesh by Ethiopian Music 9 years ago 3 minutes, 56 seconds 17,118 views",Ethiopian Music,17118,17146,28
222,"Tigist Addisu - Yekolo Tamari by Ethiopian Music 9 years ago 4 minutes, 29 seconds 10,025 views",Ethiopian Music,10025,10052,27
223,"Moke Awedametu - Beiweketu Sewmehone by Ethiopian Music 9 years ago 5 minutes, 15 seconds 2,244 views",Ethiopian Music,2244,2246,2
224,"Jejewe Ababu and Abebou Abohaye - Zemerow by Ethiopian Music 9 years ago 8 minutes, 16 seconds 297,604 views",Ethiopian Music,297604,298159,555
225,"Genene Asefa - Zomaye by Ethiopian Music 9 years ago 6 minutes, 53 seconds 14,851 views",Ethiopian Music,14851,14863,12
226,"Andoalem Lema - Tyemanesh by Ethiopian Music 9 years ago 5 minutes 18,237 views",Ethiopian Music,18237,18332,95
227,"Endalekachew Yeneyhun (2Pac) - Getemegne by Ethiopian Music 9 years ago 6 minutes, 51 seconds 155,554 views",Ethiopian Music,155554,156448,894
228,"Adane Teka - Yeadane Feretoche by Ethiopian Music 9 years ago 6 minutes, 38 seconds 75,800 views",Ethiopian Music,75800,75958,158
229,"Adane Teka - Sekota by Ethiopian Music 9 years ago 6 minutes, 38 seconds 61,022 views",Ethiopian Music,61022,61147,125
230,"Tenay Teshale - Gondere New by Ethiopian Music 9 years ago 5 minutes, 51 seconds 47,306 views",Ethiopian Music,47306,47337,31
231,"Eteneshe Girma - Teweledo Gojam New by Ethiopian Music 9 years ago 4 minutes, 41 seconds 80,179 views",Ethiopian Music,80179,80240,61
232,"Ashabere Belaye - Serg Behagerachen by Ethiopian Music 9 years ago 6 minutes, 16 seconds 20,459 views",Ethiopian Music,20459,20484,25
233,"Andoalem Dagnachew - Yekefa Lij by Ethiopian Music 9 years ago 6 minutes, 18 seconds 71,423 views",Ethiopian Music,71423,71655,232
234,"Andoalem Dagnachew - Yagerene Libese by Ethiopian Music 9 years ago 5 minutes, 47 seconds 194,660 views",Ethiopian Music,194660,195259,599
235,"Andoalem Dagnachew - Kebela New Zare by Ethiopian Music 9 years ago 5 minutes, 35 seconds 64,322 views",Ethiopian Music,64322,64484,162
236,"Andoalem Dagnachew - Fiker Be Efrata by Ethiopian Music 9 years ago 6 minutes, 23 seconds 203,448 views",Ethiopian Music,203448,204155,707
237,"Andoalem Dagnachew - Efoye Beleshe by Ethiopian Music 9 years ago 5 minutes, 46 seconds 64,329 views",Ethiopian Music,64329,64486,157
238,"Andoalem Dagnachew - Atemecheme Weye by Ethiopian Music 9 years ago 6 minutes, 4 seconds 282,009 views",Ethiopian Music,282009,282349,340
239,"Tege Wegene (Gule Wegene) - Aferekawe Girema by Ethiopian Music 9 years ago 6 minutes, 8 seconds 9,961 views",Ethiopian Music,9961,9966,5
240,"Tesfaye Gedeye - Tehegusu Do Kmaye by Ethiopian Music 9 years ago 7 minutes, 5 seconds 166,251 views",Ethiopian Music,166251,166326,75
241,"Tege Wegene (Gule Wegene) - Wesene by Ethiopian Music 9 years ago 5 minutes, 36 seconds 24,314 views",Ethiopian Music,24314,24331,17
242,"Tege Wegene (Gule Wegene) - Demke Berhane by Ethiopian Music 9 years ago 5 minutes, 45 seconds 17,923 views",Ethiopian Music,17923,17932,9
243,"Muse Taeme - Meleye by Ethiopian Music 9 years ago 6 minutes, 25 seconds 10,908 views",Ethiopian Music,10908,10915,7
244,"Kenefe GebreGereges - Kesade Brile by Ethiopian Music 9 years ago 6 minutes, 31 seconds 5,891 views",Ethiopian Music,5891,5896,5
245,"Hiruye GebreSelase - Tilaleye by Ethiopian Music 9 years ago 5 minutes, 18 seconds 10,375 views",Ethiopian Music,10375,10386,11
246,"Dgefe Meruti - Tiaba Tigebe by Ethiopian Music 9 years ago 3 minutes, 41 seconds 6,099 views",Ethiopian Music,6099,6111,12
247,"Atahaleti Demaze - Bhele Adhe by Ethiopian Music 9 years ago 6 minutes, 6 seconds 9,758 views",Ethiopian Music,9758,9764,6
248,"Anbesa Tehila - Niesnete by Ethiopian Music 9 years ago 5 minutes, 50 seconds 228,402 views",Ethiopian Music,228402,228906,504
249,"Anbesa Tehila - Ati Mizere by Ethiopian Music 9 years ago 5 minutes, 47 seconds 10,364 views",Ethiopian Music,10364,10417,53
250,"Anbesa Tehila - Ati Gamay Kihlo by Ethiopian Music 9 years ago 6 minutes, 11 seconds 47,643 views",Ethiopian Music,47643,47819,176
251,"Yodit Worku - Yeserg Bahlachin by Ethiopian Music 10 years ago 5 minutes, 12 seconds 135,790 views",Ethiopian Music,135790,135925,135
252,"Tadese Meket - Ediget Banadinat by Ethiopian Music 10 years ago 8 minutes, 31 seconds 123,178 views",Ethiopian Music,123178,125665,2487
253,"Habtamu Abere - Arso Bale by Ethiopian Music 10 years ago 5 minutes, 44 seconds 12,923 views",Ethiopian Music,12923,12930,7
254,"Gizachw Teklemariam - Yekolo Tamari by Ethiopian Music 10 years ago 6 minutes, 2 seconds 7,183 views",Ethiopian Music,7183,7190,7
255,"Gizachew Teklemariam - Wayno by Ethiopian Music 10 years ago 6 minutes, 29 seconds 21,163 views",Ethiopian Music,21163,21200,37
256,"Begashaw Tefere - Gojam by Ethiopian Music 10 years ago 5 minutes, 59 seconds 80,800 views",Ethiopian Music,80800,80820,20
257,"Aster Mulualem - Haya Bal by Ethiopian Music 10 years ago 5 minutes, 20 seconds 21,470 views",Ethiopian Music,21470,21508,38
258,"Asmamaw Masmur - Hagere Malo by Ethiopian Music 10 years ago 4 minutes, 35 seconds 5,688 views",Ethiopian Music,5688,5692,4
259,"Almaza Tajeb - KelKay Yesenim by Ethiopian Music 10 years ago 4 minutes, 16 seconds 6,113 views",Ethiopian Music,6113,6122,9
260,"Tefere Selefe - Yadinagay Sir Wiha by Ethiopian Music 10 years ago 7 minutes, 4 seconds 71,903 views",Ethiopian Music,71903,72475,572
261,"Tefere Selefe - Etu Mela Zewda by Ethiopian Music 10 years ago 6 minutes, 26 seconds 211,442 views",Ethiopian Music,211442,212326,884
262,"Tefere Selefe - Deldil Belew by Ethiopian Music 10 years ago 8 minutes, 56 seconds 16,380 views",Ethiopian Music,16380,16675,295
263,"Sara Mamo - Shaday by Ethiopian Music 10 years ago 7 minutes, 10 seconds 37,349 views",Ethiopian Music,37349,37653,304
264,"Mekwananat Melese - Yiku Banizew by Ethiopian Music 10 years ago 6 minutes, 9 seconds 31,488 views",Ethiopian Music,31488,31785,297
265,"Benachi Amlak Getahun - Tizita by Ethiopian Music 10 years ago 7 minutes, 13 seconds 34,664 views",Ethiopian Music,34664,37412,2748
266,"Aweru Iyasu - Yalemway by Ethiopian Music 10 years ago 5 minutes, 51 seconds 16,209 views",Ethiopian Music,16209,16412,203
267,"Asitar Welada - Kalitina Azmirada by Ethiopian Music 10 years ago 6 minutes, 57 seconds 44,280 views",Ethiopian Music,44280,44511,231
268,"Lemlem Shumet - YetitiTilegn (Teweminah) by Ethiopian Music 10 years ago 4 minutes, 26 seconds 42,441 views",Ethiopian Music,42441,42494,53
269,"Lemlem Shumet - Sera Alebign by Ethiopian Music 10 years ago 6 minutes, 32 seconds 23,874 views",Ethiopian Music,23874,23938,64
270,"Lemlem Shumet - Gubeli by Ethiopian Music 10 years ago 6 minutes, 26 seconds 236,062 views",Ethiopian Music,236062,237009,947
271,"Lemlem Shumet - Belu Enehidu by Ethiopian Music 10 years ago 5 minutes, 38 seconds 201,580 views",Ethiopian Music,201580,201876,296
272,"Asnaku Chemer - Wede Shibela by Ethiopian Music 10 years ago 5 minutes, 21 seconds 1,172,643 views",Ethiopian Music,1172643,1174955,2312
273,"Asnaku Chemer - Teragne by Ethiopian Music 10 years ago 6 minutes, 19 seconds 451,195 views",Ethiopian Music,451195,452400,1205
274,"Asnaku Chemer - Himeme by Ethiopian Music 10 years ago 4 minutes, 28 seconds 712,394 views",Ethiopian Music,712394,713420,1026
275,"Asnaku Chemer - Enetafihu by Ethiopian Music 10 years ago 5 minutes, 37 seconds 1,038,222 views",Ethiopian Music,1038222,1040892,2670
276,"Asnaku Chemer - Ayanama by Ethiopian Music 10 years ago 6 minutes, 34 seconds 620,956 views",Ethiopian Music,620956,623307,2351
277,"Wagnew Ashenafi - Jenemu Gojame by Ethiopian Music 10 years ago 5 minutes, 59 seconds 359,812 views",Ethiopian Music,359812,360165,353
278,"Wagnew Ashenafi - Borena by Ethiopian Music 10 years ago 8 minutes, 11 seconds 208,376 views",Ethiopian Music,208376,209419,1043
279,"Wagnew Ashenafi - Bedelea Bisama by Ethiopian Music 10 years ago 7 minutes, 55 seconds 242,437 views",Ethiopian Music,242437,243332,895
280,"Shiway Zewale - Yefkerine Gudaye by Ethiopian Music 10 years ago 6 minutes, 48 seconds 683,598 views",Ethiopian Music,683598,684011,413
281,"Shiway Zewale - Gena Newe Gena by Ethiopian Music 10 years ago 5 minutes, 14 seconds 66,343 views",Ethiopian Music,66343,66368,25
282,"Yezina Negash - Tefategna Enedalehone by Ethiopian Music 10 years ago 3 minutes, 49 seconds 1,253,308 views",Ethiopian Music,1253308,1254091,783
283,"Yezina Negash - Sentune Asalefi by Ethiopian Music 10 years ago 4 minutes, 50 seconds 228,725 views",Ethiopian Music,228725,228834,109
284,"Yezina Negash - Sekota by Ethiopian Music 10 years ago 6 minutes, 18 seconds 70,854 views",Ethiopian Music,70854,71073,219
285,"Yezina Negash - Mengedegnaw by Ethiopian Music 10 years ago 5 minutes, 23 seconds 208,729 views",Ethiopian Music,208729,209643,914
286,"Yezina Negash - Gonder by Ethiopian Music 10 years ago 6 minutes, 51 seconds 299,517 views",Ethiopian Music,299517,300763,1246
287,"Yezina Negash - Gojam by Ethiopian Music 10 years ago 2 minutes, 50 seconds 37,304 views",Ethiopian Music,37304,37360,56
288,"Yezina Negash - Gela by Ethiopian Music 10 years ago 5 minutes, 13 seconds 180,249 views",Ethiopian Music,180249,181089,840
289,"Yezina Negash - Gedamu by Ethiopian Music 10 years ago 4 minutes, 40 seconds 34,592 views",Ethiopian Music,34592,34784,192
290,"Yezina Negash - Aneresaw by Ethiopian Music 10 years ago 5 minutes, 42 seconds 180,520 views",Ethiopian Music,180520,180687,167
291,"Tesfaye Mengesha - Kemya Aleki by Ethiopian Music 10 years ago 6 minutes, 31 seconds 328,598 views",Ethiopian Music,328598,330859,2261
292,"Tesfaledet (Wedi Mesfin) - Tebhibhi by Ethiopian Music 10 years ago 8 minutes 12,883 views",Ethiopian Music,12883,12893,10
293,"Tesfaledet (Wedi Mesfin) - Sara by Ethiopian Music 10 years ago 5 minutes, 57 seconds 43,594 views",Ethiopian Music,43594,43861,267
294,"Temesgen Tineko - Tifeune Delekyo by Ethiopian Music 10 years ago 6 minutes, 30 seconds 26,841 views",Ethiopian Music,26841,26869,28
295,"Sami Berhan - Ayeneye by Ethiopian Music 10 years ago 6 minutes, 4 seconds 62,935 views",Ethiopian Music,62935,65047,2112
296,"Melaku Bireda - Yehi Acha Bekorem by Ethiopian Music 10 years ago 5 minutes, 51 seconds 64,378 views",Ethiopian Music,64378,64494,116
297,"Melaku Bireda - Yebebube Teke Namageta by Ethiopian Music 10 years ago 5 minutes, 39 seconds 12,635 views",Ethiopian Music,12635,12648,13
298,"Melaku Bireda - Waka Waka by Ethiopian Music 10 years ago 5 minutes, 44 seconds 26,516 views",Ethiopian Music,26516,26560,44
299,"Melaku Bireda - Twist Be Gurage by Ethiopian Music 10 years ago 5 minutes, 20 seconds 14,972 views",Ethiopian Music,14972,15031,59
300,"Melaku Bireda - Shiguleli by Ethiopian Music 10 years ago 5 minutes, 43 seconds 41,191 views",Ethiopian Music,41191,41271,80
301,"Melaku Bireda - Nihe Nihe Gere by Ethiopian Music 10 years ago 5 minutes, 4 seconds 33,872 views",Ethiopian Music,33872,33907,35
302,"Melaku Bireda - Esherere by Ethiopian Music 10 years ago 6 minutes, 26 seconds 67,405 views",Ethiopian Music,67405,67618,213
303,"Melaku Bireda - Befenehi Yesere by Ethiopian Music 10 years ago 4 minutes, 42 seconds 17,386 views",Ethiopian Music,17386,17408,22
304,"Melaku Bireda - Ena Zere Gura by Ethiopian Music 10 years ago 5 minutes, 38 seconds 19,859 views",Ethiopian Music,19859,19892,33
305,"Melaku Bireda - Alembere by Ethiopian Music 10 years ago 4 minutes, 53 seconds 26,440 views",Ethiopian Music,26440,26489,49
306,"Zerehun Abraham - Yebekanare by Ethiopian Music 10 years ago 5 minutes, 4 seconds 2,442 views",Ethiopian Music,2442,2455,13
307,"Tigist Fikre - Aminehalehu by Ethiopian Music 10 years ago 5 minutes, 53 seconds 119,187 views",Ethiopian Music,119187,120483,1296
308,"Selamnesh Zemen - Yegeremal by Ethiopian Music 10 years ago 5 minutes, 17 seconds 268,992 views",Ethiopian Music,268992,270850,1858
309,"Selamnesh Zemen - Salayehe Alewelem by Ethiopian Music 10 years ago 6 minutes, 51 seconds 388,479 views",Ethiopian Music,388479,390401,1922
310,"Selamnesh Zemen - Ale Gena by Ethiopian Music 10 years ago 5 minutes, 15 seconds 697,125 views",Ethiopian Music,697125,704157,7032
311,"Mehret Mileyone - Behaset by Ethiopian Music 10 years ago 4 minutes, 54 seconds 16,736 views",Ethiopian Music,16736,16749,13
312,"Gideon Engidawerk - Ityopiawito by Ethiopian Music 10 years ago 5 minutes, 17 seconds 2,062 views",Ethiopian Music,2062,2068,6
313,"Gideon Engidawerk - Ateteyegne by Ethiopian Music 10 years ago 5 minutes, 41 seconds 5,713 views",Ethiopian Music,5713,5718,5
314,"Rahel Haile - Yeawaye Seyeyedo by Ethiopian Music 10 years ago 6 minutes, 18 seconds 194,955 views",Ethiopian Music,194955,195112,157
315,"Rahel Haile - Siye Welila by Ethiopian Music 10 years ago 5 minutes, 51 seconds 308,716 views",Ethiopian Music,308716,308912,196
316,"Rahel Haile - Senebebe Nei Nabaye by Ethiopian Music 10 years ago 4 minutes, 57 seconds 37,322 views",Ethiopian Music,37322,37441,119
317,"Rahel Haile - Metset Metset by Ethiopian Music 10 years ago 5 minutes, 33 seconds 58,978 views",Ethiopian Music,58978,59059,81
318,"Rahel Haile - Embebeye Embebeyti by Ethiopian Music 10 years ago 5 minutes, 10 seconds 144,750 views",Ethiopian Music,144750,144962,212
319,"Rahel Haile - Embeb Misesa by Ethiopian Music 10 years ago 6 minutes, 38 seconds 50,477 views",Ethiopian Music,50477,50592,115
320,"Rahel Haile - Ashenda Adey by Ethiopian Music 10 years ago 6 minutes, 36 seconds 171,113 views",Ethiopian Music,171113,171183,70
321,"Rahel Haile - Anebesaye Seruye by Ethiopian Music 10 years ago 6 minutes, 10 seconds 76,591 views",Ethiopian Music,76591,76705,114
322,"Esiminesh Desa - Des Kibil by Ethiopian Music 10 years ago 6 minutes, 26 seconds 4,137 views",Ethiopian Music,4137,4144,7
323,"Solomon Haile - Liwumay by Ethiopian Music 10 years ago 5 minutes, 17 seconds 874,943 views",Ethiopian Music,874943,909568,34625
324,"Rishan Gebre - Lilay by Ethiopian Music 10 years ago 8 minutes, 4 seconds 20,874 views",Ethiopian Music,20874,20903,29
325,"Solomon Haile - Gezana by Ethiopian Music 10 years ago 5 minutes, 15 seconds 1,069,754 views",Ethiopian Music,1069754,1085342,15588
326,"Musugat Kahisay (Wedi Romit) - Libiyu Zirey by Ethiopian Music 10 years ago 6 minutes, 43 seconds 6,489 views",Ethiopian Music,6489,6591,102
327,"Kinfe G/Girges - Kumel by Ethiopian Music 10 years ago 6 minutes, 14 seconds 22,076 views",Ethiopian Music,22076,22304,228
328,"Gizachew Solomon - Wesisu by Ethiopian Music 10 years ago 5 minutes, 40 seconds 427,155 views",Ethiopian Music,427155,446770,19615
329,"Eyob Belay - Mihashegi by Ethiopian Music 10 years ago 6 minutes, 39 seconds 11,869 views",Ethiopian Music,11869,11919,50
330,"Amir Dawid - Kealo by Ethiopian Music 10 years ago 6 minutes, 59 seconds 59,186 views",Ethiopian Music,59186,62589,3403
331,"Tesfaye Gedeye - Anekiatene Maro by Ethiopian Music 10 years ago 6 minutes, 7 seconds 9,515 views",Ethiopian Music,9515,9542,27
332,"Tewolde Kasahun - Temesgene Fetare by Ethiopian Music 10 years ago 5 minutes, 48 seconds 8,199 views",Ethiopian Music,8199,8205,6
333,"Tsega Wegane - Kemeshishiwta by Ethiopian Music 10 years ago 5 minutes, 31 seconds 16,404 views",Ethiopian Music,16404,16425,21
334,"Tewelde Yemane - Yenegeselya by Ethiopian Music 10 years ago 6 minutes, 32 seconds 105,832 views",Ethiopian Music,105832,105988,156
335,"Sofia Atsbeha - Harfeka by Ethiopian Music 10 years ago 5 minutes, 36 seconds 88,668 views",Ethiopian Music,88668,89705,1037
336,"Sentayehu Ameha - Hawye Enebeleke by Ethiopian Music 10 years ago 6 minutes, 29 seconds 94,429 views",Ethiopian Music,94429,95353,924
337,"Seble Aregawi - Ate Segemeye by Ethiopian Music 10 years ago 4 minutes, 56 seconds 24,768 views",Ethiopian Music,24768,24819,51
338,"Efrem Hagos - Asadu Raya by Ethiopian Music 10 years ago 5 minutes, 33 seconds 25,464 views",Ethiopian Music,25464,25472,8
339,"Efrem Hagos - Arehaye by Ethiopian Music 10 years ago 6 minutes, 9 seconds 19,294 views",Ethiopian Music,19294,19300,6
340,"Toleeraa Ittisaa - Shimaala Koo by Ethiopian Music 10 years ago 5 minutes, 35 seconds 17,640 views",Ethiopian Music,17640,17651,11
341,"Tashoomee Guyyee - Yaadannoo Jireenyaa by Ethiopian Music 10 years ago 5 minutes, 6 seconds 259,963 views",Ethiopian Music,259963,260225,262
342,"Sooraa Kadiir (Husseen) - Obsaa Qabuu by Ethiopian Music 10 years ago 6 minutes, 4 seconds 511,857 views",Ethiopian Music,511857,512380,523
343,"Kadiir Xekkuu - Baantuu by Ethiopian Music 10 years ago 4 minutes, 11 seconds 13,544 views",Ethiopian Music,13544,13551,7
344,"Kadiir Xekkuu - Ammaamotoore by Ethiopian Music 10 years ago 5 minutes, 14 seconds 58,496 views",Ethiopian Music,58496,58550,54
345,"Guutuu Buntii (Dargaggoo) - Simararre by Ethiopian Music 10 years ago 4 minutes, 37 seconds 36,379 views",Ethiopian Music,36379,36388,9
346,"Guutuu Buntii (Dargaggoo) - Oofee by Ethiopian Music 10 years ago 5 minutes, 31 seconds 68,798 views",Ethiopian Music,68798,68875,77
347,"Guutuu Buntii (Dargaggoo) - Miisiroo by Ethiopian Music 10 years ago 6 minutes, 8 seconds 26,090 views",Ethiopian Music,26090,26098,8
348,"Guutuu Buntii (Dargaggoo) - Martuu by Ethiopian Music 10 years ago 5 minutes, 10 seconds 9,007 views",Ethiopian Music,9007,9038,31
349,"Guutuu Buntii (Dargaggoo) - Dubbi Kana by Ethiopian Music 10 years ago 4 minutes 9,482 views",Ethiopian Music,9482,9484,2
350,"Feeysal Abdurahmaan (Fese) - Marii by Ethiopian Music 10 years ago 5 minutes, 26 seconds 16,825 views",Ethiopian Music,16825,16829,4
351,"Feeysal Abdurahmaan (Fese) - Hamilee by Ethiopian Music 10 years ago 6 minutes, 15 seconds 4,830 views",Ethiopian Music,4830,4831,1
352,"Badhaanee Burqaa - Naanayii by Ethiopian Music 10 years ago 5 minutes, 2 seconds 4,112 views",Ethiopian Music,4112,4119,7
353,"Badhaanee Burqaa - Dadamaaqa by Ethiopian Music 10 years ago 6 minutes, 28 seconds 2,554 views",Ethiopian Music,2554,2556,2
354,"Badhaanee Burqaa - Jalaalee by Ethiopian Music 10 years ago 5 minutes, 26 seconds 3,587 views",Ethiopian Music,3587,3589,2
355,"Badhaanee Burqaa - Bishaan Amiboo by Ethiopian Music 10 years ago 5 minutes, 19 seconds 3,062 views",Ethiopian Music,3062,3066,4
356,"Araarsaa Gabbisaa - Yaamaakodii by Ethiopian Music 10 years ago 5 minutes, 31 seconds 26,613 views",Ethiopian Music,26613,26642,29
357,"Araarsaa Gabbisaa - Koomee by Ethiopian Music 10 years ago 7 minutes, 13 seconds 49,350 views",Ethiopian Music,49350,49451,101
358,"Araarsaa Gabbisaa - Miishingaa by Ethiopian Music 10 years ago 6 minutes, 50 seconds 30,254 views",Ethiopian Music,30254,30337,83
359,"Taddalaa Gammachuu - Yaamioftuu by Ethiopian Music 10 years ago 5 minutes, 36 seconds 36,614 views",Ethiopian Music,36614,36651,37
360,"Taddalaa Gammachuu - Takkitii Tiyya by Ethiopian Music 10 years ago 5 minutes, 59 seconds 38,618 views",Ethiopian Music,38618,38640,22
361,"Taddalaa Gammachuu - Siyaadeera by Ethiopian Music 10 years ago 6 minutes, 56 seconds 57,860 views",Ethiopian Music,57860,58379,519
362,"Taddalaa Gammachuu - Raada Raadaa by Ethiopian Music 10 years ago 6 minutes, 16 seconds 10,768 views",Ethiopian Music,10768,10778,10
363,"Taddalaa Gammachuu - Oromoon Faaya by Ethiopian Music 10 years ago 5 minutes 21,106 views",Ethiopian Music,21106,21176,70
364,"Taddalaa Gammachuu - Birrolee by Ethiopian Music 10 years ago 4 minutes, 22 seconds 3,687 views",Ethiopian Music,3687,3700,13
365,"Taddalaa Gammachuu - Bashaanantoo by Ethiopian Music 10 years ago 5 minutes, 46 seconds 191,482 views",Ethiopian Music,191482,191633,151
366,"Taddalaa Gammachuu - Aruztoota by Ethiopian Music 10 years ago 5 minutes, 19 seconds 220,743 views",Ethiopian Music,220743,220993,250
367,"Jamboo Joote (JJ)- Imimman by Ethiopian Music 10 years ago 5 minutes, 47 seconds 22,868 views",Ethiopian Music,22868,22891,23
368,"Jamboo Joote (JJ) - Wollagga by Ethiopian Music 10 years ago 4 minutes, 12 seconds 13,264 views",Ethiopian Music,13264,13272,8
369,"Jamboo Joote (JJ) - Kamisee by Ethiopian Music 10 years ago 5 minutes, 57 seconds 11,789 views",Ethiopian Music,11789,11793,4
370,"Jamboo Joote (JJ) - Gooba Korma by Ethiopian Music 10 years ago 7 minutes, 35 seconds 6,153 views",Ethiopian Music,6153,6159,6
371,"Haacaaluu Hundeessaa - Sanyii Mootii by Ethiopian Music 10 years ago 5 minutes, 51 seconds 3,812 views",Ethiopian Music,3812,3818,6
372,"Jamboo Joote (JJ) - Folle by Ethiopian Music 10 years ago 6 minutes, 19 seconds 10,624 views",Ethiopian Music,10624,10650,26
373,"Jamboo Joote (JJ) - Dafi Kootu by Ethiopian Music 10 years ago 4 minutes, 41 seconds 10,217 views",Ethiopian Music,10217,10244,27
374,"Haacaaluu Hundeessaa - Oromumma by Ethiopian Music 10 years ago 5 minutes, 20 seconds 9,339 views",Ethiopian Music,9339,9347,8
375,"Haacaaluu Hundeessaa - Oolmaankei by Ethiopian Music 10 years ago 6 minutes, 11 seconds 2,472 views",Ethiopian Music,2472,2475,3
376,"Humneessaa Badhaasaa - Mucaa Qananii by Ethiopian Music 10 years ago 7 minutes, 2 seconds 251,434 views",Ethiopian Music,251434,252084,650
377,"Urgessa Gabissa - Xanee Jalalaa by Ethiopian Music 10 years ago 5 minutes, 11 seconds 128,762 views",Ethiopian Music,128762,128787,25
378,"Urgessa Gabissa - Hadhaa Mashiini by Ethiopian Music 10 years ago 5 minutes, 40 seconds 287,177 views",Ethiopian Music,287177,288212,1035
379,"Jaagamaa Taaddalaa (Jag) - Sinsiinnii by Ethiopian Music 10 years ago 6 minutes, 57 seconds 295,966 views",Ethiopian Music,295966,296651,685
380,"Jaagamaa Taaddalaa (Jag) - Lookoo Bulloo by Ethiopian Music 10 years ago 5 minutes, 24 seconds 484,118 views",Ethiopian Music,484118,485613,1495
381,"Jaagamaa Taaddalaa (Jag) - Kullee Bareeddu by Ethiopian Music 10 years ago 5 minutes, 12 seconds 172,701 views",Ethiopian Music,172701,173231,530
382,"Jaagamaa Taaddalaa (Jag) - Hin Roobaa by Ethiopian Music 10 years ago 6 minutes, 34 seconds 271,453 views",Ethiopian Music,271453,272653,1200
383,"Jaagamaa Taaddalaa (Jag) - Asa'ii Magaalle by Ethiopian Music 10 years ago 5 minutes, 13 seconds 348,364 views",Ethiopian Music,348364,348714,350
384,"Jaagamaa Taaddalaa (Jag) - Haabultuu Dubbin by Ethiopian Music 10 years ago 5 minutes, 24 seconds 258,808 views",Ethiopian Music,258808,259159,351
385,"Adaanechi Lataa - Yaa Fira Halalaa by Ethiopian Music 10 years ago 4 minutes, 44 seconds 275,344 views",Ethiopian Music,275344,275738,394
386,"Adaanechi Lataa - Walewlee by Ethiopian Music 10 years ago 4 minutes, 59 seconds 36,450 views",Ethiopian Music,36450,36486,36
387,"Aadam Ahimad - Yoom Wal Agarra by Ethiopian Music 10 years ago 5 minutes, 30 seconds 58,941 views",Ethiopian Music,58941,59039,98
388,"Galaanee Bulbulaa - Irreechaa Irreeffanaa by Ethiopian Music 10 years ago 5 minutes, 46 seconds 61,163 views",Ethiopian Music,61163,61298,135
389,"Daadhii Galaan - Yaa Ejersa by Ethiopian Music 10 years ago 5 minutes, 30 seconds 143,931 views",Ethiopian Music,143931,144269,338
390,"Daadhii Galaan - Qaaman Lafan Jira by Ethiopian Music 10 years ago 5 minutes, 51 seconds 341,404 views",Ethiopian Music,341404,342238,834
391,"Daadhii Galaan - Doboqaa by Ethiopian Music 10 years ago 6 minutes, 24 seconds 51,186 views",Ethiopian Music,51186,51189,3
392,"Asaffaa Tashoomaa - Yaijooliyo by Ethiopian Music 10 years ago 6 minutes, 39 seconds 70,727 views",Ethiopian Music,70727,71035,308
393,"Asaffaa Tashoomaa - Yaaikaaka Yaadatee by Ethiopian Music 10 years ago 4 minutes, 10 seconds 153,605 views",Ethiopian Music,153605,154512,907
394,"Asaffaa Tashoomaa - Yaa'ee Gryyaa'ee by Ethiopian Music 10 years ago 6 minutes, 26 seconds 40,404 views",Ethiopian Music,40404,40519,115
395,"Asaffaa Tashoomaa - Shantamee by Ethiopian Music 10 years ago 5 minutes, 1 second 614,891 views",Ethiopian Music,614891,616959,2068
396,"Asaffaa Tashoomaa - Koyyabire by Ethiopian Music 10 years ago 5 minutes, 58 seconds 149,689 views",Ethiopian Music,149689,150552,863
397,"Asaffaa Tashoomaa - Koottuu by Ethiopian Music 10 years ago 5 minutes, 50 seconds 189,610 views",Ethiopian Music,189610,189970,360
398,"Asaffaa Tashoomaa - Dheessee Hin Qalu by Ethiopian Music 10 years ago 3 minutes, 17 seconds 143,878 views",Ethiopian Music,143878,144358,480
399,"Asaffaa Tashoomaa - Akkanatti by Ethiopian Music 10 years ago 4 minutes, 53 seconds 120,006 views",Ethiopian Music,120006,120327,321
400,"Mohamed Zeyin - Olqabaa by Ethiopian Music 10 years ago 5 minutes, 46 seconds 4,393 views",Ethiopian Music,4393,4393,0
401,"Mohamed Zeyin - Africa by Ethiopian Music 10 years ago 5 minutes, 8 seconds 91,756 views",Ethiopian Music,91756,91832,76
402,"Fayyisaa Furii (Fayyee) - Simalee by Ethiopian Music 10 years ago 4 minutes, 40 seconds 91,148 views",Ethiopian Music,91148,91381,233
403,"Fayyisaa Furii (Fayyee) - San Daabilee by Ethiopian Music 10 years ago 5 minutes, 51 seconds 54,863 views",Ethiopian Music,54863,56067,1204
404,"Fayyisaa Furii (Fayyee) - Misirroolee by Ethiopian Music 10 years ago 4 minutes, 44 seconds 529,035 views",Ethiopian Music,529035,542186,13151
405,"Fayyisaa Furii (Fayyee) - Lakkii Dhiis by Ethiopian Music 10 years ago 6 minutes, 2 seconds 29,471 views",Ethiopian Music,29471,29539,68
406,"Fayyisaa Furii (Fayyee) - I Love You Forever by Ethiopian Music 10 years ago 5 minutes, 3 seconds 42,110 views",Ethiopian Music,42110,43463,1353
407,"Fayyisaa Furii (Fayyee) - Gowwee by Ethiopian Music 10 years ago 4 minutes, 55 seconds 73,136 views",Ethiopian Music,73136,73310,174
408,"Fayyisaa Furii (Fayyee) - Geerarsa by Ethiopian Music 10 years ago 4 minutes, 31 seconds 32,718 views",Ethiopian Music,32718,33119,401
409,"Fayyisaa Furii (Fayyee) - Daballee by Ethiopian Music 10 years ago 5 minutes, 20 seconds 21,697 views",Ethiopian Music,21697,21823,126
410,"Fayyisaa Furii (Fayyee) - Beenu Beenu by Ethiopian Music 10 years ago 4 minutes, 59 seconds 53,174 views",Ethiopian Music,53174,53633,459
411,"Fayyisaa Furii (Fayyee) - Akkamittiin by Ethiopian Music 10 years ago 5 minutes, 8 seconds 33,916 views",Ethiopian Music,33916,34018,102
412,"Tafarii Salaalee (Abbaabu) - Farada Gurraacha by Ethiopian Music 10 years ago 6 minutes, 8 seconds 266,534 views",Ethiopian Music,266534,267085,551
413,"Shuurtuu Bashaa - Qalla by Ethiopian Music 10 years ago 6 minutes, 13 seconds 17,895 views",Ethiopian Music,17895,17896,1
414,"Shuurtuu Bashaa - Ayyaani Irreessaa by Ethiopian Music 10 years ago 4 minutes, 32 seconds 36,708 views",Ethiopian Music,36708,36712,4
415,"Ashanafii Yohaannis - Maggallee by Ethiopian Music 10 years ago 4 minutes 18,597 views",Ethiopian Music,18597,18606,9
416,"Ashanafii Yohaannis - Jimma by Ethiopian Music 10 years ago 5 minutes, 10 seconds 39,217 views",Ethiopian Music,39217,39226,9
417,"Ashanafii Yohaannis - Hinchittii by Ethiopian Music 10 years ago 5 minutes, 40 seconds 43,850 views",Ethiopian Music,43850,43857,7
418,"Ashanafii Yohaannis - Geelloo by Ethiopian Music 10 years ago 5 minutes, 33 seconds 16,075 views",Ethiopian Music,16075,16078,3
419,"Ashanafii Yohaannis - Cidha by Ethiopian Music 10 years ago 5 minutes, 29 seconds 12,340 views",Ethiopian Music,12340,12342,2
420,"Ashanafii Yohaannis - Awash by Ethiopian Music 10 years ago 5 minutes, 27 seconds 29,928 views",Ethiopian Music,29928,29934,6
421,"Ashanafii Yohaannis - Aadaa by Ethiopian Music 10 years ago 5 minutes, 24 seconds 11,744 views",Ethiopian Music,11744,11748,4
422,"Aadam Ahmad - Aanole by Ethiopian Music 10 years ago 6 minutes, 26 seconds 133,290 views",Ethiopian Music,133290,133400,110
423,"Yeshi Tadesse - Anigo by Ethiopian Music 10 years ago 6 minutes, 17 seconds 85,438 views",Ethiopian Music,85438,85950,512
424,"Windi - Ayne Tew Sile Noro by Ethiopian Music 10 years ago 6 minutes, 13 seconds 1,385 views",Ethiopian Music,1385,1388,3
425,"Tizeta - Tawagn by Ethiopian Music 10 years ago 3 minutes, 36 seconds 2,483 views",Ethiopian Music,2483,2515,32
426,"Tewodros Getenet - Wibet Bizabat by Ethiopian Music 10 years ago 4 minutes, 35 seconds 1,097 views",Ethiopian Music,1097,1100,3
427,"Sami - Hasabe Nesh by Ethiopian Music 10 years ago 5 minutes, 19 seconds 2,149 views",Ethiopian Music,2149,2158,9
428,"Gamo - Bir by Ethiopian Music 10 years ago 4 minutes, 42 seconds 116,603 views",Ethiopian Music,116603,117658,1055
429,"Biruk Tesfaye - Kebre Mogese Nesh by Ethiopian Music 10 years ago 6 minutes, 49 seconds 3,452 views",Ethiopian Music,3452,3455,3
430,"Abiy - Esaw Tatsinanagn by Ethiopian Music 10 years ago 5 minutes, 13 seconds 2,427 views",Ethiopian Music,2427,2434,7
431,"Tirhas Tereke - Abelo by Ethiopian Music 10 years ago 6 minutes, 8 seconds 10,780 views",Ethiopian Music,10780,10870,90
432,"Mulugeta Kahsay - Unu-Duwu by Ethiopian Music 10 years ago 6 minutes, 42 seconds 96,155 views",Ethiopian Music,96155,96728,573
433,"Mizan Tesfay - Kanecha Mishila by Ethiopian Music 10 years ago 6 minutes, 47 seconds 9,186 views",Ethiopian Music,9186,9255,69
434,"Adam Mahamed - Ayenebreni by Ethiopian Music 10 years ago 7 minutes, 18 seconds 8,875 views",Ethiopian Music,8875,9003,128
435,"Yohanes Argaw (Joni) - Eyesakeche by Ethiopian Music 10 years ago 4 minutes, 46 seconds 21,260 views",Ethiopian Music,21260,21326,66
436,"Yeamlakesra Bidirega - Dese Yetegeal by Ethiopian Music 10 years ago 5 minutes 49,932 views",Ethiopian Music,49932,49944,12
437,"Mustafa Enderes - Jijiga Lay by Ethiopian Music 10 years ago 4 minutes, 16 seconds 53,814 views",Ethiopian Music,53814,53851,37
438,"Mulualem Shiferaw (Messengers) - Denduayte by Ethiopian Music 10 years ago 4 minutes, 45 seconds 1,464 views",Ethiopian Music,1464,1469,5
439,"Lemlem Hailemichael - Lante by Ethiopian Music 10 years ago 4 minutes, 14 seconds 19,133 views",Ethiopian Music,19133,19202,69
440,"Ermias Aschalew  and Tokichaw - Yaberedu Jima by Ethiopian Music 10 years ago 5 minutes, 32 seconds 38,065 views",Ethiopian Music,38065,38152,87
441,"Bizuneh Tegegn - Mineyawekel by Ethiopian Music 10 years ago 5 minutes, 29 seconds 1,011 views",Ethiopian Music,1011,1015,4
442,"Alemiye Getachaw - Mereba by Ethiopian Music 10 years ago 4 minutes, 41 seconds 5,144 views",Ethiopian Music,5144,5149,5
443,"Tsegaye Seme - Taziwuniham by Ethiopian Music 10 years ago 6 minutes, 10 seconds 34,170 views",Ethiopian Music,34170,34353,183
444,"Tsegaye Seme - Limu Yekun by Ethiopian Music 10 years ago 6 minutes, 36 seconds 70,681 views",Ethiopian Music,70681,71122,441
445,"Tsegaye Seme - Yesiminee by Ethiopian Music 10 years ago 5 minutes, 57 seconds 16,381 views",Ethiopian Music,16381,16467,86
446,"Tsegaye Seme - Yeshalibee by Ethiopian Music 10 years ago 5 minutes, 50 seconds 21,560 views",Ethiopian Music,21560,21661,101
447,"Tsegaye Seme - Yahuyi Baso by Ethiopian Music 10 years ago 6 minutes, 52 seconds 21,708 views",Ethiopian Music,21708,22018,310
448,"Tsegaye Seme - Saboy Sim by Ethiopian Music 10 years ago 5 minutes, 54 seconds 9,611 views",Ethiopian Music,9611,9672,61
449,"Tsegaye Seme - Lafe Bel by Ethiopian Music 10 years ago 5 minutes, 18 seconds 25,231 views",Ethiopian Music,25231,25585,354
450,"Tsegaye Seme - Egizar Yabish by Ethiopian Music 10 years ago 6 minutes, 12 seconds 17,875 views",Ethiopian Music,17875,17971,96
451,"Enkutatash Besha - Aydelem by Ethiopian Music 10 years ago 5 minutes, 13 seconds 33,731 views",Ethiopian Music,33731,33741,10
452,"Zema Sabawiyan - Alebsise by Ethiopian Music 10 years ago 4 minutes, 35 seconds 6,489 views",Ethiopian Music,6489,6526,37
453,"Amsal Mitke - Zigeyebegn by Ethiopian Music 10 years ago 5 minutes, 28 seconds 3,297 views",Ethiopian Music,3297,3407,110
454,"Amsal Mitke - Zemen Ende Seat by Ethiopian Music 10 years ago 6 minutes, 36 seconds 115,906 views",Ethiopian Music,115906,118410,2504
455,"Amsal Mitke - Geday Neh by Ethiopian Music 10 years ago 5 minutes, 39 seconds 13,124 views",Ethiopian Music,13124,13257,133
456,"Amsal Mitke - Halo Magalo by Ethiopian Music 10 years ago 6 minutes, 26 seconds 17,664 views",Ethiopian Music,17664,17810,146
457,"Amsal Mitke - Etinakakegn by Ethiopian Music 10 years ago 6 minutes, 53 seconds 20,433 views",Ethiopian Music,20433,20475,42
458,"Amsal Mitke - Biwadut by Ethiopian Music 10 years ago 5 minutes, 37 seconds 10,950 views",Ethiopian Music,10950,11013,63
459,"Amsal Mitke - Behig Amlak by Ethiopian Music 10 years ago 5 minutes, 42 seconds 9,048 views",Ethiopian Music,9048,9106,58
460,"Zerihun Demissie - Yetizita Miriko by Ethiopian Music 10 years ago 6 minutes, 22 seconds 23,450 views",Ethiopian Music,23450,23899,449
461,"Zerihun Demissie - Osha Koshena by Ethiopian Music 10 years ago 5 minutes, 6 seconds 5,530 views",Ethiopian Music,5530,5554,24
462,"Zerihun Demissie - Lamelash Yizashan by Ethiopian Music 10 years ago 6 minutes, 8 seconds 12,151 views",Ethiopian Music,12151,12396,245
463,"Zerihun Demissie - Demo Mintewera by Ethiopian Music 10 years ago 5 minutes, 28 seconds 17,149 views",Ethiopian Music,17149,17704,555
464,"Tsehaye Wolde - Asazinagn by Ethiopian Music 10 years ago 5 minutes, 23 seconds 11,944 views",Ethiopian Music,11944,11965,21
465,"Tsehaye Wolde - Amaregn by Ethiopian Music 10 years ago 5 minutes, 6 seconds 1,623 views",Ethiopian Music,1623,1627,4
466,"Tigist Fantahun - Yekirb Ruk by Ethiopian Music 10 years ago 3 minutes, 24 seconds 5,119 views",Ethiopian Music,5119,5148,29
467,"Mahlet Solomon - Wedihalehu by Ethiopian Music 10 years ago 3 minutes, 59 seconds 2,758 views",Ethiopian Music,2758,2775,17
468,"Gizachew Amera - Lijinetish by Ethiopian Music 10 years ago 4 minutes, 19 seconds 2,999 views",Ethiopian Music,2999,3020,21
469,"Endeshaw Negash - Irm Alilim Biye by Ethiopian Music 10 years ago 5 minutes, 5 seconds 2,500 views",Ethiopian Music,2500,2590,90
470,"Abebe Desalegn - Sergih Lay Neberkugn by Ethiopian Music 10 years ago 5 minutes, 3 seconds 4,286 views",Ethiopian Music,4286,4297,11
471,"Semere Kiros - Reggea Kemise by Ethiopian Music 10 years ago 6 minutes, 57 seconds 4,693 views",Ethiopian Music,4693,4703,10
472,"Fisum Demisse - Obsi by Ethiopian Music 10 years ago 5 minutes, 48 seconds 5,615 views",Ethiopian Music,5615,5618,3
473,"Behailu Tafesse - Kenuyi by Ethiopian Music 10 years ago 4 minutes, 36 seconds 18,666 views",Ethiopian Music,18666,18674,8
474,"Alex Olompia - Girlfriend's Birthday by Ethiopian Music 10 years ago 5 minutes, 10 seconds 22,956 views",Ethiopian Music,22956,22998,42
475,"Dani Boy - Felagot Betenfash by Ethiopian Music 10 years ago 5 minutes, 2 seconds 5,015 views",Ethiopian Music,5015,5045,30
476,"Jossy - Bati by Ethiopian Music 10 years ago 5 minutes, 22 seconds 1,447 views",Ethiopian Music,1447,1471,24
477,"Mimila & Kichini - Awe Awe Bade. by Ethiopian Music 10 years ago 6 minutes, 4 seconds 822,176 views",Ethiopian Music,822176,827830,5654
478,"Young Sami - Konjo by Ethiopian Music 10 years ago 2 minutes, 55 seconds 4,118 views",Ethiopian Music,4118,4179,61
479,"Behailu Tafesse - Enderasesh by Ethiopian Music 10 years ago 4 minutes, 51 seconds 7,796 views",Ethiopian Music,7796,7802,6
480,"Mahlet Demere - Ayawatam by Ethiopian Music 10 years ago 5 minutes, 8 seconds 9,863 views",Ethiopian Music,9863,9906,43
481,"Muluken Tsehay - Agebashalew by Ethiopian Music 10 years ago 4 minutes, 45 seconds 2,275 views",Ethiopian Music,2275,2278,3
482,"Layne MutuBerhan - And Nen by Ethiopian Music 10 years ago 3 minutes, 52 seconds 566 views",Ethiopian Music,566,569,3
483,"Feleke Maru - Enshoshila by Ethiopian Music 10 years ago 6 minutes, 38 seconds 157,275 views",Ethiopian Music,157275,158781,1506
484,"Asnake Cheru - Gojam Gojam Belu by Ethiopian Music 10 years ago 6 minutes, 55 seconds 1,049,539 views",Ethiopian Music,1049539,1051161,1622
485,"Zekarias Alamirew - Hagere by Ethiopian Music 10 years ago 5 minutes, 18 seconds 2,113 views",Ethiopian Music,2113,2117,4
486,"Fitsum Gebretsadik - Kiss Me by Ethiopian Music 10 years ago 5 minutes, 20 seconds 13,489 views",Ethiopian Music,13489,13559,70
487,"Messengers - Libbie by Ethiopian Music 10 years ago 5 minutes, 16 seconds 531 views",Ethiopian Music,531,532,1
488,"B Mastro - Mamush by Ethiopian Music 10 years ago 5 minutes, 28 seconds 1,086 views",Ethiopian Music,1086,1091,5
489,"Getsh Mamo - Marign Hagere by Ethiopian Music 10 years ago 4 minutes, 31 seconds 137,378 views",Ethiopian Music,137378,137471,93
490,"Girum Baye - Na Beyign by Ethiopian Music 10 years ago 4 minutes, 31 seconds 27,263 views",Ethiopian Music,27263,27287,24
491,"Sayat Demessie - Tew Maneh by Ethiopian Music 10 years ago 4 minutes, 27 seconds 3,216 views",Ethiopian Music,3216,3218,2
492,"Mikias Angaw - Tamagne Gela by Ethiopian Music 10 years ago 3 minutes, 43 seconds 7,400 views",Ethiopian Music,7400,7479,79
493,"Kaki Tesfaye - Shega Haftey by Ethiopian Music 10 years ago 5 minutes, 35 seconds 113,735 views",Ethiopian Music,113735,113950,215
494,"Gamo Boys -Tebeb by Ethiopian Music 10 years ago 4 minutes, 51 seconds 2,611 views",Ethiopian Music,2611,2619,8
495,"Fikre Zewdu - Seberta by Ethiopian Music 10 years ago 5 minutes, 38 seconds 45,297 views",Ethiopian Music,45297,45543,246
496,"Dagmawi Tsehaye - Sebseb Belu by Ethiopian Music 10 years ago 5 minutes, 15 seconds 7,613 views",Ethiopian Music,7613,7716,103
497,"Ze Blak Nothe Stars - Yagere Lij by Ethiopian Music 10 years ago 4 minutes, 14 seconds 5,742 views",Ethiopian Music,5742,5806,64
498,"Lelaalem Manaye - Yenenesh by Ethiopian Music 10 years ago 4 minutes, 15 seconds 286,109 views",Ethiopian Music,286109,286366,257
499,"Genet Woldemariam - Yewello Lij by Ethiopian Music 10 years ago 5 minutes, 51 seconds 2,829 views",Ethiopian Music,2829,2837,8
500,"Sambusa in 6 Easy Steps | Mills Kitchen by Ethiopian Music 1 year ago 7 minutes, 29 seconds 10,329 views",Ethiopian Music,10329,10512,183
501,"Kinfe Gebregergis - Timchiweni by Ethiopian Music 9 years ago 6 minutes, 17 seconds 57,270 views",Ethiopian Music,57270,57325,55
502,"Kinfe Gebregergis - Tilhit Kudadey by Ethiopian Music 9 years ago 5 minutes, 21 seconds 227,361 views",Ethiopian Music,227361,229878,2517
503,"Kinfe Gebregergis - Nihawet by Ethiopian Music 9 years ago 7 minutes, 31 seconds 467,903 views",Ethiopian Music,467903,470386,2483
504,"Kinfe Gebregergis - Lekiyoma by Ethiopian Music 9 years ago 7 minutes, 10 seconds 523,326 views",Ethiopian Music,523326,525874,2548
505,"Kinfe Gebregergis - Awda Amet by Ethiopian Music 9 years ago 8 minutes, 15 seconds 18,381 views",Ethiopian Music,18381,18400,19
506,"Kinfe Gebregergis - Amel by Ethiopian Music 9 years ago 6 minutes, 57 seconds 231,719 views",Ethiopian Music,231719,233402,1683
507,"Kinfe Gebregergis - Adi Anbesa by Ethiopian Music 9 years ago 6 minutes, 59 seconds 86,842 views",Ethiopian Music,86842,87828,986
508,"Reshad Kedir - Miriyamore by Ethiopian Music 9 years ago 6 minutes 72,713 views",Ethiopian Music,72713,73039,326
509,"Teka Asefa - Wegush by Ethiopian Music 9 years ago 4 minutes, 16 seconds 134,072 views",Ethiopian Music,134072,135446,1374
510,"Desalegn Mersha - Ayarsha by Ethiopian Music 9 years ago 5 minutes, 36 seconds 35,518 views",Ethiopian Music,35518,35712,194
511,"Demise Teka - Yewerema Gere by Ethiopian Music 9 years ago 5 minutes, 18 seconds 12,796 views",Ethiopian Music,12796,12816,20
512,"Demise Teka - Yehirm Hirm by Ethiopian Music 9 years ago 4 minutes, 28 seconds 45,440 views",Ethiopian Music,45440,46259,819
513,"Demise Teka - Yab Tadot Bet by Ethiopian Music 9 years ago 4 minutes, 49 seconds 62,300 views",Ethiopian Music,62300,63398,1098
514,"Demise Teka - Tiyarisina by Ethiopian Music 9 years ago 4 minutes, 41 seconds 67,737 views",Ethiopian Music,67737,68164,427
515,"Demise Teka - Nizigidina by Ethiopian Music 9 years ago 8 minutes, 10 seconds 80,696 views",Ethiopian Music,80696,81467,771
516,"Demise Teka - Betena Mura by Ethiopian Music 9 years ago 3 minutes, 59 seconds 66,090 views",Ethiopian Music,66090,66852,762
517,"Demise Teka - Arte Azemena by Ethiopian Music 9 years ago 5 minutes, 12 seconds 163,642 views",Ethiopian Music,163642,164964,1322
518,"Aragaw Belay - Abay Gudal by Ethiopian Music 9 years ago 6 minutes, 48 seconds 478,578 views",Ethiopian Music,478578,478868,290
519,"Yohanes Argaw (Joni) - Eski Ney Leyesh by Ethiopian Music 9 years ago 5 minutes, 15 seconds 27,203 views",Ethiopian Music,27203,27852,649
520,"Ashenafi Kebede - Lebura by Ethiopian Music 9 years ago 6 minutes, 6 seconds 30,294 views",Ethiopian Music,30294,30356,62
521,"Endashaw Negash - Feyay by Ethiopian Music 9 years ago 5 minutes, 24 seconds 11,909 views",Ethiopian Music,11909,12083,174
522,"Braahim Muhaamaadii - Rufaarufaaree by Ethiopian Music 9 years ago 5 minutes, 29 seconds 7,003 views",Ethiopian Music,7003,7031,28
523,"Ashenafi Bogale - Ayn Aykelekel by Ethiopian Music 9 years ago 4 minutes, 59 seconds 15,621 views",Ethiopian Music,15621,15676,55
524,"Ashu Guma - Untitled by Ethiopian Music 9 years ago 4 minutes, 59 seconds 6,777 views",Ethiopian Music,6777,6800,23
525,"Ashenafi Bogale - Goma by Ethiopian Music 9 years ago 4 minutes, 57 seconds 24,746 views",Ethiopian Music,24746,24844,98
526,"Agere Legesse - Ney Likasesh by Ethiopian Music 9 years ago 5 minutes, 49 seconds 16,888 views",Ethiopian Music,16888,16956,68
527,"Agere Legesse - Yefikir Awdina by Ethiopian Music 9 years ago 6 minutes, 18 seconds 17,425 views",Ethiopian Music,17425,17495,70
528,"Agere Legesse - Untitled 2 by Ethiopian Music 9 years ago 6 minutes, 17 seconds 16,793 views",Ethiopian Music,16793,16871,78
529,"Monika Sisay - Yewelo Lij by Ethiopian Music 9 years ago 6 minutes, 2 seconds 140,725 views",Ethiopian Music,140725,142322,1597
530,"Monika Sisay - Yaw Tegegntual by Ethiopian Music 9 years ago 6 minutes, 5 seconds 11,370 views",Ethiopian Music,11370,11478,108
531,"Monika Sisay - Shekshik by Ethiopian Music 9 years ago 6 minutes, 22 seconds 15,526 views",Ethiopian Music,15526,15781,255
532,"Monika Sisay - Libih Lela Lemdo by Ethiopian Music 9 years ago 6 minutes, 2 seconds 77,076 views",Ethiopian Music,77076,77748,672
533,"Monika Sisay - Fikre Temekakren by Ethiopian Music 9 years ago 5 minutes, 31 seconds 50,787 views",Ethiopian Music,50787,51394,607
534,"Dereje Haile ena Habte Mitiku - Min Yilishal by Ethiopian Music 9 years ago 4 minutes, 25 seconds 88,401 views",Ethiopian Music,88401,90930,2529
535,"Dereje Haile ena Habte Mitiku - Zemena by Ethiopian Music 9 years ago 1 minute, 59 seconds 14,471 views",Ethiopian Music,14471,14996,525
536,"Dereje Haile ena Habte Mitiku - Muyash by Ethiopian Music 9 years ago 3 minutes, 54 seconds 45,396 views",Ethiopian Music,45396,46754,1358
537,"Dereje Haile ena Habte Mitiku - Kiray by Ethiopian Music 9 years ago 4 minutes, 14 seconds 42,330 views",Ethiopian Music,42330,43675,1345
538,"Dereje Haile ena Habte Mitiku - Duba by Ethiopian Music 9 years ago 3 minutes, 42 seconds 61,886 views",Ethiopian Music,61886,63244,1358
539,"Dereje Haile ena Habte Mitiku - Arada by Ethiopian Music 9 years ago 3 minutes, 58 seconds 217,962 views",Ethiopian Music,217962,223901,5939
540,"Zelalem Atalay - Balageru by Ethiopian Music 9 years ago 6 minutes, 48 seconds 101,837 views",Ethiopian Music,101837,101966,129
541,"Wala - Kererto by Ethiopian Music 9 years ago 7 minutes, 9 seconds 325,704 views",Ethiopian Music,325704,325855,151
542,"Tizazu Ayalaw - Nay Alem by Ethiopian Music 9 years ago 3 minutes, 56 seconds 477,366 views",Ethiopian Music,477366,478163,797
543,"Shewaye Zewuale - Yizezegna by Ethiopian Music 9 years ago 5 minutes, 38 seconds 33,622 views",Ethiopian Music,33622,33669,47
544,"Miretu Bazu - Shilela by Ethiopian Music 9 years ago 4 minutes, 14 seconds 320,062 views",Ethiopian Music,320062,320222,160
545,"Miretu Bazu - Hedech Alu by Ethiopian Music 9 years ago 5 minutes, 37 seconds 75,407 views",Ethiopian Music,75407,75516,109
546,"Miretu Bazu - Hay Minamuna by Ethiopian Music 9 years ago 9 minutes, 26 seconds 579,468 views",Ethiopian Music,579468,582006,2538
547,"Meseret Jembera - Shilela by Ethiopian Music 9 years ago 5 minutes, 24 seconds 62,910 views",Ethiopian Music,62910,62940,30
548,"Meseret Jembera - Kererto by Ethiopian Music 9 years ago 5 minutes, 32 seconds 49,275 views",Ethiopian Music,49275,49305,30
549,"Meseret Jembera - Kererto 2 by Ethiopian Music 9 years ago 6 minutes, 6 seconds 116,900 views",Ethiopian Music,116900,116979,79
550,"Meseret Jembera - Gondar by Ethiopian Music 9 years ago 5 minutes, 42 seconds 189,928 views",Ethiopian Music,189928,190519,591
551,"Kasahun Werkneh - Shilela by Ethiopian Music 9 years ago 6 minutes, 9 seconds 155,717 views",Ethiopian Music,155717,155808,91
552,"Teshome Wolde - Yeshewa Alemena by Ethiopian Music 9 years ago 5 minutes, 17 seconds 19,822 views",Ethiopian Music,19822,19982,160
553,"Fikiraddis Nekatibeb - Sabalew by Ethiopian Music 9 years ago 6 minutes, 10 seconds 53,652 views",Ethiopian Music,53652,53899,247
554,"Tadese Abraha - Muna by Ethiopian Music 9 years ago 5 minutes, 34 seconds 10,923 views",Ethiopian Music,10923,11013,90
555,"Demere Legesse - Kotu Malo by Ethiopian Music 9 years ago 6 minutes, 53 seconds 59,856 views",Ethiopian Music,59856,60094,238
556,"Meseret Belete - Emamu Geday by Ethiopian Music 9 years ago 4 minutes, 45 seconds 41,148 views",Ethiopian Music,41148,41671,523
557,"Fasil Demoz - Bilakem by Ethiopian Music 9 years ago 8 minutes, 22 seconds 133,477 views",Ethiopian Music,133477,133930,453
558,"Adane Teka - Biharesebachena by Ethiopian Music 9 years ago 4 minutes, 45 seconds 84,078 views",Ethiopian Music,84078,84259,181
559,"Semahegn Belew - Balageru by Ethiopian Music 9 years ago 7 minutes, 27 seconds 98,193 views",Ethiopian Music,98193,99118,925
560,"Derege Degefaw - Altemechednam by Ethiopian Music 9 years ago 6 minutes, 58 seconds 8,880 views",Ethiopian Music,8880,8922,42
561,"Metseba Milinyem by Ethiopian Music 9 years ago 8 minutes, 17 seconds 961 views",Ethiopian Music,961,962,1
562,"Muchay Zerega by Ethiopian Music 9 years ago 6 minutes, 26 seconds 2,357 views",Ethiopian Music,2357,2365,8
563,"Begu by Ethiopian Music 9 years ago 9 minutes, 6 seconds 2,888 views",Ethiopian Music,2888,2900,12
564,"Tadese Alemu - Shir Bela by Ethiopian Music 9 years ago 10 minutes, 24 seconds 5,959 views",Ethiopian Music,5959,6142,183
565,"Tadese Alemu - Sela by Ethiopian Music 9 years ago 7 minutes, 45 seconds 2,646 views",Ethiopian Music,2646,2664,18
566,"Tadese Alemu - Misha Misho by Ethiopian Music 9 years ago 6 minutes, 16 seconds 6,131 views",Ethiopian Music,6131,6261,130
567,"Tadese Alemu - Goje Melegnaw by Ethiopian Music 9 years ago 7 minutes, 11 seconds 16,939 views",Ethiopian Music,16939,17387,448
568,"Tadese Alemu - Eyamaru Gela by Ethiopian Music 9 years ago 8 minutes, 54 seconds 1,693 views",Ethiopian Music,1693,1701,8
569,"Tadese Alemu - Erikum by Ethiopian Music 9 years ago 6 minutes, 37 seconds 7,603 views",Ethiopian Music,7603,7658,55
570,"Tadese Alemu - Emo Yagurasew by Ethiopian Music 9 years ago 6 minutes, 11 seconds 24,844 views",Ethiopian Music,24844,25090,246
571,"Tadese Alemu - Awdamet by Ethiopian Music 9 years ago 5 minutes, 34 seconds 4,323 views",Ethiopian Music,4323,4456,133
572,"Tadese Alemu - Arada by Ethiopian Music 9 years ago 7 minutes, 12 seconds 3,684 views",Ethiopian Music,3684,3852,168
573,"Tadese Alemu - Alamano by Ethiopian Music 9 years ago 6 minutes, 6 seconds 13,902 views",Ethiopian Music,13902,13972,70
574,"Endalekachew  Yeneyhun (2Pac) - Kwas by Ethiopian Music 9 years ago 6 minutes, 21 seconds 18,037 views",Ethiopian Music,18037,18231,194
575,"Endalekachew  Yeneyhun (2Pac) - Masiko by Ethiopian Music 9 years ago 6 minutes, 47 seconds 23,196 views",Ethiopian Music,23196,23370,174
576,"Endalekachew  Yeneyhun (2Pac) - Untitled by Ethiopian Music 9 years ago 5 minutes, 47 seconds 5,178 views",Ethiopian Music,5178,5283,105
577,"Mudade - Gasa by Ethiopian Music 9 years ago 4 minutes, 50 seconds 2,272 views",Ethiopian Music,2272,2286,14
578,"Zuriyash Abiyu - Arada by Ethiopian Music 9 years ago 7 minutes, 55 seconds 2,128 views",Ethiopian Music,2128,2137,9
579,"Tigabu Chernet - Balageru by Ethiopian Music 9 years ago 5 minutes, 7 seconds 2,041 views",Ethiopian Music,2041,2049,8
580,"Tigabu Chernet - Zew Zew by Ethiopian Music 9 years ago 3 minutes, 56 seconds 2,815 views",Ethiopian Music,2815,2828,13
581,"Teferi - Lembo (Sidamo) by Ethiopian Music 9 years ago 4 minutes, 5 seconds 2,468 views",Ethiopian Music,2468,2479,11
582,"Tigabu Chernet - Agewenga by Ethiopian Music 9 years ago 4 minutes, 12 seconds 1,585 views",Ethiopian Music,1585,1588,3
583,"Melaku Chachisa - Erikuma by Ethiopian Music 9 years ago 4 minutes, 57 seconds 3,426 views",Ethiopian Music,3426,3458,32
584,"Fasil Demewoz - Yewesawa by Ethiopian Music 9 years ago 5 minutes, 18 seconds 9,241 views",Ethiopian Music,9241,9257,16
585,"Jimi Wedera Birhanu - Desa Lay by Ethiopian Music 9 years ago 4 minutes, 7 seconds 9,981 views",Ethiopian Music,9981,10076,95
586,"Abonesh Adinew - Guragigna by Ethiopian Music 9 years ago 4 minutes, 19 seconds 75,004 views",Ethiopian Music,75004,75459,455
587,"Fasil Demewoz - Aynuma by Ethiopian Music 9 years ago 6 minutes, 21 seconds 78,725 views",Ethiopian Music,78725,79247,522
588,"Elisabet Meshesha - Awdamet by Ethiopian Music 9 years ago 5 minutes, 19 seconds 957 views",Ethiopian Music,957,960,3
589,"Dimisawiyan - Megibeya Gitim by Ethiopian Music 9 years ago 3 minutes, 49 seconds 1,092 views",Ethiopian Music,1092,1095,3
590,"Yeshi Demelash - Tizita by Ethiopian Music 9 years ago 4 minutes, 20 seconds 75,207 views",Ethiopian Music,75207,75243,36
591,"Yeshi Demelash - Qine by Ethiopian Music 9 years ago 4 minutes, 16 seconds 17,974 views",Ethiopian Music,17974,18017,43
592,"Endeshaw Kasaw - Abay Dar Komeyalehu by Ethiopian Music 9 years ago 5 minutes, 22 seconds 38,757 views",Ethiopian Music,38757,39224,467
593,"Yusef Maga (Josi) - Ebana Ebana by Ethiopian Music 9 years ago 5 minutes, 42 seconds 2,774 views",Ethiopian Music,2774,2775,1
594,"Tigist Adisu - Yewelo Lij Nana by Ethiopian Music 9 years ago 5 minutes, 36 seconds 72,232 views",Ethiopian Music,72232,72351,119
595,"Tigist Adisu - Ya Wegene by Ethiopian Music 9 years ago 5 minutes, 35 seconds 381,593 views",Ethiopian Music,381593,382813,1220
596,"Tigabe Zerihun - Hode Abeba by Ethiopian Music 9 years ago 6 minutes, 39 seconds 55,418 views",Ethiopian Music,55418,56093,675
597,"Maritu Tesema Alew - Sifiligih Keramiku (Shebelaye) by Ethiopian Music 9 years ago 5 minutes, 8 seconds 104,349 views",Ethiopian Music,104349,105174,825
598,"Maritu Tesema Alew - Mekenatan Lifta by Ethiopian Music 9 years ago 6 minutes, 20 seconds 169,084 views",Ethiopian Music,169084,170550,1466
599,"Maritu Tesema Alew - Bat Tehulet Suri by Ethiopian Music 9 years ago 5 minutes, 52 seconds 32,358 views",Ethiopian Music,32358,32505,147
600,"Mareshet Damtaw - Kadele by Ethiopian Music 9 years ago 5 minutes, 26 seconds 20,207 views",Ethiopian Music,20207,20269,62
601,"Habtamu Tedla - Megen Menye by Ethiopian Music 9 years ago 5 minutes, 18 seconds 9,717 views",Ethiopian Music,9717,9777,60
602,"Genene Asefa - Wiletaw Belay by Ethiopian Music 9 years ago 7 minutes, 6 seconds 15,958 views",Ethiopian Music,15958,15973,15
603,"Genene Asefa - Na Belegn by Ethiopian Music 9 years ago 5 minutes, 25 seconds 5,181 views",Ethiopian Music,5181,5196,15
604,"Ertihu Agegnehu - Yeawiwa Lij by Ethiopian Music 9 years ago 5 minutes, 57 seconds 30,053 views",Ethiopian Music,30053,30075,22
605,"Ertihu Agegnehu -  Sorina by Ethiopian Music 9 years ago 5 minutes, 29 seconds 11,316 views",Ethiopian Music,11316,11325,9
606,"Endeshaw Kasaw - Bederaku Lachegn (Shelela) by Ethiopian Music 9 years ago 7 minutes, 2 seconds 274,799 views",Ethiopian Music,274799,275005,206
607,"Belachew Garedu - New Mela by Ethiopian Music 9 years ago 7 minutes, 19 seconds 59,051 views",Ethiopian Music,59051,59404,353
608,"Belachew Garedu - Ashebel Gedawa by Ethiopian Music 9 years ago 5 minutes, 37 seconds 157,272 views",Ethiopian Music,157272,157630,358
609,"Atirisaw Debalike - Ney Ney Yene Abeba by Ethiopian Music 9 years ago 7 minutes, 38 seconds 27,181 views",Ethiopian Music,27181,27547,366
610,"Asmamaw Lema - Yeabay Yetan Lij by Ethiopian Music 9 years ago 4 minutes, 34 seconds 11,715 views",Ethiopian Music,11715,11754,39
611,"Andualem Ayelew - Anchim Dehna Dehna by Ethiopian Music 9 years ago 6 minutes, 48 seconds 13,719 views",Ethiopian Music,13719,13744,25
612,"Alelign Tilahun - Kora Yalew Betu by Ethiopian Music 9 years ago 6 minutes, 38 seconds 227,243 views",Ethiopian Music,227243,230436,3193
613,"Moges Mebratu - Alichalekum by Ethiopian Music 9 years ago 4 minutes, 46 seconds 33,883 views",Ethiopian Music,33883,33895,12
614,"Mikael Solomon - Weleyua by Ethiopian Music 9 years ago 7 minutes, 29 seconds 5,090 views",Ethiopian Music,5090,5136,46
615,"Mesfin Bekele - Bahir Dar Yalashaw by Ethiopian Music 9 years ago 6 minutes, 18 seconds 33,842 views",Ethiopian Music,33842,33905,63
616,"Mahamed Hasan - Gira Gebagna by Ethiopian Music 9 years ago 4 minutes, 53 seconds 3,923 views",Ethiopian Music,3923,3929,6
617,"Degal Mekonen - Set by Ethiopian Music 9 years ago 5 minutes, 47 seconds 4,138 views",Ethiopian Music,4138,4151,13
618,"Bisrat Garedew - Saylawis Afua by Ethiopian Music 9 years ago 4 minutes, 52 seconds 130,486 views",Ethiopian Music,130486,131038,552
619,"Ashanafi Mulugeta - Befikir Tirigna by Ethiopian Music 9 years ago 5 minutes, 6 seconds 4,356 views",Ethiopian Music,4356,4363,7
620,"Anteneh Aynalan - Ayuga by Ethiopian Music 9 years ago 5 minutes 5,991 views",Ethiopian Music,5991,5994,3
621,"Zewditu Asechalew - Yabay Dar Gumare by Ethiopian Music 9 years ago 5 minutes, 1 second 485,190 views",Ethiopian Music,485190,486003,813
622,"Zewditu Asechalew - Sekota by Ethiopian Music 9 years ago 5 minutes, 32 seconds 395,956 views",Ethiopian Music,395956,396244,288
623,"Zemenay Tiliku - Bichana Belay by Ethiopian Music 9 years ago 4 minutes, 30 seconds 36,266 views",Ethiopian Music,36266,36289,23
624,"Werku Andualem - Selam Nesh Gonder by Ethiopian Music 9 years ago 5 minutes, 43 seconds 126,049 views",Ethiopian Music,126049,126381,332
625,"Werku Andualem - Anchi Asesa by Ethiopian Music 9 years ago 6 minutes, 43 seconds 374,267 views",Ethiopian Music,374267,374910,643
626,"Kebebush Gedefaw - Tewelija by Ethiopian Music 9 years ago 5 minutes, 47 seconds 243,314 views",Ethiopian Music,243314,244546,1232
627,"Kebebush Gedefaw - Ara Erya by Ethiopian Music 9 years ago 5 minutes, 47 seconds 116,361 views",Ethiopian Music,116361,116807,446
628,"Banchiamlak Belayneh - Belay by Ethiopian Music 9 years ago 4 minutes, 40 seconds 122,436 views",Ethiopian Music,122436,123299,863
629,"Aragahagn Fikadu - Yegamitidi by Ethiopian Music 9 years ago 5 minutes, 33 seconds 3,644 views",Ethiopian Music,3644,3808,164
630,"Aragahagn Fikadu - Wacho Kebe Yesechu Bedocho by Ethiopian Music 9 years ago 6 minutes, 48 seconds 10,439 views",Ethiopian Music,10439,10648,209
631,"Aragahagn Fikadu - Nazagnu by Ethiopian Music 9 years ago 5 minutes, 7 seconds 33,306 views",Ethiopian Music,33306,34500,1194
632,"Aragahagn Fikadu - Instrumental 2 by Ethiopian Music 9 years ago 5 minutes, 12 seconds 7,297 views",Ethiopian Music,7297,7314,17
633,"Aragahagn Fikadu - Instrumental 1 by Ethiopian Music 9 years ago 4 minutes, 48 seconds 6,577 views",Ethiopian Music,6577,6595,18
634,"Aragahagn Fikadu - Emtede by Ethiopian Music 9 years ago 5 minutes, 29 seconds 3,478 views",Ethiopian Music,3478,3499,21
635,"Aragahagn Fikadu - Bakato Yibalote Yeketo by Ethiopian Music 9 years ago 4 minutes, 18 seconds 7,004 views",Ethiopian Music,7004,7308,304
636,"Aragahagn Fikadu - Atebile by Ethiopian Music 9 years ago 7 minutes, 47 seconds 24,438 views",Ethiopian Music,24438,25663,1225
637,"Aragahagn Fikadu - Ametebalochegna by Ethiopian Music 9 years ago 5 minutes, 33 seconds 6,614 views",Ethiopian Music,6614,6649,35
638,"Tizialu Fante - Emotilatalahu by Ethiopian Music 9 years ago 6 minutes, 31 seconds 895,362 views",Ethiopian Music,895362,896214,852
639,"Silashi Yagizawe - Yemasinko Shufer by Ethiopian Music 9 years ago 7 minutes, 28 seconds 40,959 views",Ethiopian Music,40959,41196,237
640,"Haymanot Sisaye ena Silashi Yagizawe - Egnaw Entarake by Ethiopian Music 9 years ago 6 minutes, 53 seconds 1,675,962 views",Ethiopian Music,1675962,1695947,19985
641,"Getachaw Zewdu - Erikum by Ethiopian Music 9 years ago 6 minutes, 13 seconds 1,650,774 views",Ethiopian Music,1650774,1653814,3040
642,"Getachaw Zewdu - Anbesa Gedaye by Ethiopian Music 9 years ago 5 minutes, 36 seconds 32,811 views",Ethiopian Music,32811,32841,30
643,"Getachaw Zewdu - Aba Kositir by Ethiopian Music 9 years ago 11 minutes, 28 seconds 39,772 views",Ethiopian Music,39772,39800,28
644,"Eyachiw Abuye ena Haymonot Sisaya - Ayale Bezina by Ethiopian Music 9 years ago 6 minutes, 29 seconds 369,708 views",Ethiopian Music,369708,369988,280
645,"Eyachiw Abuye - Tizita by Ethiopian Music 9 years ago 6 minutes, 21 seconds 249,027 views",Ethiopian Music,249027,249186,159
646,"Eyachiw Abuye - Aya Belaw by Ethiopian Music 9 years ago 6 minutes, 45 seconds 456,597 views",Ethiopian Music,456597,458055,1458
647,"Laggasaa Abdii - Untitled by Ethiopian Music 9 years ago 5 minutes, 33 seconds 11,704 views",Ethiopian Music,11704,11743,39
648,"Jireenyaa Dassalee  - Untitled by Ethiopian Music 9 years ago 6 minutes, 25 seconds 4,354 views",Ethiopian Music,4354,4361,7
649,"Jireenyaa Dassalee and Hawin Tazarraa - Untitled by Ethiopian Music 9 years ago 6 minutes, 49 seconds 11,990 views",Ethiopian Music,11990,11998,8
650,"Hawin Tazarraa - Untitled 2 by Ethiopian Music 9 years ago 4 minutes, 34 seconds 13,114 views",Ethiopian Music,13114,13118,4
651,"Hawin Tazarraa - Untitled 1 by Ethiopian Music 9 years ago 3 minutes, 6 seconds 15,808 views",Ethiopian Music,15808,15809,1
652,"Halloo Daawwee - Untitled 2 by Ethiopian Music 9 years ago 6 minutes, 33 seconds 98,185 views",Ethiopian Music,98185,98195,10
653,"Halloo Daawwee - Untitled 1 by Ethiopian Music 9 years ago 6 minutes, 15 seconds 18,989 views",Ethiopian Music,18989,18993,4
654,"Agere Legesse - Untitled by Ethiopian Music 9 years ago 6 minutes, 7 seconds 5,946 views",Ethiopian Music,5946,5953,7
655,"Abdii Ibraahime - Untitled 2 by Ethiopian Music 9 years ago 6 minutes, 45 seconds 10,711 views",Ethiopian Music,10711,10717,6
656,"Abdii Ibraahime - Untitled 1 by Ethiopian Music 9 years ago 5 minutes, 55 seconds 7,917 views",Ethiopian Music,7917,7921,4
657,"Yitayaw Dagne - Yane Ayal by Ethiopian Music 9 years ago 5 minutes, 43 seconds 91,864 views",Ethiopian Music,91864,92208,344
658,"Yitayaw Dagne - Marakee Wibatwa by Ethiopian Music 9 years ago 5 minutes, 30 seconds 383,444 views",Ethiopian Music,383444,384128,684
659,"Yitayaw Dagne - Lewey Lewey by Ethiopian Music 9 years ago 5 minutes, 34 seconds 41,579 views",Ethiopian Music,41579,41917,338
660,"Yitayaw Dagne - Abay Molalish by Ethiopian Music 9 years ago 6 minutes, 3 seconds 36,864 views",Ethiopian Music,36864,37200,336
661,"Mola Satiarge - Wey Wey by Ethiopian Music 9 years ago 5 minutes, 12 seconds 148,808 views",Ethiopian Music,148808,149412,604
662,"Mola Satiarge - Gondar by Ethiopian Music 9 years ago 5 minutes, 37 seconds 14,351 views",Ethiopian Music,14351,14392,41
663,"Mola Satiarge - Dinbilo Abeba by Ethiopian Music 9 years ago 6 minutes, 12 seconds 112,924 views",Ethiopian Music,112924,113318,394
664,"Mola Satiarge - Dena Belaw by Ethiopian Music 9 years ago 5 minutes, 35 seconds 44,258 views",Ethiopian Music,44258,44917,659
665,"Mola Satiarge - Abebaye Nesh by Ethiopian Music 9 years ago 5 minutes, 41 seconds 228,677 views",Ethiopian Music,228677,229062,385
666,"Misiganaw Yitayaw - Yedeman Shama by Ethiopian Music 9 years ago 5 minutes, 26 seconds 491,794 views",Ethiopian Music,491794,492992,1198
667,"Zenebech Taday - Hod Yefajaw by Ethiopian Music 9 years ago 5 minutes, 58 seconds 1,063,658 views",Ethiopian Music,1063658,1067632,3974
668,"Mola Setarege - Yekubat Magado by Ethiopian Music 9 years ago 7 minutes, 12 seconds 520,337 views",Ethiopian Music,520337,522285,1948
669,"Mola Setarege - Yekonjo Leba by Ethiopian Music 9 years ago 5 minutes, 9 seconds 99,174 views",Ethiopian Music,99174,100480,1306
670,"Mola Setarege - Min Amatash by Ethiopian Music 9 years ago 3 minutes, 43 seconds 751,535 views",Ethiopian Music,751535,752954,1419
671,"Mola Setarege - Endet Nesh by Ethiopian Music 9 years ago 5 minutes, 19 seconds 246,617 views",Ethiopian Music,246617,247410,793
672,"Mimi Muluken - Man Semaw by Ethiopian Music 9 years ago 6 minutes, 32 seconds 44,043 views",Ethiopian Music,44043,44556,513
673,"Betelehem Aklilu - Min Alkat by Ethiopian Music 9 years ago 4 minutes, 40 seconds 166,808 views",Ethiopian Music,166808,169509,2701
674,"Mimi Muluken - Ayen Ayenehen by Ethiopian Music 9 years ago 5 minutes, 33 seconds 142,505 views",Ethiopian Music,142505,144206,1701
675,"Betelehem Aklilu - Chawa Neh by Ethiopian Music 9 years ago 4 minutes, 15 seconds 401,964 views",Ethiopian Music,401964,406586,4622
676,"Betelehem Aklilu - Bagar by Ethiopian Music 9 years ago 6 minutes, 43 seconds 3,163,393 views",Ethiopian Music,3163393,3182628,19235
677,"Yenegete Fantahun - Endet Nesh by Ethiopian Music 9 years ago 3 minutes, 56 seconds 17,118 views",Ethiopian Music,17118,17146,28
678,"Tigist Addisu - Yekolo Tamari by Ethiopian Music 9 years ago 4 minutes, 29 seconds 10,025 views",Ethiopian Music,10025,10052,27
679,"Moke Awedametu - Beiweketu Sewmehone by Ethiopian Music 9 years ago 5 minutes, 15 seconds 2,244 views",Ethiopian Music,2244,2246,2
680,"Jejewe Ababu and Abebou Abohaye - Zemerow by Ethiopian Music 9 years ago 8 minutes, 16 seconds 297,604 views",Ethiopian Music,297604,298159,555
681,"Genene Asefa - Zomaye by Ethiopian Music 9 years ago 6 minutes, 53 seconds 14,851 views",Ethiopian Music,14851,14863,12
682,"Andoalem Lema - Tyemanesh by Ethiopian Music 9 years ago 5 minutes 18,237 views",Ethiopian Music,18237,18332,95
683,"Endalekachew Yeneyhun (2Pac) - Getemegne by Ethiopian Music 9 years ago 6 minutes, 51 seconds 155,554 views",Ethiopian Music,155554,156448,894
684,"Adane Teka - Yeadane Feretoche by Ethiopian Music 9 years ago 6 minutes, 38 seconds 75,800 views",Ethiopian Music,75800,75958,158
685,"Adane Teka - Sekota by Ethiopian Music 9 years ago 6 minutes, 38 seconds 61,022 views",Ethiopian Music,61022,61147,125
686,"Tenay Teshale - Gondere New by Ethiopian Music 9 years ago 5 minutes, 51 seconds 47,306 views",Ethiopian Music,47306,47337,31
687,"Eteneshe Girma - Teweledo Gojam New by Ethiopian Music 9 years ago 4 minutes, 41 seconds 80,179 views",Ethiopian Music,80179,80240,61
688,"Ashabere Belaye - Serg Behagerachen by Ethiopian Music 9 years ago 6 minutes, 16 seconds 20,459 views",Ethiopian Music,20459,20484,25
689,"Andoalem Dagnachew - Yekefa Lij by Ethiopian Music 9 years ago 6 minutes, 18 seconds 71,423 views",Ethiopian Music,71423,71655,232
690,"Andoalem Dagnachew - Yagerene Libese by Ethiopian Music 9 years ago 5 minutes, 47 seconds 194,660 views",Ethiopian Music,194660,195259,599
691,"Andoalem Dagnachew - Kebela New Zare by Ethiopian Music 9 years ago 5 minutes, 35 seconds 64,322 views",Ethiopian Music,64322,64484,162
692,"Andoalem Dagnachew - Fiker Be Efrata by Ethiopian Music 9 years ago 6 minutes, 23 seconds 203,448 views",Ethiopian Music,203448,204155,707
693,"Andoalem Dagnachew - Efoye Beleshe by Ethiopian Music 9 years ago 5 minutes, 46 seconds 64,329 views",Ethiopian Music,64329,64486,157
694,"Andoalem Dagnachew - Atemecheme Weye by Ethiopian Music 9 years ago 6 minutes, 4 seconds 282,009 views",Ethiopian Music,282009,282349,340
695,"Tege Wegene (Gule Wegene) - Aferekawe Girema by Ethiopian Music 9 years ago 6 minutes, 8 seconds 9,961 views",Ethiopian Music,9961,9966,5
696,"Tesfaye Gedeye - Tehegusu Do Kmaye by Ethiopian Music 9 years ago 7 minutes, 5 seconds 166,251 views",Ethiopian Music,166251,166326,75
697,"Tege Wegene (Gule Wegene) - Wesene by Ethiopian Music 9 years ago 5 minutes, 36 seconds 24,314 views",Ethiopian Music,24314,24331,17
698,"Tege Wegene (Gule Wegene) - Demke Berhane by Ethiopian Music 9 years ago 5 minutes, 45 seconds 17,923 views",Ethiopian Music,17923,17932,9
699,"Muse Taeme - Meleye by Ethiopian Music 9 years ago 6 minutes, 25 seconds 10,908 views",Ethiopian Music,10908,10915,7
700,"Kenefe GebreGereges - Kesade Brile by Ethiopian Music 9 years ago 6 minutes, 31 seconds 5,891 views",Ethiopian Music,5891,5896,5
701,"Hiruye GebreSelase - Tilaleye by Ethiopian Music 9 years ago 5 minutes, 18 seconds 10,375 views",Ethiopian Music,10375,10386,11
702,"Dgefe Meruti - Tiaba Tigebe by Ethiopian Music 9 years ago 3 minutes, 41 seconds 6,099 views",Ethiopian Music,6099,6111,12
703,"Atahaleti Demaze - Bhele Adhe by Ethiopian Music 9 years ago 6 minutes, 6 seconds 9,758 views",Ethiopian Music,9758,9764,6
704,"Anbesa Tehila - Niesnete by Ethiopian Music 9 years ago 5 minutes, 50 seconds 228,402 views",Ethiopian Music,228402,228906,504
705,"Anbesa Tehila - Ati Mizere by Ethiopian Music 9 years ago 5 minutes, 47 seconds 10,364 views",Ethiopian Music,10364,10417,53
706,"Anbesa Tehila - Ati Gamay Kihlo by Ethiopian Music 9 years ago 6 minutes, 11 seconds 47,643 views",Ethiopian Music,47643,47819,176
707,"Yodit Worku - Yeserg Bahlachin by Ethiopian Music 10 years ago 5 minutes, 12 seconds 135,790 views",Ethiopian Music,135790,135925,135
708,"Tadese Meket - Ediget Banadinat by Ethiopian Music 10 years ago 8 minutes, 31 seconds 123,178 views",Ethiopian Music,123178,125665,2487
709,"Habtamu Abere - Arso Bale by Ethiopian Music 10 years ago 5 minutes, 44 seconds 12,923 views",Ethiopian Music,12923,12930,7
710,"Gizachw Teklemariam - Yekolo Tamari by Ethiopian Music 10 years ago 6 minutes, 2 seconds 7,183 views",Ethiopian Music,7183,7190,7
711,"Gizachew Teklemariam - Wayno by Ethiopian Music 10 years ago 6 minutes, 29 seconds 21,163 views",Ethiopian Music,21163,21200,37
712,"Begashaw Tefere - Gojam by Ethiopian Music 10 years ago 5 minutes, 59 seconds 80,800 views",Ethiopian Music,80800,80820,20
713,"Aster Mulualem - Haya Bal by Ethiopian Music 10 years ago 5 minutes, 20 seconds 21,470 views",Ethiopian Music,21470,21508,38
714,"Asmamaw Masmur - Hagere Malo by Ethiopian Music 10 years ago 4 minutes, 35 seconds 5,688 views",Ethiopian Music,5688,5692,4
715,"Almaza Tajeb - KelKay Yesenim by Ethiopian Music 10 years ago 4 minutes, 16 seconds 6,113 views",Ethiopian Music,6113,6122,9
716,"Tefere Selefe - Yadinagay Sir Wiha by Ethiopian Music 10 years ago 7 minutes, 4 seconds 71,903 views",Ethiopian Music,71903,72475,572
717,"Tefere Selefe - Etu Mela Zewda by Ethiopian Music 10 years ago 6 minutes, 26 seconds 211,442 views",Ethiopian Music,211442,212326,884
718,"Tefere Selefe - Deldil Belew by Ethiopian Music 10 years ago 8 minutes, 56 seconds 16,380 views",Ethiopian Music,16380,16675,295
719,"Sara Mamo - Shaday by Ethiopian Music 10 years ago 7 minutes, 10 seconds 37,349 views",Ethiopian Music,37349,37653,304
720,"Mekwananat Melese - Yiku Banizew by Ethiopian Music 10 years ago 6 minutes, 9 seconds 31,488 views",Ethiopian Music,31488,31785,297
721,"Benachi Amlak Getahun - Tizita by Ethiopian Music 10 years ago 7 minutes, 13 seconds 34,664 views",Ethiopian Music,34664,37412,2748
722,"Aweru Iyasu - Yalemway by Ethiopian Music 10 years ago 5 minutes, 51 seconds 16,209 views",Ethiopian Music,16209,16412,203
723,"Asitar Welada - Kalitina Azmirada by Ethiopian Music 10 years ago 6 minutes, 57 seconds 44,280 views",Ethiopian Music,44280,44511,231
724,"Lemlem Shumet - YetitiTilegn (Teweminah) by Ethiopian Music 10 years ago 4 minutes, 26 seconds 42,441 views",Ethiopian Music,42441,42494,53
725,"Lemlem Shumet - Sera Alebign by Ethiopian Music 10 years ago 6 minutes, 32 seconds 23,874 views",Ethiopian Music,23874,23938,64
726,"Lemlem Shumet - Gubeli by Ethiopian Music 10 years ago 6 minutes, 26 seconds 236,062 views",Ethiopian Music,236062,237009,947
727,"Lemlem Shumet - Belu Enehidu by Ethiopian Music 10 years ago 5 minutes, 38 seconds 201,580 views",Ethiopian Music,201580,201876,296
728,"Asnaku Chemer - Wede Shibela by Ethiopian Music 10 years ago 5 minutes, 21 seconds 1,172,643 views",Ethiopian Music,1172643,1174955,2312
729,"Asnaku Chemer - Teragne by Ethiopian Music 10 years ago 6 minutes, 19 seconds 451,195 views",Ethiopian Music,451195,452400,1205
730,"Asnaku Chemer - Himeme by Ethiopian Music 10 years ago 4 minutes, 28 seconds 712,394 views",Ethiopian Music,712394,713420,1026
731,"Asnaku Chemer - Enetafihu by Ethiopian Music 10 years ago 5 minutes, 37 seconds 1,038,222 views",Ethiopian Music,1038222,1040892,2670
732,"Asnaku Chemer - Ayanama by Ethiopian Music 10 years ago 6 minutes, 34 seconds 620,956 views",Ethiopian Music,620956,623307,2351
733,"Wagnew Ashenafi - Jenemu Gojame by Ethiopian Music 10 years ago 5 minutes, 59 seconds 359,812 views",Ethiopian Music,359812,360165,353
734,"Wagnew Ashenafi - Borena by Ethiopian Music 10 years ago 8 minutes, 11 seconds 208,376 views",Ethiopian Music,208376,209419,1043
735,"Wagnew Ashenafi - Bedelea Bisama by Ethiopian Music 10 years ago 7 minutes, 55 seconds 242,437 views",Ethiopian Music,242437,243332,895
736,"Shiway Zewale - Yefkerine Gudaye by Ethiopian Music 10 years ago 6 minutes, 48 seconds 683,598 views",Ethiopian Music,683598,684011,413
737,"Shiway Zewale - Gena Newe Gena by Ethiopian Music 10 years ago 5 minutes, 14 seconds 66,343 views",Ethiopian Music,66343,66368,25
738,"Yezina Negash - Tefategna Enedalehone by Ethiopian Music 10 years ago 3 minutes, 49 seconds 1,253,308 views",Ethiopian Music,1253308,1254091,783
739,"Yezina Negash - Sentune Asalefi by Ethiopian Music 10 years ago 4 minutes, 50 seconds 228,725 views",Ethiopian Music,228725,228834,109
740,"Yezina Negash - Sekota by Ethiopian Music 10 years ago 6 minutes, 18 seconds 70,854 views",Ethiopian Music,70854,71073,219
741,"Yezina Negash - Mengedegnaw by Ethiopian Music 10 years ago 5 minutes, 23 seconds 208,729 views",Ethiopian Music,208729,209643,914
742,"Yezina Negash - Gonder by Ethiopian Music 10 years ago 6 minutes, 51 seconds 299,517 views",Ethiopian Music,299517,300763,1246
743,"Yezina Negash - Gojam by Ethiopian Music 10 years ago 2 minutes, 50 seconds 37,304 views",Ethiopian Music,37304,37360,56
744,"Yezina Negash - Gela by Ethiopian Music 10 years ago 5 minutes, 13 seconds 180,249 views",Ethiopian Music,180249,181089,840
745,"Yezina Negash - Gedamu by Ethiopian Music 10 years ago 4 minutes, 40 seconds 34,592 views",Ethiopian Music,34592,34784,192
746,"Yezina Negash - Aneresaw by Ethiopian Music 10 years ago 5 minutes, 42 seconds 180,520 views",Ethiopian Music,180520,180687,167
747,"Tesfaye Mengesha - Kemya Aleki by Ethiopian Music 10 years ago 6 minutes, 31 seconds 328,598 views",Ethiopian Music,328598,330859,2261
748,"Tesfaledet (Wedi Mesfin) - Tebhibhi by Ethiopian Music 10 years ago 8 minutes 12,883 views",Ethiopian Music,12883,12893,10
749,"Tesfaledet (Wedi Mesfin) - Sara by Ethiopian Music 10 years ago 5 minutes, 57 seconds 43,594 views",Ethiopian Music,43594,43861,267
750,"Temesgen Tineko - Tifeune Delekyo by Ethiopian Music 10 years ago 6 minutes, 30 seconds 26,841 views",Ethiopian Music,26841,26869,28
751,"Sami Berhan - Ayeneye by Ethiopian Music 10 years ago 6 minutes, 4 seconds 62,935 views",Ethiopian Music,62935,65047,2112
752,"Melaku Bireda - Yehi Acha Bekorem by Ethiopian Music 10 years ago 5 minutes, 51 seconds 64,378 views",Ethiopian Music,64378,64494,116
753,"Melaku Bireda - Yebebube Teke Namageta by Ethiopian Music 10 years ago 5 minutes, 39 seconds 12,635 views",Ethiopian Music,12635,12648,13
754,"Melaku Bireda - Waka Waka by Ethiopian Music 10 years ago 5 minutes, 44 seconds 26,516 views",Ethiopian Music,26516,26560,44
755,"Melaku Bireda - Twist Be Gurage by Ethiopian Music 10 years ago 5 minutes, 20 seconds 14,972 views",Ethiopian Music,14972,15031,59
756,"Melaku Bireda - Shiguleli by Ethiopian Music 10 years ago 5 minutes, 43 seconds 41,191 views",Ethiopian Music,41191,41271,80
757,"Melaku Bireda - Nihe Nihe Gere by Ethiopian Music 10 years ago 5 minutes, 4 seconds 33,872 views",Ethiopian Music,33872,33907,35
758,"Melaku Bireda - Esherere by Ethiopian Music 10 years ago 6 minutes, 26 seconds 67,405 views",Ethiopian Music,67405,67618,213
759,"Melaku Bireda - Befenehi Yesere by Ethiopian Music 10 years ago 4 minutes, 42 seconds 17,386 views",Ethiopian Music,17386,17408,22
760,"Melaku Bireda - Ena Zere Gura by Ethiopian Music 10 years ago 5 minutes, 38 seconds 19,859 views",Ethiopian Music,19859,19892,33
761,"Melaku Bireda - Alembere by Ethiopian Music 10 years ago 4 minutes, 53 seconds 26,440 views",Ethiopian Music,26440,26489,49
762,"Zerehun Abraham - Yebekanare by Ethiopian Music 10 years ago 5 minutes, 4 seconds 2,442 views",Ethiopian Music,2442,2455,13
763,"Tigist Fikre - Aminehalehu by Ethiopian Music 10 years ago 5 minutes, 53 seconds 119,187 views",Ethiopian Music,119187,120483,1296
764,"Selamnesh Zemen - Yegeremal by Ethiopian Music 10 years ago 5 minutes, 17 seconds 268,992 views",Ethiopian Music,268992,270850,1858
765,"Selamnesh Zemen - Salayehe Alewelem by Ethiopian Music 10 years ago 6 minutes, 51 seconds 388,479 views",Ethiopian Music,388479,390401,1922
766,"Selamnesh Zemen - Ale Gena by Ethiopian Music 10 years ago 5 minutes, 15 seconds 697,125 views",Ethiopian Music,697125,704157,7032
767,"Mehret Mileyone - Behaset by Ethiopian Music 10 years ago 4 minutes, 54 seconds 16,736 views",Ethiopian Music,16736,16749,13
768,"Gideon Engidawerk - Ityopiawito by Ethiopian Music 10 years ago 5 minutes, 17 seconds 2,062 views",Ethiopian Music,2062,2068,6
769,"Gideon Engidawerk - Ateteyegne by Ethiopian Music 10 years ago 5 minutes, 41 seconds 5,713 views",Ethiopian Music,5713,5718,5
770,"Rahel Haile - Yeawaye Seyeyedo by Ethiopian Music 10 years ago 6 minutes, 18 seconds 194,955 views",Ethiopian Music,194955,195112,157
771,"Rahel Haile - Siye Welila by Ethiopian Music 10 years ago 5 minutes, 51 seconds 308,716 views",Ethiopian Music,308716,308912,196
772,"Rahel Haile - Senebebe Nei Nabaye by Ethiopian Music 10 years ago 4 minutes, 57 seconds 37,322 views",Ethiopian Music,37322,37441,119
773,"Rahel Haile - Metset Metset by Ethiopian Music 10 years ago 5 minutes, 33 seconds 58,978 views",Ethiopian Music,58978,59059,81
774,"Rahel Haile - Embebeye Embebeyti by Ethiopian Music 10 years ago 5 minutes, 10 seconds 144,750 views",Ethiopian Music,144750,144962,212
775,"Rahel Haile - Embeb Misesa by Ethiopian Music 10 years ago 6 minutes, 38 seconds 50,477 views",Ethiopian Music,50477,50592,115
776,"Rahel Haile - Ashenda Adey by Ethiopian Music 10 years ago 6 minutes, 36 seconds 171,113 views",Ethiopian Music,171113,171183,70
777,"Rahel Haile - Anebesaye Seruye by Ethiopian Music 10 years ago 6 minutes, 10 seconds 76,591 views",Ethiopian Music,76591,76705,114
778,"Esiminesh Desa - Des Kibil by Ethiopian Music 10 years ago 6 minutes, 26 seconds 4,137 views",Ethiopian Music,4137,4144,7
779,"Solomon Haile - Liwumay by Ethiopian Music 10 years ago 5 minutes, 17 seconds 874,943 views",Ethiopian Music,874943,909568,34625
780,"Rishan Gebre - Lilay by Ethiopian Music 10 years ago 8 minutes, 4 seconds 20,874 views",Ethiopian Music,20874,20903,29
781,"Solomon Haile - Gezana by Ethiopian Music 10 years ago 5 minutes, 15 seconds 1,069,754 views",Ethiopian Music,1069754,1085342,15588
782,"Musugat Kahisay (Wedi Romit) - Libiyu Zirey by Ethiopian Music 10 years ago 6 minutes, 43 seconds 6,489 views",Ethiopian Music,6489,6591,102
783,"Kinfe G/Girges - Kumel by Ethiopian Music 10 years ago 6 minutes, 14 seconds 22,076 views",Ethiopian Music,22076,22304,228
784,"Gizachew Solomon - Wesisu by Ethiopian Music 10 years ago 5 minutes, 40 seconds 427,155 views",Ethiopian Music,427155,446770,19615
785,"Eyob Belay - Mihashegi by Ethiopian Music 10 years ago 6 minutes, 39 seconds 11,869 views",Ethiopian Music,11869,11919,50
786,"Amir Dawid - Kealo by Ethiopian Music 10 years ago 6 minutes, 59 seconds 59,186 views",Ethiopian Music,59186,62589,3403
787,"Tesfaye Gedeye - Anekiatene Maro by Ethiopian Music 10 years ago 6 minutes, 7 seconds 9,515 views",Ethiopian Music,9515,9542,27
788,"Tewolde Kasahun - Temesgene Fetare by Ethiopian Music 10 years ago 5 minutes, 48 seconds 8,199 views",Ethiopian Music,8199,8205,6
789,"Tsega Wegane - Kemeshishiwta by Ethiopian Music 10 years ago 5 minutes, 31 seconds 16,404 views",Ethiopian Music,16404,16425,21
790,"Tewelde Yemane - Yenegeselya by Ethiopian Music 10 years ago 6 minutes, 32 seconds 105,832 views",Ethiopian Music,105832,105988,156
791,"Sofia Atsbeha - Harfeka by Ethiopian Music 10 years ago 5 minutes, 36 seconds 88,668 views",Ethiopian Music,88668,89705,1037
792,"Sentayehu Ameha - Hawye Enebeleke by Ethiopian Music 10 years ago 6 minutes, 29 seconds 94,429 views",Ethiopian Music,94429,95353,924
793,"Seble Aregawi - Ate Segemeye by Ethiopian Music 10 years ago 4 minutes, 56 seconds 24,768 views",Ethiopian Music,24768,24819,51
794,"Efrem Hagos - Asadu Raya by Ethiopian Music 10 years ago 5 minutes, 33 seconds 25,464 views",Ethiopian Music,25464,25472,8
795,"Efrem Hagos - Arehaye by Ethiopian Music 10 years ago 6 minutes, 9 seconds 19,294 views",Ethiopian Music,19294,19300,6
796,"Toleeraa Ittisaa - Shimaala Koo by Ethiopian Music 10 years ago 5 minutes, 35 seconds 17,640 views",Ethiopian Music,17640,17651,11
797,"Tashoomee Guyyee - Yaadannoo Jireenyaa by Ethiopian Music 10 years ago 5 minutes, 6 seconds 259,963 views",Ethiopian Music,259963,260225,262
798,"Sooraa Kadiir (Husseen) - Obsaa Qabuu by Ethiopian Music 10 years ago 6 minutes, 4 seconds 511,857 views",Ethiopian Music,511857,512380,523
799,"Kadiir Xekkuu - Baantuu by Ethiopian Music 10 years ago 4 minutes, 11 seconds 13,544 views",Ethiopian Music,13544,13551,7
800,"Kadiir Xekkuu - Ammaamotoore by Ethiopian Music 10 years ago 5 minutes, 14 seconds 58,496 views",Ethiopian Music,58496,58550,54
801,"Guutuu Buntii (Dargaggoo) - Simararre by Ethiopian Music 10 years ago 4 minutes, 37 seconds 36,379 views",Ethiopian Music,36379,36388,9
802,"Guutuu Buntii (Dargaggoo) - Oofee by Ethiopian Music 10 years ago 5 minutes, 31 seconds 68,798 views",Ethiopian Music,68798,68875,77
803,"Guutuu Buntii (Dargaggoo) - Miisiroo by Ethiopian Music 10 years ago 6 minutes, 8 seconds 26,090 views",Ethiopian Music,26090,26098,8
804,"Guutuu Buntii (Dargaggoo) - Martuu by Ethiopian Music 10 years ago 5 minutes, 10 seconds 9,007 views",Ethiopian Music,9007,9038,31
805,"Guutuu Buntii (Dargaggoo) - Dubbi Kana by Ethiopian Music 10 years ago 4 minutes 9,482 views",Ethiopian Music,9482,9484,2
806,"Feeysal Abdurahmaan (Fese) - Marii by Ethiopian Music 10 years ago 5 minutes, 26 seconds 16,825 views",Ethiopian Music,16825,16829,4
807,"Feeysal Abdurahmaan (Fese) - Hamilee by Ethiopian Music 10 years ago 6 minutes, 15 seconds 4,830 views",Ethiopian Music,4830,4831,1
808,"Badhaanee Burqaa - Naanayii by Ethiopian Music 10 years ago 5 minutes, 2 seconds 4,112 views",Ethiopian Music,4112,4119,7
809,"Badhaanee Burqaa - Dadamaaqa by Ethiopian Music 10 years ago 6 minutes, 28 seconds 2,554 views",Ethiopian Music,2554,2556,2
810,"Badhaanee Burqaa - Jalaalee by Ethiopian Music 10 years ago 5 minutes, 26 seconds 3,587 views",Ethiopian Music,3587,3589,2
811,"Badhaanee Burqaa - Bishaan Amiboo by Ethiopian Music 10 years ago 5 minutes, 19 seconds 3,062 views",Ethiopian Music,3062,3066,4
812,"Araarsaa Gabbisaa - Yaamaakodii by Ethiopian Music 10 years ago 5 minutes, 31 seconds 26,613 views",Ethiopian Music,26613,26642,29
813,"Araarsaa Gabbisaa - Koomee by Ethiopian Music 10 years ago 7 minutes, 13 seconds 49,350 views",Ethiopian Music,49350,49451,101
814,"Araarsaa Gabbisaa - Miishingaa by Ethiopian Music 10 years ago 6 minutes, 50 seconds 30,254 views",Ethiopian Music,30254,30337,83
815,"Taddalaa Gammachuu - Yaamioftuu by Ethiopian Music 10 years ago 5 minutes, 36 seconds 36,614 views",Ethiopian Music,36614,36651,37
816,"Taddalaa Gammachuu - Takkitii Tiyya by Ethiopian Music 10 years ago 5 minutes, 59 seconds 38,618 views",Ethiopian Music,38618,38640,22
817,"Taddalaa Gammachuu - Siyaadeera by Ethiopian Music 10 years ago 6 minutes, 56 seconds 57,860 views",Ethiopian Music,57860,58379,519
818,"Taddalaa Gammachuu - Raada Raadaa by Ethiopian Music 10 years ago 6 minutes, 16 seconds 10,768 views",Ethiopian Music,10768,10778,10
819,"Taddalaa Gammachuu - Oromoon Faaya by Ethiopian Music 10 years ago 5 minutes 21,106 views",Ethiopian Music,21106,21176,70
820,"Taddalaa Gammachuu - Birrolee by Ethiopian Music 10 years ago 4 minutes, 22 seconds 3,687 views",Ethiopian Music,3687,3700,13
821,"Taddalaa Gammachuu - Bashaanantoo by Ethiopian Music 10 years ago 5 minutes, 46 seconds 191,482 views",Ethiopian Music,191482,191633,151
822,"Taddalaa Gammachuu - Aruztoota by Ethiopian Music 10 years ago 5 minutes, 19 seconds 220,743 views",Ethiopian Music,220743,220993,250
823,"Jamboo Joote (JJ)- Imimman by Ethiopian Music 10 years ago 5 minutes, 47 seconds 22,868 views",Ethiopian Music,22868,22891,23
824,"Jamboo Joote (JJ) - Wollagga by Ethiopian Music 10 years ago 4 minutes, 12 seconds 13,264 views",Ethiopian Music,13264,13272,8
825,"Jamboo Joote (JJ) - Kamisee by Ethiopian Music 10 years ago 5 minutes, 57 seconds 11,789 views",Ethiopian Music,11789,11793,4
826,"Jamboo Joote (JJ) - Gooba Korma by Ethiopian Music 10 years ago 7 minutes, 35 seconds 6,153 views",Ethiopian Music,6153,6159,6
827,"Haacaaluu Hundeessaa - Sanyii Mootii by Ethiopian Music 10 years ago 5 minutes, 51 seconds 3,812 views",Ethiopian Music,3812,3818,6
828,"Jamboo Joote (JJ) - Folle by Ethiopian Music 10 years ago 6 minutes, 19 seconds 10,624 views",Ethiopian Music,10624,10650,26
829,"Jamboo Joote (JJ) - Dafi Kootu by Ethiopian Music 10 years ago 4 minutes, 41 seconds 10,217 views",Ethiopian Music,10217,10244,27
830,"Haacaaluu Hundeessaa - Oromumma by Ethiopian Music 10 years ago 5 minutes, 20 seconds 9,339 views",Ethiopian Music,9339,9347,8
831,"Haacaaluu Hundeessaa - Oolmaankei by Ethiopian Music 10 years ago 6 minutes, 11 seconds 2,472 views",Ethiopian Music,2472,2475,3
832,"Humneessaa Badhaasaa - Mucaa Qananii by Ethiopian Music 10 years ago 7 minutes, 2 seconds 251,434 views",Ethiopian Music,251434,252084,650
833,"Urgessa Gabissa - Xanee Jalalaa by Ethiopian Music 10 years ago 5 minutes, 11 seconds 128,762 views",Ethiopian Music,128762,128787,25
834,"Urgessa Gabissa - Hadhaa Mashiini by Ethiopian Music 10 years ago 5 minutes, 40 seconds 287,177 views",Ethiopian Music,287177,288212,1035
835,"Jaagamaa Taaddalaa (Jag) - Sinsiinnii by Ethiopian Music 10 years ago 6 minutes, 57 seconds 295,966 views",Ethiopian Music,295966,296651,685
836,"Jaagamaa Taaddalaa (Jag) - Lookoo Bulloo by Ethiopian Music 10 years ago 5 minutes, 24 seconds 484,118 views",Ethiopian Music,484118,485613,1495
837,"Jaagamaa Taaddalaa (Jag) - Kullee Bareeddu by Ethiopian Music 10 years ago 5 minutes, 12 seconds 172,701 views",Ethiopian Music,172701,173231,530
838,"Jaagamaa Taaddalaa (Jag) - Hin Roobaa by Ethiopian Music 10 years ago 6 minutes, 34 seconds 271,453 views",Ethiopian Music,271453,272653,1200
839,"Jaagamaa Taaddalaa (Jag) - Asa'ii Magaalle by Ethiopian Music 10 years ago 5 minutes, 13 seconds 348,364 views",Ethiopian Music,348364,348714,350
840,"Jaagamaa Taaddalaa (Jag) - Haabultuu Dubbin by Ethiopian Music 10 years ago 5 minutes, 24 seconds 258,808 views",Ethiopian Music,258808,259159,351
841,"Adaanechi Lataa - Yaa Fira Halalaa by Ethiopian Music 10 years ago 4 minutes, 44 seconds 275,344 views",Ethiopian Music,275344,275738,394
842,"Adaanechi Lataa - Walewlee by Ethiopian Music 10 years ago 4 minutes, 59 seconds 36,450 views",Ethiopian Music,36450,36486,36
843,"Aadam Ahimad - Yoom Wal Agarra by Ethiopian Music 10 years ago 5 minutes, 30 seconds 58,941 views",Ethiopian Music,58941,59039,98
844,"Galaanee Bulbulaa - Irreechaa Irreeffanaa by Ethiopian Music 10 years ago 5 minutes, 46 seconds 61,163 views",Ethiopian Music,61163,61298,135
845,"Daadhii Galaan - Yaa Ejersa by Ethiopian Music 10 years ago 5 minutes, 30 seconds 143,931 views",Ethiopian Music,143931,144269,338
846,"Daadhii Galaan - Qaaman Lafan Jira by Ethiopian Music 10 years ago 5 minutes, 51 seconds 341,404 views",Ethiopian Music,341404,342238,834
847,"Daadhii Galaan - Doboqaa by Ethiopian Music 10 years ago 6 minutes, 24 seconds 51,186 views",Ethiopian Music,51186,51189,3
848,"Asaffaa Tashoomaa - Yaijooliyo by Ethiopian Music 10 years ago 6 minutes, 39 seconds 70,727 views",Ethiopian Music,70727,71035,308
849,"Asaffaa Tashoomaa - Yaaikaaka Yaadatee by Ethiopian Music 10 years ago 4 minutes, 10 seconds 153,605 views",Ethiopian Music,153605,154512,907
850,"Asaffaa Tashoomaa - Yaa'ee Gryyaa'ee by Ethiopian Music 10 years ago 6 minutes, 26 seconds 40,404 views",Ethiopian Music,40404,40519,115
851,"Asaffaa Tashoomaa - Shantamee by Ethiopian Music 10 years ago 5 minutes, 1 second 614,891 views",Ethiopian Music,614891,616959,2068
852,"Asaffaa Tashoomaa - Koyyabire by Ethiopian Music 10 years ago 5 minutes, 58 seconds 149,689 views",Ethiopian Music,149689,150552,863
853,"Asaffaa Tashoomaa - Koottuu by Ethiopian Music 10 years ago 5 minutes, 50 seconds 189,610 views",Ethiopian Music,189610,189970,360
854,"Asaffaa Tashoomaa - Dheessee Hin Qalu by Ethiopian Music 10 years ago 3 minutes, 17 seconds 143,878 views",Ethiopian Music,143878,144358,480
855,"Asaffaa Tashoomaa - Akkanatti by Ethiopian Music 10 years ago 4 minutes, 53 seconds 120,006 views",Ethiopian Music,120006,120327,321
856,"Mohamed Zeyin - Olqabaa by Ethiopian Music 10 years ago 5 minutes, 46 seconds 4,393 views",Ethiopian Music,4393,4393,0
857,"Mohamed Zeyin - Africa by Ethiopian Music 10 years ago 5 minutes, 8 seconds 91,756 views",Ethiopian Music,91756,91832,76
858,"Fayyisaa Furii (Fayyee) - Simalee by Ethiopian Music 10 years ago 4 minutes, 40 seconds 91,148 views",Ethiopian Music,91148,91381,233
859,"Fayyisaa Furii (Fayyee) - San Daabilee by Ethiopian Music 10 years ago 5 minutes, 51 seconds 54,863 views",Ethiopian Music,54863,56067,1204
860,"Fayyisaa Furii (Fayyee) - Misirroolee by Ethiopian Music 10 years ago 4 minutes, 44 seconds 529,035 views",Ethiopian Music,529035,542186,13151
861,"Fayyisaa Furii (Fayyee) - Lakkii Dhiis by Ethiopian Music 10 years ago 6 minutes, 2 seconds 29,471 views",Ethiopian Music,29471,29539,68
862,"Fayyisaa Furii (Fayyee) - I Love You Forever by Ethiopian Music 10 years ago 5 minutes, 3 seconds 42,110 views",Ethiopian Music,42110,43463,1353
863,"Fayyisaa Furii (Fayyee) - Gowwee by Ethiopian Music 10 years ago 4 minutes, 55 seconds 73,136 views",Ethiopian Music,73136,73310,174
864,"Fayyisaa Furii (Fayyee) - Geerarsa by Ethiopian Music 10 years ago 4 minutes, 31 seconds 32,718 views",Ethiopian Music,32718,33119,401
865,"Fayyisaa Furii (Fayyee) - Daballee by Ethiopian Music 10 years ago 5 minutes, 20 seconds 21,697 views",Ethiopian Music,21697,21823,126
866,"Fayyisaa Furii (Fayyee) - Beenu Beenu by Ethiopian Music 10 years ago 4 minutes, 59 seconds 53,174 views",Ethiopian Music,53174,53633,459
867,"Fayyisaa Furii (Fayyee) - Akkamittiin by Ethiopian Music 10 years ago 5 minutes, 8 seconds 33,916 views",Ethiopian Music,33916,34018,102
868,"Tafarii Salaalee (Abbaabu) - Farada Gurraacha by Ethiopian Music 10 years ago 6 minutes, 8 seconds 266,534 views",Ethiopian Music,266534,267085,551
869,"Shuurtuu Bashaa - Qalla by Ethiopian Music 10 years ago 6 minutes, 13 seconds 17,895 views",Ethiopian Music,17895,17896,1
870,"Shuurtuu Bashaa - Ayyaani Irreessaa by Ethiopian Music 10 years ago 4 minutes, 32 seconds 36,708 views",Ethiopian Music,36708,36712,4
871,"Ashanafii Yohaannis - Maggallee by Ethiopian Music 10 years ago 4 minutes 18,597 views",Ethiopian Music,18597,18606,9
872,"Ashanafii Yohaannis - Jimma by Ethiopian Music 10 years ago 5 minutes, 10 seconds 39,217 views",Ethiopian Music,39217,39226,9
873,"Ashanafii Yohaannis - Hinchittii by Ethiopian Music 10 years ago 5 minutes, 40 seconds 43,850 views",Ethiopian Music,43850,43857,7
874,"Ashanafii Yohaannis - Geelloo by Ethiopian Music 10 years ago 5 minutes, 33 seconds 16,075 views",Ethiopian Music,16075,16078,3
875,"Ashanafii Yohaannis - Cidha by Ethiopian Music 10 years ago 5 minutes, 29 seconds 12,340 views",Ethiopian Music,12340,12342,2
876,"Ashanafii Yohaannis - Awash by Ethiopian Music 10 years ago 5 minutes, 27 seconds 29,928 views",Ethiopian Music,29928,29934,6
877,"Ashanafii Yohaannis - Aadaa by Ethiopian Music 10 years ago 5 minutes, 24 seconds 11,744 views",Ethiopian Music,11744,11748,4
878,"Aadam Ahmad - Aanole by Ethiopian Music 10 years ago 6 minutes, 26 seconds 133,290 views",Ethiopian Music,133290,133400,110
879,"Yeshi Tadesse - Anigo by Ethiopian Music 10 years ago 6 minutes, 17 seconds 85,438 views",Ethiopian Music,85438,85950,512
880,"Windi - Ayne Tew Sile Noro by Ethiopian Music 10 years ago 6 minutes, 13 seconds 1,385 views",Ethiopian Music,1385,1388,3
881,"Tizeta - Tawagn by Ethiopian Music 10 years ago 3 minutes, 36 seconds 2,483 views",Ethiopian Music,2483,2515,32
882,"Tewodros Getenet - Wibet Bizabat by Ethiopian Music 10 years ago 4 minutes, 35 seconds 1,097 views",Ethiopian Music,1097,1100,3
883,"Sami - Hasabe Nesh by Ethiopian Music 10 years ago 5 minutes, 19 seconds 2,149 views",Ethiopian Music,2149,2158,9
884,"Gamo - Bir by Ethiopian Music 10 years ago 4 minutes, 42 seconds 116,603 views",Ethiopian Music,116603,117658,1055
885,"Biruk Tesfaye - Kebre Mogese Nesh by Ethiopian Music 10 years ago 6 minutes, 49 seconds 3,452 views",Ethiopian Music,3452,3455,3
886,"Abiy - Esaw Tatsinanagn by Ethiopian Music 10 years ago 5 minutes, 13 seconds 2,427 views",Ethiopian Music,2427,2434,7
887,"Tirhas Tereke - Abelo by Ethiopian Music 10 years ago 6 minutes, 8 seconds 10,780 views",Ethiopian Music,10780,10870,90
888,"Mulugeta Kahsay - Unu-Duwu by Ethiopian Music 10 years ago 6 minutes, 42 seconds 96,155 views",Ethiopian Music,96155,96728,573
889,"Mizan Tesfay - Kanecha Mishila by Ethiopian Music 10 years ago 6 minutes, 47 seconds 9,186 views",Ethiopian Music,9186,9255,69
890,"Adam Mahamed - Ayenebreni by Ethiopian Music 10 years ago 7 minutes, 18 seconds 8,875 views",Ethiopian Music,8875,9003,128
891,"Yohanes Argaw (Joni) - Eyesakeche by Ethiopian Music 10 years ago 4 minutes, 46 seconds 21,260 views",Ethiopian Music,21260,21326,66
892,"Yeamlakesra Bidirega - Dese Yetegeal by Ethiopian Music 10 years ago 5 minutes 49,932 views",Ethiopian Music,49932,49944,12
893,"Mustafa Enderes - Jijiga Lay by Ethiopian Music 10 years ago 4 minutes, 16 seconds 53,814 views",Ethiopian Music,53814,53851,37
894,"Mulualem Shiferaw (Messengers) - Denduayte by Ethiopian Music 10 years ago 4 minutes, 45 seconds 1,464 views",Ethiopian Music,1464,1469,5
895,"Lemlem Hailemichael - Lante by Ethiopian Music 10 years ago 4 minutes, 14 seconds 19,133 views",Ethiopian Music,19133,19202,69
896,"Ermias Aschalew  and Tokichaw - Yaberedu Jima by Ethiopian Music 10 years ago 5 minutes, 32 seconds 38,065 views",Ethiopian Music,38065,38152,87
897,"Bizuneh Tegegn - Mineyawekel by Ethiopian Music 10 years ago 5 minutes, 29 seconds 1,011 views",Ethiopian Music,1011,1015,4
898,"Alemiye Getachaw - Mereba by Ethiopian Music 10 years ago 4 minutes, 41 seconds 5,144 views",Ethiopian Music,5144,5149,5
899,"Tsegaye Seme - Taziwuniham by Ethiopian Music 10 years ago 6 minutes, 10 seconds 34,170 views",Ethiopian Music,34170,34353,183
900,"Tsegaye Seme - Limu Yekun by Ethiopian Music 10 years ago 6 minutes, 36 seconds 70,681 views",Ethiopian Music,70681,71122,441
901,"Tsegaye Seme - Yesiminee by Ethiopian Music 10 years ago 5 minutes, 57 seconds 16,381 views",Ethiopian Music,16381,16467,86
902,"Tsegaye Seme - Yeshalibee by Ethiopian Music 10 years ago 5 minutes, 50 seconds 21,560 views",Ethiopian Music,21560,21661,101
903,"Tsegaye Seme - Yahuyi Baso by Ethiopian Music 10 years ago 6 minutes, 52 seconds 21,708 views",Ethiopian Music,21708,22018,310
904,"Tsegaye Seme - Saboy Sim by Ethiopian Music 10 years ago 5 minutes, 54 seconds 9,611 views",Ethiopian Music,9611,9672,61
905,"Tsegaye Seme - Lafe Bel by Ethiopian Music 10 years ago 5 minutes, 18 seconds 25,231 views",Ethiopian Music,25231,25585,354
906,"Tsegaye Seme - Egizar Yabish by Ethiopian Music 10 years ago 6 minutes, 12 seconds 17,875 views",Ethiopian Music,17875,17971,96
907,"Enkutatash Besha - Aydelem by Ethiopian Music 10 years ago 5 minutes, 13 seconds 33,731 views",Ethiopian Music,33731,33741,10
908,"Zema Sabawiyan - Alebsise by Ethiopian Music 10 years ago 4 minutes, 35 seconds 6,489 views",Ethiopian Music,6489,6526,37
909,"Amsal Mitke - Zigeyebegn by Ethiopian Music 10 years ago 5 minutes, 28 seconds 3,297 views",Ethiopian Music,3297,3407,110
910,"Amsal Mitke - Zemen Ende Seat by Ethiopian Music 10 years ago 6 minutes, 36 seconds 115,906 views",Ethiopian Music,115906,118410,2504
911,"Amsal Mitke - Geday Neh by Ethiopian Music 10 years ago 5 minutes, 39 seconds 13,124 views",Ethiopian Music,13124,13257,133
912,"Amsal Mitke - Halo Magalo by Ethiopian Music 10 years ago 6 minutes, 26 seconds 17,664 views",Ethiopian Music,17664,17810,146
913,"Amsal Mitke - Etinakakegn by Ethiopian Music 10 years ago 6 minutes, 53 seconds 20,433 views",Ethiopian Music,20433,20475,42
914,"Amsal Mitke - Biwadut by Ethiopian Music 10 years ago 5 minutes, 37 seconds 10,950 views",Ethiopian Music,10950,11013,63
915,"Amsal Mitke - Behig Amlak by Ethiopian Music 10 years ago 5 minutes, 42 seconds 9,048 views",Ethiopian Music,9048,9106,58
916,"Zerihun Demissie - Yetizita Miriko by Ethiopian Music 10 years ago 6 minutes, 22 seconds 23,450 views",Ethiopian Music,23450,23899,449
917,"Zerihun Demissie - Osha Koshena by Ethiopian Music 10 years ago 5 minutes, 6 seconds 5,530 views",Ethiopian Music,5530,5554,24
918,"Zerihun Demissie - Lamelash Yizashan by Ethiopian Music 10 years ago 6 minutes, 8 seconds 12,151 views",Ethiopian Music,12151,12396,245
919,"Zerihun Demissie - Demo Mintewera by Ethiopian Music 10 years ago 5 minutes, 28 seconds 17,149 views",Ethiopian Music,17149,17704,555
920,"Tsehaye Wolde - Asazinagn by Ethiopian Music 10 years ago 5 minutes, 23 seconds 11,944 views",Ethiopian Music,11944,11965,21
921,"Tsehaye Wolde - Amaregn by Ethiopian Music 10 years ago 5 minutes, 6 seconds 1,623 views",Ethiopian Music,1623,1627,4
922,"Tigist Fantahun - Yekirb Ruk by Ethiopian Music 10 years ago 3 minutes, 24 seconds 5,119 views",Ethiopian Music,5119,5148,29
923,"Mahlet Solomon - Wedihalehu by Ethiopian Music 10 years ago 3 minutes, 59 seconds 2,758 views",Ethiopian Music,2758,2775,17
924,"Gizachew Amera - Lijinetish by Ethiopian Music 10 years ago 4 minutes, 19 seconds 2,999 views",Ethiopian Music,2999,3020,21
925,"Endeshaw Negash - Irm Alilim Biye by Ethiopian Music 10 years ago 5 minutes, 5 seconds 2,500 views",Ethiopian Music,2500,2590,90
926,"Abebe Desalegn - Sergih Lay Neberkugn by Ethiopian Music 10 years ago 5 minutes, 3 seconds 4,286 views",Ethiopian Music,4286,4297,11
927,"Semere Kiros - Reggea Kemise by Ethiopian Music 10 years ago 6 minutes, 57 seconds 4,693 views",Ethiopian Music,4693,4703,10
928,"Fisum Demisse - Obsi by Ethiopian Music 10 years ago 5 minutes, 48 seconds 5,615 views",Ethiopian Music,5615,5618,3
929,"Behailu Tafesse - Kenuyi by Ethiopian Music 10 years ago 4 minutes, 36 seconds 18,666 views",Ethiopian Music,18666,18674,8
930,"Alex Olompia - Girlfriend's Birthday by Ethiopian Music 10 years ago 5 minutes, 10 seconds 22,956 views",Ethiopian Music,22956,22998,42
931,"Dani Boy - Felagot Betenfash by Ethiopian Music 10 years ago 5 minutes, 2 seconds 5,015 views",Ethiopian Music,5015,5045,30
932,"Jossy - Bati by Ethiopian Music 10 years ago 5 minutes, 22 seconds 1,447 views",Ethiopian Music,1447,1471,24
933,"Mimila & Kichini - Awe Awe Bade. by Ethiopian Music 10 years ago 6 minutes, 4 seconds 822,176 views",Ethiopian Music,822176,827830,5654
934,"Young Sami - Konjo by Ethiopian Music 10 years ago 2 minutes, 55 seconds 4,118 views",Ethiopian Music,4118,4179,61
935,"Behailu Tafesse - Enderasesh by Ethiopian Music 10 years ago 4 minutes, 51 seconds 7,796 views",Ethiopian Music,7796,7802,6
936,"Mahlet Demere - Ayawatam by Ethiopian Music 10 years ago 5 minutes, 8 seconds 9,863 views",Ethiopian Music,9863,9906,43
937,"Muluken Tsehay - Agebashalew by Ethiopian Music 10 years ago 4 minutes, 45 seconds 2,275 views",Ethiopian Music,2275,2278,3
938,"Layne MutuBerhan - And Nen by Ethiopian Music 10 years ago 3 minutes, 52 seconds 566 views",Ethiopian Music,566,569,3
939,"Feleke Maru - Enshoshila by Ethiopian Music 10 years ago 6 minutes, 38 seconds 157,275 views",Ethiopian Music,157275,158781,1506
940,"Asnake Cheru - Gojam Gojam Belu by Ethiopian Music 10 years ago 6 minutes, 55 seconds 1,049,539 views",Ethiopian Music,1049539,1051161,1622
941,"Zekarias Alamirew - Hagere by Ethiopian Music 10 years ago 5 minutes, 18 seconds 2,113 views",Ethiopian Music,2113,2117,4
942,"Fitsum Gebretsadik - Kiss Me by Ethiopian Music 10 years ago 5 minutes, 20 seconds 13,489 views",Ethiopian Music,13489,13559,70
943,"Messengers - Libbie by Ethiopian Music 10 years ago 5 minutes, 16 seconds 531 views",Ethiopian Music,531,532,1
944,"B Mastro - Mamush by Ethiopian Music 10 years ago 5 minutes, 28 seconds 1,086 views",Ethiopian Music,1086,1091,5
945,"Getsh Mamo - Marign Hagere by Ethiopian Music 10 years ago 4 minutes, 31 seconds 137,378 views",Ethiopian Music,137378,137471,93
946,"Girum Baye - Na Beyign by Ethiopian Music 10 years ago 4 minutes, 31 seconds 27,263 views",Ethiopian Music,27263,27287,24
947,"Sayat Demessie - Tew Maneh by Ethiopian Music 10 years ago 4 minutes, 27 seconds 3,216 views",Ethiopian Music,3216,3218,2
948,"Mikias Angaw - Tamagne Gela by Ethiopian Music 10 years ago 3 minutes, 43 seconds 7,400 views",Ethiopian Music,7400,7479,79
949,"Kaki Tesfaye - Shega Haftey by Ethiopian Music 10 years ago 5 minutes, 35 seconds 113,735 views",Ethiopian Music,113735,113950,215
950,"Gamo Boys -Tebeb by Ethiopian Music 10 years ago 4 minutes, 51 seconds 2,611 views",Ethiopian Music,2611,2619,8
951,"Fikre Zewdu - Seberta by Ethiopian Music 10 years ago 5 minutes, 38 seconds 45,297 views",Ethiopian Music,45297,45543,246
952,"Dagmawi Tsehaye - Sebseb Belu by Ethiopian Music 10 years ago 5 minutes, 15 seconds 7,613 views",Ethiopian Music,7613,7716,103
953,"Ze Blak Nothe Stars - Yagere Lij by Ethiopian Music 10 years ago 4 minutes, 14 seconds 5,742 views",Ethiopian Music,5742,5806,64
954,"Lelaalem Manaye - Yenenesh by Ethiopian Music 10 years ago 4 minutes, 15 seconds 286,109 views",Ethiopian Music,286109,286366,257
955,"Genet Woldemariam - Yewello Lij by Ethiopian Music 10 years ago 5 minutes, 51 seconds 2,829 views",Ethiopian Music,2829,2837,8
