,Posts,Channel,Views_03/03,Views_03/12,view_delta
0,"#Evangadi #EthiopiaMusic #Elsabet  Elsabet Teshome - በሰንሰል፡ልከበብ New Music Video 2021(Official Video) by Evangadi Production 10 months ago 6 minutes, 6 seconds 1,914 views",Evangadi Production,1914,1932,18
1,"#NEWAYDEBEBE #EVANGADI Neway Debebe Hagerane Aleresam Ethiopian Music 2021 by Evangadi Production 1 year ago 5 minutes, 5 seconds 553 views",Evangadi Production,553,554,1
2,"#Evangadi #Menzuma #MuhammedAwol Muhammed Awol New Ethiopian Menzuma 2020 by Evangadi Production 1 year ago 23 minutes 7,821 views",Evangadi Production,7821,7847,26
3,"#Evangadi #Ethiopia  ማረን፡የህብር፡ዜማ #2 (በሙዚቀኛ፡ዘሪሁን፡ማርቆስ) New Ethiopian Music 2020 by Evangadi Production 1 year ago 6 minutes, 46 seconds 1,904 views",Evangadi Production,1904,1908,4
4,"#Evangadiproduction Yared Belay ‐ Sewedese | ስወድሽ ‐ New Ethiopian Music 2020 (Official Video) by Evangadi Production 2 years ago 5 minutes, 41 seconds 7,856 views",Evangadi Production,7856,7885,29
5,"ሰማኸኝ፣በለው ❨ያኮራናል❩ Rocking Music Revolution Addis Night club by Evangadi Production 2 years ago 2 minutes, 5 seconds 856 views",Evangadi Production,856,861,5
6,"#Ethiopia #Evangadi Doctor Artist Tilahun Gessese Last Show in Washington Dc by Evangadi Production 2 years ago 7 minutes, 2 seconds 783 views",Evangadi Production,783,787,4
7,"#Evangadi #Ethiopian Abinet Girma ትንቩ ጥላሁን አብነት ግርማ by Evangadi Production 2 years ago 4 minutes, 2 seconds 6,886 views",Evangadi Production,6886,6907,21
8,"#evangadi #Ethiopia #DawitMeleseDawit Melese Performing Live ላልጠላሸ ቃል አለኘ Revolution Night club by Evangadi Production 2 years ago 2 minutes, 55 seconds 2,609 views",Evangadi Production,2609,2658,49
9,"#Evangadi Elias Tebabel For the First time Performing  Live at club Music Revolution  ማማዬ ኤልያስ ተባበል by Evangadi Production 2 years ago 7 minutes, 36 seconds 4,316 views",Evangadi Production,4316,4322,6
10,"#Evangadi  #Ethiopianidol #Revo Ethiopian Idol Winners Dawit Tsiga And Essayas Tamerat በአንድ፡ላይ ፡አዜሙ by Evangadi Production 2 years ago 3 minutes, 45 seconds 56,494 views",Evangadi Production,56494,56619,125
11,"#Evangadi #Ethiopiamusic #MusicRevolution Temesgen Tafesse Rock Revolution Night club ከፍ፡ከፍ 2019 by Evangadi Production 2 years ago 3 minutes, 55 seconds 1,737 views",Evangadi Production,1737,1748,11
12,"#Evangadi #Ethiopia #Revolution Getachew kassa የከረመ፡ፍቅር 2019 Rock Addis Ababa by Evangadi Production 2 years ago 3 minutes, 24 seconds 3,795 views",Evangadi Production,3795,3802,7
13,"#Evangadi #Ethiopia #Revolution ነዋይ ደበበ - ማበልነው እና አገሬን አልረሳም  Rock Revolution Night Club by Evangadi Production 2 years ago 7 minutes, 14 seconds 1,583 views",Evangadi Production,1583,1586,3
14,"#Evangadi  #Ethiopiamusic #Revolution ፍቅርሽ ነው የጎዳኝ Debekulu Jano Band Surprise Appearance Last Night by Evangadi Production 2 years ago 1 minute, 27 seconds 506 views",Evangadi Production,506,509,3
15,"#Evangadi #Ethiopia #Revolution Fikeraddis Nekatebe Rock Addis Ababa by Evangadi Production 2 years ago 4 minutes, 32 seconds 5,264 views",Evangadi Production,5264,5333,69
16,"#Evangadi #Ethiopia #Revolution Eferem Amare Live Performance Addis Ababa Ethiopia by Evangadi Production 2 years ago 2 minutes, 47 seconds 1,499 views",Evangadi Production,1499,1502,3
17,"#Evangadi #Ethiopia #Revolution Temesgen Tafesse Rock Addis Ababa by Evangadi Production 2 years ago 2 minutes, 40 seconds 1,047 views",Evangadi Production,1047,1049,2
18,"#EVANGADI #ETHIOPIA #REVOLUTION Shewandan Hailu Rock Addis Ababa by Evangadi Production 2 years ago 2 minutes, 13 seconds 2,294 views",Evangadi Production,2294,2303,9
19,"#Evangadi #MusicRevolution #Ethiopia Mohamud Ahemed Rock Addis Ababa by Evangadi Production 2 years ago 2 minutes, 29 seconds 654 views",Evangadi Production,654,655,1
20,"#Revolution #Evangadi  #Ethiopia Ephrem Amare Rack Revolution Addis by Evangadi Production 2 years ago 4 minutes, 3 seconds 2,862 views",Evangadi Production,2862,2868,6
21,"#Evangadi #Ethiopia #wendimujira Wendemu Jira - Beal ወንድሙ፡ጅራ በአሌ New Ethiopian Music 2019 by Evangadi Production 3 years ago 4 minutes, 40 seconds 3,230 views",Evangadi Production,3230,3233,3
22,"Surrender Night Club Every Tuesday With  Zagol Band by Evangadi Production 3 years ago 1 minute, 6 seconds 437 views",Evangadi Production,437,437,0
23,"Mesfin Abebe Yetazebese Leba መስፍን አበበ Ethiopian Music by Evangadi Production 3 years ago 5 minutes, 7 seconds 3,407 views",Evangadi Production,3407,3466,59
24,"Mesfin Abebe Yaselene Ketero መስፍን አበበ Ethiopian Music by Evangadi Production 3 years ago 6 minutes, 57 seconds 1,613 views",Evangadi Production,1613,1627,14
25,"Mesfin Abebe Yecegere Neger መስፍን አበበ Ethiopian Music by Evangadi Production 3 years ago 5 minutes, 37 seconds 7,155 views",Evangadi Production,7155,7266,111
26,"Mesfin Abebe Yalakema Wedeja መስፍን አበበ Ethiopian Music by Evangadi Production 3 years ago 8 minutes, 24 seconds 6,916 views",Evangadi Production,6916,6937,21
27,"Mesfin Abebe Webe Abeba Mesaye መስፍን አበበ Ethiopian Music by Evangadi Production 3 years ago 5 minutes, 48 seconds 7,075 views",Evangadi Production,7075,7121,46
28,"Mesfin Abebe Wededena Mote መስፍን አበበ Ethiopian Music by Evangadi Production 3 years ago 3 minutes, 51 seconds 4,082 views",Evangadi Production,4082,4101,19
29,"Mesfin Abebe Heyweta Fekera መስፍን አበበ Ethiopian Music by Evangadi Production 3 years ago 7 minutes, 57 seconds 11,453 views",Evangadi Production,11453,11520,67
30,"Mesfin Abebe Setamabese Nora መስፍን አበበ Ethiopian Music by Evangadi Production 3 years ago 5 minutes, 34 seconds 13,745 views",Evangadi Production,13745,13821,76
31,"Mesfin Abebe Heyweta Fekera መስፍን አበበ Ethiopian Music by Evangadi Production 3 years ago 3 minutes, 55 seconds 2,587 views",Evangadi Production,2587,2597,10
32,"Mesfin Abebe Feker Endewaza መስፍን አበበ Ethiopian Music by Evangadi Production 3 years ago 4 minutes, 50 seconds 1,740 views",Evangadi Production,1740,1750,10
33,"Mesfin Abebe  Anchi Lij መስፍን አበበ Ethiopian Music by Evangadi Production 3 years ago 4 minutes, 34 seconds 2,026 views",Evangadi Production,2026,2035,9
34,"Mesfin Abebe Fiket Becelema መስፍን አበበ Ethiopian Music by Evangadi Production 3 years ago 5 minutes, 27 seconds 2,517 views",Evangadi Production,2517,2538,21
35,"Mesfin Abebe Beat Sereta Beleba መስፍን አበበ Ethiopian Music by Evangadi Production 3 years ago 7 minutes, 50 seconds 1,637 views",Evangadi Production,1637,1655,18
36,"Mesfin Abebe Bemalawekew Hager መስፍን አበበ Ethiopian Music by Evangadi Production 3 years ago 6 minutes, 40 seconds 4,023 views",Evangadi Production,4023,4049,26
37,"Mihret Mesfin (Merci) Ere Menew Feat.Hahu Beatz Ethiopian Music (Official Video) by Evangadi Production 3 years ago 4 minutes, 30 seconds 3,289 views",Evangadi Production,3289,3314,25
38,"Daniel Tilahun Gessesse (Lenate) New Ethiopian Music 2018 (Official Video) by Evangadi Production 3 years ago 4 minutes, 48 seconds 8,667 views",Evangadi Production,8667,8680,13
39,"Falmata Ashabir Feetu of Ajeesi New Ethiopian Oromo Music 2018 by Evangadi Production 4 years ago 4 minutes, 30 seconds 3,379 views",Evangadi Production,3379,3396,17
40,"Ethiopia - Dawit Alemayehu - Weynua - (Official Video) - ETHIOPIAN NEW MUSIC 2018 by Evangadi Production 4 years ago 4 minutes, 11 seconds 6,239 views",Evangadi Production,6239,6253,14
41,"KASSAHUN ESHETU- Wedejase Ekonew Ethioian Music (Official Video) by Evangadi Production 4 years ago 21 minutes 3,632 views",Evangadi Production,3632,3653,21
42,"ABEL RASTA ALMAZ አቤል ራስታ NEW ETHIOPIAN MUSIC 2017 (Ofical lVideo) by Evangadi Production 4 years ago 4 minutes, 30 seconds 2,277 views",Evangadi Production,2277,2292,15
43,"Abebe Kefena - Beekeen New Ethiopian Music 2017 (Official Video) by Evangadi Production 4 years ago 4 minutes, 39 seconds 585 views",Evangadi Production,585,587,2
44,"Ellias Hussen (Ella Man) - Tiblaw Biren New Ethiopian Music (Official Video) by Evangadi Production 4 years ago 4 minutes, 46 seconds 56,434 views",Evangadi Production,56434,57623,1189
45,"Betelhem Mekonnen - Yet New Ethiopian Music (Official Video) by Evangadi Production 4 years ago 4 minutes, 26 seconds 181,070 views",Evangadi Production,181070,181777,707
46,"Saron Teferi & Muda Shede Miso Negaya - Part 2 - Ethiopian Music (Official Video) by Evangadi Production 4 years ago 5 minutes 104,911 views",Evangadi Production,104911,106045,1134
47,"Yalemsera Babey-Hibelew New Ethiopian Music 2017 (Official Video) by Evangadi Production 4 years ago 5 minutes, 9 seconds 1,353 views",Evangadi Production,1353,1353,0
48,"Temesgen Gebregziabher-Embi Alelesem (Offical Video)Ethiopian Music by Evangadi Production 4 years ago 4 minutes, 21 seconds 128,948 views",Evangadi Production,128948,130007,1059
49,"Nigusu Tamirat-Haadhakko (Offical Video) Ethiopian Music by Evangadi Production 4 years ago 7 minutes, 33 seconds 20,209 views",Evangadi Production,20209,20274,65
50,"Dawit Nega - Wesida Mizan(ወሲዳ ሚዛን) Cultural Ethiopian Music 2017 ዳዊት ነጋ (Official Video) by Evangadi Production 4 years ago 7 minutes, 7 seconds 12,163 views",Evangadi Production,12163,12169,6
51,"Yiirdaw Tenaw - Yegeter Temer Ethiopian Music(Official Video) by Evangadi Production 4 years ago 4 minutes, 6 seconds 3,672 views",Evangadi Production,3672,3693,21
52,"Yarad Belay - Dumbusho New Ethiopian music 2017(Official Video) by Evangadi Production 4 years ago 5 minutes, 15 seconds 1,547 views",Evangadi Production,1547,1554,7
53,"Nati Haile - Kene saymese Ethiopian Music(Official Video) by Evangadi Production 4 years ago 5 minutes, 4 seconds 9,793 views",Evangadi Production,9793,9828,35
54,"Bitsat Seyoum - Enisebaseb Ethiopian Music (Official video) by Evangadi Production 4 years ago 7 minutes, 22 seconds 58,846 views",Evangadi Production,58846,59317,471
55,"Alemayehu Hirpo - Temecesewey Ethiopian Music(Official video) by Evangadi Production 4 years ago 5 minutes, 1 second 120,389 views",Evangadi Production,120389,122653,2264
56,"Abraham Gebremedhin - Tedebise Ethiopian Music(Official video) by Evangadi Production 4 years ago 5 minutes, 1 second 6,364 views",Evangadi Production,6364,6370,6
57,"Yared Belay -Yhem Aydel Ehiopian music 2017 by Evangadi Production 4 years ago 5 minutes, 9 seconds 931 views",Evangadi Production,931,935,4
58,"Almaze -Abel Rasta Ethiopia Music 2017 by Evangadi Production 4 years ago 4 minutes, 30 seconds 1,678 views",Evangadi Production,1678,1682,4
59,"Tilahun Gessesse -Ethiopia by Evangadi Production 4 years ago 7 minutes, 5 seconds 8,986 views",Evangadi Production,8986,9017,31
60,"Nigusu Tamirat-Yaniko (Offical Video) by Evangadi Production 4 years ago 5 minutes, 12 seconds 53,108 views",Evangadi Production,53108,53297,189
61,"Daniel Tilahun Gessesse - Ethiopaian Atenku(Official Video)2017 by Evangadi Production 4 years ago 4 minutes, 28 seconds 38,818 views",Evangadi Production,38818,38895,77
62,"Muluken Dawit - Gojam (official Audio) New Ethiopian Music 2017 by Evangadi Production 4 years ago 5 minutes, 1 second 6,712 views",Evangadi Production,6712,6718,6
63,"Bezuayehu Demise - Bati(Official Video) Ethiopian Music by Evangadi Production 4 years ago 6 minutes, 9 seconds 7,692 views",Evangadi Production,7692,7751,59
64,"Rase Jany - Jedime New Ethiopian Music 2017(Official Video) by Evangadi Production 4 years ago 4 minutes, 23 seconds 948 views",Evangadi Production,948,949,1
65,"Tsedenia G/Markose - Konjo Mesay(Official Video)Ethiopian Music by Evangadi Production 4 years ago 5 minutes, 42 seconds 1,547 views",Evangadi Production,1547,1549,2
66,"Muhammed Awol Ethiopian Menzuma ,እንጉርጉሮ, Mote, ( ENGURGURO ) 1 by Evangadi Production 4 years ago 27 minutes 184,706 views",Evangadi Production,184706,184884,178
67,"Muhammed Awol Ethiopian Menzuma ,እንጉርጉሮ, khedija, ( ENGURGURO)2 by Evangadi Production 4 years ago 29 minutes 14,432 views",Evangadi Production,14432,14476,44
68,"Mahmoud Ahmed The Legend (Documentary) Ethiopia Music 2017 by Evangadi Production 4 years ago 26 minutes 7,995 views",Evangadi Production,7995,8026,31
69,"Yenegestat Tarik (Ethiopian history) by Evangadi Production 4 years ago 55 minutes 235,606 views",Evangadi Production,235606,236576,970
70,"Abinet Agonafer - Ateregemat Ethiopian Music by Evangadi Production 5 years ago 5 minutes, 42 seconds 8,564 views",Evangadi Production,8564,8601,37
71,"Nigusu Tamirat ( Official Video) Ethiopian Music by Evangadi Production 5 years ago 6 minutes, 21 seconds 2,765 views",Evangadi Production,2765,2774,9
72,"Dangerous Crossing-Dawit Nega, Tadele Roba, Yeshi Demelash New Ethiopian Music  2017 by Evangadi Production 5 years ago 5 minutes, 25 seconds 9,659 views",Evangadi Production,9659,9661,2
73,"Nigusu Tamirat (Official Video) Ethiopian Music by Evangadi Production 5 years ago 6 minutes, 19 seconds 4,741 views",Evangadi Production,4741,4751,10
74,"Nigusu Tamirat Jaalala Dhugaa
(Official Video) Ethiopian Music by Evangadi Production 5 years ago 7 minutes, 21 seconds 700,662 views",Evangadi Production,700662,704459,3797
75,"Antene Worqu Tegereda (official audio) Ethiopian Music by Evangadi Production 5 years ago 6 minutes, 6 seconds 1,905 views",Evangadi Production,1905,1944,39
76,"Antene Worqu Yegeremal(official audio) Ethiopian Music by Evangadi Production 5 years ago 5 minutes, 27 seconds 6,805 views",Evangadi Production,6805,6843,38
77,"Antena Worqu Yeheweta Tesfa(official audio) Ethiopian Music by Evangadi Production 5 years ago 3 minutes, 12 seconds 2,898 views",Evangadi Production,2898,2954,56
78,"Antene Worqu Yehoden Awteca(official audio) Ethiopian Music by Evangadi Production 5 years ago 5 minutes, 39 seconds 2,418 views",Evangadi Production,2418,2437,19
79,"Antene Worqu Feker Kena Endayeleyen(offical  audio) Ethiopian Music by Evangadi Production 5 years ago 4 minutes, 8 seconds 2,734 views",Evangadi Production,2734,2790,56
80,"Antene Worqu Anchi Endemtwjine( official audio) Ethiopian Music by Evangadi Production 5 years ago 4 minutes, 3 seconds 5,934 views",Evangadi Production,5934,6135,201
81,"SamiDan Anchi Yene (Official Video) Ethiopian Music by Evangadi Production 5 years ago 4 minutes, 2 seconds 668 views",Evangadi Production,668,675,7
82,"Yalnorkut Lijinet New Ethiopian Movie 2016 by Evangadi Production 5 years ago 1 hour, 30 minutes 427,844 views",Evangadi Production,427844,428064,220
83,"Jacky Gosee Amsterdam Closing Night Fim Esat Ethiopian Music by Evangadi Production 5 years ago 1 minute, 25 seconds 10,919 views",Evangadi Production,10919,10919,0
84,"Nelson Mandela Guramayle Documentary Trailer 2016 by Evangadi Production 5 years ago 1 minute, 8 seconds 1,635 views",Evangadi Production,1635,1637,2
85,"የፀሃይ መውጫ ልጆች    Sons of Sunrise   New Amharic Movie Trailer by Evangadi Production 5 years ago 1 minute, 11 seconds 1,155 views",Evangadi Production,1155,1157,2
86,"Elsabet Teshome Be Birr Aygezam Ethiopian Music 2016 (Official Audio) by Evangadi Production 5 years ago 4 minutes, 46 seconds 42,625 views",Evangadi Production,42625,42987,362
87,"Elsabet Teshome Sentune Ayew Bante Ethiopian Music 2016 (Official Audio) by Evangadi Production 5 years ago 4 minutes, 46 seconds 38,577 views",Evangadi Production,38577,38899,322
88,"Elsabet Teshome Addis Fiker New Ethiopian Music 2016 (Official Audio) by Evangadi Production 5 years ago 3 minutes, 52 seconds 62,662 views",Evangadi Production,62662,63141,479
89,"Elsabet Teshome Ayasayene Cenkune New Ethiopian Music 2016 (Official Audio) by Evangadi Production 5 years ago 5 minutes, 40 seconds 25,400 views",Evangadi Production,25400,25600,200
90,"Elsabet Teshome Besensel Lekebeb New Ethiopian Music 2016 (Official Audio) by Evangadi Production 5 years ago 6 minutes, 10 seconds 73,287 views",Evangadi Production,73287,73675,388
91,"Elsabet Teshome Semhen Salanesa New Ethiopian Music 2016 (Official Audio) by Evangadi Production 5 years ago 5 minutes, 21 seconds 30,324 views",Evangadi Production,30324,30506,182
92,"Elsabet Teshome Satemote Endate Lalekes New Ethiopian Music 2016 (Official Audio) by Evangadi Production 5 years ago 4 minutes, 56 seconds 36,776 views",Evangadi Production,36776,36961,185
93,"Elsabet Teshome Ayewetanem Kefu Negere New Ethiopian Music 2016 (Official Audio) by Evangadi Production 5 years ago 4 minutes, 58 seconds 43,931 views",Evangadi Production,43931,44202,271
94,"Elsabet Teshome Yecenkenal New Ethiopian Music 2016 (Official Audio) by Evangadi Production 5 years ago 4 minutes, 46 seconds 68,030 views",Evangadi Production,68030,68323,293
95,"Elsabet Teshome Kal Menotan Man Yawekal New Ethiopian Music 2016 (Official Audio) by Evangadi Production 5 years ago 4 minutes, 42 seconds 38,654 views",Evangadi Production,38654,38921,267
96,"Elsabet Teshome Kal Kedan Teresto New Ethiopian Music 2016 (Official Audio) by Evangadi Production 5 years ago 4 minutes, 53 seconds 86,874 views",Evangadi Production,86874,87225,351
97,"Elsabet Teshome Men Bedelkut Menew New Ethiopian Music 2016 (Official Audio) by Evangadi Production 5 years ago 5 minutes, 29 seconds 53,654 views",Evangadi Production,53654,53901,247
98,"Elsabet Teshome Men Neber New Ethiopian Music 2016 (Official Audio) by Evangadi Production 5 years ago 3 minutes, 39 seconds 49,500 views",Evangadi Production,49500,49748,248
99,"Elsabet Teshome Felagota New Ethiopian Music 2016 (Official Audio) by Evangadi Production 5 years ago 3 minutes, 19 seconds 61,815 views",Evangadi Production,61815,62169,354
100,"ወፌ ቆመች Wefa Komeche New Ethiopian Amharic Movie Trailer by Evangadi Production 5 years ago 1 minute, 22 seconds 18,746 views",Evangadi Production,18746,18753,7
101,"የብርሃን ፊርማ Yebrhan Firma New Ethiopian Movie Trailer 2016 by Evangadi Production 5 years ago 1 minute, 1 second 5,792 views",Evangadi Production,5792,5794,2
102,"ሀገርሽ ሀገሬ   Hagerish Hagere   2016 New Ethiopian Amharic Movie Trailer by Evangadi Production 5 years ago 1 minute, 24 seconds 13,334 views",Evangadi Production,13334,13338,4
103,"ሳንተያይ   Santeyay   New Ethiopian Amharic Movie Trailer 2016 by Evangadi Production 5 years ago 1 minute, 30 seconds 12,372 views",Evangadi Production,12372,12381,9
104,"የነገን አልወልድም   Yenegen Alweledim   2016 New Amharic Movie Trailer by Evangadi Production 5 years ago 1 minute, 30 seconds 5,639 views",Evangadi Production,5639,5651,12
105,"Sable Tadesse ድማማዬ (Official Music) Ethiopian Music 2016 by Evangadi Production 5 years ago 4 minutes, 21 seconds 9,469 views",Evangadi Production,9469,9474,5
106,"Sable Tadesse Fiker (official music video) New Ethiopia Music 2016 by Evangadi Production 5 years ago 3 minutes, 47 seconds 5,754 views",Evangadi Production,5754,5754,0
107,"Negusu Tamerat Bishan Addis Abebea New Ethiopian Music 2016 by Evangadi Production 5 years ago 4 minutes, 42 seconds 33,600 views",Evangadi Production,33600,33991,391
108,"Miki Yo Hgere New Ethiopia Music 2016 by Evangadi Production 6 years ago 3 minutes, 53 seconds 12,679 views",Evangadi Production,12679,12681,2
109,"Ye Addis Ababa Gudoch Ethiopian New Full  Movie 2016 by Evangadi Production 6 years ago 1 hour, 2 minutes 355,613 views",Evangadi Production,355613,355624,11
110,"kebebew Geda Ethiopian Full Movie 2016 by Evangadi Production 6 years ago 1 hour, 23 minutes 30,600 views",Evangadi Production,30600,30652,52
111,"Wendmu Jira Sime Nesh New Ethiopian Music 2016 by Evangadi Production 6 years ago 5 minutes, 2 seconds 8,379 views",Evangadi Production,8379,8379,0
112,"Jacky Gosee Balager 2015 by Evangadi Production 6 years ago 5 minutes, 21 seconds 9,374 views",Evangadi Production,9374,9375,1
113,"Jacky Gosee Ethiopian Day Washington DC Bandiraw by Evangadi Production 6 years ago 2 minutes, 18 seconds 9,186 views",Evangadi Production,9186,9188,2
114,"Jacky Gosee Men Tadergewalese Ethiopian Music by Evangadi Production 6 years ago 4 minutes, 17 seconds 9,428 views",Evangadi Production,9428,9429,1
115,"Beki Massawa Bey Ney Official New Music 2015 by Evangadi Production 6 years ago 4 minutes, 53 seconds 6,315 views",Evangadi Production,6315,6316,1
116,"Terengo Asenabetune [2015] New Comedy Music by Evangadi Production 6 years ago 4 minutes, 25 seconds 46,898 views",Evangadi Production,46898,46932,34
117,"Merkeb baryagabr Waniney  [2015] New Tigrina Music by Evangadi Production 6 years ago 7 minutes, 31 seconds 9,501 views",Evangadi Production,9501,9503,2
118,"Evangadi Production promo by Evangadi Production 6 years ago 1 minute, 20 seconds 1,786 views",Evangadi Production,1786,1787,1
119,"Edidiya Ayele Kafe [2015] Ethiopian New Music by Evangadi Production 6 years ago 4 minutes, 49 seconds 8,115 views",Evangadi Production,8115,8127,12
120,"Mesfin (Gena Gena) Tolo Tolo [2015] New Ethiopian Music by Evangadi Production 6 years ago 4 minutes, 57 seconds 94,117 views",Evangadi Production,94117,94427,310
121,"ABEL RASTA YENE YEGLE 2015 አቤል ራስታ የኔ የግሌ 2015 by Evangadi Production 6 years ago 4 minutes, 36 seconds 1,303 views",Evangadi Production,1303,1306,3
122,"oromo negusu tameirat by Evangadi Production 11 years ago 5 minutes, 7 seconds 44,065 views",Evangadi Production,44065,44071,6
123,"Tadesse Mekete - AYECHESHALHU  - MIX 2020 by Fenthun Belete 1 year ago 3 minutes, 2 seconds 21,891 views",Fenthun Belete,21891,22017,126
124,"arif mix adies 2018 by Fenthun Belete 3 years ago 3 minutes, 1 second 56,056 views",Fenthun Belete,56056,56204,148
125,"Ethiopian music 2018 mulat eshete (genet)በፍቅር bezema by Fenthun Belete 3 years ago 3 minutes 6,250 views",Fenthun Belete,6250,6260,10
126,"best ethiopian music 2018 by Fenthun Belete 3 years ago 4 minutes, 21 seconds 74,315 views",Fenthun Belete,74315,74517,202
127,"New Ethiopian Music 2018 - gonder by Fenthun Belete 3 years ago 2 minutes, 14 seconds 41,889 views",Fenthun Belete,41889,42035,146
128,"ethiopian music new 2018 by Fenthun Belete 3 years ago 4 minutes, 15 seconds 48,325 views",Fenthun Belete,48325,48495,170
129,"arif mix adies 2018 by Fenthun Belete 3 years ago 3 minutes, 1 second 19,294 views",Fenthun Belete,19294,19312,18
130,"hot ethiopian music 2018 mulat eshete by Fenthun Belete 3 years ago 5 minutes, 39 seconds 63,004 views",Fenthun Belete,63004,63085,81
131,"Tesfaye Adugna - Weleba ¦ ወለባ - New Ethiopian Music 2018 by Fenthun Belete 3 years ago 2 minutes, 58 seconds 18,789 views",Fenthun Belete,18789,18868,79
132,"ethiopian music new 2018 by Fenthun Belete 3 years ago 2 minutes, 16 seconds 22,552 views",Fenthun Belete,22552,22630,78
133,"ethiopian music new 2018 by Fenthun Belete 4 years ago 2 minutes, 41 seconds 39,449 views",Fenthun Belete,39449,39556,107
134,"new ethiopian music 2018 by Fenthun Belete 4 years ago 3 minutes, 1 second 71,021 views",Fenthun Belete,71021,71136,115
135,"Selemon Admasu - Batgarugn - Ethiopian New Music 2018 by Fenthun Belete 4 years ago 4 minutes, 11 seconds 15,614 views",Fenthun Belete,15614,15649,35
136,"ethiopian music new 2018 by Fenthun Belete 4 years ago 3 minutes, 46 seconds 69,129 views",Fenthun Belete,69129,69173,44
137,"best ethiopian music 2017 by Fenthun Belete 4 years ago 3 minutes, 4 seconds 49,910 views",Fenthun Belete,49910,50033,123
138,"arif adis rimex 2017 by Fenthun Belete 4 years ago 2 minutes, 13 seconds 15,566 views",Fenthun Belete,15566,15611,45
139,"ethiopian music new 2017 by Fenthun Belete 4 years ago 2 minutes, 40 seconds 12,165 views",Fenthun Belete,12165,12201,36
140,"best ethiopian music 2017 by Fenthun Belete 4 years ago 3 minutes, 1 second 27,634 views",Fenthun Belete,27634,27709,75
141,"arif Remix  2017 by Fenthun Belete 4 years ago 6 minutes, 1 second 281,277 views",Fenthun Belete,281277,281611,334
142,"behailu bayou- des bilongnal ethiopian music 2017 by Fenthun Belete 4 years ago 2 minutes, 37 seconds 75,930 views",Fenthun Belete,75930,76053,123
143,"Yosef Josi - Wesewesegn - Official Music Video - New Ethiopian Music 2017 by Fenthun Belete 4 years ago 4 minutes, 31 seconds 12,381 views",Fenthun Belete,12381,12387,6
144,"ethiopian music new 2017 by Fenthun Belete 4 years ago 3 minutes, 4 seconds 83,836 views",Fenthun Belete,83836,84022,186
145,"mix adies 2017 by Fenthun Belete 4 years ago 3 minutes, 11 seconds 17,219 views",Fenthun Belete,17219,17249,30
146,"mix adies 2017 by Fenthun Belete 4 years ago 3 minutes, 2 seconds 20,690 views",Fenthun Belete,20690,20735,45
147,"New Ethiopian Music 2017 by Fenthun Belete 4 years ago 2 minutes, 50 seconds 448,576 views",Fenthun Belete,448576,449486,910
148,"Best ethiopian music 2017 by Fenthun Belete 5 years ago 2 minutes, 19 seconds 42,558 views",Fenthun Belete,42558,42584,26
149,"ethiopian music new 2017 by Fenthun Belete 5 years ago 2 minutes, 32 seconds 457,320 views",Fenthun Belete,457320,457379,59
150,"arif mix adies 2017 by Fenthun Belete 5 years ago 2 minutes, 20 seconds 2,367,776 views",Fenthun Belete,2367776,2370726,2950
151,"Yosef Mersha - Wey Libe ¦ ወይ ልቤ - New Ethiopian Music 2017 by Fenthun Belete 5 years ago 3 minutes, 34 seconds 28,581 views",Fenthun Belete,28581,28625,44
152,"ethiopian music 2017 by Fenthun Belete 5 years ago 2 minutes, 43 seconds 136,669 views",Fenthun Belete,136669,136691,22
153,"Ethiopian - Maditu Weday - Eshkem(እሽክም) - New Ethiopian Music 2016(Official Video) by Fenthun Belete 5 years ago 3 minutes, 4 seconds 54,689 views",Fenthun Belete,54689,54723,34
154,"arif adies mix 2017 by Fenthun Belete 5 years ago 2 minutes, 26 seconds 46,029 views",Fenthun Belete,46029,46118,89
155,"ethiopian arif music 2017 by Fenthun Belete 5 years ago 2 minutes, 50 seconds 114,500 views",Fenthun Belete,114500,114544,44
156,"arif masinko 2016 by Fenthun Belete 5 years ago 3 minutes, 1 second 22,274 views",Fenthun Belete,22274,22287,13
157,"arif adies mix 2016 by Fenthun Belete 5 years ago 2 minutes, 2 seconds 151,496 views",Fenthun Belete,151496,151985,489
158,"ariffffffffffff music 2016 by Fenthun Belete 5 years ago 2 minutes, 43 seconds 85,423 views",Fenthun Belete,85423,85514,91
159,"The best dancer in the world by Fenthun Belete 5 years ago 1 minute, 7 seconds 51,615 views",Fenthun Belete,51615,53178,1563
160,"ethiopian music 2016 by Fenthun Belete 5 years ago 4 minutes, 17 seconds 213,092 views",Fenthun Belete,213092,213274,182
161,"ethiopian music 2016 by Fenthun Belete 5 years ago 3 minutes, 37 seconds 45,079 views",Fenthun Belete,45079,45129,50
162,"Alula G/Amlack -Mateben -(Official Music Video)-New Ethiopian Music 2016 by Fenthun Belete 5 years ago 13 minutes, 11 seconds 41,741 views",Fenthun Belete,41741,41846,105
163,"የአድዋ ፈረሶች (የዳዊት ተስፋዬ ግጥም) A poem by Dawit Tesfaye #Adwa #AdwaVictory #Ethiopia by Firma 1 day ago 3 minutes, 19 seconds 528 views",Firma,528,978,450
164,"Hagere | Grum Zenebe (a poem by Gebrekirstos Desta) ከፍ ከፍ1 አገሬ | የገብረ ክርስቶስ ደስታን ግጥም ግሩም ዘነበ እንደከወነው by Firma 2 months ago 11 minutes, 34 seconds 6,324 views",Firma,6324,6394,70
165,"Ethiopian Music: Ab Man (Yileyal) New Ethiopian Music ይለያል | ኤቢ ማን New Ethiopian Music 2021 #Ab_Man by Firma 2 months ago 3 minutes, 46 seconds 3,469 views",Firma,3469,3756,287
166,"Ethiopian Music: Yohannes Girma (Wetader Negn) ወታደር ነኝ | ዮሐንስ ግርማ (Official Music Video) by Firma 5 months ago 5 minutes, 10 seconds 31,720 views",Firma,31720,32004,284
167,"Ethiopian Music: Yohannes Girma (Wetader Negn) New Ethiopian Music 2021 ወታደር ነኝ | ዮሐንስ ግርማ by Firma 6 months ago 5 minutes, 13 seconds 29,465 views",Firma,29465,29862,397
168,"ሽማግሌ ጠፋ | የዳዊት የትም (ዴቭ ሳክስ) አጭር ስታንዳፕ ኮሜዲ A stand-up comedy by Dawit Yetim by Firma 7 months ago 8 minutes, 41 seconds 7,458 views",Firma,7458,7488,30
169,"የቃልአብ ሙሉጌታ ""አዲስ አበባዬ"" በቀረፃ ላይ | The Making of “Addis Abebaye” New Ethiopian Music 2021 by Firma 7 months ago 11 minutes, 42 seconds 519 views",Firma,519,521,2
170,Addis Abebaye | Kaleab Mulugeta : Making Trailer የአዲስ አበባዬ ቀረፃ ቅምሻ|  New Ethiopian Music 2021 by Firma 8 months ago 52 seconds 478 views,Firma,478,485,7
171,"Addis Abebaye | Kaleab Mulugeta : Ethiopian Music አዲስ አበባዬ | ቃልአብ ሙሉጌታ New Ethiopian Music by Firma 8 months ago 5 minutes, 32 seconds 13,689 views",Firma,13689,13788,99
172,"Ethiopian music | Yohannes Girma (Bibeza Semanya) ዮሐንስ ግርማ (ቢበዛ ሰማንያ) New Ethiopian music 2021 by Firma 11 months ago 4 minutes, 15 seconds 8,126 views",Firma,8126,8164,38
173,"Ethiopian music | Asseged Eshetu (Abay Eshururu) አሰግድ እሸቱ (አባይ እሹሩሩ) - New Ethiopian music 2021 by Firma 1 year ago 5 minutes, 35 seconds 7,442 views",Firma,7442,7486,44
174,"ሰው | SEW (ማጀቢያ ሙዚቃ) by Firma 1 year ago 12 minutes, 23 seconds 2,977 views",Firma,2977,2993,16
175,"ከፊርማ አባላት ጋር እንተዋወቅ | Meet the first Firma Members by Firma 1 year ago 2 minutes, 30 seconds 2,396 views",Firma,2396,2398,2
176,"Zerubabbel Molla | የኢትዮጵያ አምላክ (ከንጋት ታዳሚ ዐልባ ኮንሰርት) by Firma 1 year ago 6 minutes, 45 seconds 2,159 views",Firma,2159,2175,16
177,"Firma - Alpha by Firma 1 year ago 1 minute, 28 seconds 1,647 views",Firma,1647,1648,1
178,"Addisu  G/ michael  ( ከይትሓስብዮ)  (Official Music Video) New Ethiopian Music by G O L A G U L 1 year ago 4 minutes, 14 seconds 1,737 views",G O L A G U L,1737,1757,20
179,"Brhanu kiros  (ላንጋ ላንጋ ፍቅሪ)  (Official Music Video) New Ethiopian Music by G O L A G U L 1 year ago 5 minutes, 40 seconds 1,372 views",G O L A G U L,1372,1386,14
180,"Alem Tesfay  / ሃዋርያ ሰላም/  (Official Music Video) New Ethiopian Music by G O L A G U L 1 year ago 5 minutes, 1 second 3,516 views",G O L A G U L,3516,3524,8
181,"Genet Hagos ፡ ትግራይ ዝዓደይ  (Official Music Video) New Ethiopian Music by G O L A G U L 1 year ago 4 minutes, 24 seconds 1,875 views",G O L A G U L,1875,1896,21
182,"Mengistab Gebregergs  Aday  (Official Music Video) New Ethiopian Music by G O L A G U L 2 years ago 7 minutes, 27 seconds 962 views",G O L A G U L,962,968,6
183,"Yergalm Tedros  (ቀሲነ ፡የ)  (Official Music Video) New Ethiopian Music by G O L A G U L 2 years ago 6 minutes, 19 seconds 1,755 views",G O L A G U L,1755,1760,5
184,"Tadesse desta ( Fisto )  እምቤቴይ  (Official Music Video) New Ethiopian Music by G O L A G U L 2 years ago 3 minutes, 50 seconds 2,424 views",G O L A G U L,2424,2429,5
185,"Mengstab G/gergs (Official Music Video) New Ethiopian Music by G O L A G U L 2 years ago 7 minutes, 27 seconds 1,031 views",G O L A G U L,1031,1033,2
186,"Ethiopian Old Tigriga Music  (Official Music Video) old Ethiopian Music by G O L A G U L 2 years ago 6 minutes, 11 seconds 7,518 views",G O L A G U L,7518,7531,13
187,"Raza Raya (Official Music Video) New Ethiopian Music by G O L A G U L 2 years ago 3 minutes, 28 seconds 1,750 views",G O L A G U L,1750,1752,2
188,"Wedi tsehay=korialki new clip  (Official Music Video) New Ethiopian Music by G O L A G U L 3 years ago 4 minutes, 56 seconds 4,030 views",G O L A G U L,4030,4036,6
189,"ኣታኽልቲ ፅሮታ ማቻ ኢኺ  (Official Music Video) New Ethiopian Music by G O L A G U L 3 years ago 6 minutes, 7 seconds 62,498 views",G O L A G U L,62498,62626,128
190,"Kiros Legesse  (Official Music Video) New Ethiopian  Poem by G O L A G U L 3 years ago 6 minutes, 16 seconds 785 views",G O L A G U L,785,786,1
191,"Mulu Alemu (Official Music Video) New Ethiopian Music by G O L A G U L 3 years ago 5 minutes, 25 seconds 2,351 views",G O L A G U L,2351,2356,5
192,"New Afar Music Tahir mussa (Aba'ala)  (Official Music Video) New Ethiopian Music by G O L A G U L 3 years ago 4 minutes, 43 seconds 19,550 views",G O L A G U L,19550,19706,156
193,"Ewnet by Young Hayu ft Aki  (Official Music Video) New Ethiopian Music by G O L A G U L 3 years ago 4 minutes, 56 seconds 1,166 views",G O L A G U L,1166,1167,1
194,"ተኽላይ ገ/ሚካኤል  (Official Music Video) New Ethiopian Music by G O L A G U L 3 years ago 4 minutes, 57 seconds 1,846 views",G O L A G U L,1846,1854,8
195,"Semaetat Program part 3 (Official Music Video) New Ethiopian Music by G O L A G U L 3 years ago 9 minutes, 11 seconds 615 views",G O L A G U L,615,615,0
196,"Semaetat Program part 2 (Official Music Video) New Ethiopian Music by G O L A G U L 3 years ago 7 minutes, 29 seconds 570 views",G O L A G U L,570,571,1
197,"Yohannes Berihu  (Way Shelel Elkyo) (Official Music Video) New Ethiopian Music by G O L A G U L 3 years ago 4 minutes, 10 seconds 440 views",G O L A G U L,440,441,1
198,"Haftom Bruqas /ቀያሕ ቆልዓ /(Official Music Video) New Ethiopian Music by G O L A G U L 3 years ago 4 minutes, 20 seconds 1,591 views",G O L A G U L,1591,1593,2
199,"Henok Aregawi Adey Etay  (Official Music Video) New Ethiopian Music by G O L A G U L 3 years ago 5 minutes, 26 seconds 6,102 views",G O L A G U L,6102,6108,6
200,"Mokonen fesha / Metseni/ (Official Music Video) New Ethiopian Music by G O L A G U L 3 years ago 5 minutes, 12 seconds 1,088 views",G O L A G U L,1088,1088,0
201,"asefa brhane ( Nay Men Kon Tekoni ) (Official Music Video) New Ethiopian Music by G O L A G U L 3 years ago 5 minutes, 41 seconds 1,445 views",G O L A G U L,1445,1448,3
202,"Aziz Hagos /Yrisae Do Koyinu/ (Official Music Video) New Ethiopian Music by G O L A G U L 3 years ago 6 minutes, 22 seconds 5,752 views",G O L A G U L,5752,5757,5
203,"Alemayehu Hafte Ye'es blka hitim New Tigrigna Raya poem 2018 full by G O L A G U L 3 years ago 5 minutes, 20 seconds 579 views",G O L A G U L,579,582,3
204,"goitom gebrehiwe dokile new song 2010 by G O L A G U L 3 years ago 5 minutes, 35 seconds 2,911 views",G O L A G U L,2911,2917,6
205,"Semaetat Program part 1 (Official Music Video) New Ethiopian Music by G O L A G U L 4 years ago 10 minutes, 40 seconds 1,020 views",G O L A G U L,1020,1021,1
206,"Tadael Ylma/ Tesemieni/ (Official Music Video) New Ethiopian Music by G O L A G U L 4 years ago 5 minutes, 51 seconds 3,173 views",G O L A G U L,3173,3173,0
207,"Zekaris G Tsadik & Ataklti Aberha/ Enkae Natka Koneku/(Official Music Video) New Ethiopian Music by G O L A G U L 4 years ago 4 minutes, 35 seconds 1,720 views",G O L A G U L,1720,1720,0
208,"Alembrhan G/tnsae - Nienay (Official Music Video) New Ethiopian Music by G O L A G U L 4 years ago 5 minutes, 36 seconds 2,792 views",G O L A G U L,2792,2798,6
209,"Yohanes Bayru - Welwalo  (Official Music Video) New Ethiopian Tigrigna Music by G O L A G U L 4 years ago 6 minutes, 43 seconds 104,875 views",G O L A G U L,104875,105240,365
210,"MIKIALE WELU (maico) - aboy (Official Music Video) New Ethiopian Tigrigna Music by G O L A G U L 4 years ago 4 minutes, 36 seconds 1,511 views",G O L A G U L,1511,1512,1
211,"Luel Kidane - Gena ' ya (Official Music Video) New Tigrigna Music by G O L A G U L 4 years ago 6 minutes, 37 seconds 12,803 views",G O L A G U L,12803,12807,4
212,"Solomon Mizan - Sus ye (Official Music Video) New Ethiopian Tigrigna Music by G O L A G U L 4 years ago 6 minutes, 17 seconds 15,326 views",G O L A G U L,15326,15332,6
213,"Desaley Mengstu - Hafti Monaliza (Official Music Video) New Ethiopian Tigrigna Music by G O L A G U L 4 years ago 7 minutes, 9 seconds 10,397 views",G O L A G U L,10397,10401,4
214,"Kidane & Haftom - Mamana (Official Music Video) New Ethiopian Tigrigna Music by G O L A G U L 4 years ago 6 minutes, 18 seconds 13,747 views",G O L A G U L,13747,13748,1
215,"Metsae Gebrekidan - Weledo Terekebwa (Official Music Video) New Tigrigna Music by G O L A G U L 5 years ago 5 minutes, 6 seconds 46,868 views",G O L A G U L,46868,46879,11
216,"Temtu Gebrehiwet - Weyney (Official Music Video) New Ethiopian Tigrigna Music by G O L A G U L 5 years ago 7 minutes, 36 seconds 67,459 views",G O L A G U L,67459,67522,63
217,"Binyam Yemane - Jeganu (Official Music Video) New Ethiopian Tigrigna Music by G O L A G U L 5 years ago 6 minutes 29,833 views",G O L A G U L,29833,29869,36
218,"Teklay Berhe - Nienay'ndo Niagame (Official Music Video) New Ethiopian Tigrigna Music 2016 by G O L A G U L 5 years ago 7 minutes, 10 seconds 152,346 views",G O L A G U L,152346,153225,879
219,"Yemane (Wedi Afro)  &  Kiros -  ( Kuhilye (Official Music Video) New Ethiopian Tigrigna Music 2016 by G O L A G U L 5 years ago 5 minutes, 48 seconds 29,862 views",G O L A G U L,29862,29888,26
220,"New Ethiopian Tigrigna Music 2016 Tesfealem Atsbeha - Hagerey by G O L A G U L 5 years ago 5 minutes, 48 seconds 6,141 views",G O L A G U L,6141,6145,4
221,"New Ethiopian Tigrigna Music 2016 -Teshelalemi / ተሸላለሚ by G O L A G U L 5 years ago 5 minutes, 11 seconds 89,450 views",G O L A G U L,89450,89464,14
222,"Ashenafi Birhane - KEYDA /ከይዳ New Ethiopian Music 2016 by G O L A G U L 5 years ago 5 minutes, 23 seconds 8,416 views",G O L A G U L,8416,8425,9
223,"New Ethiopian Music Aba nedi (lil pac) - yene gagari by G O L A G U L 6 years ago 3 minutes, 32 seconds 2,670 views",G O L A G U L,2670,2670,0
224,"Mtslal Gidey & Yitbarek Mesfin - Tinbitawit Elet New Ethiopian Tigrigna Music 2016 by G O L A G U L 6 years ago 6 minutes, 4 seconds 7,821 views",G O L A G U L,7821,7824,3
225,"Tesfealem G/slassie - Genzeb #ገንዘብ# New Ethiopian Tigrigna Music 2016 by G O L A G U L 6 years ago 6 minutes, 10 seconds 23,842 views",G O L A G U L,23842,23886,44
226,"Gezae Fitwi & Haben Fantay - Waero Tigray #ዋዕሮ ትግራይ# New Tigrigna Music 2016 by G O L A G U L 6 years ago 5 minutes, 11 seconds 11,967 views",G O L A G U L,11967,11981,14
227,"Yapi Mapi - Beautiful New Ethiopian Music 2016 by G O L A G U L 6 years ago 4 minutes, 30 seconds 33,642 views",G O L A G U L,33642,33673,31
228,"New Tigrigna Music 2016 - Mehari kiros ''NIYATEY'' by G O L A G U L 6 years ago 4 minutes, 23 seconds 2,507 views",G O L A G U L,2507,2509,2
229,"New Tigrigna Music - Wezef Gidena - edley by G O L A G U L 6 years ago 4 minutes, 31 seconds 34,624 views",G O L A G U L,34624,34628,4
230,"New Tigrigna Music - Sntayehu Molla - Hagerey by G O L A G U L 6 years ago 6 minutes, 9 seconds 4,283 views",G O L A G U L,4283,4283,0
231,"New Tigrigna Music 2016 - Kalayu G/her - Desdes by G O L A G U L 6 years ago 6 minutes, 14 seconds 110,095 views",G O L A G U L,110095,110163,68
232,"New Tigrigna Music - Kidist Birhane #milat Lbey# by G O L A G U L 6 years ago 5 minutes, 36 seconds 65,955 views",G O L A G U L,65955,65973,18
233,"Spa - Natural Spring water by G O L A G U L 6 years ago 1 minute, 23 seconds 925 views",G O L A G U L,925,925,0
234,"New Ethiopian Tigrigna Music Dejen & Selam Ruhu Aykonen ርሑቕ ኣይኮነን by G O L A G U L 6 years ago 6 minutes, 5 seconds 16,451 views",G O L A G U L,16451,16462,11
235,"New Tigrigna Music 2015 Abreham Haftu   Akieluki ኣኽኢሉኪ by G O L A G U L 6 years ago 6 minutes, 21 seconds 4,893 views",G O L A G U L,4893,4895,2
236,"New Tigrigna Traditional Music 2015 Awetash Fitiwi #Shnuney# ሽኑነይ by G O L A G U L 6 years ago 5 minutes, 50 seconds 36,452 views",G O L A G U L,36452,36537,85
237,"New Tigrigna Music 2015 Rezene Teame #RAHRHI# ራህርሂ by G O L A G U L 6 years ago 6 minutes, 24 seconds 261,387 views",G O L A G U L,261387,262599,1212
238,"Thank you - Yapi mapi Meles Tribute  Song by G O L A G U L 6 years ago 6 minutes, 42 seconds 1,576 views",G O L A G U L,1576,1583,7
239,"Neglect - rahwa addis tesfay by G O L A G U L 6 years ago 2 minutes, 51 seconds 1,371 views",G O L A G U L,1371,1371,0
240,"On Track By Rahwa Addis Tesfay by G O L A G U L 6 years ago 1 minute, 27 seconds 2,303 views",G O L A G U L,2303,2304,1
241,"Winta Ataklti ft.  Yodit Muruts #Hagerey#  New Ethiopian music 2015 by G O L A G U L 6 years ago 5 minutes, 38 seconds 7,569 views",G O L A G U L,7569,7572,3
242,"Gzachew Solomon #Weni# ወኒ (NEW TRADITINAL TIGRIGNA MUSIC 2015) by G O L A G U L 6 years ago 5 minutes, 23 seconds 48,007 views",G O L A G U L,48007,48047,40
243,"Aregawi G/her  #Bizey seb# ብዘይ ሰብ (NEW TRADITIONAL TIGRIGNA MUSIC 2015)Bahlawi by G O L A G U L 6 years ago 6 minutes, 49 seconds 1,577,785 views",G O L A G U L,1577785,1587518,9733
244,"Fitawrari Kibromma # Ab yelakat # ኣብ የላካት by G O L A G U L 6 years ago 4 minutes, 18 seconds 3,235 views",G O L A G U L,3235,3238,3
245,"Desta Berhe ""Chaw Chaw"" ቻው ቻው New Traditional Tigrigna Music 2015 by G O L A G U L 6 years ago 6 minutes, 25 seconds 48,431 views",G O L A G U L,48431,48453,22
246,"dawit nega /damena / #tsehay tsome arbea# ፀሓይ ጶም ኣርበዓ by G O L A G U L 6 years ago 6 minutes, 8 seconds 18,814 views",G O L A G U L,18814,18817,3
247,"Amharic Film Trailer ''Marqueza'' ማርኬዛ by G O L A G U L 7 years ago 1 minute, 58 seconds 4,295 views",G O L A G U L,4295,4296,1
248,"Dawi Nega /Deamena/  #Gutena# /New Tigrigna Music 2015/ by G O L A G U L 7 years ago 4 minutes, 24 seconds 31,505 views",G O L A G U L,31505,31507,2
249,"Solomon Ykunoamlak #ALMAZ# New Tigrigna Music 2015 by G O L A G U L 7 years ago 5 minutes, 47 seconds 176,750 views",G O L A G U L,176750,176843,93
250,"Tesfay Gidey ''Salakaye'' ሳላካየ New Tigrigna Music 2015 by G O L A G U L 7 years ago 6 minutes, 36 seconds 95,264 views",G O L A G U L,95264,95346,82
251,"New Traditional  Tigrigna Music 2015 ''Hileley'' Selam Kelelom by G O L A G U L 7 years ago 5 minutes, 18 seconds 56,677 views",G O L A G U L,56677,56682,5
252,"HAGRE yapi Mapi Ft. dawit nega Ethiopian Music 2015 by G O L A G U L 7 years ago 4 minutes, 10 seconds 68,670 views",G O L A G U L,68670,68697,27
253,"New Tigrigna Music 2015 ውቅብተይ ""Wukbtey"" Saymon Haile by G O L A G U L 7 years ago 3 minutes, 23 seconds 32,066 views",G O L A G U L,32066,32070,4
254,"New Tigrigna Music 2015 ለካቲት ንዓና by G O L A G U L 7 years ago 6 minutes, 7 seconds 36,643 views",G O L A G U L,36643,36647,4
255,"Goyteom Tamrat (fiyona) #ኣይእዘዝን 'ዩ ፍቅሪ#Tigrigna Music New 2015 by G O L A G U L 7 years ago 4 minutes, 56 seconds 140,445 views",G O L A G U L,140445,140470,25
256,"New Tigrigna Music 2015 ''Keynmano'' Goiteom Weldegerima by G O L A G U L 7 years ago 6 minutes, 4 seconds 71,453 views",G O L A G U L,71453,71454,1
257,"''Entay Kabseley'' Awetash Ftiwi Best Tigrigna Music by G O L A G U L 7 years ago 6 minutes, 47 seconds 17,985 views",G O L A G U L,17985,18082,97
258,"New Tigrigna music ''ምስ ወዲ  ሩባይ'' Gidey Tesfay by G O L A G U L 7 years ago 6 minutes, 35 seconds 37,706 views",G O L A G U L,37706,37745,39
259,"New Tigrigna Music Girmay G/hiwet by G O L A G U L 7 years ago 6 minutes, 7 seconds 16,103 views",G O L A G U L,16103,16118,15
260,"Tigrigna Music  #ኣቲ ወይዘሮ# atiweyzero Tsegalul H/mariam by G O L A G U L 7 years ago 5 minutes, 28 seconds 28,008 views",G O L A G U L,28008,28037,29
261,"New Traditional Tigrigna Music #ኣውርስ# Girmay G/hiwet by G O L A G U L 7 years ago 5 minutes, 6 seconds 16,274 views",G O L A G U L,16274,16281,7
262,"Winta Birhane ''Zreaye Aynu Ybrah'' ዝረኣየ ዓይኑ ይብራህ by G O L A G U L 7 years ago 5 minutes, 44 seconds 36,979 views",G O L A G U L,36979,37050,71
263,"Yemane G/tsadkan '' Ykunelki'' New tigrigna music by G O L A G U L 7 years ago 6 minutes, 32 seconds 5,802 views",G O L A G U L,5802,5802,0
264,"Kiros Girmay  ''Genet Adom'' ገነት ኤዶም New Tigrigna  Traditiona music by G O L A G U L 7 years ago 6 minutes, 56 seconds 5,948 views",G O L A G U L,5948,5949,1
265,"Ftsum Hagos /weyley weyley/ New Tigrigna Music ''Tefelalina dina'' by G O L A G U L 7 years ago 4 minutes, 16 seconds 3,994 views",G O L A G U L,3994,3998,4
266,"New Ethiopian Traditional Music by G O L A G U L 7 years ago 5 minutes, 24 seconds 19,021 views",G O L A G U L,19021,19024,3
267,"New Ethiopian Traditional tigrigna Music ''muzey'' by G O L A G U L 7 years ago 5 minutes, 23 seconds 23,664 views",G O L A G U L,23664,23667,3
268,"New Tigrigna Music 2014 ''Smeru'' Solomon Ykunoamlak by G O L A G U L 7 years ago 6 minutes, 49 seconds 58,783 views",G O L A G U L,58783,58833,50
269,"Celebration Ashenda by G O L A G U L 7 years ago 3 minutes, 26 seconds 9,396 views",G O L A G U L,9396,9400,4
270,"New Traditional  Tigrigna Music 2014 ደሞኒ by G O L A G U L 7 years ago 6 minutes, 11 seconds 174,092 views",G O L A G U L,174092,174131,39
271,"New Tigrigna Music 2014 ''Shkorina'' ሽኮሪና by G O L A G U L 7 years ago 6 minutes, 21 seconds 19,932 views",G O L A G U L,19932,19942,10
272,"Solomon Bayre /Wedi Bayre/ New Tigrigna Music 2014 ''Beynki nie'' በይንኺ ንዒ by G O L A G U L 7 years ago 5 minutes, 20 seconds 690,752 views",G O L A G U L,690752,692615,1863
273,"ktmetsni- Gezae Teshome by G O L A G U L 7 years ago 5 minutes, 25 seconds 5,456 views",G O L A G U L,5456,5468,12
274,"''Yekuriro'' Tigrigna Music New 2014 Rahel Getachew by G O L A G U L 7 years ago 5 minutes, 58 seconds 34,321 views",G O L A G U L,34321,34346,25
275,"New Tigrigna Music 2014 ''Aytihawkeni'' Halewat Hagos by G O L A G U L 7 years ago 4 minutes, 34 seconds 9,267 views",G O L A G U L,9267,9275,8
276,"New Traditional Tigrigna Music ''Birey'' Tesfalem Berhe by G O L A G U L 7 years ago 5 minutes, 47 seconds 39,892 views",G O L A G U L,39892,39906,14
277,"Celebration Kistay 2 in Planet Hotel Mekelle by G O L A G U L 7 years ago 12 minutes, 35 seconds 42,435 views",G O L A G U L,42435,42441,6
278,"New Tigrigna Music 2014 ''Mama'' Solomon Ykunoamlak by G O L A G U L 7 years ago 4 minutes, 7 seconds 34,361 views",G O L A G U L,34361,34373,12
279,"New Tigrigna Music 2014 ""Dine Mot'' Tiemtu G/hiwet & Amanual yemane by G O L A G U L 7 years ago 8 minutes, 13 seconds 24,644 views",G O L A G U L,24644,24651,7
280,"New Tigrigna Music Tseame Zewde ""Aykonetin Nsa"" by G O L A G U L 7 years ago 5 minutes, 50 seconds 2,734 views",G O L A G U L,2734,2734,0
281,"Traditional Tigrigna Music Rahwa Yemane by G O L A G U L 7 years ago 6 minutes, 33 seconds 260,981 views",G O L A G U L,260981,261184,203
282,"Traditional Ethiopian Music marta g/medhin by G O L A G U L 7 years ago 5 minutes, 28 seconds 15,893 views",G O L A G U L,15893,15896,3
283,"New Tigrigna Music 2014 Kidan Zerabruk ""Maley'' ማለይ by G O L A G U L 7 years ago 6 minutes, 5 seconds 8,833 views",G O L A G U L,8833,8835,2
284,"Traditional Tigrigna Music ፈለገ ረዳ ድቦኦተይ by G O L A G U L 7 years ago 6 minutes, 24 seconds 31,408 views",G O L A G U L,31408,31413,5
285,"New Traditional Tigrigna Awris ሄለን ገሂወት ኮኾብ እዩ ዓይንኻ by G O L A G U L 7 years ago 6 minutes, 3 seconds 19,528 views",G O L A G U L,19528,19538,10
286,"New Traditional Tigrigna Music 2014 ""Hileley"" Solomon G/michael ሒለለይ by G O L A G U L 7 years ago 6 minutes, 41 seconds 149,829 views",G O L A G U L,149829,149944,115
287,"Traditional Tigrigna Music  ባህልና - ሄለን ገ/ሂወት + ልእልቲ ፀጋይ by G O L A G U L 7 years ago 6 minutes, 27 seconds 66,795 views",G O L A G U L,66795,66809,14
288,"New Tigrigna Music 2014 ደስ ኢሉኒ - ትርሓስ ታረቀ ኮበለይ by G O L A G U L 7 years ago 6 minutes, 3 seconds 78,837 views",G O L A G U L,78837,78840,3
289,"New Traditional Tigrigna Music ወይናይ - ኣድሓነት ዕቋር by G O L A G U L 7 years ago 5 minutes, 31 seconds 98,436 views",G O L A G U L,98436,98484,48
290,"New Tigrigna Music ሰላም ናዓኺ - ደሳለኝ ዘርኡ by G O L A G U L 7 years ago 6 minutes, 41 seconds 4,801 views",G O L A G U L,4801,4805,4
291,"Best New Tradirional Tigrigna Music ወደሽ - ገ/ሂወት ገ/ማርያም (ምራጭ) ባህላዊ by G O L A G U L 7 years ago 4 minutes, 54 seconds 905,507 views",G O L A G U L,905507,908473,2966
292,"New Traditional Tigrigna Music 2014 ጡዑም ወረ - ገነት የማነ by G O L A G U L 7 years ago 5 minutes, 59 seconds 88,036 views",G O L A G U L,88036,88344,308
293,"New Traditional Tigrigna Music 2014 የሒላል ዶ - ክፍሎም ገ/ማርያም by G O L A G U L 7 years ago 6 minutes, 24 seconds 11,254 views",G O L A G U L,11254,11260,6
294,"Traditional Music New 2014 ነጠባ - ኪዳን ዘርኣብሩኽ by G O L A G U L 7 years ago 5 minutes, 17 seconds 6,027 views",G O L A G U L,6027,6030,3
295,"New Tigrigna Music 2014 ኣምፅኣያ ፍቅሪ - ትግስት ሃሚካኤል by G O L A G U L 7 years ago 6 minutes, 11 seconds 12,441 views",G O L A G U L,12441,12445,4
296,"በዓል ልደት ምስ ተጋዳላይ ገብሩ ፋኖ by GiZE TIGRIGNA ENTERTAINMENT 1 month ago 24 minutes 22,173 views",GiZE TIGRIGNA ENTERTAINMENT,22173,22252,79
297,"ካብ ወፃኢ ናብ ግንባር | ተጋዳላይ ዮናስን ተጋዳላይ ሰዓረን by GiZE TIGRIGNA ENTERTAINMENT 1 month ago 24 minutes 42,551 views",GiZE TIGRIGNA ENTERTAINMENT,42551,42684,133
298,"Hadush Gebrehiwet - ትግራይ - Tigrigna music ካብ ግንባር by GiZE TIGRIGNA ENTERTAINMENT 1 month ago 8 minutes, 32 seconds 14,811 views",GiZE TIGRIGNA ENTERTAINMENT,14811,15032,221
299,"Aregawi Tesfay - ሰሚዐዮ ደሃይካ - Tigrigna music ካብ ግንባር by GiZE TIGRIGNA ENTERTAINMENT 1 month ago 9 minutes, 58 seconds 78,601 views",GiZE TIGRIGNA ENTERTAINMENT,78601,79901,1300
300,"በዓል ልደት ምስ ተጋዳላይ ዘመን ኣለምሰገድ ካብ ግንባር by GiZE TIGRIGNA ENTERTAINMENT 1 month ago 31 minutes 39,366 views",GiZE TIGRIGNA ENTERTAINMENT,39366,39503,137
301,"ጠርጣራው ስቡሕ - ቃልሲ ኣብ ወፃኢ | Tertaraw Sbuh - Kalsi Ab Wetsae - TPLF Tigrigna Music by GiZE TIGRIGNA ENTERTAINMENT 3 months ago 3 minutes, 49 seconds 1,395 views",GiZE TIGRIGNA ENTERTAINMENT,1395,1412,17
302,"ብፃይነት | ሰራዊት ትግራይ by GiZE TIGRIGNA ENTERTAINMENT 3 months ago 11 minutes, 15 seconds 2,469 views",GiZE TIGRIGNA ENTERTAINMENT,2469,2476,7
303,"ስደደለይ ወረ | Tertaraw Sbuh - Sdedeley Were - Tigrigna Music by GiZE TIGRIGNA ENTERTAINMENT 5 months ago 4 minutes, 21 seconds 9,956 views",GiZE TIGRIGNA ENTERTAINMENT,9956,10254,298
304,"Abebe Araya ~ ሽደነይ ሓለፎም | Shideney Halefom - Tigrigna Music 2021 by GiZE TIGRIGNA ENTERTAINMENT 5 months ago 6 minutes, 46 seconds 4,708 views",GiZE TIGRIGNA ENTERTAINMENT,4708,4730,22
305,"ወሸን ኢልካዮም አንበሳ ሰራዊት | ካብ ዜማታት ተጋድሎ - Tigrigna Music by GiZE TIGRIGNA ENTERTAINMENT 6 months ago 4 minutes, 23 seconds 1,657 views",GiZE TIGRIGNA ENTERTAINMENT,1657,1669,12
306,"ውረሰኒ ተጋዳላይ - ኮለኔል ፀጋይ ትኩእ | Col. Tsegay Tkue - Wureseni Tegadalay - TPLF Tigrigna Music by GiZE TIGRIGNA ENTERTAINMENT 1 year ago 5 minutes, 51 seconds 61,657 views",GiZE TIGRIGNA ENTERTAINMENT,61657,61919,262
307,"በረኻ ዓደይ || Bereka Adey - ካብ ዜማታት ተጋድሎ - Tigrigna Music 2021 by GiZE TIGRIGNA ENTERTAINMENT 1 year ago 7 minutes, 45 seconds 16,502 views",GiZE TIGRIGNA ENTERTAINMENT,16502,16568,66
308,"ትግራይ ዓደይ ናተይ | ካብ ዜማታት ተጋድሎ - Tigray Adey Natey -Tigrigna Music 2021 by GiZE TIGRIGNA ENTERTAINMENT 1 year ago 5 minutes, 46 seconds 6,239 views",GiZE TIGRIGNA ENTERTAINMENT,6239,6268,29
309,"ዘይትሽፈን ሓቀኛ ቅያ | ካብ ዜማታት ተጋድሎ - Tigrigna Music by GiZE TIGRIGNA ENTERTAINMENT 1 year ago 4 minutes, 40 seconds 35,298 views",GiZE TIGRIGNA ENTERTAINMENT,35298,35392,94
310,"Abrhet Abdu - Gezana || ገዛና -  best Memorable Tigrigna Music by GiZE TIGRIGNA ENTERTAINMENT 1 year ago 5 minutes, 14 seconds 24,034 views",GiZE TIGRIGNA ENTERTAINMENT,24034,24379,345
311,"ዒፈየ | Awetash Mulugeta -  Efeye Teleakini Do - New Tigrigna Music by GiZE TIGRIGNA ENTERTAINMENT 1 year ago 3 minutes, 26 seconds 30,266 views",GiZE TIGRIGNA ENTERTAINMENT,30266,30498,232
312,"Tesfay Weldeyowhans - Abzkone Bota  || ተስፋይ ዋጣ  best Tigrigna music by GiZE TIGRIGNA ENTERTAINMENT 1 year ago 6 minutes, 37 seconds 24,243 views",GiZE TIGRIGNA ENTERTAINMENT,24243,24665,422
313,"Mizan Tesfay - Selel Beli || ሰለል በሊ - Tigrigna music 2020 by GiZE TIGRIGNA ENTERTAINMENT 1 year ago 6 minutes, 18 seconds 4,513 views",GiZE TIGRIGNA ENTERTAINMENT,4513,4558,45
314,"ፍሰሃ ገበል - ንሓርነት || Fisha Gebel - NHarnet - Tigrigna old TPLF Music by GiZE TIGRIGNA ENTERTAINMENT 1 year ago 3 minutes, 53 seconds 14,097 views",GiZE TIGRIGNA ENTERTAINMENT,14097,14232,135
315,"ትግራይ - ካብ ደርፍታት ቀደም || Tigray - TPLF old Tigrigna Music by GiZE TIGRIGNA ENTERTAINMENT 1 year ago 3 minutes, 36 seconds 5,189 views",GiZE TIGRIGNA ENTERTAINMENT,5189,5209,20
316,"ሓረስታይ 'ያ ኮይኑ ኢሎሙዋቶ ዝብኢ - Old Tplf Tigrigna Political Music 2020 by GiZE TIGRIGNA ENTERTAINMENT 1 year ago 4 minutes, 11 seconds 5,424 views",GiZE TIGRIGNA ENTERTAINMENT,5424,5424,0
317,"ሓርነት ዮውሃንስ ~ በይዛ ዓድና ንውደቐላ || Harnet Yewhans - Beyza Adna Nwdekela - Tigrigna TPLF Music by GiZE TIGRIGNA ENTERTAINMENT 1 year ago 4 minutes, 14 seconds 2,674 views",GiZE TIGRIGNA ENTERTAINMENT,2674,2683,9
318,"ተቖነንለይ || Hiluf Alemu ~ Tekonenley - best (Old) Tigrigna Music 2020 by GiZE TIGRIGNA ENTERTAINMENT 1 year ago 7 minutes, 38 seconds 175,643 views",GiZE TIGRIGNA ENTERTAINMENT,175643,182320,6677
319,"Mizan Tesfay ~ Zyada || ዝያዳ - Tigrigna Music by GiZE TIGRIGNA ENTERTAINMENT 1 year ago 6 minutes, 2 seconds 3,198 views",GiZE TIGRIGNA ENTERTAINMENT,3198,3221,23
320,"Tewelde Yemane ~ Alelikiyo do || ኣለሊኪዮ 'ዶ - Tigrigna Music by GiZE TIGRIGNA ENTERTAINMENT 1 year ago 7 minutes, 2 seconds 7,397 views",GiZE TIGRIGNA ENTERTAINMENT,7397,7429,32
321,"Awetash Mulugeta - ሓዱሽ ኣይኮነን ንዓና || Hadush Aykonen Nana - Tigrigna TPLF Music by GiZE TIGRIGNA ENTERTAINMENT 1 year ago 5 minutes, 46 seconds 31,776 views",GiZE TIGRIGNA ENTERTAINMENT,31776,32084,308
322,"Eyasu Berhe - ደምኩም 'ዩ ቃል ኪዳንና - Tplf Tigrigna Music by GiZE TIGRIGNA ENTERTAINMENT 1 year ago 10 minutes, 36 seconds 84,277 views",GiZE TIGRIGNA ENTERTAINMENT,84277,84582,305
323,"እንተሸፈንካያ ዘይትሽፈን - ካብ ዜማታት ተጋድሎ - Tigrigna Tplf Music by GiZE TIGRIGNA ENTERTAINMENT 1 year ago 5 minutes, 16 seconds 28,352 views",GiZE TIGRIGNA ENTERTAINMENT,28352,28389,37
324,"Yemane GebreMichael - Weyno || ወይኖ - Wedi Afro - Tigrigna Music by GiZE TIGRIGNA ENTERTAINMENT 1 year ago 6 minutes, 43 seconds 20,065 views",GiZE TIGRIGNA ENTERTAINMENT,20065,20126,61
325,"ያይኔ ኣባይ - በዓልቲ ማዕዶ || Yayne Abay - Bealti Maedo - Tigrigna Music by GiZE TIGRIGNA ENTERTAINMENT 1 year ago 6 minutes, 38 seconds 16,519 views",GiZE TIGRIGNA ENTERTAINMENT,16519,16556,37
326,"Habtom Gebremichael - Kem Kahtay || ከም ቃሕታይ - Tigrigna Music by GiZE TIGRIGNA ENTERTAINMENT 1 year ago 6 minutes, 56 seconds 25,903 views",GiZE TIGRIGNA ENTERTAINMENT,25903,25942,39
327,"ያይኔ ኣባይ - ኣሸሙንየ || Yayne Abay - Ashemunye - Tigrigna Music by GiZE TIGRIGNA ENTERTAINMENT 1 year ago 6 minutes, 57 seconds 61,853 views",GiZE TIGRIGNA ENTERTAINMENT,61853,61954,101
328,"ያይኔ ኣባይ - ዕሰልየ || Yayne Abay - Esel'ye - Best Traditional Tigrigna Music by GiZE TIGRIGNA ENTERTAINMENT 1 year ago 10 minutes, 50 seconds 13,005 views",GiZE TIGRIGNA ENTERTAINMENT,13005,13083,78
329,"Yayne Abay - Shim Sienelki || ሽም ስኢነልኪ - Tigrigna Music by GiZE TIGRIGNA ENTERTAINMENT 1 year ago 7 minutes, 21 seconds 36,874 views",GiZE TIGRIGNA ENTERTAINMENT,36874,36909,35
330,"ያይኔ ኣባይ - ነብሲ || Yayne Abay - Nebsi - Tigrigna Music by GiZE TIGRIGNA ENTERTAINMENT 1 year ago 6 minutes, 32 seconds 20,005 views",GiZE TIGRIGNA ENTERTAINMENT,20005,20051,46
331,"Birhane Haile - Msgana || ምስጋና - Tigrigna Music 2020 by GiZE TIGRIGNA ENTERTAINMENT 1 year ago 8 minutes, 9 seconds 32,412 views",GiZE TIGRIGNA ENTERTAINMENT,32412,32604,192
332,"ዓወት ቀሪባ || Awet Keriba - Tigrigna Tplf Old Music by GiZE TIGRIGNA ENTERTAINMENT 1 year ago 4 minutes, 8 seconds 11,431 views",GiZE TIGRIGNA ENTERTAINMENT,11431,11503,72
333,"Weldegebriel Tsegay - Atnie || ኣትኔ - Tigrigna Traditional Music by GiZE TIGRIGNA ENTERTAINMENT 1 year ago 5 minutes, 46 seconds 23,423 views",GiZE TIGRIGNA ENTERTAINMENT,23423,24267,844
334,"Nigsti Hayelom - Selam || ሰላም - Tigrigna Music by GiZE TIGRIGNA ENTERTAINMENT 1 year ago 7 minutes, 40 seconds 2,428 views",GiZE TIGRIGNA ENTERTAINMENT,2428,2459,31
335,"Esayas Arefayne - Gual Gezay || ጓል ገዛይ - Best Tigrigna Music by GiZE TIGRIGNA ENTERTAINMENT 1 year ago 6 minutes, 29 seconds 27,323 views",GiZE TIGRIGNA ENTERTAINMENT,27323,27384,61
336,"ጠርጣራው ስቡሕ - ዓዲ ጀጋኑ ዓደይ || Tertaraw Sbuh - Adi Jeganu Adey - Tigrigna Old Music by GiZE TIGRIGNA ENTERTAINMENT 1 year ago 4 minutes, 51 seconds 9,384 views",GiZE TIGRIGNA ENTERTAINMENT,9384,9459,75
337,"Abrehet Abdu ~ Tsewuley || ፀውዑለይ - Tigrigna Music 2020 by GiZE TIGRIGNA ENTERTAINMENT 1 year ago 5 minutes, 55 seconds 39,319 views",GiZE TIGRIGNA ENTERTAINMENT,39319,40764,1445
338,"Tirhas Tareke ~ Alemey || ዓለመይ - Tigrigna Music by GiZE TIGRIGNA ENTERTAINMENT 1 year ago 5 minutes, 46 seconds 28,692 views",GiZE TIGRIGNA ENTERTAINMENT,28692,28723,31
339,"Eyasu Berhe ~ Hadera || ሓደራ - Tigrigna Tplf Music by GiZE TIGRIGNA ENTERTAINMENT 1 year ago 6 minutes, 41 seconds 77,741 views",GiZE TIGRIGNA ENTERTAINMENT,77741,78177,436
340,"Sofia Atsbeha ~ Nsu Eyu Natey || ንሱ 'ዩ ናተይ - Tigrigna Music by GiZE TIGRIGNA ENTERTAINMENT 1 year ago 5 minutes, 58 seconds 31,442 views",GiZE TIGRIGNA ENTERTAINMENT,31442,31550,108
341,"Mizan Tesfay ~ Adeye || ዓደየ - Tigrigna Music by GiZE TIGRIGNA ENTERTAINMENT 1 year ago 5 minutes, 47 seconds 15,434 views",GiZE TIGRIGNA ENTERTAINMENT,15434,15492,58
342,"Gebru Fano - Kulu Kiele || ኩሉ ኺኢለ - Tigrigna Music by GiZE TIGRIGNA ENTERTAINMENT 1 year ago 6 minutes, 39 seconds 50,280 views",GiZE TIGRIGNA ENTERTAINMENT,50280,50366,86
343,"Eyasu Berhe ~ ይሓርስ ኣለኹ  || እያሱ በርሀ - ካብ ደርፍታት ቐደም - OLD Tigrigna Tplf Music by GiZE TIGRIGNA ENTERTAINMENT 1 year ago 5 minutes, 26 seconds 11,245 views",GiZE TIGRIGNA ENTERTAINMENT,11245,11356,111
344,"Abebe Araya ~ Nay Fikri Meaza || ናይ ፍቕሪ መኣዛ -  Tigrigna Music by GiZE TIGRIGNA ENTERTAINMENT 1 year ago 5 minutes, 17 seconds 25,584 views",GiZE TIGRIGNA ENTERTAINMENT,25584,25797,213
345,"ተጋዳላይ ኣበበ ኣርኣያ - ድምፂ ወያነ ትግራይ || Abebe Araya - Dimtsi Woyane Tigray Tigrigna Music by GiZE TIGRIGNA ENTERTAINMENT 1 year ago 4 minutes, 36 seconds 41,622 views",GiZE TIGRIGNA ENTERTAINMENT,41622,41783,161
346,"Abrhet Abdu ~ Emeneni || እመነኒ - Tigrigna Music by GiZE TIGRIGNA ENTERTAINMENT 1 year ago 5 minutes, 19 seconds 70,372 views",GiZE TIGRIGNA ENTERTAINMENT,70372,70719,347
347,"Weldegebrial Tsegay - Abey Ke Ada || ኣበይ ከ ዓዳ - Tigrigna Hot Guaila Music 2020 by GiZE TIGRIGNA ENTERTAINMENT 1 year ago 6 minutes, 38 seconds 39,478 views",GiZE TIGRIGNA ENTERTAINMENT,39478,42169,2691
348,"Sofya Atsbaha -  Sdet | ስደት - Tigrigna Music 2020 by GiZE TIGRIGNA ENTERTAINMENT 1 year ago 6 minutes, 7 seconds 9,878 views",GiZE TIGRIGNA ENTERTAINMENT,9878,9935,57
349,"Hiluf Alemu - Wursi Aleni || ውርሲ ኣለኒ - Tigrigna Music by GiZE TIGRIGNA ENTERTAINMENT 1 year ago 7 minutes, 6 seconds 17,296 views",GiZE TIGRIGNA ENTERTAINMENT,17296,17339,43
350,"Sofiya Atsbaha - Hberu || ሕበሩ - Tigrigna Music by GiZE TIGRIGNA ENTERTAINMENT 1 year ago 7 minutes, 4 seconds 17,358 views",GiZE TIGRIGNA ENTERTAINMENT,17358,17382,24
351,"Abrehet Abdu - Keyeresasuna || ከየረሳሱዑና - Tigrigna Music 2020 by GiZE TIGRIGNA ENTERTAINMENT 1 year ago 5 minutes, 4 seconds 85,257 views",GiZE TIGRIGNA ENTERTAINMENT,85257,86251,994
352,"Ataklti Hailemichael - Maleye | ምዓለየ | Tigrigna Music by GiZE TIGRIGNA ENTERTAINMENT 1 year ago 5 minutes, 43 seconds 65,364 views",GiZE TIGRIGNA ENTERTAINMENT,65364,66663,1299
353,"Eyasu Berhe ~ Guzm Bele [ ጉዝም በለ ] Tigrigna TPLF Music by GiZE TIGRIGNA ENTERTAINMENT 2 years ago 4 minutes, 44 seconds 54,476 views",GiZE TIGRIGNA ENTERTAINMENT,54476,54543,67
354,"Tewelde Yemane ~ Kizawin Eye [ ክዛውን 'የ ] Tigrigna Music by GiZE TIGRIGNA ENTERTAINMENT 2 years ago 7 minutes, 7 seconds 10,568 views",GiZE TIGRIGNA ENTERTAINMENT,10568,10639,71
355,"Birhane Haile || ቀጨውጨው ||  kechewchew  ~ best Tigrigna music 2019 by GiZE TIGRIGNA ENTERTAINMENT 2 years ago 6 minutes 111,090 views",GiZE TIGRIGNA ENTERTAINMENT,111090,113833,2743
356,"ሰሙነይ || Debesay Zegeye ~ Semuney ~ Tigrigna Music 2019 by GiZE TIGRIGNA ENTERTAINMENT 2 years ago 7 minutes, 25 seconds 86,071 views",GiZE TIGRIGNA ENTERTAINMENT,86071,88150,2079
357,"ሕዘኒ ሕዘንለይ || Tewelde Yemane ~ Hizeni Hzenley ~ Tigrigna Music 2019 by GiZE TIGRIGNA ENTERTAINMENT 2 years ago 6 minutes, 35 seconds 10,302 views",GiZE TIGRIGNA ENTERTAINMENT,10302,10329,27
358,"ፍቕሪ ዳኣ ዋና || Tewelde Yemane ~ Fqri DeA Wana - Tigrigna Music 2019 by GiZE TIGRIGNA ENTERTAINMENT 3 years ago 7 minutes, 25 seconds 105,365 views",GiZE TIGRIGNA ENTERTAINMENT,105365,105802,437
359,"እያሱ በርሀ ~ ሚዘር ኣላ'ኾ || Eyasu Berhe ~ Mizer Ala'ko ~ Tigrigna Music by GiZE TIGRIGNA ENTERTAINMENT 3 years ago 8 minutes, 24 seconds 61,683 views",GiZE TIGRIGNA ENTERTAINMENT,61683,63002,1319
360,"Hiluf Alemu ~ Adey Marey [ ኣደይ ማዓረይ ] best(old) Tigrigna Music 2019 by GiZE TIGRIGNA ENTERTAINMENT 3 years ago 6 minutes, 39 seconds 415,921 views",GiZE TIGRIGNA ENTERTAINMENT,415921,416872,951
361,"እያሱ በርሀ ~ ከላዕሎ ተጋድሎ  ||  Eyasu Berhe ~ KelaElo tegadilo ~ Tigrigna Music 2019 by GiZE TIGRIGNA ENTERTAINMENT 3 years ago 10 minutes, 38 seconds 909,247 views",GiZE TIGRIGNA ENTERTAINMENT,909247,917165,7918
362,"ትርሓስ ታረቀ ~ ኦሮማይ || Tirhas Tareke ~ Oromay Tigrigna Music 2019 by GiZE TIGRIGNA ENTERTAINMENT 3 years ago 6 minutes, 52 seconds 153,682 views",GiZE TIGRIGNA ENTERTAINMENT,153682,153911,229
363,"Birhane Haile ~ Ane Nbeyney || ኣነ ንበይነይ - Best New Tigrigna Music 2018 by GiZE TIGRIGNA ENTERTAINMENT 3 years ago 7 minutes, 4 seconds 177,194 views",GiZE TIGRIGNA ENTERTAINMENT,177194,179531,2337
364,"ብርሃነ ሃይለ ~ ኣዳልዩኒ ኣሰራ || Birhane Haile ~ Adalyuni Asera - Best Tigrigna Music 2018 by GiZE TIGRIGNA ENTERTAINMENT 3 years ago 9 minutes, 41 seconds 167,353 views",GiZE TIGRIGNA ENTERTAINMENT,167353,168269,916
365,"ኣበበ ኣርኣያ ~ ተዘኪሩኒ || Abebe Araya ~ Tezekiruni - Best Memorical Tigrigna new music 2018 by GiZE TIGRIGNA ENTERTAINMENT 3 years ago 6 minutes, 35 seconds 18,852 views",GiZE TIGRIGNA ENTERTAINMENT,18852,18890,38
366,"ኣበበ ኣርኣያ ~ ሰናይ ብሩህ ተስፋ - Abebe Araya ~ Senay Biruh Tesfa - Best Tigrigna Music by GiZE TIGRIGNA ENTERTAINMENT 3 years ago 5 minutes, 10 seconds 15,899 views",GiZE TIGRIGNA ENTERTAINMENT,15899,15923,24
367,"Abebe Araya ~ Nabaki Eyu kelbey [ ናባኺ እዩ ቀልበይ ] Best Tigrigna Music by GiZE TIGRIGNA ENTERTAINMENT 3 years ago 6 minutes, 26 seconds 28,805 views",GiZE TIGRIGNA ENTERTAINMENT,28805,29030,225
368,"ንግስቲ ሓየሎም ~ ሰናይ || Nigisti Hayelom ~ Senay - Tigrigna Music by GiZE TIGRIGNA ENTERTAINMENT 3 years ago 6 minutes, 21 seconds 26,960 views",GiZE TIGRIGNA ENTERTAINMENT,26960,27191,231
369,"ንግስቲ ሓየሎም ~  ጉማየ || Nigisti Hayelom ~ Gumaye Raya ~ Best tigrigna Music by GiZE TIGRIGNA ENTERTAINMENT 3 years ago 6 minutes, 58 seconds 59,391 views",GiZE TIGRIGNA ENTERTAINMENT,59391,59656,265
370,"ንግስቲ ሓየሎም -  ምጻእ ንገዛይ || Nigisti Hayelom -  MitsaE Nigezay -  Best Tigrigna Music 2018 by GiZE TIGRIGNA ENTERTAINMENT 3 years ago 4 minutes, 52 seconds 49,163 views",GiZE TIGRIGNA ENTERTAINMENT,49163,49530,367
371,"ንግስቲ ሓየሎም - እዚኦምየ ተጋሩ 'ዮምየ || Nigisti Hayelom - Eziomye Tegaru Eyomye  -  Best Tigrigna Musics by GiZE TIGRIGNA ENTERTAINMENT 3 years ago 5 minutes, 52 seconds 25,090 views",GiZE TIGRIGNA ENTERTAINMENT,25090,25333,243
372,"ንግስቲ ሓየሎም - ዓይኒ ብርከይ - Nigisti Hayelom - Ayni birkey - Best Tigrigna Music by GiZE TIGRIGNA ENTERTAINMENT 3 years ago 5 minutes, 48 seconds 15,013 views",GiZE TIGRIGNA ENTERTAINMENT,15013,15077,64
373,"ኣበበ ኣርኣያ - ሙልየነይ || Abebe Araya - Muleney - best Tigrigna Music by GiZE TIGRIGNA ENTERTAINMENT 3 years ago 7 minutes, 45 seconds 12,215 views",GiZE TIGRIGNA ENTERTAINMENT,12215,12263,48
374,"ኣበበ ኣርኣያ - ከላዕሎ ጀግና || Abebe Araya - KelAlo Jegna -  best Tigrigna Music by GiZE TIGRIGNA ENTERTAINMENT 3 years ago 5 minutes, 48 seconds 12,967 views",GiZE TIGRIGNA ENTERTAINMENT,12967,13051,84
375,"ኣበበ ኣርኣያ -  Iroma ኩናማ || Abebe Araya  -  Iroma  - best Kunama Music by GiZE TIGRIGNA ENTERTAINMENT 3 years ago 4 minutes, 19 seconds 2,218 views",GiZE TIGRIGNA ENTERTAINMENT,2218,2223,5
376,"ኣበበ ኣርኣያ -  ገዲዱኒ || Abebe Araya - Gediduni - best Tigrigna Music by GiZE TIGRIGNA ENTERTAINMENT 3 years ago 6 minutes, 46 seconds 4,684 views",GiZE TIGRIGNA ENTERTAINMENT,4684,4689,5
377,"ኣበበ ኣርኣያ -  ፍቅረይ ሓፁረይ ||  Abebe Araya -  Fikrey Hatsurey -  best Tigrigna Music by GiZE TIGRIGNA ENTERTAINMENT 3 years ago 5 minutes, 46 seconds 11,157 views",GiZE TIGRIGNA ENTERTAINMENT,11157,11187,30
378,"ኣበበ ኣርኣያ  - ኣትክል ስድራኻ ||  Abebe Araya - Atikl Sidraka -  best igrigna Music by GiZE TIGRIGNA ENTERTAINMENT 3 years ago 6 minutes, 1 second 5,116 views",GiZE TIGRIGNA ENTERTAINMENT,5116,5126,10
379,"ኣበበ ኣርኣያ - ዓደይ ወለላ || Abebe Araya - Adey Welela - best tigrigna Music by GiZE TIGRIGNA ENTERTAINMENT 3 years ago 6 minutes, 13 seconds 5,589 views",GiZE TIGRIGNA ENTERTAINMENT,5589,5592,3
380,"ኣበበ ኣርኣያ - ኣፍቒረ ||  Abebe Araya - Afkire - best tigrigna Music by GiZE TIGRIGNA ENTERTAINMENT 3 years ago 6 minutes, 13 seconds 6,330 views",GiZE TIGRIGNA ENTERTAINMENT,6330,6417,87
381,"ኣበበ ኣርኣያ - ኣስቴር || Abebe Araya - Aster - best tigrigna Music by GiZE TIGRIGNA ENTERTAINMENT 3 years ago 6 minutes, 36 seconds 13,761 views",GiZE TIGRIGNA ENTERTAINMENT,13761,13821,60
382,"ስለ ራያ መንነት ብዓበይቲ ዓዲ እንትግለፅ by GiZE TIGRIGNA ENTERTAINMENT 3 years ago 7 minutes, 7 seconds 2,769 views",GiZE TIGRIGNA ENTERTAINMENT,2769,2773,4
383,"ካብ ከብቢ ዳሞ ዝተረከበ ትግርኛ ጓይላ Tigrigna guala by GiZE TIGRIGNA ENTERTAINMENT 3 years ago 7 minutes, 8 seconds 3,553 views",GiZE TIGRIGNA ENTERTAINMENT,3553,3554,1
384,"Mulugeta Kahsay ( Wedi Romit ) ~ Kembwaza [ ከምብዋዛ ] Tigrigna Music by GiZE TIGRIGNA ENTERTAINMENT 3 years ago 4 minutes, 34 seconds 1,067 views",GiZE TIGRIGNA ENTERTAINMENT,1067,1082,15
385,"Mulugeta Kahsay ( Wedi romit ) ~ instrument ~ Tigrigna Music by GiZE TIGRIGNA ENTERTAINMENT 3 years ago 3 minutes, 45 seconds 1,742 views",GiZE TIGRIGNA ENTERTAINMENT,1742,1752,10
386,"Mulugeta Kahsay ( Wedi romit ) ~ Gena [ ገና ] Tigrigna Music by GiZE TIGRIGNA ENTERTAINMENT 3 years ago 6 minutes, 19 seconds 5,322 views",GiZE TIGRIGNA ENTERTAINMENT,5322,5373,51
387,"Mulugeta Kahsay ( Wedi romit ) ~ Gumaye [ ጉማየ ] Tigrigna Music by GiZE TIGRIGNA ENTERTAINMENT 3 years ago 6 minutes, 7 seconds 8,216 views",GiZE TIGRIGNA ENTERTAINMENT,8216,8714,498
388,"Mulugeta Kahsay ( Wedi romit ) ~ Amoray [ ኣሞራይ ] Tigrigna Music by GiZE TIGRIGNA ENTERTAINMENT 3 years ago 6 minutes, 5 seconds 7,823 views",GiZE TIGRIGNA ENTERTAINMENT,7823,7939,116
389,"Mulugeta Kahsay ( Wedi romit ) ~ Alesha [ ኣለሻ ]  Best Tigrigna Music by GiZE TIGRIGNA ENTERTAINMENT 3 years ago 5 minutes, 20 seconds 1,515 views",GiZE TIGRIGNA ENTERTAINMENT,1515,1528,13
390,"Mulugeta Kahsay ( Wedi romit ) ~ Alem [ ዓለም ] Best Tigrigna Music by GiZE TIGRIGNA ENTERTAINMENT 3 years ago 5 minutes, 38 seconds 4,737 views",GiZE TIGRIGNA ENTERTAINMENT,4737,4761,24
391,"Mulugeta Kahsay ( Wedi romit ) ~  Aytzuri [ ኣይትዙሪ ]  Tigrigna Music by GiZE TIGRIGNA ENTERTAINMENT 3 years ago 6 minutes, 9 seconds 1,459 views",GiZE TIGRIGNA ENTERTAINMENT,1459,1483,24
392,"መስቀል ኣብ ዓድግራት meskel in Adigrat ድሮ መስቅል by GiZE TIGRIGNA ENTERTAINMENT 3 years ago 10 minutes, 35 seconds 2,773 views",GiZE TIGRIGNA ENTERTAINMENT,2773,2776,3
393,"ሚዛን ተስፋይ ~ መስቀል ኣብ ዓዲግራት mizan tesfay on Adigrat Meskel by GiZE TIGRIGNA ENTERTAINMENT 3 years ago 4 minutes, 32 seconds 1,037 views",GiZE TIGRIGNA ENTERTAINMENT,1037,1040,3
394,"ኣታክልቲ ሃይለሚካኤል ~ ደሞነይ ደሞነይ || Ataklti Hailemichael ~ Demoney demoney   Best Tigrigna Music by GiZE TIGRIGNA ENTERTAINMENT 3 years ago 7 minutes, 45 seconds 29,854 views",GiZE TIGRIGNA ENTERTAINMENT,29854,30519,665
395,"ኣታክልቲ ሃይለሚካኤል ~ ወስ || Ataklti Hailemichael ~ Wes ~ Best Tigrigna Music by GiZE TIGRIGNA ENTERTAINMENT 3 years ago 7 minutes, 46 seconds 174,092 views",GiZE TIGRIGNA ENTERTAINMENT,174092,176260,2168
396,"ኣታክልቲ ሃይለሚካኤል ~ ከም መንደርኒ  || Ataklti Hailemichael ~ kem menderini   Best Tigrigna Music by GiZE TIGRIGNA ENTERTAINMENT 3 years ago 6 minutes, 51 seconds 214,940 views",GiZE TIGRIGNA ENTERTAINMENT,214940,216544,1604
397,"ኣታክልቲ ሃይለሚካኤል ~ ኣውርስ || Ataklti Hailemichael ~ Awiris   Best Tigrigna Music by GiZE TIGRIGNA ENTERTAINMENT 3 years ago 5 minutes, 3 seconds 3,638 views",GiZE TIGRIGNA ENTERTAINMENT,3638,3650,12
398,"ኣታክልቲ ሃይለሚካኤል ~ ኣነ ምሳኺ ወለል ~ Ataklti Hailemichael ~ Ane misaki welel    Best Tigrigna Music by GiZE TIGRIGNA ENTERTAINMENT 3 years ago 7 minutes, 14 seconds 80,552 views",GiZE TIGRIGNA ENTERTAINMENT,80552,81482,930
399,"ኣታክልቲ ሃይለሚካኤል ~ ንእስነት ||  Ataklti Hailemichael ~ NiEsinet   Best Tigrigna Music by GiZE TIGRIGNA ENTERTAINMENT 3 years ago 8 minutes, 1 second 205,931 views",GiZE TIGRIGNA ENTERTAINMENT,205931,207443,1512
400,"ኣታክልቲ ሃይለሚካኤል ~ ብረር ብረር ከዓ በለኒ || Ataklti michael ~ Brer brer kea beleni   Best Tigrigna Music by GiZE TIGRIGNA ENTERTAINMENT 3 years ago 7 minutes, 17 seconds 66,558 views",GiZE TIGRIGNA ENTERTAINMENT,66558,67847,1289
401,"ኣታክልቲ ሃይለሚካኤል ~ ቆልዓ ትግራይ || Ataklti Hailemichael ~ Kolau Tigray   Best Tigrigna Music by GiZE TIGRIGNA ENTERTAINMENT 3 years ago 5 minutes, 49 seconds 9,322 views",GiZE TIGRIGNA ENTERTAINMENT,9322,9387,65
402,"ኣታክልቲ ሃይለሚካኤል ~ ርሑስ ጋማ || Ataklti Hailemichael ~ Rhus Gama   Best Tigrigna Music by GiZE TIGRIGNA ENTERTAINMENT 3 years ago 8 minutes, 6 seconds 27,168 views",GiZE TIGRIGNA ENTERTAINMENT,27168,27345,177
403,"ኣታክልቲ ሃይለሚካኤል ~ ሰሙን ሓዘን || Ataklti Hailemichael ~ Semun hazen   Best Tigrigna Music by GiZE TIGRIGNA ENTERTAINMENT 3 years ago 7 minutes, 49 seconds 103,588 views",GiZE TIGRIGNA ENTERTAINMENT,103588,104683,1095
404,"ኣታክልቲ ሃይለሚካኤል ~ ሃሎ በልኒ ~ Ataklti Hailemichael ~ Halo belni    Best Tigrigna Music by GiZE TIGRIGNA ENTERTAINMENT 3 years ago 7 minutes, 59 seconds 199,579 views",GiZE TIGRIGNA ENTERTAINMENT,199579,201727,2148
405,"ኣታክልቲ ሃይለሚካኤል ~ መን ዩ ሞ መን ~ Ataklti michael ~ Men u mo men    Best Tigrigna Music by GiZE TIGRIGNA ENTERTAINMENT 3 years ago 7 minutes, 17 seconds 370,464 views",GiZE TIGRIGNA ENTERTAINMENT,370464,373794,3330
406,"Abrhet Abdu ~Nmntay [ንምንታይ] Tigrigna Music by GiZE TIGRIGNA ENTERTAINMENT 3 years ago 6 minutes, 40 seconds 13,044 views",GiZE TIGRIGNA ENTERTAINMENT,13044,13221,177
407,"Abrhet Abdu ~ Tesfaleni [ተስፋ'ለኒ] Tigrigna Music by GiZE TIGRIGNA ENTERTAINMENT 3 years ago 6 minutes, 16 seconds 26,776 views",GiZE TIGRIGNA ENTERTAINMENT,26776,27096,320
408,"Abrhet Abdu ~ Tegayishe [ተጋይሸ] Tigrigna Music by GiZE TIGRIGNA ENTERTAINMENT 3 years ago 6 minutes, 8 seconds 161,737 views",GiZE TIGRIGNA ENTERTAINMENT,161737,163235,1498
409,"Abrhet Abdu ~ Paqumen Hatsar [ጳግሜን ሓፃር] Tigrigna Music by GiZE TIGRIGNA ENTERTAINMENT 3 years ago 7 minutes, 31 seconds 2,676 views",GiZE TIGRIGNA ENTERTAINMENT,2676,2738,62
410,"Abrhet Abdu ~ Nabra Sidet [ናብራ ስደት] Tigrigna Music by GiZE TIGRIGNA ENTERTAINMENT 3 years ago 5 minutes, 16 seconds 38,887 views",GiZE TIGRIGNA ENTERTAINMENT,38887,39470,583
411,"Abrhet Abdu ~ Misaka [ምሳኻ] Tigrigna Music by GiZE TIGRIGNA ENTERTAINMENT 3 years ago 6 minutes, 57 seconds 46,866 views",GiZE TIGRIGNA ENTERTAINMENT,46866,47208,342
412,"Abrhet Abdu ~ Mekseb [መኽሰብ] Tigrigna Music by GiZE TIGRIGNA ENTERTAINMENT 3 years ago 6 minutes, 58 seconds 28,047 views",GiZE TIGRIGNA ENTERTAINMENT,28047,28220,173
413,"Abrhet Abdu ~ Libey KeAlo [ልበይ ከኣሎ] Tigrigna Music by GiZE TIGRIGNA ENTERTAINMENT 3 years ago 5 minutes, 15 seconds 31,426 views",GiZE TIGRIGNA ENTERTAINMENT,31426,31761,335
414,"Abrhet Abdu ~ Hadeyu wana [ሓደ እዩ ዋና] Tigrigna Music by GiZE TIGRIGNA ENTERTAINMENT 3 years ago 7 minutes, 12 seconds 75,506 views",GiZE TIGRIGNA ENTERTAINMENT,75506,77033,1527
415,"Abrhet Abdu ~ Halawi wesen [ሓላዊ ወሰን] Tigrigna Music by GiZE TIGRIGNA ENTERTAINMENT 3 years ago 6 minutes, 46 seconds 28,587 views",GiZE TIGRIGNA ENTERTAINMENT,28587,28773,186
416,"Abrhet Abdu ~ Gena Gena [ገና ገና] Tigrigna Music by GiZE TIGRIGNA ENTERTAINMENT 3 years ago 6 minutes, 30 seconds 193,309 views",GiZE TIGRIGNA ENTERTAINMENT,193309,195299,1990
417,"Abrhet Abdu ~ Fikirna [ፍቕርና] Tigrigna Music by GiZE TIGRIGNA ENTERTAINMENT 3 years ago 6 minutes, 27 seconds 31,615 views",GiZE TIGRIGNA ENTERTAINMENT,31615,32065,450
418,"Abrhet Abdu ~ Chaw Belo [ቻው በሎ] Tigrigna Music by GiZE TIGRIGNA ENTERTAINMENT 3 years ago 6 minutes, 39 seconds 104,885 views",GiZE TIGRIGNA ENTERTAINMENT,104885,106154,1269
419,"Eyasu Berhe ~ Sheraro [ሸራሮ]  Tigrigna Music by GiZE TIGRIGNA ENTERTAINMENT 3 years ago 3 minutes, 59 seconds 37,433 views",GiZE TIGRIGNA ENTERTAINMENT,37433,38068,635
420,"Gizachew Teshome - Ney Ney Musiraye by Gojo Media 4 years ago 6 minutes, 14 seconds 1,305,712 views",Gojo Media,1305712,1310245,4533
421,"Ethiopian Gojam music by Gojo Media 4 years ago 5 minutes, 55 seconds 150,799 views",Gojo Media,150799,151295,496
422,"Mebre Mengste - Kehagere Yasededegn by Gojo Media 4 years ago 7 minutes, 31 seconds 922,050 views",Gojo Media,922050,924879,2829
423,"Hailu Sertse - Zomalem by Gojo Media 4 years ago 5 minutes, 36 seconds 368,151 views",Gojo Media,368151,369297,1146
424,"Meseret Denekew - Bekebel Betaza by Gojo Media 5 years ago 6 minutes 411,755 views",Gojo Media,411755,412849,1094
425,"Eyayu Tenagn - Teshagere Wollo by Gojo Media 5 years ago 4 minutes, 30 seconds 412,493 views",Gojo Media,412493,412807,314
426,"Sete Zebegna - Gebahu Lalibela by Gojo Media 5 years ago 2 minutes, 7 seconds 982,035 views",Gojo Media,982035,986726,4691
427,"Yirga Ababu - Sidemer Siqenes by Gojo Media 5 years ago 4 minutes, 55 seconds 317,963 views",Gojo Media,317963,318274,311
428,"Melaku Sisay - Hode Ney Ney by Gojo Media 5 years ago 5 minutes, 36 seconds 301,336 views",Gojo Media,301336,302617,1281
429,"Eyayu Tenagne - Abro Menor by Gojo Media 5 years ago 5 minutes, 45 seconds 592,906 views",Gojo Media,592906,593351,445
430,"Aregahegn Worash - Yene Fetena by Gojo Media 5 years ago 5 minutes, 39 seconds 1,662,260 views",Gojo Media,1662260,1666932,4672
431,"Tesfaye Wube - Yewollo Shebela by Gojo Media 5 years ago 6 minutes, 13 seconds 89,267 views",Gojo Media,89267,89522,255
432,"Neberu Sintayehu - Borena by Gojo Media 5 years ago 5 minutes, 34 seconds 53,912 views",Gojo Media,53912,54009,97
433,"Teshome Mekonen - Besdet Lay by Gojo Media 5 years ago 5 minutes, 45 seconds 289,172 views",Gojo Media,289172,289579,407
434,"Nibret Waleligne - Yezarew Adare by Gojo Media 5 years ago 5 minutes, 54 seconds 396,672 views",Gojo Media,396672,399192,2520
435,"Melaku Negus - Shegawa by Gojo Media 5 years ago 6 minutes, 41 seconds 231,964 views",Gojo Media,231964,232603,639
436,"Habtu Ashagre - Jemeregn by Gojo Media 5 years ago 5 minutes, 31 seconds 169,681 views",Gojo Media,169681,169826,145
437,"Yirga Ababu  & Eyayu Tenagn - Yejegna Hager by Gojo Media 5 years ago 5 minutes, 43 seconds 71,031 views",Gojo Media,71031,71068,37
438,"Meseret Denekew - Teyew Ema by Gojo Media 5 years ago 7 minutes, 25 seconds 3,018,237 views",Gojo Media,3018237,3028049,9812
439,"Fenta Bele & Alemayehu Tesfaye - Wushetun Sikedew (Vol. 2) by Gojo Media 5 years ago 4 minutes, 33 seconds 396,031 views",Gojo Media,396031,396797,766
440,"Geremew Asefa - kerbrshigne by Gojo Media 5 years ago 4 minutes, 59 seconds 564,695 views",Gojo Media,564695,565502,807
441,"Selemon Yazachew - Neydemo by Gojo Media 5 years ago 6 minutes, 45 seconds 112,625 views",Gojo Media,112625,112662,37
442,"Nibret Walelign - Benager Chegeregn by Gojo Media 5 years ago 9 minutes, 35 seconds 221,986 views",Gojo Media,221986,222447,461
443,"Worku Andualem - Endemnew by Gojo Media 5 years ago 5 minutes, 51 seconds 500,499 views",Gojo Media,500499,502900,2401
444,"Mulusew Habtamu - Gedam by Gojo Media 5 years ago 5 minutes, 51 seconds 431,341 views",Gojo Media,431341,432961,1620
445,"Anmaw Basazenew - Yeshebelu by Gojo Media 5 years ago 8 minutes, 9 seconds 86,378 views",Gojo Media,86378,86573,195
446,"Demelash Shiferaw - Gizew Adergognal by Gojo Media 5 years ago 6 minutes, 38 seconds 33,395 views",Gojo Media,33395,33405,10
447,"Melaku Neguss - Ney Ney by Gojo Media 5 years ago 5 minutes, 12 seconds 147,814 views",Gojo Media,147814,148094,280
448,"Mimi Genetu - Abay Lewogenu by Gojo Media 5 years ago 6 minutes, 17 seconds 608,303 views",Gojo Media,608303,609699,1396
449,"Muhabaw Alamrew - Shire Eyalech by Gojo Media 5 years ago 6 minutes, 10 seconds 232,548 views",Gojo Media,232548,232885,337
450,"Aster Mulugeta - Arhibu by Gojo Media 5 years ago 4 minutes, 55 seconds 538,601 views",Gojo Media,538601,539889,1288
451,"Aster Mulugeta - Hagere by Gojo Media 5 years ago 5 minutes, 57 seconds 699,294 views",Gojo Media,699294,699618,324
452,"Mulusew Habtamu - Chiger New by Gojo Media 5 years ago 5 minutes, 30 seconds 659,832 views",Gojo Media,659832,660340,508
453,"Nibret Walelign - Yekenfer Wedaje by Gojo Media 5 years ago 6 minutes, 22 seconds 492,803 views",Gojo Media,492803,493217,414
454,"Worku Andualem - Aynama by Gojo Media 5 years ago 9 minutes, 11 seconds 498,058 views",Gojo Media,498058,499602,1544
455,"Melaku Sisay - Tutuan Getla by Gojo Media 5 years ago 5 minutes, 45 seconds 1,082,270 views",Gojo Media,1082270,1082492,222
456,"Endalkachew Yenehun - Ashebel Gedaye by Gojo Media 5 years ago 12 minutes, 28 seconds 563,233 views",Gojo Media,563233,564111,878
457,"Mebtu Adugna - Lalemye by Gojo Media 5 years ago 6 minutes 520,837 views",Gojo Media,520837,521893,1056
458,"Mulusew Habtamu - Zeb Leder by Gojo Media 5 years ago 6 minutes, 1 second 277,076 views",Gojo Media,277076,277371,295
459,"Misret Denekew - Bemot Engenagne by Gojo Media 6 years ago 7 minutes, 7 seconds 490,510 views",Gojo Media,490510,492659,2149
460,"Nibret Walelign - Yedera Lij Nat by Gojo Media 6 years ago 5 minutes, 39 seconds 357,354 views",Gojo Media,357354,359075,1721
461,"Tesfahun Hailu - Yefikir Rhabe by Gojo Media 6 years ago 6 minutes, 29 seconds 622,267 views",Gojo Media,622267,623170,903
462,"Teketel Eyalneh - Kaltemechesh by Gojo Media 6 years ago 5 minutes, 48 seconds 318,146 views",Gojo Media,318146,318255,109
463,"H/michael Melak - Wollo Yabekelat by Gojo Media 6 years ago 5 minutes, 51 seconds 504,919 views",Gojo Media,504919,506551,1632
464,"Aynalem Abere - Bikotuh Enateh by Gojo Media 6 years ago 8 minutes, 1 second 935,509 views",Gojo Media,935509,937945,2436
465,"Tigist Getu - Yigermal by Gojo Media 6 years ago 4 minutes, 41 seconds 63,526 views",Gojo Media,63526,63584,58
466,"Abebaw Kesete Berzebo by Gojo Media 6 years ago 6 minutes, 25 seconds 590,271 views",Gojo Media,590271,590788,517
467,"Getahun Ayalew - Yewolo Lij by Gojo Media 6 years ago 5 minutes, 13 seconds 303,904 views",Gojo Media,303904,304084,180
468,"Amsal Mitike - Zare New by Gojo Media 6 years ago 5 minutes, 58 seconds 3,522,195 views",Gojo Media,3522195,3535384,13189
469,"Mekuanent Melese - Na Beyign by Gojo Media 6 years ago 4 minutes, 41 seconds 953,034 views",Gojo Media,953034,956837,3803
470,"Solomon Yazachew - Yefikir Metimed by Gojo Media 6 years ago 6 minutes, 28 seconds 187,973 views",Gojo Media,187973,188026,53
471,"Berhanu Adugna - Tileshign Athiji by Gojo Media 7 years ago 4 minutes, 40 seconds 304,485 views",Gojo Media,304485,304723,238
472,"Semahegn Belew - Zena Bey by Gojo Media 7 years ago 7 minutes, 22 seconds 2,948,893 views",Gojo Media,2948893,2968433,19540
473,"Kassahun Taye - Ambayewa by Gojo Media 7 years ago 6 minutes, 37 seconds 1,466,701 views",Gojo Media,1466701,1467773,1072
474,"Yewolo Lije - Ethiopian Gojam Music by Gojo Media 7 years ago 5 minutes, 22 seconds 301,297 views",Gojo Media,301297,301374,77
475,"Tadesse Mekete - Ere Gobez by Gojo Media 7 years ago 5 minutes, 43 seconds 871,700 views",Gojo Media,871700,874398,2698
476,"Mola Setarge - Sibir EndeAmora by Gojo Media 7 years ago 5 minutes, 32 seconds 130,711 views",Gojo Media,130711,130753,42
477,"Yalew Aneley - Yewolo Lije by Gojo Media 7 years ago 5 minutes, 23 seconds 158,952 views",Gojo Media,158952,158990,38
478,"Amazing Ethiopian Gojam Zefen by Gojo Media 7 years ago 5 minutes, 48 seconds 77,182 views",Gojo Media,77182,77213,31
479,"Aweke Kassahun - Wolo by Gojo Media 7 years ago 5 minutes, 40 seconds 128,574 views",Gojo Media,128574,128675,101
480,"Andarge Worku - Wollo by Gojo Media 7 years ago 5 minutes, 20 seconds 642,715 views",Gojo Media,642715,644077,1362
481,"Yitbarek Getasetegn - Haray by Gojo Media 7 years ago 5 minutes, 5 seconds 211,677 views",Gojo Media,211677,211764,87
482,"Kassahun Taye - Eskis by Gojo Media 8 years ago 5 minutes, 43 seconds 815,726 views",Gojo Media,815726,818129,2403
483,"Mehari Degefaw - Raya by Gojo Media 8 years ago 5 minutes, 56 seconds 1,963,379 views",Gojo Media,1963379,1968617,5238
484,"Mehari Degefaw - Gonder by Gojo Media 8 years ago 6 minutes, 19 seconds 1,824,567 views",Gojo Media,1824567,1830946,6379
485,"Mehari Degefaw - Gojam by Gojo Media 8 years ago 5 minutes, 1 second 749,501 views",Gojo Media,749501,752073,2572
486,"Zinet Muhaba by Gojo Media 8 years ago 7 minutes, 29 seconds 1,025,341 views",Gojo Media,1025341,1027477,2136
487,"Dereje Degifew by Gojo Media 9 years ago 6 minutes, 36 seconds 839,837 views",Gojo Media,839837,842041,2204
488,"Ethiopian 2pac Azmari by Gojo Media 9 years ago 9 minutes, 27 seconds 73,768 views",Gojo Media,73768,73791,23
489,"Hailye Tadesse - Kuru Nech by Gojo Media 9 years ago 4 minutes, 31 seconds 517,019 views",Gojo Media,517019,517595,576
490,"Asefu Debalke by Gojo Media 10 years ago 4 minutes, 37 seconds 76,474 views",Gojo Media,76474,76520,46
491,"Asefu Debalke by Gojo Media 10 years ago 8 minutes, 12 seconds 900,936 views",Gojo Media,900936,902948,2012
492,"Teddy Afro - Lejenet Alat by Gojo Media 11 years ago 6 minutes, 20 seconds 2,099,349 views",Gojo Media,2099349,2101654,2305
493,"Gebisa Berehanu - Hin Ooluu - Ethiopian Oromo Music 2022 [Official Video] by Golden Ethio Music 1 day ago 4 minutes, 43 seconds 5,089 views",Golden Ethio Music,5089,21135,16046
494,"Birhaanuu Girmaa - Asaassaatemmoo - Ethiopian Oromo Music 2022 [Official Video] by Golden Ethio Music 1 day ago 4 minutes, 36 seconds 5,580 views",Golden Ethio Music,5580,19040,13460
495,"Miki Papi - Wedzi Wedeza /ወደዚ ወደዛ - New Ethiopian Music 2022 [Official Video] by Golden Ethio Music 3 days ago 3 minutes, 21 seconds 3,216 views",Golden Ethio Music,3216,4536,1320
496,"Melkamu Ayele - Dhufuufi - Ethiopian Oromo Music 2022 [Official Video] by Golden Ethio Music 4 days ago 5 minutes, 48 seconds 5,621 views",Golden Ethio Music,5621,16724,11103
497,"Iftuu Abbaani - Nu Oromoodha - Ethiopian Oromo Music 2022 [Official Video] by Golden Ethio Music 4 days ago 5 minutes, 33 seconds 10,965 views",Golden Ethio Music,10965,15458,4493
498,"Tesfa Meselu - Yaz Belew / ያዝ በለው - New Ethiopian Music 2022 [Official Video] by Golden Ethio Music 4 days ago 7 minutes 2,265 views",Golden Ethio Music,2265,2926,661
499,"Eyaderadis Bewekt - Abay Yegna New / አባይ የኛ ነው - New Ethiopian Music 2022 [Official Video] by Golden Ethio Music 5 days ago 5 minutes, 11 seconds 964 views",Golden Ethio Music,964,1085,121
500,"Ephrem Shewarega - ኤፍሬም ሸዋረጋ - Agerdi / አገር ዲ - New Ethiopian Music 2022 [Official Video] by Golden Ethio Music 6 days ago 6 minutes, 1 second 567 views",Golden Ethio Music,567,663,96
501,"Sisay Berane Ft. Tiblet Tuji - Gadi Ethiopiankera - Ethiopian Oromo Music 2022 [Official Video] by Golden Ethio Music 7 days ago 5 minutes, 32 seconds 2,414 views",Golden Ethio Music,2414,2594,180
502,"Naafta’i Amaan - Eegi iccitii - Ethiopian Oromo Music 2022 [Official Video] by Golden Ethio Music 8 days ago 4 minutes, 45 seconds 5,105 views",Golden Ethio Music,5105,6060,955
503,"Dajanee ifaa - Lookoo koo - Ethiopian Oromo Music 2022 [Official Video] by Golden Ethio Music 8 days ago 5 minutes, 34 seconds 15,359 views",Golden Ethio Music,15359,25451,10092
504,"Tazarraa Camadaa - Inni Sunis Inni Kunis - Ethiopian Oromo Music 2022 [Official Video] by Golden Ethio Music 11 days ago 4 minutes, 52 seconds 15,354 views",Golden Ethio Music,15354,19599,4245
505,"Abebe Teshome - Mukukkula - Ethiopian Oromo Music 2022 [Official Video] by Golden Ethio Music 11 days ago 4 minutes, 13 seconds 4,811 views",Golden Ethio Music,4811,5317,506
506,"Diinaraas Tsaggaayee - Sirraan Maqu - Ethiopian Oromo Music 2022 [Official Video] by Golden Ethio Music 12 days ago 4 minutes, 59 seconds 10,914 views",Golden Ethio Music,10914,11657,743
507,"Eebbisee Biraanuu - Seenaa Guduunfate - Ethiopian Oromo Music 2022 [Official Video] by Golden Ethio Music 2 weeks ago 7 minutes, 3 seconds 13,060 views",Golden Ethio Music,13060,14861,1801
508,"Taammiruu Mi’eessaa - Nu Hin Tuqinaa - Ethiopian Oromo Music 2022 [Official Video] by Golden Ethio Music 2 weeks ago 6 minutes, 38 seconds 14,875 views",Golden Ethio Music,14875,15725,850
509,"Jamaal Usmaa’il - Ati Tiyya - Ethiopian Oromo Music 2022 [Official Video] by Golden Ethio Music 3 weeks ago 5 minutes, 43 seconds 142,540 views",Golden Ethio Music,142540,186847,44307
510,"Farhaan Anawaar - Jangallee - Ethiopian Oromo Music 2022 [Official Video] by Golden Ethio Music 1 month ago 4 minutes, 56 seconds 12,795 views",Golden Ethio Music,12795,13310,515
511,"Ararsa Gebisa /አራርሳ ገቢሳ - Dhuagaan Gaaraa/ ዱጋን  ጋራ - Ethiopian Oromo Music 2022 [Official Video] by Golden Ethio Music 1 month ago 6 minutes, 20 seconds 39,125 views",Golden Ethio Music,39125,40863,1738
512,"Bizuneh Tefera - Biyya Melee - Ethiopian Oromo Music 2022 [Official Video] by Golden Ethio Music 1 month ago 6 minutes, 58 seconds 33,279 views",Golden Ethio Music,33279,33795,516
513,"Jemal Simele - Belay - Ethiopian Oromo Music 2022 [Official Video] by Golden Ethio Music 1 month ago 6 minutes, 29 seconds 12,318 views",Golden Ethio Music,12318,12529,211
514,"Obsinaan Suleeyman - Capha Lafee - Ethiopian Oromo Music 2022 [Official Video] by Golden Ethio Music 1 month ago 5 minutes, 27 seconds 23,088 views",Golden Ethio Music,23088,23511,423
515,"Biraanuu Mangistuu - Sirna Kalee - Ethiopian Oromo Music 2022 [Official Video] by Golden Ethio Music 1 month ago 7 minutes, 7 seconds 39,819 views",Golden Ethio Music,39819,41284,1465
516,"Legese Guluma - Yaa Biyya Ofii - Ethiopian Oromo Music 2022 [Official Video] by Golden Ethio Music 1 month ago 6 minutes, 7 seconds 4,736 views",Golden Ethio Music,4736,5025,289
517,"Biiftuu Darajjee - Quufa Dadhabdee - New Ethiopian Oromo Music 2022 [Official Video] by Golden Ethio Music 1 month ago 5 minutes, 58 seconds 51,171 views",Golden Ethio Music,51171,52640,1469
518,"Dannaboo Gammachuu - Mee ka'een Gottaa Farsaa - New Ethiopian Oromo Music 2022 [Official Video] by Golden Ethio Music 1 month ago 6 minutes, 15 seconds 4,572 views",Golden Ethio Music,4572,4803,231
519,"Du’ees Hin Duune Oromo Movie ,2022 by Golden Ethio Music 1 month ago 1 minute, 40 seconds 1,506 views",Golden Ethio Music,1506,1525,19
520,"Habiib Husseen (Bussii) - Waan Kee - New Ethiopian Oromo Music 2022 [Official Video] by Golden Ethio Music 1 month ago 4 minutes, 16 seconds 3,533 views",Golden Ethio Music,3533,3628,95
521,"Amaan Biqilaa - Injifannoon Galla - New Ethiopian Oromo Music 2022 [Official Video] by Golden Ethio Music 1 month ago 5 minutes, 19 seconds 13,655 views",Golden Ethio Music,13655,14410,755
522,"Nimoonaa Irranaa - Baka Si Malle - New Ethiopian Oromo Music 2022 [Official Video] by Golden Ethio Music 1 month ago 5 minutes, 41 seconds 18,120 views",Golden Ethio Music,18120,18615,495
523,"Geetuu Baaburee - Lafti Barii Dide - New Ethiopian Oromo Music 2022 [Official Video] by Golden Ethio Music 1 month ago 6 minutes, 15 seconds 39,416 views",Golden Ethio Music,39416,41942,2526
524,"Wana Yehzeb Lij  - Min Ale Gobz Mn Ale - New Ethiopian Music 2021 [Official Video] by Golden Ethio Music 2 months ago 6 minutes, 56 seconds 2,721 views",Golden Ethio Music,2721,2797,76
525,"Susenyos Abaw / ሱስንዮስ አበው - Eyewededkush | እየወደድኩሽ - New Ethiopian Music 2021 [Official Video] by Golden Ethio Music 2 months ago 5 minutes, 37 seconds 3,818 views",Golden Ethio Music,3818,3859,41
526,"Abduraman Turaa - Haabibatii - New Ethiopian Oromo Music 2021 [Official Video] by Golden Ethio Music 2 months ago 5 minutes, 51 seconds 5,558 views",Golden Ethio Music,5558,5598,40
527,"Abdi Furi Bariso/ አብዲ ፉሪ ባሪሶ - Biyya Abbaatu Eega - New Ethiopian Oromo Music 2021 [Official Video] by Golden Ethio Music 2 months ago 5 minutes, 38 seconds 34,661 views",Golden Ethio Music,34661,35198,537
528,"ሀሙስ 12:00 ላይ 📍@golden_music_ethiopia #oromo by Golden Ethio Music 2 months ago 15 seconds 3,244 views",Golden Ethio Music,3244,3486,242
529,"Aser Aleka T/Mariyam Niguse - Nebelbal New Kindhe - New Ethiopian Music 2021 [Official Video] by Golden Ethio Music 2 months ago 6 minutes, 10 seconds 3,893 views",Golden Ethio Music,3893,3914,21
530,"Abduraman Turaa - Raayyaa Biyyaa - New Ethiopian Oromo Music 2021 [Official Video] by Golden Ethio Music 2 months ago 5 minutes, 28 seconds 7,181 views",Golden Ethio Music,7181,7265,84
531,"Daaawwii Tolasaa  - Addaaroollee - New Ethiopian Oromo Music 2021 [Official Video] by Golden Ethio Music 2 months ago 4 minutes, 15 seconds 21,112 views",Golden Ethio Music,21112,21316,204
532,"Roobeeraa Amanuu /አርቲስት ሮቤራ አመኑ - Dammiroo - New Ethiopian Oromo Music 2021 [Official Video] by Golden Ethio Music 3 months ago 6 minutes, 48 seconds 184,905 views",Golden Ethio Music,184905,190596,5691
533,"የአርቲስት ሮቤራ አመኑ አዲስ ስራ በ ጎልደን ኢንተርቴይመንት በቅርብ ቀን ይጠብቁን... #ethiopianmusic #oromo by Golden Ethio Music 3 months ago 19 seconds 5,145 views",Golden Ethio Music,5145,5619,474
534,"Jamaal Simalee,Daaawwii Tolasaa - Otu wal Jaalannuu - New Ethiopian Oromo Music 2021[Official Video] by Golden Ethio Music 3 months ago 5 minutes, 58 seconds 19,566 views",Golden Ethio Music,19566,19998,432
535,"Daawwii Tolasaa Fi Risqu Ha/Mohammad - BIYYA QABNAA - New Ethiopian Oromo Music 2021[Official Video] by Golden Ethio Music 3 months ago 5 minutes, 43 seconds 7,193 views",Golden Ethio Music,7193,7377,184
536,"Dagim Adane - Ataskefign / አታስከፊኝ - New Ethiopian Music 2021 [Official Video] by Golden Ethio Music 3 months ago 5 minutes, 14 seconds 19,899 views",Golden Ethio Music,19899,20643,744
537,"Bersena Geremew - Gaafa Isiin Biyyee.... - Ethiopian Oromo Music 2021 [Official Video] by Golden Ethio Music 3 months ago 3 minutes, 57 seconds 5,319 views",Golden Ethio Music,5319,5397,78
538,"Abduraman Turaa - Waan Aadaa Teenyaa - Ethiopian Oromo Music 2021 [Official Video] by Golden Ethio Music 3 months ago 6 minutes, 30 seconds 3,949 views",Golden Ethio Music,3949,3986,37
539,"Zeynu Mahbub - Albeeni - New Ethiopian Oromo Music 2021 [Official Video] by Golden Ethio Music 3 months ago 5 minutes, 43 seconds 12,418 views",Golden Ethio Music,12418,12835,417
540,"Dagim Adane #ethiopianmusic #ethiopia #ethiopianmovie #ethiopia #goldenmusic by Golden Ethio Music 3 months ago 24 seconds 2,789 views",Golden Ethio Music,2789,2869,80
541,"Abdusalaam Hajii - Abbaa Biyyummaa - Ethiopian Oromo Music 2021 [Official Video] by Golden Ethio Music 3 months ago 6 minutes, 20 seconds 8,931 views",Golden Ethio Music,8931,9379,448
542,"Mulata Diriba - Galma Dhugaa - Ethiopian Oromo Music 2021 [Official Video] by Golden Ethio Music 3 months ago 5 minutes, 49 seconds 12,214 views",Golden Ethio Music,12214,12967,753
543,"Tesfaye Taye - Enat Hagere | እናት ሀገሬ - Ethiopian Music 2021 [Official Video] by Golden Ethio Music 3 months ago 5 minutes, 37 seconds 1,894 views",Golden Ethio Music,1894,1910,16
544,"Mestawot Tesfayee - Sin Jaladha - Ethiopian Oromo Music 2021 [Official Video] by Golden Ethio Music 4 months ago 5 minutes, 28 seconds 8,321 views",Golden Ethio Music,8321,8359,38
545,"Guddataa Olaanaa - Galaanee - Ethiopian Oromo Music 2021 [Official Video] by Golden Ethio Music 4 months ago 4 minutes, 52 seconds 19,797 views",Golden Ethio Music,19797,19884,87
546,"Kalkidan Tesfaye - Hageren Tebekat - Ethiopian Music 2021 [Official Video] by Golden Ethio Music 4 months ago 6 minutes, 45 seconds 2,411 views",Golden Ethio Music,2411,2424,13
547,"Obecka Team - Fuggiso - Ethiopian Oromo Music 2021 [Official Video] by Golden Ethio Music 4 months ago 3 minutes, 45 seconds 8,827 views",Golden Ethio Music,8827,8940,113
548,"Salaamoon Dachaasaa - Jalalli Xiqqoo Hin Qabuu - Ethiopian Oromo Music 2021 [Official Video] by Golden Ethio Music 4 months ago 6 minutes, 45 seconds 119,014 views",Golden Ethio Music,119014,123691,4677
549,"Abdusalaam Hajii - Sabakoo Oromo - Ethiopian Oromo Music 2021 [Official Video] by Golden Ethio Music 4 months ago 5 minutes, 19 seconds 34,725 views",Golden Ethio Music,34725,36099,1374
550,"Kebebush Girma - Nabeeki Dhugaa - Ethiopian Oromo Music 2021 [Official Video] by Golden Ethio Music 4 months ago 4 minutes, 13 seconds 4,347 views",Golden Ethio Music,4347,4367,20
551,"Tariikuu Yalfal - Jibbaa Dhiisi - Ethiopian Oromo Music 2021 [Official Video] by Golden Ethio Music 4 months ago 5 minutes, 35 seconds 7,010 views",Golden Ethio Music,7010,7050,40
552,"Zerihun Endale - Anberebade - Ethiopian Oromo Music 2021 [Official Video] by Golden Ethio Music 4 months ago 5 minutes, 11 seconds 3,423 views",Golden Ethio Music,3423,3444,21
553,"Dijee Saam - Mareehoo - Ethiopian Oromo Music 2021 [Official Video] by Golden Ethio Music 5 months ago 6 minutes, 51 seconds 5,196 views",Golden Ethio Music,5196,5203,7
554,"Maashoo Abdurrahman - Irreecha Milkii - Ethiopian Oromo Music 2021 [Official Video] by Golden Ethio Music 5 months ago 6 minutes, 57 seconds 37,387 views",Golden Ethio Music,37387,37585,198
555,"Tsahaay Hundee - Roobee Roobee - Ethiopian Oromo Music 2021 [Official Video] by Golden Ethio Music 5 months ago 5 minutes, 59 seconds 27,391 views",Golden Ethio Music,27391,28833,1442
556,"Abbabaa Dirribaa - Kuni Maali Garuu - Ethiopian Oromo Music 2021 [Official Video] by Golden Ethio Music 5 months ago 5 minutes, 20 seconds 23,092 views",Golden Ethio Music,23092,23126,34
557,"Salaamoon Ayyalaa - Oromiyaa - Ethiopian Oromo Music 2021 [Official Video] by Golden Ethio Music 5 months ago 5 minutes, 16 seconds 14,562 views",Golden Ethio Music,14562,14590,28
558,"Baatiruu Yaadatee - Jaallan Tumsina - Ethiopian Oromo Music 2021 [Official Video] by Golden Ethio Music 5 months ago 5 minutes, 8 seconds 19,178 views",Golden Ethio Music,19178,19255,77
559,"Dammaksaa Ambassaa - Ayyaana Nagaa - Ethiopian Oromo Music 2021 [Official Video] by Golden Ethio Music 5 months ago 4 minutes, 45 seconds 5,612 views",Golden Ethio Music,5612,5632,20
560,"Masfin Mul'ataa - Bobookkise - Ethiopian Oromo Music 2021 [Official Video] by Golden Ethio Music 5 months ago 5 minutes, 28 seconds 15,271 views",Golden Ethio Music,15271,15307,36
561,"Yaasin Faaris - Yaailma Namaa - Ethiopian Oromo Music 2021 [Official Video] by Golden Ethio Music 5 months ago 5 minutes, 42 seconds 9,415 views",Golden Ethio Music,9415,9514,99
562,"Abdurhaman Tura - Ethiopia Siin Ijaaramte - Ethiopian Oromo Music 2021 [Official Video] by Golden Ethio Music 5 months ago 7 minutes, 39 seconds 8,787 views",Golden Ethio Music,8787,8809,22
563,"Geetuu Tufaa - Sii Wayya - Ethiopian Oromo Music 2021 [Official Video] by Golden Ethio Music 5 months ago 5 minutes, 43 seconds 10,776 views",Golden Ethio Music,10776,10841,65
564,"Taaddala Girma - Biyya Hayyuu - Ethiopian Oromo Music 2021 [Official Video] by Golden Ethio Music 5 months ago 5 minutes, 49 seconds 7,120 views",Golden Ethio Music,7120,7151,31
565,"Serawit Tadesse - Dubusha - Ethiopian Music 2021 [Official Video] by Golden Ethio Music 5 months ago 3 minutes, 47 seconds 4,477 views",Golden Ethio Music,4477,4487,10
566,"Gammachis Guutamaa - Sin Gannu - Ethiopian Oromo Music 2021 [Official Video] by Golden Ethio Music 5 months ago 6 minutes, 48 seconds 12,827 views",Golden Ethio Music,12827,12840,13
567,"Lencho Abdishakur - Yene Bicha Ayseram | የኔ ብቻ አይሰራም - Ethiopian Oromo Music 2021 [Official Video] by Golden Ethio Music 5 months ago 3 minutes, 39 seconds 21,980 views",Golden Ethio Music,21980,22411,431
568,"Bilisuma Bajigaa - Raayyaa Biyyaa - Ethiopian Oromo Music 2021 [Official Video] by Golden Ethio Music 5 months ago 4 minutes, 57 seconds 16,981 views",Golden Ethio Music,16981,17425,444
569,"Habuu Guutamaa - Qunni Buqqifana - Ethiopian Oromo Music 2021 [Official Video] by Golden Ethio Music 5 months ago 6 minutes, 21 seconds 51,780 views",Golden Ethio Music,51780,52483,703
570,"Meseret Nuguse - Qaammee - Ethiopian Oromo Music 2021 [Official Video] by Golden Ethio Music 5 months ago 6 minutes, 48 seconds 83,573 views",Golden Ethio Music,83573,84409,836
571,"Nimoonaa Bariisoo - Nurtiin Keeti - Ethiopian Oromo Music 2021 [Official Video] by Golden Ethio Music 5 months ago 5 minutes, 54 seconds 8,463 views",Golden Ethio Music,8463,8508,45
572,"Galaana Nuguse - Kabaja Gatiin Meeqa ??  - Ethiopian Oromo Music 2021 [Official Video] by Golden Ethio Music 5 months ago 6 minutes, 12 seconds 34,673 views",Golden Ethio Music,34673,34868,195
573,"Qananii Shifarra - Maarabee - Ethiopian Oromo Music 2021 [Official Video] by Golden Ethio Music 5 months ago 7 minutes, 37 seconds 11,606 views",Golden Ethio Music,11606,11642,36
574,"Shaashoo Bokee - Ayyaana Waggaa - Ethiopian Oromo Music 2021 [Official Video] by Golden Ethio Music 5 months ago 4 minutes, 52 seconds 24,915 views",Golden Ethio Music,24915,24980,65
575,"Ajaa'ibaa Baqqalaa - Haftee Jara Kaleessaa - Ethiopian Oromo Music 2021 [Official Video] by Golden Ethio Music 5 months ago 4 minutes, 53 seconds 14,462 views",Golden Ethio Music,14462,14509,47
576,"Shamee Birquu - Yaa Habaaboo - Ethiopian Oromo Music 2021 [Official Video] by Golden Ethio Music 5 months ago 5 minutes, 59 seconds 45,724 views",Golden Ethio Music,45724,45998,274
577,"Mullis Gadaa - Bu`aa Ba`ii - Ethiopian Oromo Music 2021 [Official Video] by Golden Ethio Music 5 months ago 4 minutes, 58 seconds 3,881 views",Golden Ethio Music,3881,3892,11
578,"Darajjee Katamaa - Goobee - Ethiopian Oromo Music 2021 [Official Video] by Golden Ethio Music 5 months ago 5 minutes, 21 seconds 37,415 views",Golden Ethio Music,37415,37553,138
579,"Gaaddisaa Amantee Ft. Hawwii Tashoomaa - Gaaddisee Too - Ethiopian Oromo Music 2021 [Official Video] by Golden Ethio Music 5 months ago 7 minutes, 54 seconds 295,427 views",Golden Ethio Music,295427,303464,8037
580,"Selamawit Fikadu - Jeginaw Tenesa | ጀግናው ተነሳ - Ethiopian Music 2021 [Official Video] by Golden Ethio Music 5 months ago 4 minutes, 32 seconds 14,730 views",Golden Ethio Music,14730,14804,74
581,"Komander. Legesse Guluma - Gaachana Koo - Ethiopian Oromo Music 2021 [Official Video] by Golden Ethio Music 6 months ago 5 minutes, 42 seconds 84,134 views",Golden Ethio Music,84134,85974,1840
582,"Eskindir Taammiruu - Anaaf Mooii - Ethiopian Oromo Music 2021 [Official Video] by Golden Ethio Music 6 months ago 5 minutes, 8 seconds 9,232 views",Golden Ethio Music,9232,9262,30
583,"Coming Soon New Album 2021 (Man New?) Andupa Teshome by Golden Ethio Music 6 months ago 46 seconds 7,001 views",Golden Ethio Music,7001,7108,107
584,"Buzuu Alamuu  - Sanyii Waaqo Guutu - Ethiopian Oromo Music 2021 [Official Video] by Golden Ethio Music 6 months ago 4 minutes, 10 seconds 13,511 views",Golden Ethio Music,13511,13560,49
585,"Wabii Moosisaa - Galaa Gooto Taaf - Ethiopian Oromo Music 2021 [Official Video] by Golden Ethio Music 6 months ago 6 minutes 23,122 views",Golden Ethio Music,23122,23185,63
586,"Baay'isaa Bulii - Obseen Obsaare - Ethiopian Oromo Music 2021 [Official Video] by Golden Ethio Music 6 months ago 4 minutes, 37 seconds 11,249 views",Golden Ethio Music,11249,11276,27
587,"Tadese Bekele - An Sin Dhiisuu - Ethiopian Oromo Music 2021 [Official Video] by Golden Ethio Music 7 months ago 4 minutes, 45 seconds 81,147 views",Golden Ethio Music,81147,81261,114
588,"Kumaa Habetamuu - Dhowwaa Lakkii - Ethiopian Oromo Music 2021 [Official Video] by Golden Ethio Music 7 months ago 4 minutes, 30 seconds 29,831 views",Golden Ethio Music,29831,29908,77
589,"Cabsii Kabbadaa - Aayyoo Too - Ethiopian Oromo Music 2021 [Official Video] by Golden Ethio Music 7 months ago 4 minutes, 23 seconds 5,859 views",Golden Ethio Music,5859,5872,13
590,"Sable Gulummaa - Tummehoo - Ethiopian Oromo Music 2021 [Official Video] by Golden Ethio Music 7 months ago 4 minutes, 19 seconds 20,469 views",Golden Ethio Music,20469,20525,56
591,"Tesfaye Adugna - Humna Walii Taana - Ethiopian Oromo Music 2021 [Official Video] by Golden Ethio Music 7 months ago 5 minutes, 59 seconds 13,853 views",Golden Ethio Music,13853,13905,52
592,"Lammii Tesfaye - Seenaatu Na Gaafata - Ethiopian Oromo Music 2021 [Official Video] by Golden Ethio Music 7 months ago 6 minutes 16,435 views",Golden Ethio Music,16435,16496,61
593,"Qachaa Horaa - Fardii Koo Garmamuuf - Ethiopian Oromo Music 2021 [Official Video] by Golden Ethio Music 7 months ago 7 minutes, 13 seconds 6,827 views",Golden Ethio Music,6827,6848,21
594,"Daraaraa Urgeessaa - Safuu - Ethiopian Oromo Music 2021 [Official Video] by Golden Ethio Music 7 months ago 5 minutes, 44 seconds 19,254 views",Golden Ethio Music,19254,19321,67
595,"Olyaad Eebbisaa - Irbuuqabna - Ethiopian Oromo Music 2021 [Official Video] by Golden Ethio Music 7 months ago 5 minutes, 28 seconds 19,924 views",Golden Ethio Music,19924,20013,89
596,"Ashenafi Bekele - Yaadame Tolee - Ethiopian Cover Oromo Music 2021 [Official Video] by Golden Ethio Music 7 months ago 7 minutes, 22 seconds 622,836 views",Golden Ethio Music,622836,641911,19075
597,"Obsaa Caalaa - Hacaaluu - Ethiopian Oromo Music 2021 [Official Video] by Golden Ethio Music 8 months ago 6 minutes, 18 seconds 123,177 views",Golden Ethio Music,123177,124481,1304
598,"Aman Abdela - Dhoksanu Hin Dhokatu - Ethiopian Oromo Music 2021 [Official Video] by Golden Ethio Music 8 months ago 4 minutes, 52 seconds 19,659 views",Golden Ethio Music,19659,19835,176
599,"Burtukaan Iddeessaa - Boonaa Kiyya Lalisaa - Ethiopian Oromo Music 2021 [Official Video] by Golden Ethio Music 8 months ago 5 minutes, 28 seconds 7,934 views",Golden Ethio Music,7934,7953,19
600,"Kaabaa Baqqalaa - Kololaa Koo - Ethiopian Oromo Music 2021 [Official Video] by Golden Ethio Music 8 months ago 5 minutes, 48 seconds 16,814 views",Golden Ethio Music,16814,16896,82
601,"Carra Dajanee - Leelloo Tiyyaa - Ethiopian Oromo Music 2021 [Official Video] by Golden Ethio Music 8 months ago 5 minutes, 16 seconds 22,728 views",Golden Ethio Music,22728,22785,57
602,"Lelisa Kebede - Madaa Garaakoo - Ethiopian Oromo Music 2021 [Official Video] by Golden Ethio Music 8 months ago 5 minutes, 31 seconds 17,372 views",Golden Ethio Music,17372,17418,46
603,"Dessaalenyi Tarreessa - Gootota Keenya - Ethiopian Oromo Music 2021 [Official Video] by Golden Ethio Music 8 months ago 8 minutes, 4 seconds 198,763 views",Golden Ethio Music,198763,201460,2697
604,"Caalaa Adaree - Dachee too - Ethiopian Oromo Music 2021 [Official Video] by Golden Ethio Music 8 months ago 5 minutes, 15 seconds 8,241 views",Golden Ethio Music,8241,8265,24
605,"Hacaaluu Diribsaa - Waadaa Cabse - Ethiopian Oromo Music 2021 [Official Video] by Golden Ethio Music 8 months ago 6 minutes, 56 seconds 114,056 views",Golden Ethio Music,114056,114702,646
606,"Kaki Tesfaye - Rega Rega | ረጋ ረጋ - Ethiopian Music 2021 [Official Audio] by Golden Ethio Music 8 months ago 5 minutes, 3 seconds 4,302 views",Golden Ethio Music,4302,4342,40
607,"Zewudu Selashe Ft. Elssa Nugusee - Rakko Jira - Ethiopian Oromo Music 2021 [Official Video] by Golden Ethio Music 8 months ago 6 minutes, 32 seconds 440,881 views",Golden Ethio Music,440881,444678,3797
608,"Hundaaol Kumaa - Saba Dhugaa Qabu - Ethiopian Oromo Music 2021 [Official Video] by Golden Ethio Music 8 months ago 5 minutes, 59 seconds 15,265 views",Golden Ethio Music,15265,15289,24
609,"Abebe Tsehaye - Aneflgem - Ethiopian Music 2021 [Official Video] by Golden Ethio Music 8 months ago 4 minutes, 29 seconds 4,184 views",Golden Ethio Music,4184,4195,11
610,"Godesa Boru ft. Sena Lenjiso - Hosee Leema - Ethiopian Oromo Music 2021 [Official Video] by Golden Ethio Music 8 months ago 4 minutes, 52 seconds 30,122 views",Golden Ethio Music,30122,30160,38
611,"Mulugeetaa Lataa - Gootota Haqaa Biqilee! - Ethiopian Oromo Music 2021 [Official Video] by Golden Ethio Music 8 months ago 6 minutes, 50 seconds 38,312 views",Golden Ethio Music,38312,38479,167
612,"Ilfinesh Dhaabaa fi.Naa'ol Boggaala - Naaf Barii - Ethiopian Oromo Music 2021 [Official Video] by Golden Ethio Music 8 months ago 4 minutes, 34 seconds 38,301 views",Golden Ethio Music,38301,38418,117
613,"Shawan Damee - Iriyee Ijollummaa - Ethiopian Oromo Music 2021 [Official Video] by Golden Ethio Music 9 months ago 5 minutes, 33 seconds 10,937 views",Golden Ethio Music,10937,10950,13
614,"Melaku Belay (መላኩ በላይ) - ጉለሸ ኻግርጘጘ - Ethiopian Music 2021 [Official Video] by Golden Ethio Music 9 months ago 6 minutes, 15 seconds 76,566 views",Golden Ethio Music,76566,78820,2254
615,"Lammaa Kabbadaa - Hin Qabnu Sodaa - Ethiopian Oromo Music 2021 [Official Video] by Golden Ethio Music 9 months ago 4 minutes, 52 seconds 12,161 views",Golden Ethio Music,12161,12180,19
616,"Getahun Nebeyu - Ethiopia - Ethiopian Music 2021 [Official Video] by Golden Ethio Music 9 months ago 5 minutes, 12 seconds 4,436 views",Golden Ethio Music,4436,4452,16
617,"Feeneet Qajeelaa - Itti Cabsi! - Ethiopian Oromo Music 2021 [Official Video] by Golden Ethio Music 9 months ago 7 minutes, 11 seconds 358,657 views",Golden Ethio Music,358657,360649,1992
618,"Kokeb Abedu - Ande Nen | አንድ ነን - Ethiopian Music 2021 [Official Video] by Golden Ethio Music 9 months ago 5 minutes, 28 seconds 4,265 views",Golden Ethio Music,4265,4271,6
619,"Caalaa Bayyanaa - Yaa Hamammota - Ethiopian Oromo Music 2021 [Official Video] by Golden Ethio Music 9 months ago 7 minutes, 4 seconds 242,666 views",Golden Ethio Music,242666,247428,4762
620,"Obsee Cawwaaqqa - Filii Koottuu - Ethiopian Oromo Music 2021 [Official Video] by Golden Ethio Music 9 months ago 5 minutes, 3 seconds 8,801 views",Golden Ethio Music,8801,8913,112
621,"Singatuan Dirribaa - Hinmaraanne! - Ethiopian Oromo Music 2021 [Official Video] by Golden Ethio Music 9 months ago 4 minutes, 41 seconds 35,108 views",Golden Ethio Music,35108,35217,109
622,"Daanyee Galaanaa - Nadhaqqabi - Ethiopian Oromo Music 2021 [Official Video] by Golden Ethio Music 9 months ago 6 minutes, 4 seconds 198,056 views",Golden Ethio Music,198056,199087,1031
623,"Tigist Girma & Jemal  Huesin - Mare Mare - Ethiopian Music 2021 [Official Video] by Golden Ethio Music 9 months ago 6 minutes, 8 seconds 8,347 views",Golden Ethio Music,8347,8393,46
624,"Kumaa Qaabii - Kaayyoo Dur  Abbeetii - Ethiopian Oromo Music 2021 [Official Video] by Golden Ethio Music 9 months ago 4 minutes, 25 seconds 5,052 views",Golden Ethio Music,5052,5094,42
625,"Yohannis Diriba - Ayeresam | አይረሳም  - Ethiopian Music 2021 [Official Video] by Golden Ethio Music 9 months ago 4 minutes, 35 seconds 1,693 views",Golden Ethio Music,1693,1698,5
626,"Gazzaahany Wubisheet  - Seenaa Darbee Achii Dhisii - Ethiopian Oromo Music 2021 [Official Video] by Golden Ethio Music 9 months ago 6 minutes, 4 seconds 22,766 views",Golden Ethio Music,22766,23077,311
627,"Milliyon Fayisa - Shage Malo - Ethiopian Oromo Music 2021 [Official Video] by Golden Ethio Music 9 months ago 4 minutes, 2 seconds 13,995 views",Golden Ethio Music,13995,14064,69
628,"Dehaaboo Babilee - Gotoota Badhaadhina - Ethiopian Oromo Music 2021 [Official Video] by Golden Ethio Music 10 months ago 6 minutes, 35 seconds 97,659 views",Golden Ethio Music,97659,98093,434
629,"Gammachuu Nugusee - Lafa Seenaa - Ethiopian Oromo Music 2021 [Official Video] by Golden Ethio Music 10 months ago 5 minutes, 32 seconds 5,892 views",Golden Ethio Music,5892,5906,14
630,"Gulumaa Misgaanuu - Sumaaf Nadhaanan - Ethiopian Oromo Music 2021 [Official Video] by Golden Ethio Music 10 months ago 5 minutes, 36 seconds 10,118 views",Golden Ethio Music,10118,10180,62
631,"Genet Adugna - Yaa Marii Kiyya - Ethiopian Oromo Music 2021 [Official Video] by Golden Ethio Music 10 months ago 4 minutes, 15 seconds 12,711 views",Golden Ethio Music,12711,12776,65
632,"Mulusew Addis (ሙሉሰው አዲስ) - ኢትዮ አበባ | Ethio Abeba - Ethiopian Music 2021 [Official Video] by Golden Ethio Music 10 months ago 4 minutes, 58 seconds 1,467 views",Golden Ethio Music,1467,1478,11
633,"Tarreessaa Taammiruu - Itti Diigi Mee - Ethiopian Oromo Music 2021 [Official Video] by Golden Ethio Music 10 months ago 7 minutes, 9 seconds 22,693 views",Golden Ethio Music,22693,22837,144
634,"Addisuu Tolasaa - YAA MAGAAZII - Ethiopian Oromo Music 2021 [Official Video] by Golden Ethio Music 10 months ago 6 minutes, 40 seconds 39,864 views",Golden Ethio Music,39864,40433,569
635,"Ittisiqaa Bayyanaa - ONNEE NA SEENTE - Ethiopian Oromo Music 2021 [Official Video] by Golden Ethio Music 10 months ago 4 minutes, 57 seconds 9,731 views",Golden Ethio Music,9731,9778,47
636,"Esube Omega - SAMNAT - Ethiopian Music 2021 [Official Video] by Golden Ethio Music 10 months ago 3 minutes, 35 seconds 4,247 views",Golden Ethio Music,4247,4263,16
637,"Sayyoo Mokonnin - IMALA DHEERAA - Ethiopian Oromo Music 2021 [Official Video] by Golden Ethio Music 11 months ago 5 minutes, 18 seconds 59,534 views",Golden Ethio Music,59534,59846,312
638,"Emebet Melkamu - Ema | እማ - Ethiopian Music 2021 [Official Video] by Golden Ethio Music 11 months ago 5 minutes, 13 seconds 20,412 views",Golden Ethio Music,20412,20429,17
639,"Tokkummaa Leellisaa - Haras Jirra - Ethiopian Oromo Music 2021 [Official Video] by Golden Ethio Music 11 months ago 7 minutes 75,880 views",Golden Ethio Music,75880,76072,192
640,"Boontu Kabbadaa - Ilkaan Kolfa Tole - Ethiopian Oromo Music 2021 by Golden Ethio Music 11 months ago 6 minutes, 16 seconds 45,606 views",Golden Ethio Music,45606,45787,181
641,"Tafarraa Margaa - Gadaan Jaalala - Ethiopian Oromo Music 2021 [Official Video] by Golden Ethio Music 11 months ago 4 minutes, 26 seconds 14,360 views",Golden Ethio Music,14360,14408,48
642,"Boontu Kabbadaa Ft. Ayyaantu Abdulqaadir - Ateete Hadha Joobire - Ethiopian Oromo Music 2021 by Golden Ethio Music 11 months ago 5 minutes, 50 seconds 20,419 views",Golden Ethio Music,20419,20510,91
643,"Guddisaa Midhaksaa - Bashaatuu Tiyyaa - Ethiopian Oromo Music 2021 [Official Video] by Golden Ethio Music 11 months ago 5 minutes, 32 seconds 10,527 views",Golden Ethio Music,10527,10548,21
644,"Dachaasa Yaazoo - Yaa Eemmoo - Ethiopian Oromo 2021 [Official Video] by Golden Ethio Music 11 months ago 6 minutes, 25 seconds 7,608 views",Golden Ethio Music,7608,7620,12
645,"Daanyee Galanaa - Qeerro Gaaddisa Lamiii - Ethiopian Oromo Music 2021 [Official Video] by Golden Ethio Music 11 months ago 5 minutes, 55 seconds 10,354 views",Golden Ethio Music,10354,10462,108
646,"Abdoo Huseen - Yaa Basaastuu - Ethiopian Oromo Music 2020 [Official Video] by Golden Ethio Music 11 months ago 6 minutes, 36 seconds 10,431 views",Golden Ethio Music,10431,10474,43
647,"Caaltuu Dibaaba - Damma Damma Caalu - Ethiopian Oromo Music 2021 [Official Video] by Golden Ethio Music 11 months ago 4 minutes, 41 seconds 43,902 views",Golden Ethio Music,43902,44005,103
648,"Mesay Tesfaye - Yagere Lij | ያገሬ ልጅ - Ethiopian Music 2021 [Official Video] by Golden Ethio Music 11 months ago 4 minutes, 16 seconds 6,086 views",Golden Ethio Music,6086,6096,10
649,"Ahmed Umer - Waa Sadi- Ethiopian Oromo Music 2021 [Official Video] by Golden Ethio Music 11 months ago 6 minutes, 26 seconds 12,153 views",Golden Ethio Music,12153,12187,34
650,"Caalaa Bultume - Gootota  Adawaa - Ethiopian Oromo Music 2021 [Official Video] by Golden Ethio Music 1 year ago 5 minutes, 46 seconds 79,514 views",Golden Ethio Music,79514,80250,736
651,"Chris Yali Ft. Winu Binu - Adwa - Ethiopian Music 2020 [Official Video] by Golden Ethio Music 1 year ago 4 minutes, 13 seconds 2,612 views",Golden Ethio Music,2612,2611,-1
652,"Solomon Geremew - Emameye | እማምዬ - Ethiopian Music 2020 [Official Video] by Golden Ethio Music 1 year ago 5 minutes, 17 seconds 5,393 views",Golden Ethio Music,5393,5399,6
653,"Ed Muzika - Thank You Muzika - Ethiopian Music 2021 [Official Video] by Golden Ethio Music 1 year ago 4 minutes, 18 seconds 2,589 views",Golden Ethio Music,2589,2591,2
654,"Ittaanaa Iddeessaa - Ajab Kee...! - Ethiopian Oromo Music 2021 [Official Video] by Golden Ethio Music 1 year ago 6 minutes, 21 seconds 24,792 views",Golden Ethio Music,24792,24822,30
655,"Maashoo Abdurrahmaan - Maaf Teenya - Ethiopian Oromo Music 2021 [Official Video] by Golden Ethio Music 1 year ago 4 minutes, 39 seconds 220,252 views",Golden Ethio Music,220252,221298,1046
656,"Obsituu Diimaa - Silaa Si Waliin Oola - Ethiopian Oromo Music 2021 [Official Video] by Golden Ethio Music 1 year ago 5 minutes, 13 seconds 42,332 views",Golden Ethio Music,42332,43086,754
657,"Bareentoo Abdallaa fi Iftuu Bareentoo - Aayyoo Tiyya - Ethiopian Oromo Music 2021 [Official Video] by Golden Ethio Music 1 year ago 5 minutes, 31 seconds 427,834 views",Golden Ethio Music,427834,440394,12560
658,"A Tribute To Hacaaluu Hundeessa - Tigist Kassahun - Oolmaanke - Ethiopian Oromo Music 2021 by Golden Ethio Music 1 year ago 5 minutes, 38 seconds 67,667 views",Golden Ethio Music,67667,67858,191
659,"Morka Alemu - Yaa Walee - Ethiopian Oromo Music 2021 [Official Video] by Golden Ethio Music 1 year ago 8 minutes, 11 seconds 18,295 views",Golden Ethio Music,18295,18375,80
660,"kassahun Taye Ft. Aster Welde - Wudeye | ዉድዬ - Ethiopian Music 2021 [Official Video] by Golden Ethio Music 1 year ago 6 minutes, 4 seconds 38,436 views",Golden Ethio Music,38436,38562,126
661,"Gazzee Badhaanee - Shira - Ethiopian Oromo Music 2021 [Official Video] by Golden Ethio Music 1 year ago 5 minutes, 13 seconds 13,518 views",Golden Ethio Music,13518,13549,31
662,"Sirak Mesfin - Atfersem | አትፈርስም - Ethiopian Music 2021 [Official Video] by Golden Ethio Music 1 year ago 6 minutes, 29 seconds 3,435 views",Golden Ethio Music,3435,3442,7
663,"Sharif Abbaabuna - Santu Seera - Ethiopian Oromo Music 2021 [Official Video] by Golden Ethio Music 1 year ago 5 minutes, 35 seconds 4,124 views",Golden Ethio Music,4124,4127,3
664,"Laamroot Taammiruu - Gulummaa Ko - Ethiopian Oromo Music 2021 [Official Video] by Golden Ethio Music 1 year ago 5 minutes, 32 seconds 21,365 views",Golden Ethio Music,21365,21386,21
665,"Haimanot Girma - Gid New | ግድ ነው - Ethiopian Music 2021 [Official Video] by Golden Ethio Music 1 year ago 4 minutes, 9 seconds 1,135,513 views",Golden Ethio Music,1135513,1145471,9958
666,"Daniel Mokonen - Qallokoo - Ethiopian Oromo Music 2021 [Official Video] by Golden Ethio Music 1 year ago 5 minutes, 14 seconds 28,228 views",Golden Ethio Music,28228,28282,54
667,"Efi Memrie(Ajuta) - Hayatako - Ethiopian Music 2021 [Official Video] by Golden Ethio Music 1 year ago 3 minutes, 38 seconds 3,577 views",Golden Ethio Music,3577,3586,9
668,"Lammaa Kabbadaa - Soba Seqee - Ethiopian Oromo Music 2021 [Official Video] by Golden Ethio Music 1 year ago 4 minutes, 30 seconds 11,874 views",Golden Ethio Music,11874,11919,45
669,"Hawwisoo Biqiltuu Meettaa - Goota Dhoowwaan Dadhabe - Ethiopian Oromo Music 2021 [Official Video] by Golden Ethio Music 1 year ago 5 minutes, 39 seconds 18,148 views",Golden Ethio Music,18148,18328,180
670,"Iftuu Abbaanii - kaii Qerroo - Ethiopian Oromo Music 2021 [Official Video] by Golden Ethio Music 1 year ago 6 minutes, 37 seconds 5,865 views",Golden Ethio Music,5865,5885,20
671,"Kifaalo Asheetu - Hin Agartuu - Ethiopian Oromo Music 2021 [Official Video] by Golden Ethio Music 1 year ago 5 minutes, 56 seconds 9,255 views",Golden Ethio Music,9255,9340,85
672,"Taaddasaa Asheetuu - Suuta Suufa - Ethiopian Oromo Music 2021 [Official Video] by Golden Ethio Music 1 year ago 7 minutes, 4 seconds 7,472 views",Golden Ethio Music,7472,7508,36
673,"ፍቅርን ጀባ እና ጥልቁ ገደል by Golden Ethio Music 1 year ago 32 minutes 1,454 views",Golden Ethio Music,1454,1455,1
674,"Gaaddisaa Galataa - Leencatuu Leenca Dhale - Ethiopian Oromo Music 2020 [Official Video] by Golden Ethio Music 1 year ago 5 minutes, 2 seconds 11,164 views",Golden Ethio Music,11164,11182,18
675,"Keenboon Diroo - Dhalaa Abbaa Koo Mid - Ethiopian Oromo Music 2020 [Official Video] by Golden Ethio Music 1 year ago 6 minutes, 12 seconds 47,546 views",Golden Ethio Music,47546,47657,111
676,"Gulummaa Dajanee - Dinaaf Hin Iadhuu - Ethiopian Oromo Music 2020 [Official Video] by Golden Ethio Music 1 year ago 6 minutes, 57 seconds 19,836 views",Golden Ethio Music,19836,19899,63
677,"Yeroosaa Kumaa - Dureettii Namaa - Ethiopian Oromo Music 2020 [Official Video] by Golden Ethio Music 1 year ago 5 minutes, 29 seconds 100,827 views",Golden Ethio Music,100827,100957,130
678,"Yaadeeraa Kaasahuun - Onnee Koo - Ethiopian Oromo Music 2020 [Official Video] by Golden Ethio Music 1 year ago 6 minutes, 29 seconds 284,513 views",Golden Ethio Music,284513,286642,2129
679,"Birhane Tefera - Walalaa Dammaa - Ethiopian Oromo Music 2020 [Official Video] by Golden Ethio Music 1 year ago 5 minutes, 39 seconds 223,335 views",Golden Ethio Music,223335,223883,548
680,"Eebbisee Birhanuu - Barinaan - Ethiopian Oromo Music 2020 [Official Video] by Golden Ethio Music 1 year ago 6 minutes, 23 seconds 277,895 views",Golden Ethio Music,277895,279258,1363
681,"ከአስር አመት በኋላ ወደ ሙዚቃ መመለስን እንዴት አየሽው ? አዲስ ነገር በቅርብ ቀን  / ግድ ነው... by Golden Ethio Music 1 year ago 8 minutes, 1 second 8,130 views",Golden Ethio Music,8130,8153,23
682,"Mohammad Said - Oromoo Koo - Ethiopian Oromo Music 2020 [Official Video] by Golden Ethio Music 1 year ago 5 minutes, 57 seconds 114,327 views",Golden Ethio Music,114327,114810,483
683,"Yaadasaa Baqqalaa - Waan Ofii - Ethiopian Oromo Music 2020 [Official Video] by Golden Ethio Music 1 year ago 5 minutes, 5 seconds 7,957 views",Golden Ethio Music,7957,7981,24
684,"Obsumaan Aberra - Babbaroode - Ethiopian Oromo Music 2020 [Official Video] by Golden Ethio Music 1 year ago 4 minutes, 20 seconds 9,216 views",Golden Ethio Music,9216,9250,34
685,"Abera Kebede - Lene Endanchi - Ethiopian Music 2020 [Official Video] by Golden Ethio Music 1 year ago 3 minutes, 28 seconds 5,382 views",Golden Ethio Music,5382,5390,8
686,"Daanyee Alamuu - Imaanaa Hin Nyaatin - Ethiopian Oromo Music 2020 [Official Video] by Golden Ethio Music 1 year ago 6 minutes, 18 seconds 18,625 views",Golden Ethio Music,18625,18660,35
687,"Iftiyoom Hirphaa - Yaa Goota Koo - Ethiopian Oromo Music 2020 [Official Video] by Golden Ethio Music 1 year ago 4 minutes, 59 seconds 42,065 views",Golden Ethio Music,42065,42166,101
688,"Roobaa Gabbisaa - Waa Miidhamu Malee - Ethiopian Oromo Music 2020 [Official Video] by Golden Ethio Music 1 year ago 5 minutes, 33 seconds 12,964 views",Golden Ethio Music,12964,12986,22
689,"Various Artist - Yibejenal - Ethiopian Music 2020 [Official Video] by Golden Ethio Music 1 year ago 5 minutes, 48 seconds 3,464 views",Golden Ethio Music,3464,3478,14
690,"Fayyisaa Suphaa - ""KANKEE KETUMA!"" - Ethiopian Oromo Music 2020 [Official Video] by Golden Ethio Music 1 year ago 5 minutes, 38 seconds 63,688 views",Golden Ethio Music,63688,63866,178
691,"Furguggee Muddiin - Leenca Oromoo - Ethiopian Oromo Music 2020 [Official Video] by Golden Ethio Music 1 year ago 5 minutes, 30 seconds 33,211 views",Golden Ethio Music,33211,33279,68
692,"Darajjee Dagafaa - Suuta Suuta - Ethiopian Oromo Music 2020 [Official Video] by Golden Ethio Music 1 year ago 6 minutes 22,398 views",Golden Ethio Music,22398,22479,81
693,"Guutamaa Mahaammad - Dahara Muudanii - Ethiopian Oromo Music 2020 [Official Video] by Golden Ethio Music 1 year ago 5 minutes, 13 seconds 25,827 views",Golden Ethio Music,25827,25934,107
694,"Tashoomaa Asaffa - Harmee Tiyyaa - Ethiopian Oromo Music 2020 [Official Video] by Golden Ethio Music 1 year ago 4 minutes, 52 seconds 11,783 views",Golden Ethio Music,11783,11844,61
695,"Adisha Wrld - Yamireshal - Ethiopian Music 2020 [Official Video] by Golden Ethio Music 1 year ago 3 minutes, 50 seconds 2,945 views",Golden Ethio Music,2945,2962,17
696,"Beranu Girma & Asefu Dessie - Leelloo - Ethiopian Oromo Music 2020 [Official Video] by Golden Ethio Music 1 year ago 5 minutes, 35 seconds 171,482 views",Golden Ethio Music,171482,175419,3937
697,"Abdii Kadir - Walin Diginaa - Ethiopian Oromo Music 2020 [Official Video] by Golden Ethio Music 1 year ago 5 minutes 6,356 views",Golden Ethio Music,6356,6366,10
698,"Yeroosan Fiqaaduu - Ni Moona... - Ethiopian Oromo Music 2020 [Official Video] by Golden Ethio Music 1 year ago 6 minutes, 13 seconds 16,985 views",Golden Ethio Music,16985,17028,43
699,"Fikadu Tesfaye - Iyyoolee - Ethiopian Oromo Music 2020 [Official Video] by Golden Ethio Music 1 year ago 5 minutes, 31 seconds 35,243 views",Golden Ethio Music,35243,35568,325
700,"Wesene Sh/Gizaw - Harmee - Ethiopian Oromo Music 2020 [Official Video] by Golden Ethio Music 1 year ago 5 minutes, 41 seconds 8,102 views",Golden Ethio Music,8102,8134,32
701,"Darajjee Rattaa - Birbbirsa Gooroo - Ethiopian Oromo Music 2020 [Official Video] by Golden Ethio Music 1 year ago 4 minutes, 19 seconds 75,026 views",Golden Ethio Music,75026,75756,730
702,"Kennaa Wakkeennee - Gotatu hundaa caalaa - Ethiopian Oromo Music 2020 [Official Video] by Golden Ethio Music 1 year ago 5 minutes, 39 seconds 5,721 views",Golden Ethio Music,5721,5730,9
703,"Tarikuu Lammaa - Obsineeto - Ethiopian Oromo Music 2020 [Official Video] by Golden Ethio Music 1 year ago 5 minutes, 16 seconds 10,055 views",Golden Ethio Music,10055,10073,18
704,"Adaanaa Boggaalaa - Siddisee - Ethiopian Oromo Music 2020 [Official Video] by Golden Ethio Music 1 year ago 5 minutes, 21 seconds 45,029 views",Golden Ethio Music,45029,45177,148
705,"Nugusee Fayyeeraa - Cimsii Eegi - Ethiopian Oromo Music 2020 [Official Video] by Golden Ethio Music 1 year ago 6 minutes, 22 seconds 17,328 views",Golden Ethio Music,17328,17379,51
706,"Urjii Salamoon Mikii - Roorro Diinaa - Ethiopian Oromo Music 2020 [Official Video] by Golden Ethio Music 1 year ago 5 minutes, 38 seconds 48,544 views",Golden Ethio Music,48544,48697,153
707,"Nugusee Fayyeera - Suman Barbaacha Bahe - Ethiopian Oromo Music 2020 [Official Video] by Golden Ethio Music 1 year ago 5 minutes, 10 seconds 39,426 views",Golden Ethio Music,39426,39864,438
708,"Elsa Niguse - ""Amma Amma"" - Ethiopian Oromo Music 2020 [Official Video] by Golden Ethio Music 1 year ago 5 minutes, 26 seconds 81,095 views",Golden Ethio Music,81095,81308,213
709,"Dabalaa Suyyumee - Akka Tolu Goona - Ethiopian Oromo Music 2020 [Official Video] by Golden Ethio Music 1 year ago 5 minutes, 50 seconds 20,312 views",Golden Ethio Music,20312,20331,19
710,"Jiidhaa Leellisaa - Wal - fi Yeedaloo - Ethiopian Oromo Music 2020 [Official Video] by Golden Ethio Music 1 year ago 4 minutes, 40 seconds 44,631 views",Golden Ethio Music,44631,44685,54
711,"Roorrisaa Geetuu - Manni Abbaan Tola - Ethiopian Oromo Music 2020 [Official Video] by Golden Ethio Music 1 year ago 6 minutes, 17 seconds 119,494 views",Golden Ethio Music,119494,119713,219
712,"Tolosa Girma - Mala Naaf Mali - Ethiopian Oromo Music 2020 [Official Video] by Golden Ethio Music 1 year ago 5 minutes, 18 seconds 21,218 views",Golden Ethio Music,21218,21259,41
713,"Amanuel Enegedaw - Abisinya - Ethiopian Music 2020 [Official Video] by Golden Ethio Music 1 year ago 5 minutes, 3 seconds 10,742 views",Golden Ethio Music,10742,10745,3
714,"Gabbisaa Gosaa - Nutiwal-taanaan - Ethiopian Oromo Music 2020 [Official Video] by Golden Ethio Music 1 year ago 3 minutes, 53 seconds 9,921 views",Golden Ethio Music,9921,9929,8
715,"Wabii Dhaabaa - Callisuu Burqaa - Ethiopian Oromo Music 2020 [Official Video] by Golden Ethio Music 1 year ago 6 minutes, 46 seconds 3,015,851 views",Golden Ethio Music,3015851,3046209,30358
716,"Tesfaye Aberraa - Na Yadaadhu Jallaallee - Ethiopian Oromo Music 2020 [Official Video] by Golden Ethio Music 1 year ago 4 minutes, 36 seconds 15,764 views",Golden Ethio Music,15764,15872,108
717,"Badhaasoo A/Kadiiroo - Daayirektera - Ethiopian Oromo Music 2020 [Official Video] by Golden Ethio Music 1 year ago 5 minutes, 55 seconds 27,644 views",Golden Ethio Music,27644,27827,183
718,"Baayisaa Miidhaksaa(Taaboree) - Birran Quufa - Ethiopian Oromo Music 2020 [Official Video] by Golden Ethio Music 1 year ago 6 minutes, 45 seconds 35,273 views",Golden Ethio Music,35273,35345,72
719,"Getu Babure & Bilisuma Anbes - Goobee - Ethiopian Oromo Music 2020 [Official Video] by Golden Ethio Music 1 year ago 5 minutes, 50 seconds 9,233 views",Golden Ethio Music,9233,9264,31
720,"Yeabsira Abebe - Tilanten Zekero | ትላትን ዘክሮ - Ethiopian Music 2020 [Official Video] by Golden Ethio Music 1 year ago 5 minutes, 24 seconds 4,880 views",Golden Ethio Music,4880,4885,5
721,"Mangistuu Tasammaa - BIRROOLEE - Ethiopian Oromo Music 2020 [Official Video] by Golden Ethio Music 1 year ago 5 minutes 13,037 views",Golden Ethio Music,13037,13112,75
722,"Muas Baba - Awedamet | አውዳመት - Ethiopian Music 2020 [Official Video] by Golden Ethio Music 1 year ago 3 minutes, 5 seconds 3,996 views",Golden Ethio Music,3996,4000,4
723,"Meresa Equbayesus - Wedi Adey - Ethiopian Tigrigna Music 2020 [Official Video] by Golden Ethio Music 1 year ago 5 minutes, 19 seconds 1,698 views",Golden Ethio Music,1698,1705,7
724,"Siinboonee Addunyaa - Qaammee - Ethiopian Oromo Music 2020 [Official Video] by Golden Ethio Music 1 year ago 6 minutes, 11 seconds 284,321 views",Golden Ethio Music,284321,286306,1985
725,"INDERERE - Ethiopian Oromo Music 2020 [Official Video] by Golden Ethio Music 1 year ago 6 minutes, 54 seconds 36,235 views",Golden Ethio Music,36235,36274,39
726,"Mulugeta Shete - Kuchet Ena Del | ቁጭት እና ድል - New Ethiopian Music 2020 [Official Video] by Golden Ethio Music 1 year ago 4 minutes, 23 seconds 2,847 views",Golden Ethio Music,2847,2855,8
727,"Gosaa Baacaa - Ishkummee - Ethiopian Oromo Music 2020 [Official Video] by Golden Ethio Music 1 year ago 5 minutes, 25 seconds 3,973 views",Golden Ethio Music,3973,3989,16
728,"Tariku Bekele,Lakachew Sewealem,Abebe Wedu - Ethiopia | ኢትዮጵያ - Ethiopian Music 2020[Official Video] by Golden Ethio Music 1 year ago 5 minutes, 35 seconds 3,689 views",Golden Ethio Music,3689,3693,4
729,"Isheetuu Bagaashaw - Kololee Tiyyaa - Ethiopian Oromo Music 2020 [Official Video] by Golden Ethio Music 1 year ago 5 minutes, 41 seconds 5,761 views",Golden Ethio Music,5761,5798,37
730,"Siifan Urgeessaa - Haccekoo - Ethiopian Oromo Music 2020 [Official Audio] by Golden Ethio Music 1 year ago 3 minutes, 40 seconds 13,311 views",Golden Ethio Music,13311,13318,7
731,"Tokkummaa Waaqumaa - Dibbee Tokkuummaa - Ethiopian Oromo Music 2020 [Official Video] by Golden Ethio Music 1 year ago 6 minutes, 12 seconds 24,054 views",Golden Ethio Music,24054,24292,238
732,"Wabii Dhaabaa,Caalaa Gaaromsaa,Haacaaluu Caalaa, Siinboonee Addunyaa - [ Safuu Hinbeektu Duuti ] by Golden Ethio Music 1 year ago 5 minutes, 5 seconds 990,501 views",Golden Ethio Music,990501,993919,3418
733,"Solomon Yimer - Emeye Enate | እምዬ እናቴ- Ethiopian Music 2020 [Official Video] by Golden Ethio Music 1 year ago 5 minutes, 23 seconds 8,454 views",Golden Ethio Music,8454,8502,48
734,"Betelehem Birhanu - Antena Ene | አንተና እኔ - New Ethiopian Music 2020 (Official Audio) by Golden Ethio Music 1 year ago 3 minutes, 38 seconds 3,337 views",Golden Ethio Music,3337,3344,7
735,"Betelehem Birhanu - Ye Habesha Lij | የ ሀበሻ ልጅ - New Ethiopian Music 2020 (Official Audio) by Golden Ethio Music 1 year ago 4 minutes, 58 seconds 2,390 views",Golden Ethio Music,2390,2392,2
736,"Betelehem Birhanu - Ykirta | ይቅርታ - New Ethiopian Music 2020 (Official Audio) by Golden Ethio Music 1 year ago 5 minutes, 32 seconds 7,128 views",Golden Ethio Music,7128,7129,1
737,"Dajanee Dabalaa - Nu Milkeessi - Ethiopian Oromo Music 2020 [Official Video] by Golden Ethio Music 1 year ago 4 minutes, 32 seconds 11,264 views",Golden Ethio Music,11264,11324,60
738,"Obseeraa Angechaa - Nuti Madaa Qabna - Ethiopian Oromo Music 2020 [Official Video] by Golden Ethio Music 1 year ago 7 minutes, 47 seconds 6,648 views",Golden Ethio Music,6648,6651,3
739,"Kadir Gemeda - Siif Maraataa - Ethiopian Oromo Music 2020 [Official Video] by Golden Ethio Music 1 year ago 4 minutes, 40 seconds 4,064 views",Golden Ethio Music,4064,4068,4
740,"Gammachuu Angaasuu - Mala naaf  Malaa - Ethiopian Oromo Music 2020 [Official Video] by Golden Ethio Music 1 year ago 6 minutes, 9 seconds 42,587 views",Golden Ethio Music,42587,42807,220
741,"Birhaanuu Seefee - Waadaa Hin Diigiin - Ethiopian Oromo Music 2020 [Official Video] by Golden Ethio Music 1 year ago 6 minutes, 34 seconds 14,406 views",Golden Ethio Music,14406,14456,50
742,"Meetii Hayilee Dibaabaa - Maseente Abdiin - Ethiopian Oromo Music 2020 [Official Video] by Golden Ethio Music 1 year ago 5 minutes, 39 seconds 31,338 views",Golden Ethio Music,31338,31517,179
743,"Birhane Tefera - Jaatanii - Ethiopian Oromo Music 2020 [Official Audio] by Golden Ethio Music 1 year ago 4 minutes, 29 seconds 12,502 views",Golden Ethio Music,12502,12582,80
744,"Salamoon Suyyuum - Hiibboo - Ethiopian Oromo Music 2020 [Official Video] by Golden Ethio Music 1 year ago 5 minutes, 39 seconds 7,721 views",Golden Ethio Music,7721,7774,53
745,"Abbabaa Tashoomaa (Falmataa) - WBO - Ethiopian Oromo Music 2020 [Official Video] by Golden Ethio Music 1 year ago 4 minutes, 56 seconds 10,693 views",Golden Ethio Music,10693,10722,29
746,"Lalisee Taammiruu - Gooticha Oromoo - Ethiopian Oromo Music 2020 [Official Video] by Golden Ethio Music 1 year ago 4 minutes, 55 seconds 12,198 views",Golden Ethio Music,12198,12251,53
747,"#Golden_Award የባለ ተስጦዎች ውድድር by Golden Ethio Music 1 year ago 1 minute, 32 seconds 1,083 views",Golden Ethio Music,1083,1085,2
748,"Margaa Bayeeraa - Raajjiidha Abboo - Ethiopian Oromo Music 2020 [Official Video] by Golden Ethio Music 1 year ago 6 minutes, 7 seconds 8,839 views",Golden Ethio Music,8839,8870,31
749,"Obsituu Diimaa - Yaabal'aan Laaf Seenaa - Ethiopian Oromo Music 2020 [Official Video] by Golden Ethio Music 1 year ago 6 minutes, 32 seconds 431,465 views",Golden Ethio Music,431465,434473,3008
750,"Kiyyaa Kaasuu - Yaa Haadhaa - Ethiopian Oromo Music 2020 [Official Video] by Golden Ethio Music 1 year ago 6 minutes, 21 seconds 11,172 views",Golden Ethio Music,11172,11192,20
751,"Selam Getachew & Henok Bogale - Le Negew Nuruachen - Ethiopian Music 2020 [Official Video] by Golden Ethio Music 1 year ago 4 minutes, 35 seconds 3,646 views",Golden Ethio Music,3646,3647,1
752,"Anteneh Bayle - Maren Maren - Ethiopian Music 2020 [Official Video] by Golden Ethio Music 1 year ago 4 minutes, 43 seconds 1,435 views",Golden Ethio Music,1435,1437,2
753,"Badhasoo A/Kadiro - Nuu Araarami - Ethiopian Oromo Music 2020 [Official Video] by Golden Ethio Music 1 year ago 6 minutes, 6 seconds 3,722 views",Golden Ethio Music,3722,3761,39
754,"Yared Mekonnen - Wanaw New Tena - Ethiopian Music 2020 [Official Video] by Golden Ethio Music 1 year ago 3 minutes, 32 seconds 2,048 views",Golden Ethio Music,2048,2051,3
755,"G Key & Mehert - Ayzoshe | አይዞሽ - Ethiopian Music 2020 [Official Video] by Golden Ethio Music 1 year ago 4 minutes, 43 seconds 21,051 views",Golden Ethio Music,21051,21166,115
756,"Mootii Badhaasoo - Maalan Balleesse? - Ethiopian Oromo Music 2020 [Official Video] by Golden Ethio Music 1 year ago 5 minutes, 21 seconds 41,170 views",Golden Ethio Music,41170,41279,109
757,"Berihu Mengesha - Hirayki | ሕራይኪ - Ethiopian Tigrigna Music 2020 [Official Video] by Golden Ethio Music 1 year ago 6 minutes, 24 seconds 3,606 views",Golden Ethio Music,3606,3608,2
758,"Taagaay Lammeessa & Abarraa Warquu - Safuu - Ethiopian Oromo Music 2020 [Official Video] by Golden Ethio Music 1 year ago 3 minutes, 24 seconds 10,122 views",Golden Ethio Music,10122,10145,23
759,"AmunXra - Ofeegi - Ethiopian Oromo Music 2020 [Official Video] by Golden Ethio Music 1 year ago 4 minutes 1,982 views",Golden Ethio Music,1982,1985,3
760,"Habtamu Tagesse - Tseda | ፀዳ - Ethiopian Music 2020 [Official Video] by Golden Ethio Music 1 year ago 4 minutes, 6 seconds 3,070 views",Golden Ethio Music,3070,3089,19
761,"Various Artist - Yaa Rabbi - Ethiopian Oromo Music 2020 [Official Video] by Golden Ethio Music 1 year ago 4 minutes, 55 seconds 19,272 views",Golden Ethio Music,19272,19278,6
762,"Uloxer - Ema | እማ - Ethiopian Music 2020 [Official Video] by Golden Ethio Music 1 year ago 3 minutes, 5 seconds 2,740 views",Golden Ethio Music,2740,2742,2
763,"Solomon Tesfaye(Soldam) - Kfatna Dyu Bezihu - Ethiopian Tigrigna Music 2020 [Official Video] by Golden Ethio Music 1 year ago 4 minutes, 33 seconds 1,396 views",Golden Ethio Music,1396,1398,2
764,"Selam Alemayehu - Gatii Fayyaa Beekii - Ethiopian Oromo Music 2020 [Official Video] by Golden Ethio Music 1 year ago 4 minutes, 43 seconds 56,153 views",Golden Ethio Music,56153,56288,135
765,"Bilisummaa Taaddasaa - Koronaa Ittisna - Ethiopian Oromo Music 2020 [Official Video] by Golden Ethio Music 1 year ago 4 minutes, 43 seconds 2,151 views",Golden Ethio Music,2151,2153,2
766,"Fraol Tesfaye - Wegene Atezenaga | ወገኔ አትዘናጋ - Ethiopian Music 2020 [Official Video] by Golden Ethio Music 1 year ago 4 minutes, 14 seconds 2,504 views",Golden Ethio Music,2504,2509,5
767,"Siifan Urgeessaa - Siifan Jaaware - Ethiopian Oromo Music 2020 [Official Video] by Golden Ethio Music 1 year ago 4 minutes, 43 seconds 81,848 views",Golden Ethio Music,81848,82031,183
768,"Ephy Ye Buze - Tetenkek Wegene | ተጠንቀቅ ወገኔ - Ethiopian Music 2020 [Official Video] by Golden Ethio Music 1 year ago 2 minutes, 16 seconds 2,873 views",Golden Ethio Music,2873,2873,0
769,"Dawit Alemayehu,Get Aniley,Yeshi Tadesse,Haymi,Henok - Akabedalhu | አካብዳለሁ - Ethiopian Music 2020 by Golden Ethio Music 1 year ago 4 minutes, 15 seconds 5,822 views",Golden Ethio Music,5822,5829,7
770,"Becho Girma - Obsaan - Ethiopian Oromo Music 2020 [Official Video] by Golden Ethio Music 1 year ago 5 minutes, 21 seconds 60,850 views",Golden Ethio Music,60850,61101,251
771,"Tufaa Didhaa - Fayyatu Hundaa Dursa - Ethiopian Oromo Music 2020 [Official Video] by Golden Ethio Music 1 year ago 5 minutes, 8 seconds 4,060 views",Golden Ethio Music,4060,4063,3
772,"Various Artist - NU BAASII ... - Ethiopian Oromo Music 2020 [Official Video] by Golden Ethio Music 1 year ago 4 minutes, 22 seconds 10,083 views",Golden Ethio Music,10083,10095,12
773,"Guutaa Fayisaa - Gaabbii - Ethiopian Oromo Music 2020 [Official Audio] by Golden Ethio Music 1 year ago 5 minutes, 24 seconds 12,446 views",Golden Ethio Music,12446,12455,9
774,"Guutaa Fayisaa - Gafaa Ayana Wagaa - Ethiopian Oromo Music 2020 [Official Audio] by Golden Ethio Music 1 year ago 4 minutes, 41 seconds 2,336 views",Golden Ethio Music,2336,2338,2
775,"Biqilaa Fiixaa - Walumaan Imalla - Ethiopian Oromo Music 2020 [Official Video] by Golden Ethio Music 1 year ago 5 minutes, 45 seconds 1,530 views",Golden Ethio Music,1530,1534,4
776,"Mohammed Oshe (Muse) - Si Yaadera - Ethiopian Oromo Music 2020 [Official Video] by Golden Ethio Music 1 year ago 5 minutes, 49 seconds 32,209 views",Golden Ethio Music,32209,32244,35
777,"Various Artist - Koronaa- Ethiopian Oromo Music 2020 [Official Video] by Golden Ethio Music 1 year ago 6 minutes, 16 seconds 5,891 views",Golden Ethio Music,5891,5893,2
778,"Golden Entertainment | Golden Ethio Music by Golden Ethio Music 1 year ago 12 seconds 1,950 views",Golden Ethio Music,1950,1965,15
779,"Dhaqqabaa Dammoo - Koronaa - Ethiopian Oromo Music 2020 [Official Video] by Golden Ethio Music 1 year ago 6 minutes, 6 seconds 13,014 views",Golden Ethio Music,13014,13017,3
780,"Beekan Malkaa - Haa Dubbaatu Daacheen - Ethiopian Oromo Music 2020 [Official Video] by Golden Ethio Music 1 year ago 3 minutes, 54 seconds 8,645 views",Golden Ethio Music,8645,8650,5
781,"Diinaa'ol Dajanee - Shimbirroo Koo - Ethiopian Oromo Music 2020 [Official Video] by Golden Ethio Music 1 year ago 5 minutes, 15 seconds 146,533 views",Golden Ethio Music,146533,147139,606
782,"Biqilaa Fiixaa - Dhugaan Hin Cittu - Ethiopian Oromo Music 2020 [Official Video] by Golden Ethio Music 1 year ago 5 minutes, 19 seconds 42,708 views",Golden Ethio Music,42708,42852,144
783,"Kabir G. Hageyo - Hawwii - Ethiopian Oromo Music 2020 [Official Video] by Golden Ethio Music 1 year ago 4 minutes, 43 seconds 2,912 views",Golden Ethio Music,2912,2914,2
784,"Mamo Bizunhe - Asasabi New | አሳሳቢ ነው - Ethiopian Music 2020 [Official Video] by Golden Ethio Music 1 year ago 5 minutes, 40 seconds 2,427 views",Golden Ethio Music,2427,2427,0
785,"Sisaay Dhaabaa - Yoona - Ethiopian Oromo Music 2020 [Official Video] by Golden Ethio Music 1 year ago 4 minutes, 38 seconds 5,430 views",Golden Ethio Music,5430,5441,11
786,"Adem Mohammed - Corona - Ethiopian Music 2020 [Official Video] by Golden Ethio Music 1 year ago 5 minutes, 38 seconds 62,042 views",Golden Ethio Music,62042,62053,11
787,"Ashuu Lammaa - Waardiyyaa Jaalalaa - Ethiopian Oromo Music 2020 [Official Video] by Golden Ethio Music 1 year ago 5 minutes, 20 seconds 6,406 views",Golden Ethio Music,6406,6407,1
788,"Tokkichoo Mokonnon - Suma Qofa - Ethiopian Oromo Music 2020 [Official Video] by Golden Ethio Music 1 year ago 4 minutes, 21 seconds 10,446 views",Golden Ethio Music,10446,10457,11
789,"Lammii Girmaa - Ergaa hin Dhaqin Ormaaf - Ethiopian Oromo Music 2020 [Official Video] by Golden Ethio Music 1 year ago 7 minutes, 48 seconds 54,451 views",Golden Ethio Music,54451,54593,142
790,"Asaffaa Yaadasaa - Kaampaasii - Ethiopian Oromo Music 2020 [Official Audio] by Golden Ethio Music 1 year ago 4 minutes, 48 seconds 1,108 views",Golden Ethio Music,1108,1108,0
791,"Asaffaa Yaadasaa - Haalolu - Ethiopian Oromo Music 2020 [Official Audio] by Golden Ethio Music 1 year ago 5 minutes, 39 seconds 1,310 views",Golden Ethio Music,1310,1313,3
792,"Asaffaa Yaadasaa - Odaa - Ethiopian Oromo Music 2020 [Official Audio] by Golden Ethio Music 1 year ago 5 minutes, 31 seconds 861 views",Golden Ethio Music,861,863,2
793,"Asaffaa Yaadasaa - Hoodhukaa - Ethiopian Oromo Music 2020 [Official Audio] by Golden Ethio Music 1 year ago 7 minutes, 40 seconds 1,172 views",Golden Ethio Music,1172,1173,1
794,"Asaffaa Yaadasaa - ilaalimee - Ethiopian Oromo Music 2020 [Official Audio] by Golden Ethio Music 1 year ago 4 minutes, 12 seconds 804 views",Golden Ethio Music,804,804,0
795,"Asaffaa Yaadasaa - Maaliif na Sobde - Ethiopian Oromo Music 2020 [Official Audio] by Golden Ethio Music 1 year ago 6 minutes, 45 seconds 2,273 views",Golden Ethio Music,2273,2275,2
796,"Asaffaa Yaadasaa - Iyaaffannoo - Ethiopian Oromo Music 2020 [Official Audio] by Golden Ethio Music 1 year ago 6 minutes, 24 seconds 1,290 views",Golden Ethio Music,1290,1290,0
797,"Asaffaa Yaadasaa - Maal qilleensi k - Ethiopian Oromo Music 2020 [Official Audio] by Golden Ethio Music 1 year ago 6 minutes, 49 seconds 2,169 views",Golden Ethio Music,2169,2174,5
798,"Asaffaa Yaadasaa - Maali namanaa - Ethiopian Oromo Music 2020 [Official Audio] by Golden Ethio Music 1 year ago 4 minutes, 16 seconds 5,708 views",Golden Ethio Music,5708,5713,5
799,"Kaliil Badhaasoo Baattaa - Oromummaan Dhaloota - Ethiopian Oromo Music 2020 [Official Video] by Golden Ethio Music 1 year ago 5 minutes, 44 seconds 3,526 views",Golden Ethio Music,3526,3531,5
800,"Muusaa Qumbii - Naman Robnu - Ethiopian Oromo Music 2020 [Official Video] by Golden Ethio Music 1 year ago 6 minutes, 25 seconds 5,754 views",Golden Ethio Music,5754,5760,6
801,"Baatuu Bariisoo - Jaalala Ijoollummaa - Ethiopian Oromo Music 2020 [Official Video] by Golden Ethio Music 1 year ago 4 minutes, 20 seconds 69,696 views",Golden Ethio Music,69696,69872,176
802,"Leencoo Gammachuu - Argemoo Argee - Ethiopian Oromo Music 2020 [Official Video] by Golden Ethio Music 1 year ago 8 minutes, 4 seconds 37,586 views",Golden Ethio Music,37586,37675,89
803,"Shaambal Abbabaa - Kuullee - Ethiopian Oromo Music 2020 [Official Video] by Golden Ethio Music 1 year ago 5 minutes, 47 seconds 22,582 views",Golden Ethio Music,22582,22770,188
804,"Taaboruu Tsaguu - Yaawaan Offiito - Ethiopian Oromo Music 2020 [Official Video] by Golden Ethio Music 1 year ago 5 minutes, 9 seconds 95,110 views",Golden Ethio Music,95110,95229,119
805,"Kena Angesa - Oromtittii Raayyaa - Ethiopian Music 2020 [Official Video] by Golden Ethio Music 1 year ago 4 minutes, 47 seconds 10,651 views",Golden Ethio Music,10651,10659,8
806,"Darajjee Katamaa - Walii Galla - Ethiopian Oromo Music 2020 [Official Video] by Golden Ethio Music 2 years ago 4 minutes, 42 seconds 60,087 views",Golden Ethio Music,60087,60160,73
807,"Shawaangizawu Taklee - FUULAIFTUU - Ethiopian Oromo Music 2020 [Official Video] by Golden Ethio Music 2 years ago 6 minutes, 6 seconds 48,904 views",Golden Ethio Music,48904,48977,73
808,"Dajanee Asheetuu - Asheetakoo - Ethiopian Oromo Music 2020 [Official Video] by Golden Ethio Music 2 years ago 4 minutes, 55 seconds 17,682 views",Golden Ethio Music,17682,17704,22
809,"Abarra Warquu - ASIIF ACHI - Ethiopian Oromo Music 2020 [Official Audio] by Golden Ethio Music 2 years ago 5 minutes, 57 seconds 9,800 views",Golden Ethio Music,9800,9812,12
810,"Eebbisaa Dirribaa - Dachee Abbaa Gadaa - Ethiopian Oromo Music 2020 [Official Video] by Golden Ethio Music 2 years ago 6 minutes, 31 seconds 52,058 views",Golden Ethio Music,52058,52161,103
811,"Tasfayee Malkaa - Asskottuu - Ethiopian Oromo Music 2020 [Official Video] by Golden Ethio Music 2 years ago 6 minutes, 12 seconds 7,484 views",Golden Ethio Music,7484,7500,16
812,"Gurmeessaa Magarsaa  - Irreessa Finfinnee  - Ethiopian Oromo Music 2020 [Official Video] by Golden Ethio Music 2 years ago 4 minutes 19,871 views",Golden Ethio Music,19871,19896,25
813,"Mc Kall feat. Eletriik - Mebrek - Ethiopian Hip Hop Music 2020 [Official Video] by Golden Ethio Music 2 years ago 3 minutes, 8 seconds 2,094 views",Golden Ethio Music,2094,2095,1
814,"Caaltuu Midhakssaa - Boobe Bubbise - Ethiopian Oromo Music 2020 [Official Video] by Golden Ethio Music 2 years ago 4 minutes, 49 seconds 26,066 views",Golden Ethio Music,26066,26131,65
815,"Ittisaa Bashaadaa - Aadaa Kuma qabna - Ethiopian Oromo Music 2020 [Official Video] by Golden Ethio Music 2 years ago 6 minutes, 11 seconds 37,606 views",Golden Ethio Music,37606,37726,120
816,"Nimoonaa Gabbisaa - Wallallee - Ethiopian Oromo Music 2020 [Official Video] by Golden Ethio Music 2 years ago 4 minutes, 56 seconds 16,539 views",Golden Ethio Music,16539,16608,69
817,"Habtaamuu Garasuu - MAGAN - Ethiopian Oromo Music 2020 [Official Video] by Golden Ethio Music 2 years ago 4 minutes, 49 seconds 6,837 views",Golden Ethio Music,6837,6866,29
818,"Soreettii Dasuu - Onnee Jalaate - Ethiopian Oromo Music 2020 [Official Video] by Golden Ethio Music 2 years ago 6 minutes, 57 seconds 12,000 views",Golden Ethio Music,12000,12002,2
819,"Awwalee Ciroo (Abdallaa) - Yaa Daraartuu - Ethiopian Oromo Music 2020 [Official Video] by Golden Ethio Music 2 years ago 5 minutes, 25 seconds 975,176 views",Golden Ethio Music,975176,987437,12261
820,"Boonsaa Gizaa - Galaane - Ethiopian Oromo Music 2020 [Official Video] by Golden Ethio Music 2 years ago 7 minutes, 30 seconds 93,272 views",Golden Ethio Music,93272,93530,258
821,"Warite Burka - Gootoota Baale - Ethiopian Oromo Music 2020 [Official Video] by Golden Ethio Music 2 years ago 4 minutes, 46 seconds 60,081 views",Golden Ethio Music,60081,60235,154
822,"Ayyantuu A/Qaadir - Madda Qarooma - Ethiopian Oromo Music 2020 [Official Video] by Golden Ethio Music 2 years ago 6 minutes, 14 seconds 47,894 views",Golden Ethio Music,47894,48049,155
823,"Birhane Tefera - Jaatanii - Ethiopian Oromo Music 2020 [Official Video] by Golden Ethio Music 2 years ago 4 minutes, 26 seconds 153,039 views",Golden Ethio Music,153039,153365,326
824,"Baroo Didhaa - Oolmaa Abbaa - Ethiopian Oromo Music Video 2020 [Official Video] by Golden Ethio Music 2 years ago 6 minutes, 47 seconds 25,568 views",Golden Ethio Music,25568,25611,43
825,"Aadam Mohaammad - Gadaa - Ethiopian Oromo Music 2020[Official Video] by Golden Ethio Music 2 years ago 5 minutes, 43 seconds 30,746 views",Golden Ethio Music,30746,30832,86
826,"Wandduu Tasamaa  - Waarii Guujii - Ethiopian Oromo Music 2020 [Official Video] by Golden Ethio Music 2 years ago 5 minutes, 14 seconds 12,827 views",Golden Ethio Music,12827,12888,61
827,"Lookoo Ashanee - Eeddiwaaqoo - Ethiopian Oromo Music 2020 [Official Video] by Golden Ethio Music 2 years ago 4 minutes, 56 seconds 22,702 views",Golden Ethio Music,22702,22826,124
828,"Dawit Yenealem - Yewa Mn Yihonal | የዋ ምን ይሆናል - Ethiopian Music 2020 [Official Video] by Golden Ethio Music 2 years ago 5 minutes, 34 seconds 4,161 views",Golden Ethio Music,4161,4173,12
829,"Kidanu Nebert - Ye Tarik Balebet | የታሪክ ባለቤት - Ethiopian  Music 2020 [Official Video] by Golden Ethio Music 2 years ago 4 minutes, 54 seconds 1,936 views",Golden Ethio Music,1936,1940,4
830,"Fayyisaa Suphaa - Numaatu Waliif Dawaadha - Ethiopian Oromo Music 2020 [Official Video] by Golden Ethio Music 2 years ago 6 minutes, 17 seconds 20,993 views",Golden Ethio Music,20993,21065,72
831,"Alamu ajabii - Si Malee - Ethiopian Oromo Music 2020 [Official Video] by Golden Ethio Music 2 years ago 6 minutes 35,210 views",Golden Ethio Music,35210,35242,32
832,"Guutamaa Mahaammad - Yaa Fayfayoo Tiyya - Ethiopian Oromo Music 2020 [Official Video] by Golden Ethio Music 2 years ago 5 minutes, 23 seconds 1,335,794 views",Golden Ethio Music,1335794,1351256,15462
833,"Yisak Samuel (Isaac man) - Kuullee Kuullee - Ethiopian Oromo Music 2020 [Official Video] by Golden Ethio Music 2 years ago 3 minutes, 7 seconds 16,005 views",Golden Ethio Music,16005,16066,61
834,"Tadesse Mekete - Timket Be Gonder | ጥምቀት በጎንደር - Ethiopian Music 2020 [Official Video] by Golden Ethio Music 2 years ago 5 minutes, 2 seconds 316,137 views",Golden Ethio Music,316137,317986,1849
835,"Desalegn Jima - Yamalake - Ethiopian Oromo Music 2020 [Official Video] by Golden Ethio Music 2 years ago 5 minutes, 36 seconds 27,524 views",Golden Ethio Music,27524,27552,28
836,"Tesfahun Atalele - Mushiraye | ሙሽራዬ - Ethiopian Music 2020 [Official Video] by Golden Ethio Music 2 years ago 4 minutes, 30 seconds 582,466 views",Golden Ethio Music,582466,582693,227
837,"Angaatuu Baalchaa - Marsaa - Ethiopian Oromo Music 2020 [Official Video] by Golden Ethio Music 2 years ago 4 minutes, 2 seconds 32,093 views",Golden Ethio Music,32093,32129,36
838,"Kebede Bekele - Kotu Wanofi - Ethiopian Oromo Music 2020 [Official Video] by Golden Ethio Music 2 years ago 5 minutes, 7 seconds 51,474 views",Golden Ethio Music,51474,51566,92
839,"Agerenesh Meweded - Des Yilale | ደስ ይላል - Ethiopian Music 2020 [Official Video] by Golden Ethio Music 2 years ago 6 minutes, 2 seconds 12,039 views",Golden Ethio Music,12039,12043,4
840,"Bilisummaa Araarsaa - Akkaafuu baroode - Ethiopian Oromo Music 2020 [Official Video] by Golden Ethio Music 2 years ago 6 minutes, 26 seconds 50,548 views",Golden Ethio Music,50548,50672,124
841,"Qachaa Horaa - Koottu Buburraaqi - Ethiopian Oromo Music 2020 [Official Video] by Golden Ethio Music 2 years ago 4 minutes, 8 seconds 16,844 views",Golden Ethio Music,16844,16861,17
842,"Naa'ol Abarraa - Ajjeerradhu Dafii - Ethiopian Oromo Music 2020 [Official Video] by Golden Ethio Music 2 years ago 5 minutes, 10 seconds 18,860 views",Golden Ethio Music,18860,18906,46
843,"Lammaa Kabbadaa - TOKKUMMAAF - Ethiopian Oromo Music 2020 [Official Video] by Golden Ethio Music 2 years ago 4 minutes, 51 seconds 5,491 views",Golden Ethio Music,5491,5498,7
844,"Addunyaa Lammii  - Koottu Dibeebaabe - Ethiopian Oromo Music 2020 [Official Video] by Golden Ethio Music 2 years ago 5 minutes, 35 seconds 84,431 views",Golden Ethio Music,84431,84551,120
845,"Mekds Melese  - Jambo | ጃምቦ - New Ethiopian Oromo Music 2020 [Official Video] by Golden Ethio Music 2 years ago 5 minutes, 7 seconds 149,683 views",Golden Ethio Music,149683,151788,2105
846,"Milki Beshada - Michuu Kilaashii - New Ethiopian Oromo Music 2019 [Official Video] by Golden Ethio Music 2 years ago 7 minutes 11,421 views",Golden Ethio Music,11421,11480,59
847,"Seenaa Tashoomaa & Eebissa Dabbabaa - Sinbirtuu - New Ethiopian Oromo Music 2020 [Official Video] by Golden Ethio Music 2 years ago 6 minutes, 2 seconds 553,080 views",Golden Ethio Music,553080,555569,2489
848,"Firoomsaa Abbabaa - Sabnii Oromoo Leencaa - New Ethiopian Oromo Music 2019 [Official Video] by Golden Ethio Music 2 years ago 5 minutes, 41 seconds 29,875 views",Golden Ethio Music,29875,29959,84
849,"Ibsaa Abdallaa - Wal Jabeessaa - New Ethiopian Oromo Music 2019[Official Video] by Golden Ethio Music 2 years ago 7 minutes, 1 second 23,156 views",Golden Ethio Music,23156,23192,36
850,"Haylee Bayyanaa - Malaanmaltummaa - New Ethiopian Oromo Music 2019[Official Video] by Golden Ethio Music 2 years ago 6 minutes, 21 seconds 6,196 views",Golden Ethio Music,6196,6199,3
851,"Lammaa Nugusuu - Mee Waansan.....? - New Ethiopian Oromo Music 2019[Official Video] by Golden Ethio Music 2 years ago 5 minutes, 52 seconds 16,264 views",Golden Ethio Music,16264,16301,37
852,"Firoomsaa Abarraa - Qe'ee Tufaa Munaa - New Ethiopian Oromo Music 2019[Official Video] by Golden Ethio Music 2 years ago 7 minutes, 9 seconds 41,525 views",Golden Ethio Music,41525,41726,201
853,"Caaltuu Naanneessoo - Yaannii Kee... - New Ethiopian Oromo Music 2019[Official Video] by Golden Ethio Music 2 years ago 4 minutes, 24 seconds 54,539 views",Golden Ethio Music,54539,54757,218
854,"Lammaa Nugusuu - Lalii - New Ethiopian Oromo Music 2019[Official Video] by Golden Ethio Music 2 years ago 4 minutes, 58 seconds 27,192 views",Golden Ethio Music,27192,27388,196
855,"Gadaa Mokonnen - Osoo Kaatani Gufatanii Cabu - New Ethiopian Oromo Music 2019[Official Video] by Golden Ethio Music 2 years ago 6 minutes, 4 seconds 45,726 views",Golden Ethio Music,45726,45958,232
856,"Badhaasoo AKadiiroo - Hidhannoorraa Bareeda Dhiirti - New Ethiopian Oromo Music 2019[Official Video] by Golden Ethio Music 2 years ago 6 minutes, 19 seconds 41,989 views",Golden Ethio Music,41989,42176,187
857,"Abbabaa Tashoomaa (Falmataa)  Maalumaa Naa Gotee? - Ethiopian Oromo Music 2019 [Official Video] by Golden Ethio Music 2 years ago 6 minutes, 8 seconds 193,476 views",Golden Ethio Music,193476,194048,572
858,"Nanati Yami - Hulee Murii - New Ethiopian Oromo Music 2019 [Official Video] by Golden Ethio Music 2 years ago 5 minutes, 15 seconds 28,046 views",Golden Ethio Music,28046,28083,37
859,"Hirkoo Nugusee - Ijibbaata - New Ethiopian Oromo Music 2019 [Official Video] by Golden Ethio Music 2 years ago 5 minutes, 22 seconds 39,855 views",Golden Ethio Music,39855,39918,63
860,"Nanati Yami - Hiree - New Ethiopian Oromo Music 2019 [Official Video] by Golden Ethio Music 2 years ago 4 minutes, 36 seconds 40,944 views",Golden Ethio Music,40944,40988,44
861,"Amarti Tamiru  - Shagar - New Ethiopian Oromo Music 2019 [Official Video] by Golden Ethio Music 2 years ago 4 minutes, 19 seconds 75,825 views",Golden Ethio Music,75825,75908,83
862,"Caalaa Gaaromsaa -  Kuluula Ko - New Ethiopian Oromo Music 2019 [Official Video] by Golden Ethio Music 2 years ago 6 minutes, 21 seconds 1,380,101 views",Golden Ethio Music,1380101,1392294,12193
863,"Faaxee Anniyyaa, Ashaa Birree - Nu Uumaan Bilisa - New Ethiopian Oromo Music 2019 [Official Video] by Golden Ethio Music 2 years ago 5 minutes, 1 second 203,431 views",Golden Ethio Music,203431,204379,948
864,"Siifan Urgeechaa - Karaa Shiraa - New Ethiopian Oromo Music 2019 [Official Video] by Golden Ethio Music 2 years ago 6 minutes, 54 seconds 184,752 views",Golden Ethio Music,184752,185231,479
865,"Form Lord - Amen | አሜን - New Ethiopian Music 2019 [Official Video] by Golden Ethio Music 2 years ago 4 minutes, 38 seconds 1,708 views",Golden Ethio Music,1708,1709,1
866,"Abdii Furii - Waliin Galla - New Ethiopian Oromo Music 2019 [Official Video] by Golden Ethio Music 2 years ago 4 minutes, 53 seconds 147,434 views",Golden Ethio Music,147434,147784,350
867,"Siifan Tolasaa - Oromiyaa - New Ethiopian Oromo Music 2019 [Official Video] by Golden Ethio Music 2 years ago 5 minutes, 44 seconds 29,472 views",Golden Ethio Music,29472,29499,27
868,"Agerneh Aweke  - Bematebu | በማተቡ - New Ethiopian Music 2019 [Official Video] by Golden Ethio Music 2 years ago 4 minutes, 13 seconds 5,824 views",Golden Ethio Music,5824,5827,3
869,"Zarihuun Fajjii (Sanyii) - ISIIN DUBARTONNI  - New Ethiopian Oromo Music 2019 [Official Video] by Golden Ethio Music 2 years ago 5 minutes, 6 seconds 6,490 views",Golden Ethio Music,6490,6494,4
870,"Dagi Man - Shikorina | ሽኮሪና - New Ethiopian Music 2019 [Official Audio] by Golden Ethio Music 2 years ago 5 minutes, 47 seconds 3,452 views",Golden Ethio Music,3452,3457,5
871,"Aklilu Mekonnen - Alagebam | አላገባም - New Ethiopian Music 2019 [Official Audio] by Golden Ethio Music 2 years ago 5 minutes, 34 seconds 3,634 views",Golden Ethio Music,3634,3639,5
872,"Nimoonaa Gabbisaa - Siidaa Gootaa - New Ethiopian Oromo Music 2019 [Official Audio] by Golden Ethio Music 2 years ago 7 minutes, 6 seconds 1,931 views",Golden Ethio Music,1931,1932,1
873,"Salamoon Baqqalaa - Baga Kiyya Taatan - New Ethiopian Oromo Music 2019 [Official Video] by Golden Ethio Music 2 years ago 7 minutes, 17 seconds 16,978 views",Golden Ethio Music,16978,16999,21
874,"Birtukan Melak Ft Sench - Nalegn | ናልኝ - New Ethiopian Music 2019 [Official Video] by Golden Ethio Music 2 years ago 4 minutes, 2 seconds 2,859 views",Golden Ethio Music,2859,2862,3
875,"Nova T X Neba Habesha - Asaygn | አሳይኝ - New Ethiopian Music 2019 [Official Video] by Golden Ethio Music 2 years ago 4 minutes, 21 seconds 17,052 views",Golden Ethio Music,17052,17109,57
876,"Guutaa Dhaabishuu  - Koo Lammiin Oromoo - New Ethiopian Oromo Music 2019 [Official Video] by Golden Ethio Music 2 years ago 5 minutes, 22 seconds 21,684 views",Golden Ethio Music,21684,21714,30
877,"Buraka  Fininsa(Bure) - Hulansibana - New Ethiopian Oromo Music 2019 [Official Video] by Golden Ethio Music 2 years ago 7 minutes, 8 seconds 255,865 views",Golden Ethio Music,255865,257193,1328
878,"Fayyee Ashee - Siibiraa Hin Hafuu - New Ethiopian Oromo Music 2019 [Official Video] by Golden Ethio Music 2 years ago 5 minutes, 5 seconds 52,636 views",Golden Ethio Music,52636,52808,172
879,"Selam Alemayehu - Bona Hararge - New Ethiopian Oromo Music 2019 [Official Video] by Golden Ethio Music 2 years ago 4 minutes, 59 seconds 242,483 views",Golden Ethio Music,242483,244358,1875
880,"Abdusalaam Haajii - Dinquu Dayyaas - New Ethiopian Oromo Music 2019 [Official Video] by Golden Ethio Music 2 years ago 6 minutes, 58 seconds 18,703 views",Golden Ethio Music,18703,18780,77
881,"Eelsaa Nugusee - Koottu Shaggar - New Ethiopian Oromo Music 2019 [Official Video] by Golden Ethio Music 2 years ago 5 minutes, 41 seconds 1,148,552 views",Golden Ethio Music,1148552,1154102,5550
882,"Yonas Berhane - Kerebat | ቅረባት - New Ethiopian Music 2019 [Official Video] by Golden Ethio Music 2 years ago 4 minutes, 45 seconds 11,516 views",Golden Ethio Music,11516,11539,23
883,"Hayyuu Huseen - Malli Maali - New Ethiopian Oromo Music 2019 [Official Video] by Golden Ethio Music 2 years ago 4 minutes, 49 seconds 11,098 views",Golden Ethio Music,11098,11102,4
884,"Mulat Eshete - Emamye | እማምዬ - New Ethiopian Music 2019 [Official Video] by Golden Ethio Music 2 years ago 4 minutes, 6 seconds 10,427 views",Golden Ethio Music,10427,10447,20
885,"Liya Solomon - Enku Baheri | ዕንቁ ባሕሪ - New Ethiopian Tigrigna Music 2019 [Official Video] by Golden Ethio Music 2 years ago 3 minutes, 21 seconds 7,617 views",Golden Ethio Music,7617,7621,4
886,"Tokuma Kebebe - Oroomiyaa - New Ethiopian Oromo Music 2019 [Official Video] by Golden Ethio Music 2 years ago 4 minutes, 17 seconds 57,616 views",Golden Ethio Music,57616,57887,271
887,"Lelisa Kebede - DHUKKUBA JAALALAA - New Ethiopian Oromo Music 2019 [Official Video] by Golden Ethio Music 2 years ago 6 minutes, 5 seconds 168,908 views",Golden Ethio Music,168908,169100,192
888,"Guddinaa Tulluu - Ya Kuullee - New Ethiopian Oromo Music 2019 [Official Video] by Golden Ethio Music 2 years ago 4 minutes, 48 seconds 14,271 views",Golden Ethio Music,14271,14306,35
889,"Ashenafi Bekele - Obsen - New Ethiopian Oromo Music 2019 [Official Video] by Golden Ethio Music 2 years ago 5 minutes, 38 seconds 73,979 views",Golden Ethio Music,73979,75659,1680
890,"Yirgu Hamar - Buska | ቡስካ - New Ethiopian Music 2019 [Official Video] by Golden Ethio Music 2 years ago 4 minutes, 49 seconds 33,396 views",Golden Ethio Music,33396,33829,433
891,"Samsom (SAS)FT. Arkan(TRUTH) - Gorzo | ጎርዞ - New Ethiopian Music 2019 [Official Video] by Golden Ethio Music 2 years ago 3 minutes, 33 seconds 1,979 views",Golden Ethio Music,1979,1981,2
892,"Maritu Tamalew - Ewenet | እውነት - New Ethiopian Music 2019 [Official Video] by Golden Ethio Music 2 years ago 5 minutes, 22 seconds 37,921 views",Golden Ethio Music,37921,38065,144
893,"Tselot Mehela  | ፀሎት ምህላ -  Ethiopia 2019 [Official Video] by Golden Ethio Music 2 years ago 8 minutes, 17 seconds 8,936 views",Golden Ethio Music,8936,8983,47
894,"Dhaabaa Girmaa - Yaa Komochoree - New Ethiopian Oromo Music 2019 [Official Video] by Golden Ethio Music 2 years ago 6 minutes, 23 seconds 335,980 views",Golden Ethio Music,335980,339226,3246
895,"Tafarii Zarfuu -Tokkummaa Jabeessaa - New Ethiopian Oromo Music 2019 [Official Video] by Golden Ethio Music 2 years ago 6 minutes, 11 seconds 54,178 views",Golden Ethio Music,54178,54333,155
896,"Lammaa Sassaabee - Sabboontuudha - New Ethiopian Oromo Music 2019 [Official Video] by Golden Ethio Music 2 years ago 5 minutes, 30 seconds 41,618 views",Golden Ethio Music,41618,41733,115
897,"Nathnail Shumye - Yajegena | ያጀግና - New Ethiopian Music 2019 [Official Video] by Golden Ethio Music 2 years ago 6 minutes, 3 seconds 3,792 views",Golden Ethio Music,3792,3797,5
898,"Saron Damete - Ziyada | ዝያዳይ - New Ethiopian Tigrigna Music 2019 [Official Video] by Golden Ethio Music 2 years ago 3 minutes, 43 seconds 5,515 views",Golden Ethio Music,5515,5518,3
899,"Nagayoo Guutamaa - Bareedduu - New Ethiopian Oromo Music 2019 [Official Video] by Golden Ethio Music 2 years ago 5 minutes, 19 seconds 573,922 views",Golden Ethio Music,573922,579424,5502
900,"Eyasu Aleme - Hager Alemitu | ሀገር አለሚቱ - New Ethiopian Music 2019 [Official Video] by Golden Ethio Music 2 years ago 5 minutes, 46 seconds 5,880 views",Golden Ethio Music,5880,5900,20
901,"Adeno Dese - Teweralesh | ተወራልሽ - New Ethiopian Music 2019 [Official Video] by Golden Ethio Music 2 years ago 6 minutes, 7 seconds 2,604 views",Golden Ethio Music,2604,2612,8
902,"Dhiigadebis Mulgeetaa - Bashannani - New Ethiopian Oromo Music 2019 [Official Video] by Golden Ethio Music 2 years ago 5 minutes, 32 seconds 2,948 views",Golden Ethio Music,2948,2952,4
903,"Derash Fenta - Enate Gedam Nesh | እናቴ ገዳም ነሽ - New Ethiopian Music 2019 [Official Video] by Golden Ethio Music 2 years ago 6 minutes, 20 seconds 80,084 views",Golden Ethio Music,80084,80249,165
904,"Ashenafi Bakele - Obsen - New Ethiopian Oromo Music 2019 [Official Video] by Golden Ethio Music 2 years ago 5 minutes, 21 seconds 9,300 views",Golden Ethio Music,9300,9445,145
905,"Ayanaw Terualem and Andarg Negash - Yemisrach | የምስራች - New Ethiopian Music 2019 [Official Video] by Golden Ethio Music 2 years ago 5 minutes, 16 seconds 9,231 views",Golden Ethio Music,9231,9268,37
906,"Ephrem Fentaw - Endemenem | እንደምንም - New Ethiopian Music 2019 [Official Video] by Golden Ethio Music 2 years ago 6 minutes, 17 seconds 3,315 views",Golden Ethio Music,3315,3318,3
907,"Jamaal usmaa'il  - Aliifii jaalalaa - New Ethiopian Oromo Music 2019 [Official Video] by Golden Ethio Music 2 years ago 6 minutes, 3 seconds 1,101,893 views",Golden Ethio Music,1101893,1118467,16574
908,"Sabboonaa Wandimmuu - Cimsii Qabi -  New Ethiopian Oromo Music 2019 [Official Video] by Golden Ethio Music 2 years ago 5 minutes, 47 seconds 24,297 views",Golden Ethio Music,24297,24452,155
909,"Urjii Salamon (Mikii) - Marii Garaa Yaa Galaane - New Ethiopian Oromo Music 2019 [Official Video] by Golden Ethio Music 2 years ago 5 minutes, 18 seconds 115,647 views",Golden Ethio Music,115647,115908,261
910,"Tadesse Mekete - Abedisaga | አብዲሳአጋ - New Ethiopian Music 2019 [Official Video] by Golden Ethio Music 2 years ago 4 minutes, 36 seconds 8,936 views",Golden Ethio Music,8936,8946,10
911,"Mulunaa Kabbadaa - Jirbiin Wal Foote - New Ethiopian Oromo Music 2019 [Official Video] by Golden Ethio Music 2 years ago 4 minutes, 59 seconds 10,007 views",Golden Ethio Music,10007,10020,13
912,"Yisaaq Samu'el(ISAAC) - ABJUU - New Ethiopian Oromo Music 2019 [Official Audio] by Golden Ethio Music 2 years ago 3 minutes, 51 seconds 1,771 views",Golden Ethio Music,1771,1777,6
913,"Yisaaq Samu'el(ISAAC) - AKKAMI - New Ethiopian Oromo Music 2019 [Official Audio] by Golden Ethio Music 2 years ago 3 minutes, 30 seconds 1,321 views",Golden Ethio Music,1321,1321,0
914,"Yisaaq Samu'el(ISAAC) - BABURII - New Ethiopian Oromo Music 2019 [Official Audio] by Golden Ethio Music 2 years ago 4 minutes, 14 seconds 1,381 views",Golden Ethio Music,1381,1381,0
915,"Yisaaq Samu'el(ISAAC) - DHITEE BARITEE - New Ethiopian Oromo Music 2019 [Official Audio] by Golden Ethio Music 2 years ago 4 minutes, 41 seconds 877 views",Golden Ethio Music,877,879,2
916,"Yisaaq Samu'el(ISAAC) - DIRREE - New Ethiopian Oromo Music 2019 [Official Audio] by Golden Ethio Music 2 years ago 3 minutes, 40 seconds 585 views",Golden Ethio Music,585,585,0
917,"Yisaaq Samu'el(ISAAC) - GADAA - New Ethiopian Oromo Music 2019 [Official Audio] by Golden Ethio Music 2 years ago 4 minutes, 49 seconds 1,032 views",Golden Ethio Music,1032,1032,0
918,"Yisaaq Samu'el(ISAAC) - HARMEE - New Ethiopian Oromo Music 2019 [Official Audio] by Golden Ethio Music 2 years ago 5 minutes, 35 seconds 1,023 views",Golden Ethio Music,1023,1023,0
919,"Yisaaq Samu'el(ISAAC) - HAYAYAA - New Ethiopian Oromo Music 2019 [Official Audio] by Golden Ethio Music 2 years ago 4 minutes, 7 seconds 735 views",Golden Ethio Music,735,737,2
920,"Yisaaq Samu'el(ISAAC) - JIMMA - New Ethiopian Oromo Music 2019 [Official Audio] by Golden Ethio Music 2 years ago 4 minutes, 3 seconds 1,674 views",Golden Ethio Music,1674,1677,3
921,"Yisaaq Samu'el(ISAAC) - KARRA NAAF BANI - New Ethiopian Oromo Music 2019 [Official Audio] by Golden Ethio Music 2 years ago 3 minutes, 24 seconds 1,072 views",Golden Ethio Music,1072,1072,0
922,"Yisaaq Samu'el(ISAAC) - KUULLEE KUULLEE - New Ethiopian Oromo Music 2019 [Official Audio] by Golden Ethio Music 2 years ago 3 minutes, 4 seconds 911 views",Golden Ethio Music,911,911,0
923,"Yisaaq Samu'el(ISAAC) - NAANJIIBINII - New Ethiopian Oromo Music 2019 [Official Audio] by Golden Ethio Music 2 years ago 3 minutes, 23 seconds 944 views",Golden Ethio Music,944,946,2
924,"Caalaa Bultume - WAGGADHAN NU GA'I - New Ethiopian Oromo Music 2019 [Official Video] by Golden Ethio Music 2 years ago 6 minutes, 27 seconds 4,566,713 views",Golden Ethio Music,4566713,4593482,26769
925,"Walabummaa Masfin  - Birroolee - New Ethiopian Oromo Music 2019 [Official Video] by Golden Ethio Music 2 years ago 4 minutes, 28 seconds 23,442 views",Golden Ethio Music,23442,23511,69
926,"Jaamboo Fayyissa - Gadaa Malee - New Ethiopian Oromo Music 2019 [Official Video] by Golden Ethio Music 2 years ago 5 minutes, 59 seconds 142,462 views",Golden Ethio Music,142462,142676,214
927,"Abarra Daggafaa - Oromiyaa Badhaatu - New Ethiopian Oromo Music 2019 [Official Video] by Golden Ethio Music 2 years ago 6 minutes 26,375 views",Golden Ethio Music,26375,26445,70
928,"Haylee Bayyanaa - Irreecha Finfinnee - New Ethiopian Oromo Music 2019 [Official Video] by Golden Ethio Music 2 years ago 5 minutes, 10 seconds 113,602 views",Golden Ethio Music,113602,113691,89
929,"Guade Shegaw - Yeken Jegena | የቀን ጀግና - New Ethiopian Music 2019 [Official Video] by Golden Ethio Music 2 years ago 6 minutes, 1 second 55,255 views",Golden Ethio Music,55255,55273,18
930,"Eknock Feat. Merry  - Co CO | ኮ ኮ - New Ethiopian Music 2019 [Official Video] by Golden Ethio Music 2 years ago 3 minutes, 41 seconds 9,015 views",Golden Ethio Music,9015,9021,6
931,"Behailu Bayou (Mata Mata) - Alsemama | አልሰማማ - New Ethiopian Music 2019 [Official Video] by Golden Ethio Music 2 years ago 5 minutes, 18 seconds 95,881 views",Golden Ethio Music,95881,96254,373
932,"Mahammaad Qancoora - Tullaa Eegge - New Ethiopian Oromo Music 2019 [Official Video] by Golden Ethio Music 2 years ago 5 minutes, 23 seconds 12,833 views",Golden Ethio Music,12833,12869,36
933,"Abarraa Warquu & Taagaay Lammeessaa - AYYAANA GAARII - New Ethiopian Oromo Music 2019 by Golden Ethio Music 2 years ago 4 minutes, 46 seconds 12,730 views",Golden Ethio Music,12730,12740,10
934,"Waakkalaa Jaarsoo - DansaanAadaa Teenna - New Ethiopian Oromo Music 2019 [Official Video] by Golden Ethio Music 2 years ago 4 minutes, 48 seconds 9,933 views",Golden Ethio Music,9933,9938,5
935,"kalkidan tesfaye - Fiker New Lebe | ፍቅር ነው ልቤ - New Ethiopian Music 2019 [Official Video] by Golden Ethio Music 2 years ago 3 minutes, 35 seconds 6,035 views",Golden Ethio Music,6035,6047,12
936,"Raggaasaa Warquu - Bira Hin Darbu - New Ethiopian Oromo Music 2019 [Official Video] by Golden Ethio Music 2 years ago 5 minutes, 58 seconds 29,852 views",Golden Ethio Music,29852,29943,91
937,"Million Wondimu - Algebagnim  | አልገባኝም - New Ethiopian Music 2019 [Official Video] by Golden Ethio Music 2 years ago 4 minutes, 52 seconds 6,053 views",Golden Ethio Music,6053,6056,3
938,"Kumaa Hordofaa - GOOBEE - New Ethiopian Oromo Music 2019 [Official Audio] by Golden Ethio Music 2 years ago 6 minutes, 47 seconds 3,249 views",Golden Ethio Music,3249,3250,1
939,"Jene Tamene - Eyemun | እየሙን - New Ethiopian Music 2019 [Official Video] by Golden Ethio Music 2 years ago 5 minutes, 10 seconds 9,029 views",Golden Ethio Music,9029,9043,14
940,"Bakkalcha Usmaanfi Ft. Ibbrahim Muhamad - MAALTU GALE - Ethiopian Oromo Music 2019 [Official Video] by Golden Ethio Music 2 years ago 4 minutes, 50 seconds 207,135 views",Golden Ethio Music,207135,207383,248
941,"Fiixee Aleks - EE AMMAA - New Ethiopian Oromo Music 2019 [Official Video] by Golden Ethio Music 2 years ago 5 minutes, 2 seconds 4,201 views",Golden Ethio Music,4201,4202,1
942,"Nimoonaa Gabbisaa - Hiibboo - New Ethiopian Music Oromo 2019 [Official Video] by Golden Ethio Music 2 years ago 5 minutes, 59 seconds 16,413 views",Golden Ethio Music,16413,16437,24
943,"Urgesa Eshetu (Urji) - A/oromoo A/hojii F/tauqaba - New Ethiopian Oromo Music 2019 [Official Video] by Golden Ethio Music 2 years ago 4 minutes, 52 seconds 7,211 views",Golden Ethio Music,7211,7227,16
944,"Fayyisaa Fufaa - Abaayee Tiyyaa - New Ethiopian Oromo Music 2019 [Official Video] by Golden Ethio Music 2 years ago 4 minutes, 50 seconds 111,434 views",Golden Ethio Music,111434,112024,590
945,"Mulugeta Shete - Aman Yehun | አማን ይሁን - New Ethiopian Music 2019 [Official Video] by Golden Ethio Music 2 years ago 5 minutes, 26 seconds 37,760 views",Golden Ethio Music,37760,37794,34
946,"Nathan - Senay Zemen | ሰናይ ዘመን  - New Ethiopian Music 2019 [Official Video] by Golden Ethio Music 2 years ago 4 minutes, 17 seconds 105,837 views",Golden Ethio Music,105837,105862,25
947,"Ibsaa Abdurahamaan - Abshir | አብሽር - New Ethiopian Oromo Music 2019 [Official Video] by Golden Ethio Music 2 years ago 5 minutes, 53 seconds 22,875 views",Golden Ethio Music,22875,22991,116
948,"Tewodros Mosisa - Tsedeye | ፀደይ - New Ethiopian Music 2019 [Official Video] by Golden Ethio Music 2 years ago 4 minutes, 43 seconds 104,385 views",Golden Ethio Music,104385,104427,42
949,"Hana Melkamu - Awedamet | አውዳመት - New Ethiopian Music 2019 [Official Video] by Golden Ethio Music 2 years ago 5 minutes, 19 seconds 13,718 views",Golden Ethio Music,13718,13726,8
950,"Boontuu Daadhi  - Yaa Abaabilee - New Ethiopian Oromo Music 2019 [Official Video] by Golden Ethio Music 2 years ago 4 minutes, 56 seconds 188,347 views",Golden Ethio Music,188347,188610,263
951,"Seenaa (Shallamaa) Taaddasaa  - Gadaan Keenya - New Ethiopian Oromo Music 2019 [Official Video] by Golden Ethio Music 2 years ago 6 minutes, 59 seconds 57,052 views",Golden Ethio Music,57052,57181,129
952,"Epic Concert In Addis Abeba For New Year’s Eve With Major Artist Performing live At Ghion Hotel by Golden Ethio Music 2 years ago 45 seconds 1,248 views",Golden Ethio Music,1248,1248,0
953,"Guutaa Dhaabishuu - Biyyaaf Falmanna - New Ethiopian Oromo Music 2019 [Official Video] by Golden Ethio Music 2 years ago 6 minutes, 57 seconds 50,277 views",Golden Ethio Music,50277,50300,23
954,"Masfiin Guutaa  - Gargar Hin Baanu - New Ethiopian Oromo Music 2019 [Official Video] by Golden Ethio Music 2 years ago 5 minutes, 16 seconds 68,716 views",Golden Ethio Music,68716,68767,51
955,"Abdoo Huseen - Rahaa - New Ethiopian Oromo Music 2019 [Official Video] by Golden Ethio Music 2 years ago 5 minutes, 31 seconds 66,440 views",Golden Ethio Music,66440,66623,183
956,"Werku Assefa - Falaasama Jaraa - New Ethiopian Oromo Music 2019 [Official Video] by Golden Ethio Music 2 years ago 6 minutes, 11 seconds 11,278 views",Golden Ethio Music,11278,11290,12
957,"Tadesse Mekete - Enateye | እናትዬ - New Ethiopian Music 2019 [Official Video] by Golden Ethio Music 2 years ago 3 minutes, 51 seconds 10,512 views",Golden Ethio Music,10512,10546,34
958,"Hailu Balcha - Eeyyeen - New Ethiopian Oromo Music 2019 [Official Video] by Golden Ethio Music 2 years ago 6 minutes, 53 seconds 10,578 views",Golden Ethio Music,10578,10599,21
959,"Leul Papi And Jossy - Bey Tega | በይ ጠጋ - New Ethiopian Music 2019 [Official Video] by Golden Ethio Music 2 years ago 3 minutes, 44 seconds 3,695 views",Golden Ethio Music,3695,3709,14
960,"Ashuu Baqqalaa - Kun Salphina - New Ethiopian Oromo Music 2019 [Official Video] by Golden Ethio Music 2 years ago 4 minutes, 52 seconds 11,427 views",Golden Ethio Music,11427,11440,13
961,"Letay Mesfin - Ashenda Ayni Wari  - New Ethiopian Tigrigna Music 2019 [Official Video] by Golden Ethio Music 2 years ago 5 minutes, 44 seconds 202,872 views",Golden Ethio Music,202872,202961,89
962,"Gebreberhan Feseha - Sedray Nafke  - New Ethiopian Tigrigna Music 2019 [Official Video] by Golden Ethio Music 2 years ago 5 minutes, 10 seconds 6,926 views",Golden Ethio Music,6926,6944,18
963,"Solomon Yimer - Fikere Semign | ፍቅሬ ስሚኝ - New Ethiopian Music 2018 (Official Video) by Golden Ethio Music 2 years ago 4 minutes, 38 seconds 2,650 views",Golden Ethio Music,2650,2652,2
964,"Sintayehu Belay  - Bosona Kunuunsaa - New Ethiopian Oromo Music 2019 [Official Video] by Golden Ethio Music 2 years ago 4 minutes, 27 seconds 2,279 views",Golden Ethio Music,2279,2297,18
965,"Ayanaw Terualem - Eskemech | እስከመች - New Ethiopian Music 2019 [Official Video] by Golden Ethio Music 2 years ago 7 minutes, 36 seconds 68,727 views",Golden Ethio Music,68727,68745,18
966,"Habtamu Hailu - Yaadan Najjeesta - New Ethiopian Oromo Music 2019 [Official Video] by Golden Ethio Music 2 years ago 5 minutes, 11 seconds 79,117 views",Golden Ethio Music,79117,79126,9
967,"Dhaabaa Girmaa - Farda Bitii Soori - New Ethiopian Oromo Music 2019 [Official Video] by Golden Ethio Music 2 years ago 5 minutes, 3 seconds 18,819 views",Golden Ethio Music,18819,18859,40
968,"Asefa Teshome - Baga Jiraanne - New Ethiopian Oromo Music 2019 [Official Video] by Golden Ethio Music 2 years ago 7 minutes, 32 seconds 172,262 views",Golden Ethio Music,172262,172870,608
969,"Gammachis Gurmeessa - Maa Sijarjaraa - New Ethiopian Oromo Music 2019 [Official Video] by Golden Ethio Music 2 years ago 5 minutes, 45 seconds 713,153 views",Golden Ethio Music,713153,718670,5517
970,"Diinaa'ol Dajanee - Finfinneen - New Ethiopian Oromo Music 2019 [Official Video] by Golden Ethio Music 2 years ago 6 minutes, 2 seconds 44,631 views",Golden Ethio Music,44631,44661,30
971,"Meetii Haylee Dibaabaa - Tuquu Laata? - New Ethiopian Oromo Music 2019 [Official Video] by Golden Ethio Music 2 years ago 7 minutes, 1 second 1,060,516 views",Golden Ethio Music,1060516,1065962,5446
972,"Bushu Haayilu  - Oromtittii | ኦሮምቲቲ - New Ethiopian Oromo Music 2019 [Official Video] by Golden Ethio Music 2 years ago 5 minutes, 11 seconds 844,021 views",Golden Ethio Music,844021,848179,4158
973,"Tewodros Mosisa - Jaleleko | ጃለሌኮ - New Ethiopian Music 2019 [Official Audio] by Golden Ethio Music 2 years ago 5 minutes, 11 seconds 19,829 views",Golden Ethio Music,19829,19889,60
974,"Tewodros Mosisa - Beletena Ahemed | በለጠና አህመድ - New Ethiopian Music 2019 [Official Audio] by Golden Ethio Music 2 years ago 5 minutes, 40 seconds 20,494 views",Golden Ethio Music,20494,20511,17
975,"Tewodros Mosisa - Yewret Fkir | የወረት ፍቅር - New Ethiopian Music 2019 [Official Audio] by Golden Ethio Music 2 years ago 4 minutes, 27 seconds 33,748 views",Golden Ethio Music,33748,33785,37
976,"Tewodros Mosisa Ft. Jalud - Bale Taxiw | ባለ ታክሲው - New Ethiopian Music 2019 [Official Audio] by Golden Ethio Music 2 years ago 5 minutes, 20 seconds 26,183 views",Golden Ethio Music,26183,26241,58
977,"Tewodros Mosisa - Shewa | ሸዋ - New Ethiopian Music 2019 [Official Audio] by Golden Ethio Music 2 years ago 5 minutes, 28 seconds 25,933 views",Golden Ethio Music,25933,25985,52
978,"Tewodros Mosisa - Chawo Asmara | ቻዎ አስመራ - New Ethiopian Music 2019 [Official Audio] by Golden Ethio Music 2 years ago 5 minutes, 52 seconds 62,427 views",Golden Ethio Music,62427,62532,105
979,"Tewodros Mosisa - Boge | ቦጌ - New Ethiopian Music 2019 [Official Audio] by Golden Ethio Music 2 years ago 4 minutes, 1 second 53,942 views",Golden Ethio Music,53942,54039,97
980,"Tewodros Mosisa - Lanchi Alhonim | ለአንቺ  አልሆንም - New Ethiopian Music 2019 [Official Audio] by Golden Ethio Music 2 years ago 4 minutes, 47 seconds 37,580 views",Golden Ethio Music,37580,37662,82
981,"Tewodros Mosisa - Melke | መልኬ - New Ethiopian Music 2019 [Official Audio] by Golden Ethio Music 2 years ago 4 minutes, 48 seconds 13,887 views",Golden Ethio Music,13887,13927,40
982,"Tewodros Mosisa - Mehala | መሐላ - New Ethiopian Music 2019 [Official Audio] by Golden Ethio Music 2 years ago 3 minutes, 59 seconds 15,724 views",Golden Ethio Music,15724,15762,38
983,"Tewodros Mosisa - Semira | ሰሚራ - New Ethiopian Music 2019 [Official Audio] by Golden Ethio Music 2 years ago 5 minutes, 11 seconds 22,567 views",Golden Ethio Music,22567,22641,74
984,"Tewodros Mosisa - Abede | አበደ - New Ethiopian Music 2019 [Official Audio] by Golden Ethio Music 2 years ago 4 minutes, 13 seconds 38,791 views",Golden Ethio Music,38791,38886,95
985,"Tewodros Mosisa Ft. Jalud- Noreyalehu | ኖሬያለሁ - New Ethiopian Music 2019 [Official Audio] by Golden Ethio Music 2 years ago 5 minutes, 39 seconds 34,620 views",Golden Ethio Music,34620,34687,67
986,"Tewodros Mosisa - Alefe | አለፈ - New Ethiopian Music 2019 [Official Audio] by Golden Ethio Music 2 years ago 5 minutes, 3 seconds 62,882 views",Golden Ethio Music,62882,62981,99
987,"Tade Barch - Demachen New Fasil | ደማችን ነው ፋሲል - New Ethiopian Music 2019 [Official Video] by Golden Ethio Music 2 years ago 4 minutes, 16 seconds 16,312 views",Golden Ethio Music,16312,16320,8
988,"Sami Go - Sonnorya | ሶኖሪያ - New Ethiopian Music 2019 [Official Video] by Golden Ethio Music 2 years ago 3 minutes, 48 seconds 86,667 views",Golden Ethio Music,86667,86885,218
989,"Awel Zeyneba Endris  - Metalech | መታለች - New Ethiopian Music 2019 [Official Video] by Golden Ethio Music 2 years ago 4 minutes, 16 seconds 18,972 views",Golden Ethio Music,18972,18975,3
990,"Tewodros Mosisa | ALEFE | New Album Promo [Official Video] 2019 by Golden Ethio Music 2 years ago 1 minute, 3 seconds 13,226 views",Golden Ethio Music,13226,13230,4
991,"Kaleab Tetemke - Teamere | ተአምሬ - New Ethiopian Music 2019 [Official Video] by Golden Ethio Music 2 years ago 4 minutes, 52 seconds 29,044 views",Golden Ethio Music,29044,29162,118
992,"Tadesse Mekete - Ayecheshalhu | አይቼሻለዉ - New Ethiopian Music 2019 [Official Video] by Golden Ethio Music 2 years ago 5 minutes, 4 seconds 727,357 views",Golden Ethio Music,727357,729169,1812
993,"Deju Papyo Ft. Akom - NIE - New Ethiopian Music 2019 [Official Video] by Golden Ethio Music 2 years ago 3 minutes, 58 seconds 9,985 views",Golden Ethio Music,9985,9993,8
994,"Abraham Ayele - 7 Argew | 7 አርገው - New Ethiopian Music 2019 [Official Video] by Golden Ethio Music 2 years ago 7 minutes, 45 seconds 77,946 views",Golden Ethio Music,77946,78060,114
995,"Enkenyelesh Niguse - Esetewalhu | እሰጠዋለሁ - New Ethiopian Music 2019 [Official Video] by Golden Ethio Music 2 years ago 4 minutes, 36 seconds 100,544 views",Golden Ethio Music,100544,100575,31
996,"Mekuanent Melesse - Hemrewa | ህምርዋ - New Ethiopian Music 2019 [Official Video] by Golden Ethio Music 2 years ago 5 minutes, 37 seconds 1,738,789 views",Golden Ethio Music,1738789,1751449,12660
997,"Alex Sahelu - Yegeyonua Gubel | የግዮንዋ ጉብል - New Ethiopian Music 2019 [Official Video] by Golden Ethio Music 2 years ago 5 minutes, 37 seconds 9,918 views",Golden Ethio Music,9918,9939,21
998,"Endalkachew Yenehun - Himemetegnaw Lebe | ህመምተኛው ልቤ - New Ethiopian Music 2019 [Official Video] by Golden Ethio Music 2 years ago 5 minutes, 59 seconds 142,084 views",Golden Ethio Music,142084,142228,144
999,"Tewodros Mosisa  - Melke | መልኬ - New Ethiopian Music 2019 [Official Video] by Golden Ethio Music 2 years ago 5 minutes, 14 seconds 199,980 views",Golden Ethio Music,199980,200726,746
1000,"Atsede Biset - Sew Malet | ሰው ማለት - New Ethiopian Music 2019 [Official Video] by Golden Ethio Music 2 years ago 3 minutes, 55 seconds 10,708 views",Golden Ethio Music,10708,10716,8
1001,"Aregash Yeheyes(Eri) - Sakelegn | ሳቅልኝ - New Ethiopian Music 2019 [Official Video] by Golden Ethio Music 2 years ago 3 minutes, 34 seconds 7,545 views",Golden Ethio Music,7545,7549,4
1002,"Fkr Mulu x Natan B ft. Beli - Kottumee | ኮቱሜ - New Ethiopian Music 2019 (Official Video) by Golden Ethio Music 2 years ago 4 minutes, 4 seconds 7,173 views",Golden Ethio Music,7173,7194,21
1003,"Abarraa Warquu - Sin Yadadhaa - New Ethiopian Oromo Music 2019 (Official Audio) by Golden Ethio Music 2 years ago 5 minutes, 13 seconds 2,429 views",Golden Ethio Music,2429,2433,4
1004,"Abarraa Warquu - Gammachuu - New Ethiopian Oromo Music 2019 (Official Audio) by Golden Ethio Music 2 years ago 4 minutes, 58 seconds 1,495 views",Golden Ethio Music,1495,1497,2
1005,"Abarraa Warquu - Hin Dhakkiin - New Ethiopian Oromo Music 2019 (Official Audio) by Golden Ethio Music 2 years ago 4 minutes, 6 seconds 1,670 views",Golden Ethio Music,1670,1673,3
1006,"Abarraa Warquu - Oromtittii - New Ethiopian Oromo Music 2019 (Official Audio) by Golden Ethio Music 2 years ago 4 minutes, 48 seconds 1,312 views",Golden Ethio Music,1312,1317,5
1007,"Abarraa Warquu - Magaal Kiyyaa - New Ethiopian Oromo Music 2019 (Official Audio) by Golden Ethio Music 2 years ago 4 minutes, 29 seconds 1,476 views",Golden Ethio Music,1476,1477,1
1008,"Abarraa Warquu - Warra Jillee - New Ethiopian Oromo Music 2019 (Official Audio) by Golden Ethio Music 2 years ago 5 minutes, 31 seconds 1,049 views",Golden Ethio Music,1049,1054,5
1009,"Abarraa Warquu - Oromiyaa - New Ethiopian Oromo Music 2019 (Official Audio) by Golden Ethio Music 2 years ago 5 minutes, 3 seconds 1,370 views",Golden Ethio Music,1370,1373,3
1010,"Abarraa Warquu - Gaa'ila Milkii - New Ethiopian Oromo Music 2019 (Official Audio) by Golden Ethio Music 2 years ago 5 minutes, 1 second 1,133 views",Golden Ethio Music,1133,1139,6
1011,"Abarraa Warquu - Jaalala Taananii - New Ethiopian Oromo Music 2019 (Official Audio) by Golden Ethio Music 2 years ago 4 minutes, 9 seconds 1,370 views",Golden Ethio Music,1370,1374,4
1012,"Abarraa Warquu - Asaassaatekaa - New Ethiopian Oromo Music 2019 (Official Audio) by Golden Ethio Music 2 years ago 5 minutes, 25 seconds 1,477 views",Golden Ethio Music,1477,1479,2
1013,"Abarraa Warquu - Nan Tuutuqiin - New Ethiopian Oromo Music 2019 (Official Audio) by Golden Ethio Music 2 years ago 5 minutes, 24 seconds 5,528 views",Golden Ethio Music,5528,5540,12
1014,"Abarraa Warquu - Wasanee - New Ethiopian Oromo Music 2019 (Official Audio) by Golden Ethio Music 2 years ago 4 minutes, 33 seconds 2,003 views",Golden Ethio Music,2003,2037,34
1015,"Abarraa Warquu - Sadaan Sooddoo - New Ethiopian Oromo Music 2019 (Official Audio) by Golden Ethio Music 2 years ago 6 minutes, 3 seconds 2,024 views",Golden Ethio Music,2024,2031,7
1016,"Abarraa Warquu - Sanyii Leencaa - New Ethiopian Oromo Music 2019 (Official Audio) by Golden Ethio Music 2 years ago 5 minutes, 32 seconds 2,703 views",Golden Ethio Music,2703,2707,4
1017,"Ayanaw Terualem - Enchi Yagere Lij | እንቺ ያገሬ ልጅ - New Ethiopian Music 2019 (Official Video) by Golden Ethio Music 2 years ago 5 minutes, 25 seconds 89,792 views",Golden Ethio Music,89792,89929,137
1018,"Demere Legese - Kotu Malo | ኮቱ ማሎ - New Ethiopian Music 2019 [Official Audio Video] by Golden Ethio Music 2 years ago 6 minutes, 37 seconds 6,479 views",Golden Ethio Music,6479,6553,74
1019,"Demere Legese - Merew | መሬዉ - New Ethiopian Music 2019 [Official Video] by Golden Ethio Music 2 years ago 5 minutes, 31 seconds 263,239 views",Golden Ethio Music,263239,263703,464
1020,"Alachew Asechale - Fikern Yakil | ፍቅርን ያክል - New Ethiopian Music 2019 (Official Video) by Golden Ethio Music 2 years ago 5 minutes, 58 seconds 25,221 views",Golden Ethio Music,25221,25258,37
1021,"Elili Birra - Madda Qaroomina - New Oromo Music 2019 [Official Video] by Golden Ethio Music 2 years ago 4 minutes, 4 seconds 29,398 views",Golden Ethio Music,29398,29414,16
1022,"Tarekegn Haile(Chapi Masinko) - Hagere | ሃገሬ - New Ethiopian Music 2019 (Official Video) by Golden Ethio Music 2 years ago 3 minutes, 38 seconds 7,602 views",Golden Ethio Music,7602,7606,4
1023,"Alpha Zema - Emu | እሙ - New Ethiopian Music 2019 (Official Video) by Golden Ethio Music 2 years ago 3 minutes, 54 seconds 5,231 views",Golden Ethio Music,5231,5239,8
1024,"Belsam & Alexander ft Blatenaw - Yenew NAT | የኔው ናት - New Ethiopian Music 2019 (Official Video) by Golden Ethio Music 2 years ago 3 minutes, 44 seconds 27,288 views",Golden Ethio Music,27288,27621,333
1025,"Nishan Belay - Sheblaw | ሸበላዉ - New Ethiopian Music 2019 (Official Video) by Golden Ethio Music 2 years ago 6 minutes, 52 seconds 6,103 views",Golden Ethio Music,6103,6106,3
1026,"Samuel Seneshaw - Tinshua Ethiopia | ትንሻ ኢትዮጲያ (አዲስ አበባ) - New Ethiopian Music 2019 (Official Video) by Golden Ethio Music 2 years ago 5 minutes, 52 seconds 59,389 views",Golden Ethio Music,59389,59394,5
1027,"Baroo Didhaa - Cuunfaa Seenaa - New Ethiopian Oromo Music 2019 (Official Video) by Golden Ethio Music 2 years ago 8 minutes, 40 seconds 3,605 views",Golden Ethio Music,3605,3610,5
1028,"Hab And Aron - Hulet Wedo | ሁለት ወዶ - New Ethiopian Music 2019 (Official Video) by Golden Ethio Music 2 years ago 3 minutes, 57 seconds 13,561 views",Golden Ethio Music,13561,13570,9
1029,"E Dove - Habesha | ሐበሻ - New Ethiopian Music 2019 (Official Video) by Golden Ethio Music 2 years ago 3 minutes, 54 seconds 5,519 views",Golden Ethio Music,5519,5542,23
1030,"Tade Barch - Lk Ende Tewodros | ልክ እንደ ቴዎድሮስ - New Ethiopian Music 2019 (Official Video) by Golden Ethio Music 2 years ago 6 minutes, 58 seconds 196,008 views",Golden Ethio Music,196008,196056,48
1031,"Bamlak Bishaw - Yeatse Lj Nat | የአፄ ልጅ ናት - New Ethiopian Music 2019 (Official Video) by Golden Ethio Music 2 years ago 6 minutes, 1 second 13,132 views",Golden Ethio Music,13132,13137,5
1032,"Tilahun Mulunhe - Atkerm Esua | አትቀርም እሷ - New Ethiopian Music 2019 (Official Video) by Golden Ethio Music 2 years ago 4 minutes, 33 seconds 9,202 views",Golden Ethio Music,9202,9203,1
1033,"Wreket Simesh - Chenekew Menderu | ጨነቀው መንደሩ - New Ethiopian Music 2019 (Official Video) by Golden Ethio Music 2 years ago 6 minutes, 6 seconds 11,837 views",Golden Ethio Music,11837,11857,20
1034,"Abraham Birhane - Kihdetesh Ymemegn | ክህደትሽ ይመመኝ - New Ethiopian Music 2019 (Official Video) by Golden Ethio Music 2 years ago 5 minutes, 51 seconds 235,946 views",Golden Ethio Music,235946,236014,68
1035,"Max 15King - Maal Taatee? - New Ethiopian Oromo Music 2019 (Official Video) by Golden Ethio Music 2 years ago 3 minutes, 18 seconds 56,793 views",Golden Ethio Music,56793,57032,239
1036,"Betelehem Birhanu - Mela Belegn | መላ በለኝ - New Ethiopian Music 2019 (Official Video) by Golden Ethio Music 2 years ago 4 minutes, 13 seconds 53,610 views",Golden Ethio Music,53610,53633,23
1037,"Nohamin - Akeshalhu | አቅሻለሁ - New Ethiopian Music 2019 (Official Video) by Golden Ethio Music 2 years ago 3 minutes, 19 seconds 9,310 views",Golden Ethio Music,9310,9313,3
1038,"Fantahun Girma - Desetaye | ደስታዬ - New Ethiopian Music 2019 (Official Video) by Golden Ethio Music 2 years ago 4 minutes, 24 seconds 36,163 views",Golden Ethio Music,36163,36214,51
1039,"Dagim Adane - Adey | አደይ - New Ethiopian Tigrigna Music 2019 (Official Audio) by Golden Ethio Music 2 years ago 4 minutes, 39 seconds 19,654 views",Golden Ethio Music,19654,19698,44
1040,"Nathan - Egna Senewaded | እኛ ስንዋደድ - New Ethiopian Music 2019 (Official Video) by Golden Ethio Music 3 years ago 4 minutes, 56 seconds 66,240 views",Golden Ethio Music,66240,66630,390
1041,"Jo Ft. Andy - Asemesay | አስመሳይ - New Ethiopian Music 2019 (Official Video) by Golden Ethio Music 3 years ago 4 minutes, 33 seconds 51,415 views",Golden Ethio Music,51415,51433,18
1042,"Sifen Beyene (Gelila) - Sememene | ሰመመኔ - New Ethiopian Music 2019 (Official Video) by Golden Ethio Music 3 years ago 4 minutes, 12 seconds 8,352 views",Golden Ethio Music,8352,8370,18
1043,"Mintamer Ermedew (Selam) - Musharaye | ሙሽራዬ - New Ethiopian Music 2019 (Official Video) by Golden Ethio Music 3 years ago 4 minutes, 31 seconds 5,032 views",Golden Ethio Music,5032,5036,4
1044,"Serkalem Worku - Maya | ማያ - New Ethiopian Music 2019 (Official Video) by Golden Ethio Music 3 years ago 5 minutes, 25 seconds 6,562 views",Golden Ethio Music,6562,6574,12
1045,"Yo Saddy - Konjo Nat | ቆንጆ ናት - New Ethiopian Music 2019 (Official Video) by Golden Ethio Music 3 years ago 3 minutes, 11 seconds 5,144 views",Golden Ethio Music,5144,5151,7
1046,"Betty Tareke -  Lemniwo | ለምንዎ - New Ethiopian Music 2019 (Official Video) by Golden Ethio Music 3 years ago 4 minutes, 23 seconds 7,368 views",Golden Ethio Music,7368,7373,5
1047,"Husen Jemal(Maji) - Asasashat | አሳሳሻት - New Ethiopian Music 2019 (Official Video) by Golden Ethio Music 3 years ago 5 minutes, 19 seconds 2,430 views",Golden Ethio Music,2430,2432,2
1048,"ADEB - GEDEB - Himamey | ሕማመይ - New Ethiopian Music 2019 (Official Video) by Golden Ethio Music 3 years ago 5 minutes, 25 seconds 4,180 views",Golden Ethio Music,4180,4195,15
1049,"Minale Tesfaye - Sil Neber Tewodros | ሲል ነበር ቴዎድሮስ - New Ethiopian Music 2019 (Official Video) by Golden Ethio Music 3 years ago 5 minutes, 4 seconds 10,335 views",Golden Ethio Music,10335,10339,4
1050,"Melese Kasahun - Kulewa | ኩሌዋ - New Ethiopian Music 2019 (Official Video) by Golden Ethio Music 3 years ago 6 minutes, 16 seconds 114,645 views",Golden Ethio Music,114645,114805,160
1051,"Semere Yewenetu - Yelem Yelem | የለም የለም  - New Ethiopian Music 2019 (Official Video) by Golden Ethio Music 3 years ago 6 minutes 5,614 views",Golden Ethio Music,5614,5615,1
1052,"5A ft Sam G and Yabu JC - Ye habesha lij | የ ሀበሻ ልጅ - New Ethiopian Music 2019 (Official Video) by Golden Ethio Music 3 years ago 3 minutes, 6 seconds 4,835 views",Golden Ethio Music,4835,4839,4
1053,"Tokichaw - Chambulo | ቻሙቡሎ - New Ethiopian Music 2019 (Official Video) by Golden Ethio Music 3 years ago 4 minutes, 50 seconds 241,695 views",Golden Ethio Music,241695,242455,760
1054,"Eleni Birhanu - Kinfe | ክነፍ - New Ethiopian Music 2019 (Official Video) by Golden Ethio Music 3 years ago 5 minutes, 30 seconds 21,292 views",Golden Ethio Music,21292,21304,12
1055,"Abeba Zema - Aberen Enaderalen | አብረን እናድራለን - New Ethiopian Music 2019 (Official Video) by Golden Ethio Music 3 years ago 4 minutes, 24 seconds 14,007 views",Golden Ethio Music,14007,14022,15
1056,"Ifaa Taliilaa Caalii - Ayyaana - New Ethiopian Music 2019 (Official Video) by Golden Ethio Music 3 years ago 6 minutes, 57 seconds 6,840 views",Golden Ethio Music,6840,6862,22
1057,"Meles Baye - Efere Shegaw | እፈረ ሸጋው - New Ethiopian Music 2019 (Official Video) by Golden Ethio Music 3 years ago 6 minutes, 46 seconds 13,493 views",Golden Ethio Music,13493,13519,26
1058,"Kv YOLO - Ahununu Eziwunu | አሁኑኑ እዚውኑ - New Ethiopian Music 2019 (Official Video) by Golden Ethio Music 3 years ago 4 minutes, 21 seconds 3,745 views",Golden Ethio Music,3745,3745,0
1059,"Misikir Awoll - Alhu | አለሁ - New Ethiopian Music 2019 (Official Video) by Golden Ethio Music 3 years ago 5 minutes, 36 seconds 1,023,203 views",Golden Ethio Music,1023203,1026130,2927
1060,"Desalegn Bekema - Elaamee - New Ethiopian Oromo Music 2018 (Official Lyrics Video) by Golden Ethio Music 3 years ago 5 minutes, 12 seconds 118,927 views",Golden Ethio Music,118927,119695,768
1061,"Elili Birra Ft. Tamaam Takkaaliny - Kahi Hinkaanaa - New Ethiopian Oromo Music 2018 (Official Video) by Golden Ethio Music 3 years ago 5 minutes, 49 seconds 17,360 views",Golden Ethio Music,17360,17620,260
1062,"Habtamu Gebretsadik - Jeba Bilegn | ጀባ ቢለኝ - New Ethiopian Music 2018 (Official Video) by Golden Ethio Music 3 years ago 5 minutes, 45 seconds 12,541 views",Golden Ethio Music,12541,12560,19
1063,"Eyerusalem Asfaw(Jerry) - Min Largelhe | ምን ላርግልህ - New Ethiopian Music 2018 (Official Video) by Golden Ethio Music 3 years ago 4 minutes, 30 seconds 768,960 views",Golden Ethio Music,768960,769531,571
1064,"Melese Kasahun - Yais Raya | ያኢስ ራያ - New Ethiopian Music 2018 (Official Video) by Golden Ethio Music 3 years ago 7 minutes, 3 seconds 215,309 views",Golden Ethio Music,215309,215609,300
1065,"Finhane Meskel - Abidiyo | ኣብድዮ - New Ethiopian Music 2018 (Official Video) by Golden Ethio Music 3 years ago 4 minutes, 21 seconds 8,390 views",Golden Ethio Music,8390,8393,3
1066,"Temeche Negus - Degemo Ney | ደግሞ ነይ - New Ethiopian Music 2018 (Official Video) by Golden Ethio Music 3 years ago 7 minutes, 22 seconds 241,318 views",Golden Ethio Music,241318,253857,12539
1067,"Lili Hagos - Metadel | መታደል - New Ethiopian Music 2018 (Official Video) by Golden Ethio Music 3 years ago 4 minutes, 50 seconds 6,583 views",Golden Ethio Music,6583,6644,61
1068,"Hassen Argaw - Konjeye | ቆንጅዬ - New Ethiopian Music 2018 (Official Video) by Golden Ethio Music 3 years ago 5 minutes, 45 seconds 11,900 views",Golden Ethio Music,11900,11903,3
1069,"Ye Tana Gudaye | የጣና ጉዳይ | New Ethiopian Music 2018 (Official Video) by Golden Ethio Music 3 years ago 5 minutes, 3 seconds 6,024 views",Golden Ethio Music,6024,6034,10
1070,"Wendale Fentahun - Tew Tew | ተዉ ተዉ - New Ethiopian Music 2018 (Official Video) by Golden Ethio Music 3 years ago 6 minutes, 32 seconds 77,568 views",Golden Ethio Music,77568,77597,29
1071,"Kidest Tenagne - Delagn | ደላኝ - New Ethiopian Music 2018 (Official Video) by Golden Ethio Music 3 years ago 3 minutes, 57 seconds 9,617 views",Golden Ethio Music,9617,9629,12
1072,"Chanie Negussie - Emut | እሙት - New Ethiopian Music 2018 (Official Video) by Golden Ethio Music 3 years ago 6 minutes 431,946 views",Golden Ethio Music,431946,431999,53
1073,"Getachew Hailemariam - Mii O Kaaraameelaa | ሚ ኦ ከረሜላ - New Ethiopian Music 2018(Official Video) by Golden Ethio Music 3 years ago 4 minutes, 42 seconds 142,670 views",Golden Ethio Music,142670,143813,1143
1074,"Efa Telila  - Bahi-Mee  - New Ethiopian Oromo Music 2018 (Official Video) by Golden Ethio Music 3 years ago 4 minutes, 44 seconds 9,463 views",Golden Ethio Music,9463,9478,15
1075,"Elili Birra - Ka'ii Sirbi - New Ethiopian Oromo Music 2018 (Official Video) by Golden Ethio Music 3 years ago 5 minutes, 47 seconds 80,345 views",Golden Ethio Music,80345,80420,75
1076,"Habtamu G/tsadik - Ayne | አይኔ  - New Ethiopian Music 2018 (Official Audio) by Golden Ethio Music 3 years ago 4 minutes, 55 seconds 12,879 views",Golden Ethio Music,12879,12900,21
1077,"Habtamu G/tsadik - Wegu Shekor Bare | ወጉ ሽኮር ባረ - New Ethiopian Music 2018 (Official Audio) by Golden Ethio Music 3 years ago 4 minutes, 50 seconds 3,288 views",Golden Ethio Music,3288,3289,1
1078,"Habtamu G/tsadik - Natey Ney | ናተይ ነይ - New Ethiopian Music 2018 (Official Audio) by Golden Ethio Music 3 years ago 4 minutes, 7 seconds 43,612 views",Golden Ethio Music,43612,43707,95
1079,"Habtamu G/tsadik  - Eyegeremegn | እየገረመኝ - New Ethiopian Music 2018 (Official Audio) by Golden Ethio Music 3 years ago 4 minutes, 22 seconds 8,199 views",Golden Ethio Music,8199,8206,7
1080,"Habtamu G/tsadik - Yayehush Leta |  ያየሁሽ ለታ - New Ethiopian Music 2018 (Official Audio) by Golden Ethio Music 3 years ago 4 minutes, 18 seconds 7,914 views",Golden Ethio Music,7914,7918,4
1081,"Asenake Gedion - Botoro Boro - New Ethiopian Music 2018 (Official Video) by Golden Ethio Music 3 years ago 4 minutes, 21 seconds 4,094 views",Golden Ethio Music,4094,4100,6
1082,"Firew Gebeyew - Hasayesa | ሀሳይሳ - New Ethiopian Music 2018 (Official Video) by Golden Ethio Music 3 years ago 4 minutes, 35 seconds 4,213 views",Golden Ethio Music,4213,4232,19
1083,"Kassahun Taye - Hagere | ሀገሬ - New Ethiopian Music 2018 (Official Video) by Golden Ethio Music 3 years ago 6 minutes, 4 seconds 448,548 views",Golden Ethio Music,448548,449200,652
1084,"Kode Rago - Tenesa | ተነሳ - New Ethiopian Music 2018 (Official Video) by Golden Ethio Music 3 years ago 3 minutes, 53 seconds 3,699 views",Golden Ethio Music,3699,3735,36
1085,"Yared Negu ft. Eknock - Omalicha | ኦማሊቻ - New Ethiopian Music 2018 (Official Video) by Golden Ethio Music 3 years ago 3 minutes, 43 seconds 145,249 views",Golden Ethio Music,145249,145373,124
1086,"Edel Tarek - Wsediya | ዉስዲያ - New Ethiopian Tigrigna Music 2018 (Official Video) by Golden Ethio Music 3 years ago 5 minutes, 35 seconds 4,013 views",Golden Ethio Music,4013,4014,1
1087,"Dj Lina - Aydelehm | አይደለህም - New Ethiopian Music 2018 (Official Video) by Golden Ethio Music 3 years ago 5 minutes, 1 second 19,655 views",Golden Ethio Music,19655,19673,18
1088,"Kidest Tenagne - Bell Nana | በል ናና - New Ethiopian Music 2018 (Official Video) by Golden Ethio Music 3 years ago 4 minutes, 19 seconds 26,637 views",Golden Ethio Music,26637,26684,47
1089,"Yacob General - Addis Ababa Big Up  - New Ethiopian Music 2018 (Official Video) by Golden Ethio Music 3 years ago 3 minutes, 32 seconds 7,667 views",Golden Ethio Music,7667,7681,14
1090,"Maebel Dawit - Skif Aybelki | ስኽፍ  ኣይበልኪ - New Ethiopian Tigrigna Music 2018 (Official Video) by Golden Ethio Music 3 years ago 5 minutes, 1 second 4,719 views",Golden Ethio Music,4719,4728,9
1091,"Yared Negu,Siso,Tesfaye Taye,Alemayehu Chufako,Aberash - Aeyanata Gifata - New Ethiopian Music 2018 by Golden Ethio Music 3 years ago 6 minutes, 11 seconds 121,412 views",Golden Ethio Music,121412,121990,578
1092,"Abrehet Abdu  - Selel | ሰለል - New Ethiopian Tigrigna Music 2018 (Official Video) by Golden Ethio Music 3 years ago 6 minutes, 19 seconds 437,514 views",Golden Ethio Music,437514,438896,1382
1093,"Ephrem Amare - Zebelu Yebelu | ዝበሉ ይበሉ - New Ethiopian Tigiregna Music 2018 (Official Video) by Golden Ethio Music 3 years ago 4 minutes, 9 seconds 365,859 views",Golden Ethio Music,365859,366294,435
1094,"Kalab Rezen - Alamedeni - New Ethiopian Tigrigna Music 2018 (Official Video) by Golden Ethio Music 3 years ago 6 minutes, 3 seconds 53,839 views",Golden Ethio Music,53839,53852,13
1095,"Shinoyyee - New Ethiopian Oromo Music 2018 (Official Video) by Golden Ethio Music 3 years ago 5 minutes, 24 seconds 776,854 views",Golden Ethio Music,776854,779662,2808
1096,"Shimeles Tasefaye - Magaalee Kamisee - New Ethiopian Oromo Music 2018 (Official Video) by Golden Ethio Music 3 years ago 5 minutes, 25 seconds 13,356 views",Golden Ethio Music,13356,13414,58
1097,"Birhan Asfawu - እዬሃ አበባዬ | Eyoha Abebaye - New Ethiopian Music 2018 (Official Video) by Golden Ethio Music 3 years ago 4 minutes, 17 seconds 4,946 views",Golden Ethio Music,4946,4948,2
1098,"Tesfaye Taye - Addis Zemen | አዲስ ዘመን - New Ethiopian Music 2018 (Official Video) by Golden Ethio Music 3 years ago 4 minutes, 56 seconds 128,211 views",Golden Ethio Music,128211,128252,41
1099,"Shimeles Tasefaye - Jiituu Birraa - New Ethiopian Oromo Music 2018 (Official Video) by Golden Ethio Music 3 years ago 4 minutes, 49 seconds 15,532 views",Golden Ethio Music,15532,15576,44
1100,"New Monologue - Tatek Legese (Taju) - Abiy Milikit New - Dedicated To | Tamagne Beyene by Golden Ethio Music 3 years ago 7 minutes, 30 seconds 3,671 views",Golden Ethio Music,3671,3672,1
1101,"Kekiya Badhadha - Dhugaa Maseenaaree!! - New Ethiopian Oromo Music 2018 (Official Video) by Golden Ethio Music 3 years ago 5 minutes, 12 seconds 1,946,700 views",Golden Ethio Music,1946700,1951744,5044
1102,"Brehanu Maleqo(Biya) -  Doya |  ዶያ - New Ethiopian Welayeta Music 2018 (Official Video) by Golden Ethio Music 3 years ago 4 minutes, 32 seconds 65,301 views",Golden Ethio Music,65301,65425,124
1103,"Ujulu Fera - Wale Xume - New Ethiopian Music 2018 (Official Video) by Golden Ethio Music 3 years ago 4 minutes, 35 seconds 3,229 views",Golden Ethio Music,3229,3241,12
1104,"Minechle Fentahun - Eyulegn | እዮልኝ - New Ethiopian Music 2018 (Official Video) by Golden Ethio Music 3 years ago 5 minutes, 28 seconds 2,528 views",Golden Ethio Music,2528,2532,4
1105,"Helen G/Hiwet - Bahli Adey | ባህሊ ዓደይ - New Ethiopian Tigeregna Music 2018 (Official Video) by Golden Ethio Music 3 years ago 6 minutes, 41 seconds 214,355 views",Golden Ethio Music,214355,214504,149
1106,"ICE Man Ft. Dj Lee - Ashenda Vs Shadey | አሸንዳ Vs ሻዴይ- New Ethiopian Music 2018 (Official Video) by Golden Ethio Music 3 years ago 5 minutes, 31 seconds 45,293 views",Golden Ethio Music,45293,45317,24
1107,"Mintamer Ermedew Selam - Ashekorememegn | አሽኮረምመኝ - New Ethiopian Music 2018 (Official Video) by Golden Ethio Music 3 years ago 5 minutes, 7 seconds 13,982 views",Golden Ethio Music,13982,13992,10
1108,"Chombe - Ema Ethiopia | እማ ኢትዬዺያ - New Ethiopian Music 2018 (Official Video) by Golden Ethio Music 3 years ago 3 minutes, 53 seconds 2,117 views",Golden Ethio Music,2117,2118,1
1109,"Letay Mesfin - Ayni Wari | አይኒ ዋሪ - New Ethiopian Music 2018 (Official Video) by Golden Ethio Music 3 years ago 6 minutes, 7 seconds 113,743 views",Golden Ethio Music,113743,113782,39
1110,"Birhane Tefera - Falmataa Koo  - New Ethiopian Oromo Music 2018 (Official Video) by Golden Ethio Music 3 years ago 4 minutes, 11 seconds 1,260,974 views",Golden Ethio Music,1260974,1262503,1529
1111,"Walabuummaa Masfin - Walif Jiraa - New Ethiopian Oromo Music 2018 (Official Video) by Golden Ethio Music 3 years ago 5 minutes, 27 seconds 11,497 views",Golden Ethio Music,11497,11560,63
1112,"Marsii Abbomaa - Gadaan Bulla - New Ethiopian Oromo Music 2018 (Official Video) by Golden Ethio Music 3 years ago 6 minutes, 39 seconds 13,795 views",Golden Ethio Music,13795,13855,60
1113,"Bikila Dubarii - Hiddaan Nu Tokkicha - New Ethiopian Music 2018 (Official Video) by Golden Ethio Music 3 years ago 7 minutes, 1 second 280,850 views",Golden Ethio Music,280850,282446,1596
1114,"Endashaw Mengestu - Ethiopia | ኢትዮጵያ - New Ethiopian Music 2018 (Official Video) by Golden Ethio Music 3 years ago 5 minutes, 57 seconds 1,525 views",Golden Ethio Music,1525,1526,1
1115,"Rabbirraa Tasfaayee(Toli) - Sanyoo - New Ethiopian Oromo Music 2018 (Official Video) by Golden Ethio Music 3 years ago 6 minutes, 17 seconds 72,423 views",Golden Ethio Music,72423,72579,156
1116,"Birhanu Fentahun - Semechalhu | ሰምቻለሁ - New Ethiopian Music 2018 (Official Video) by Golden Ethio Music 3 years ago 4 minutes, 46 seconds 2,467 views",Golden Ethio Music,2467,2469,2
1117,"Bilisummaa Birrii  - Sori Hinsorraa - New Ethiopian Oromo Music 2018 (Official Video) by Golden Ethio Music 3 years ago 5 minutes, 46 seconds 10,085 views",Golden Ethio Music,10085,10155,70
1118,"Dagim Adane - Emahoye | እማሆይ - New Ethiopian Music 2018 (Official Audio Video) by Golden Ethio Music 3 years ago 3 minutes, 34 seconds 2,700 views",Golden Ethio Music,2700,2708,8
1119,"Dagim Adane - sew | ሰዉ - New Ethiopian Music 2018 (Official Audio Video) by Golden Ethio Music 3 years ago 4 minutes, 6 seconds 3,617 views",Golden Ethio Music,3617,3630,13
1120,"Dagim Adane - Leyu Neger | ልዩ ነገር - New Ethiopian Music 2018 (Official Audio Video) by Golden Ethio Music 3 years ago 5 minutes, 33 seconds 22,605 views",Golden Ethio Music,22605,22693,88
1121,"Dagim Adane - Aybeltushim | አይበልጡሽም - New Ethiopian Music 2018 (Official Audio Video) by Golden Ethio Music 3 years ago 4 minutes, 7 seconds 12,816 views",Golden Ethio Music,12816,12855,39
1122,"Dagim Adane - Kezekeze | ቀዘቀዘ - New Ethiopian Music 2018 (Official Audio Video) by Golden Ethio Music 3 years ago 3 minutes, 58 seconds 6,699 views",Golden Ethio Music,6699,6734,35
1123,"Dagim Adane - Komolishal | ቆሞልሻል - New Ethiopian Music 2018 (Official Audio Video) by Golden Ethio Music 3 years ago 4 minutes, 23 seconds 8,297 views",Golden Ethio Music,8297,8321,24
1124,"Dagim Adane - Semerlegn | ሰመረልኝ - New Ethiopian Music 2018 (Official Audio Video) by Golden Ethio Music 3 years ago 4 minutes, 1 second 5,049 views",Golden Ethio Music,5049,5087,38
1125,"Dagim Adane - Sema | ስማ - New Ethiopian Music 2018 (Official Audio Video) by Golden Ethio Music 3 years ago 4 minutes, 6 seconds 4,503 views",Golden Ethio Music,4503,4516,13
1126,"Dagim Adane - Enitarek | እንታረቅ - New Ethiopian Music 2018 (Official Audio Video) by Golden Ethio Music 3 years ago 4 minutes, 5 seconds 29,957 views",Golden Ethio Music,29957,30102,145
1127,"Dagim Adane - Ayate | አያቴ - New Ethiopian Music 2018 (Official Audio Video) by Golden Ethio Music 3 years ago 4 minutes, 36 seconds 4,575 views",Golden Ethio Music,4575,4588,13
1128,"Dagim Adane - Eshi | እሺ - New Ethiopian Music 2018 (Official Audio Video) by Golden Ethio Music 3 years ago 3 minutes, 29 seconds 6,126 views",Golden Ethio Music,6126,6143,17
1129,"Bilisummaa Baqqalaa  - Erga Deemte - New Ethiopian Oromo Music 2018 (Official Video) by Golden Ethio Music 3 years ago 4 minutes, 4 seconds 15,242 views",Golden Ethio Music,15242,15262,20
1130,"Lil Pac - Aradawa | አራዳዋ - New Ethiopian Music 2018 (Official Video) by Golden Ethio Music 3 years ago 4 minutes, 11 seconds 6,301 views",Golden Ethio Music,6301,6308,7
1131,"Liyuneh Tamirat - Wazema | ዋዜማ - New Ethiopian Music 2018 (Official Lyrics Video) by Golden Ethio Music 3 years ago 3 minutes, 51 seconds 2,359 views",Golden Ethio Music,2359,2365,6
1132,"Birraa Charuu - Hidhu Qeerroo - New Ethiopian Oromo Music 2018 (Official Video) by Golden Ethio Music 3 years ago 6 minutes, 23 seconds 4,007 views",Golden Ethio Music,4007,4026,19
1133,"Yegna Ethiopia | የኛ ኢትዬዺያ - New Ethiopian Music 2018 (Official Video) by Golden Ethio Music 3 years ago 6 minutes 3,554 views",Golden Ethio Music,3554,3557,3
1134,"Mulugeta Hagos(Maluda) - Ney Ney | ነይ ነይ - New Ethiopian Tigrigna Music 2018 (Official Video) by Golden Ethio Music 3 years ago 5 minutes, 45 seconds 97,070 views",Golden Ethio Music,97070,97760,690
1135,"Addis Walelegn - Gonderew | ጎንደሬው - New Ethiopian Music 2018 (Official Video) by Golden Ethio Music 3 years ago 4 minutes, 48 seconds 4,271 views",Golden Ethio Music,4271,4281,10
1136,"Ak Fat And D Nice - Cher Belobegn | ጭር ብሎብኝ - New Ethiopian Music 2018 (Official Video) by Golden Ethio Music 3 years ago 4 minutes, 6 seconds 8,987 views",Golden Ethio Music,8987,8998,11
1137,"Adeno Ferede - Tetaye | ትታይ  - New Ethiopian Music 2018 (Official Video) by Golden Ethio Music 3 years ago 5 minutes, 54 seconds 16,084 views",Golden Ethio Music,16084,16095,11
1138,"Nathan Ft. Biruk Tekeba - kaley | ካለይ - New Ethiopian Music 2018 (Official Audio Video) by Golden Ethio Music 3 years ago 3 minutes, 52 seconds 3,369 views",Golden Ethio Music,3369,3373,4
1139,"Degenet Kebde - Enen Enaten | እኔን እናቴን - New Ethiopian Music 2018 (Official Video) by Golden Ethio Music 3 years ago 5 minutes, 8 seconds 9,020 views",Golden Ethio Music,9020,9024,4
1140,"Dagim Adane  - Yam Hone Yih | ያም ሆነ ይህ - New Ethiopian Music 2018 (Official Video) by Golden Ethio Music 3 years ago 4 minutes, 47 seconds 1,209,501 views",Golden Ethio Music,1209501,1225456,15955
1141,"Qananii Girmaa  -  Moone Baanaa - New Ethiopian Oromo Music 2018 (Official Video) by Golden Ethio Music 3 years ago 5 minutes, 9 seconds 16,578 views",Golden Ethio Music,16578,16621,43
1142,"Abdi Jemal - Wali Kenfo | ዋሊ ቄንፎ - New Ethiopian Music 2018 (Official Video) by Golden Ethio Music 3 years ago 5 minutes, 44 seconds 7,850 views",Golden Ethio Music,7850,7855,5
1143,"Mentesnot Tilahun - Endalay | እንዳላይ - New Ethiopian Music 2018 (Official Audio Video) by Golden Ethio Music 3 years ago 5 minutes, 58 seconds 4,094 views",Golden Ethio Music,4094,4098,4
1144,"Jan Ben ft. Sefanit & Ab-Habesha - Yameral | ያምራል - New Ethiopian Music 2018 (Official Video) by Golden Ethio Music 3 years ago 5 minutes, 47 seconds 4,691 views",Golden Ethio Music,4691,4712,21
1145,"Helen Negatu - Yesmer | ይስመር - New Ethiopian Music 2018 (Official Video) by Golden Ethio Music 3 years ago 4 minutes, 48 seconds 29,554 views",Golden Ethio Music,29554,29565,11
1146,"Abenet Girma - Gena Bzu Gize | ገና ብዙ ጊዜ  - New Ethiopian Music 2018 (Official Video) by Golden Ethio Music 3 years ago 5 minutes, 1 second 261,439 views",Golden Ethio Music,261439,262367,928
1147,"Meron H/selase - Yene Gedam | የኔ ገዳም - New Ethiopian Music 2018 (Official Video) by Golden Ethio Music 3 years ago 6 minutes, 3 seconds 140,797 views",Golden Ethio Music,140797,140837,40
1148,"Jene Tamene - Bir Ambar | ብር አምባር - New Ethiopian Music 2018 (Official Video) by Golden Ethio Music 3 years ago 4 minutes, 31 seconds 52,753 views",Golden Ethio Music,52753,52783,30
1149,"Dagim Adane (HANAZI) - Wey Nedo | ወይ ነዶ - New Ethiopian Music 2018 (Official Video) by Golden Ethio Music 3 years ago 4 minutes, 23 seconds 104,049 views",Golden Ethio Music,104049,104337,288
1150,"Abebe Araya - Lomi | ሎሚ - New Ethiopian Tigregna Music 2018 (Official Video) by Golden Ethio Music 3 years ago 7 minutes, 49 seconds 469,244 views",Golden Ethio Music,469244,469681,437
