,Posts,Channel,Views_03/03,Views_03/12,view_delta
0,"Kaleab Kinfe | ቃልአብ ክንፈ (እቴ አምሳል) | (OFFICIAL LYRICS) New Ethiopian Music 2021 by Habesha Times 7 months ago 4 minutes, 49 seconds 3,083 views",Habesha Times,3083,3126,43
1,"Ethiopian Comedy - Comedian Tomas  Best Vine HD 2021 | ኮሜድያን ቶማስ by Habesha Times 7 months ago 8 minutes, 20 seconds 19,124 views",Habesha Times,19124,19756,632
2,"ለማመን የሚከብድ የተማሪዎች አስገራሚ ጭፈራ | Saint Joseph School by Habesha Times 10 months ago 15 minutes 2,605 views",Habesha Times,2605,2663,58
3,"Elias Teshome - Hode • ሆዴ • OFFICIAL LYRICS | New Ethiopian Music 2021 by Habesha Times 11 months ago 4 minutes, 15 seconds 2,486 views",Habesha Times,2486,2527,41
4,"Zebiba Girma x Mesay Tefera (አዲስ ፍቅር) | Official Lyrics | New Ethiopian Music 2021 by Habesha Times 1 year ago 4 minutes, 38 seconds 8,245 views",Habesha Times,8245,8300,55
5,"Hewan Gebrewold (Nana) | (Official Lyrics) New Ethiopian Music 2021 | ሔዋን ገብረወልድ (ናና) by Habesha Times 1 year ago 3 minutes, 22 seconds 21,383 views",Habesha Times,21383,21479,96
6,"Sara T - Yemimosherew | የምሞሸረው (Official Lyrics) Ethiopian Music 2021 by Habesha Times 1 year ago 3 minutes, 19 seconds 7,517 views",Habesha Times,7517,7552,35
7,"Mulualem Takele - Ameseginalew |  አመሰግናለው - (Official Lyrics) New Ethiopian Music 2021 by Habesha Times 1 year ago 4 minutes, 25 seconds 4,517 views",Habesha Times,4517,4606,89
8,"Ethiopian Comedy - Comedian Tomas  Best Vine HD 2021 | ኮሜድያን ቶማስ by Habesha Times 1 year ago 8 minutes, 54 seconds 118,132 views",Habesha Times,118132,118693,561
9,"Veronica Adane & Negestat - Abay Mado | አባይ ማዶ (Lyrics) | New Ethiopian Music 2021 by Habesha Times 1 year ago 4 minutes, 25 seconds 4,547 views",Habesha Times,4547,4572,25
10,"Burik - Bla Bla | ብላ ብላ (Lyrics) | New Ethiopian Music 2021 by Habesha Times 1 year ago 3 minutes, 32 seconds 17,989 views",Habesha Times,17989,18141,152
11,"Kaleab Kinfe (Wesnual) - ቃልአብ ክንፈ (ወስኗል) | Official Lyrics | New Ethiopian Music 2021 by Habesha Times 1 year ago 5 minutes, 25 seconds 12,747 views",Habesha Times,12747,12874,127
12,"Mekdes Girma - መቅደስ ግርማ (ተላምጄህ ነው) | (Official Lyrics) - New Ethiopian Music 2021 by Habesha Times 1 year ago 4 minutes, 50 seconds 8,987 views",Habesha Times,8987,9120,133
13,"Dag Daniel - Gonderewa | ጎንደሬዋ (Official Lyrics) | New Ethiopian Music 2021 by Habesha Times 1 year ago 3 minutes, 44 seconds 2,929 views",Habesha Times,2929,2979,50
14,"Haimanot Girma - Gid Nw | ሀይማኖት ግርማ (ግድ ነው) | New Ethiopian Music 2021 by Habesha Times 1 year ago 4 minutes, 4 seconds 19,709 views",Habesha Times,19709,19810,101
15,"Ali Birra & Abreham Belayneh (Official Lyrics) | አሊ ቢራ እና አብርሃም በላይነህ (ዳርም የለው) Music Lyrics 2021 by Habesha Times 1 year ago 5 minutes, 13 seconds 6,653 views",Habesha Times,6653,6694,41
16,"ይድነቃቸው ብርሀኑ (ሲያስባት) | Yidnekachew Birhanu (Siyasibat) | (Official Lyrics) by Habesha Times 1 year ago 5 minutes, 15 seconds 22,702 views",Habesha Times,22702,22965,263
17,"የ Miko Mikee ውርደት LIVE በ Walta TV | ሚኮ ማይክ by Habesha Times 1 year ago 59 seconds 5,865 views",Habesha Times,5865,6002,137
18,"Solomon Tigabe (Zinaren) - ሰለሞን ጥጋቤ (ዝናሬን) | (Official Lyrics) New Ethiopian Music 2020 by Habesha Times 1 year ago 5 minutes, 31 seconds 5,050 views",Habesha Times,5050,5078,28
19,"Trump ወጥ ረገጠ | ""ቼ በለው አባቱም ገዳይ✊"" | አባይ by Habesha Times 1 year ago 57 seconds 2,022 views",Habesha Times,2022,2026,4
20,"Shegye Shegitu - ሸግዬ ሸጊቱ (Meek1One) | (Official Lyrics) | New Ethiopian Music 2020 by Habesha Times 1 year ago 4 minutes, 3 seconds 15,645 views",Habesha Times,15645,15718,73
21,"Wendi Mak - Geday | ገዳይ - New Ethiopian Music 2020 (Official Trailer) by Habesha Times 1 year ago 1 minute, 17 seconds 2,405 views",Habesha Times,2405,2426,21
22,"ሳሮን አየልኝ ከእንዳልክ ጋር የነበራት አዝግ😂 ቆይታ | Saron Ayelign with Endalk #shorts by Habesha Times 1 year ago 55 seconds 3,371 views",Habesha Times,3371,3382,11
23,"ዊሀ ማነው? ወንድ ነው ወይስ ሴት? 😂 | Wehaa & Aregahegn Werash #shorts by Habesha Times 1 year ago 59 seconds 1,664 views",Habesha Times,1664,1666,2
24,"Kaleab Mulugeta - (ምንም ሳይኖር) - (Official Lyrics) New Ethiopian Music 2020 | ቃልአብ ሙሉጌታ (Mnm Saynor) by Habesha Times 1 year ago 3 minutes, 54 seconds 42,376 views",Habesha Times,42376,42498,122
25,"Buze Man (Buzayehu Kifle) - Yemola | የሞላ -  (Official Lyrics) New Ethiopian Music 2020 | ቡዜ ማን by Habesha Times 1 year ago 4 minutes, 36 seconds 2,233 views",Habesha Times,2233,2252,19
26,"Ablex (Enanu) - አብሌክስ (እናኑ) - (Official Lyrics) | New Ethiopian Music 2020 by Habesha Times 1 year ago 4 minutes, 28 seconds 9,144 views",Habesha Times,9144,9168,24
27,"Teamir Gizaw - (Yiregem) | ተአምር ግዛው - ይረገም (Official Lyrics) | ""ድንቅ የመድረክ ላይ ብቃት"" by Habesha Times 1 year ago 4 minutes, 9 seconds 154,223 views",Habesha Times,154223,159534,5311
28,"Comedian Tomas x Ahadu (Banana) ኮሜድያን ቶማስ x አሃዱ (ባናና) | Official Lyrics - New Ethiopian Music 2020 by Habesha Times 1 year ago 3 minutes, 56 seconds 3,715 views",Habesha Times,3715,3723,8
29,"Comedian Zedo - ጠጅ ይመቸኛል | New Ethiopian Music 2020 | Tej Yimechegnal | ኮሜድያን ዜዶ by Habesha Times 1 year ago 49 seconds 4,325 views",Habesha Times,4325,4337,12
30,"Ethiopian Comedy - Comedian Tomas  Best Vine HD 2020 | ኮሜድያን ቶማስ by Habesha Times 1 year ago 8 minutes, 1 second 210,504 views",Habesha Times,210504,212304,1800
31,"Comedian Tomas - Banana (ባናና) - New Ethiopian Music 2020 (Official Trailer) by Habesha Times 1 year ago 57 seconds 3,063 views",Habesha Times,3063,3078,15
32,"Lemlem Hailemichael - Lalibela | ላሊበላ - New Ethiopian Music 2020 (Official Trailer) by Habesha Times 1 year ago 47 seconds 4,457 views",Habesha Times,4457,4500,43
33,"""ድፍን 19 አመት ሞላኝ"" አነጋጋሪዋ ተዋናይት ሳሮን አየልኝ | Saron Ayelign by Habesha Times 1 year ago 50 seconds 18,079 views",Habesha Times,18079,18108,29
34,"Teddy Afro የዳዊት ፅጌን (ቻል ዘንድሮ) ሙዚቃ ዘፈነ | Dawit Tsige's song by Teddy Afro | NEW ETHIOPIAN MUSIC 2020 by Habesha Times 1 year ago 5 minutes, 34 seconds 4,899 views",Habesha Times,4899,4908,9
35,"Temesgen G/Egziabher (Temu) - Web Laynor | ተመስገን ገ/እግዚአብሔር (ተሙ) - ውብ ላይኖር | Ethiopian Music Lyrics by Habesha Times 1 year ago 4 minutes, 40 seconds 67,990 views",Habesha Times,67990,68307,317
36,"New Ethiopian Nonstop Music 2020 | የ 2020 የተመረጡ አዳዲስ ዘፈኖች | Ethiopian Song Collection by Habesha Times 1 year ago 41 minutes 27,487 views",Habesha Times,27487,27558,71
37,"አስቂኝ የጎዳና ላይ ጥያቄ እና መልሶች #2 | ሰው ከ ግመል ወይስ ከ ጉማሬ ነው የመጣው? | Funny Ethiopian Street Quiz by Habesha Times 1 year ago 6 minutes, 42 seconds 851 views",Habesha Times,851,859,8
38,"አዝናኝ የጎዳና ላይ ጥያቄ እና መልሶች | Funny Ethiopian Street Quiz | ዘጠነኛው ሺ | Chubaw | Ethiopian Comedy by Habesha Times 1 year ago 9 minutes, 26 seconds 1,306 views",Habesha Times,1306,1310,4
39,"Zebiba Girma (Yamal Qenew) ""ዘቢባ ከልጇ ጋር በያማል ቅኔው አዲስ ዘፈን"" by Habesha Times 1 year ago 1 minute, 16 seconds 7,892 views",Habesha Times,7892,7900,8
40,"ዘጠነኛው ሺ - አቡ V.s ጩባው😂  | Million Birhane & Surafel Bisrat | Chubaw & Abu Jokes by Habesha Times 1 year ago 12 minutes, 41 seconds 4,898 views",Habesha Times,4898,4925,27
41,"Zebiba Girma (YAMAL QENEW) ዘቢባ ግርማ (ያማል ቅኔው) - New Ethiopian Music 2020(Trailer) by Habesha Times 1 year ago 1 minute, 25 seconds 6,673 views",Habesha Times,6673,6681,8
42,"ፈታ ፈታ😂: Comedian Tomas - ""እፀልይልሻለው😂"" / ኮሜዲያን ቶማስ by Habesha Times 1 year ago 1 minute, 47 seconds 14,334 views",Habesha Times,14334,14504,170
43,"Hayleyesus Feyssa - Emelalew (እምላለው) | New Ethiopian Music 2020 (Official Lyrics) by Habesha Times 1 year ago 5 minutes, 3 seconds 40,849 views",Habesha Times,40849,41372,523
44,"TEDDY AFRO - DEMO BE ABAY - ደሞ በአባይ - [New! Official Music Lyrics 2020] by Habesha Times 1 year ago 4 minutes, 42 seconds 56,905 views",Habesha Times,56905,56939,34
45,"ታዋቂው ሙዚቀኛ ሀጫሉ ሁንዴሳ ለምን ተገደለ? | Haccaluu Hundeessaan Xiyyitidhan Mallif Ajjeefame😖 by Habesha Times 1 year ago 9 minutes, 25 seconds 1,621 views",Habesha Times,1621,1623,2
46,"🔴 ሀጫሉ ተቀበል! | Hachalu Hundessa vs Minilk | ""የሚኒሊክ ሀውልት መፍረስ አለበት"" | OMN ላይ የተላለፈው interview በአማርኛ by Habesha Times 1 year ago 14 minutes, 6 seconds 4,238 views",Habesha Times,4238,4315,77
47,"ፈታ ፈታ😁: Seifu On EBS (አንጃይተር | ንግስት ፍቅሬ) - Nigist Fikre | እንዲህም አለ እንዴ by Habesha Times 1 year ago 2 minutes, 12 seconds 6,241 views",Habesha Times,6241,6258,17
48,"🔴 አርቲስት ሜላት ነብዩ እና ሄኖክ ድንቁ ተለያዩ💔 | ሜላት የተለያዩበትን ምክንያት ገለፀች | Melat Nebiyou & Henok Dinku by Habesha Times 1 year ago 10 minutes, 12 seconds 1,787 views",Habesha Times,1787,1796,9
49,"🔴 እንዳልክ በዛ ክፍት አፉ እራሱን አዋረደ😮 | ""ማታ በጣም ነው የበ*ውት"" | Endalk | JTV by Habesha Times 1 year ago 1 minute, 42 seconds 6,376 views",Habesha Times,6376,6451,75
50,"Ethiopia: ዘጠነኛው ሺ - የጩቢቲ አንፍር😂 ቀልዶች | Ye Chubaw Qeldoch (Part 10) by Habesha Times 1 year ago 14 minutes, 29 seconds 7,863 views",Habesha Times,7863,7963,100
51,"Ethiopia: ዘጠነኛው ሺ - ጩቢቲን የሚያስንቁ የውሮ እና የአቡ ቀልዶች😅 ሁለቱ አድክሞች | Huletu Adkimoch by Habesha Times 1 year ago 14 minutes, 37 seconds 1,957 views",Habesha Times,1957,1967,10
52,"Ethiopia: ዘጠነኛው ሺ - የጩቢቲ አንፍር😂 ቀልዶች | Ye Chubaw Qeldoch (Part 9) by Habesha Times 1 year ago 16 minutes 10,751 views",Habesha Times,10751,10896,145
53,"Abyssiniya Vine - Des Yilal | ደስ ይላል | New Ethiopian Music 2021 (Official Music) by Habesha Times 1 year ago 3 minutes, 13 seconds 6,844 views",Habesha Times,6844,6858,14
54,"Danayit (ዳናይት) - ካካ ነው (Kaka Nw) | New Remix Music by Habesha Times 1 year ago 2 minutes, 16 seconds 2,475 views",Habesha Times,2475,2481,6
55,"Ethiopia: ዘጠነኛው ሺ - የጩቢቲ አንፍር😂 ቀልዶች | Ye Chubaw Qeldoch (Part 8) by Habesha Times 1 year ago 16 minutes 42,867 views",Habesha Times,42867,43628,761
56,"Ethiopia: ዘጠነኛው ሺ - የጩቢቲ አንፍር😂 ቀልዶች | Ye Chubaw Qeldoch (Part 7) by Habesha Times 1 year ago 13 minutes, 11 seconds 24,076 views",Habesha Times,24076,24165,89
57,"መሳቅ😂 አይቻልም፤ ከሳቃቹ ተሸነፋቹ | Try not to laugh impossible | Funny Ethiopian videos 2020 by Habesha Times 1 year ago 13 minutes, 6 seconds 2,953 views",Habesha Times,2953,2966,13
58,"Ethiopia: ዘጠነኛው ሺ - የጩቢቲ አንፍር😂 ቀልዶች | Ye Chubaw Qeldoch (Part 6) by Habesha Times 1 year ago 15 minutes 34,002 views",Habesha Times,34002,34133,131
59,"መሳቅ😂 አይቻልም፤ ከሳቃቹ ተሸነፋቹ | Try not to laugh compilation | Funny Ethiopian videos 2020 by Habesha Times 1 year ago 11 minutes, 24 seconds 5,351 views",Habesha Times,5351,5357,6
60,"Roba Junior X Nati Turner - Photoshen | ፎቶሽን - New Ethiopian Music 2020 by Habesha Times 1 year ago 3 minutes, 55 seconds 2,932 views",Habesha Times,2932,2945,13
61,"Artists Funny TIK TOK Videos - 2020 by Habesha Times 1 year ago 10 minutes, 3 seconds 2,826 views",Habesha Times,2826,2832,6
62,"Betty G, Zeritu Kebede, Sofia Shibabaw &  Chachi Tadesse - Yeselam Sew Negn | የሰላም ሰው ነኝ (Lyrics) by Habesha Times 1 year ago 5 minutes, 57 seconds 7,129 views",Habesha Times,7129,7131,2
63,"Ethiopia: ዘጠነኛው ሺ - የጩቢቲ አንፍር😂 ቀልዶች | Ye Chubaw Qeldoch (Part 5) by Habesha Times 1 year ago 16 minutes 142,884 views",Habesha Times,142884,143167,283
64,"Abyssinia Vines: Stay At Home🏠 Vines (ቤት ቁጭ በማለት በእነዚህ ቪዲዮዎች ይዝናናኑ) 2020 by Habesha Times 1 year ago 10 minutes, 32 seconds 2,729 views",Habesha Times,2729,2733,4
65,"Getish Mamo (Yikir Belen) | ጌትሽ ማሞ (ይቅር በለን) Lyrics by Habesha Times 1 year ago 6 minutes, 23 seconds 6,113 views",Habesha Times,6113,6120,7
66,"የኮሜዲያን ቶማስ አዝግ ቀልዶች | Comedian Tomas Videos (2020) by Habesha Times 1 year ago 12 minutes, 41 seconds 6,084 views",Habesha Times,6084,6120,36
67,"Ethiopia: ዘጠነኛው ሺ - የጩቢቲ አንፍር😂 ቀልዶች | Ye Chubaw Qeldoch (Part 4) by Habesha Times 1 year ago 17 minutes 247,772 views",Habesha Times,247772,248557,785
68,"Ethiopia: ዘጠነኛው ሺ - የጩቢቲ አንፍር😂 ቀልዶች | Ye Chubaw Qeldoch (Part 3) by Habesha Times 1 year ago 16 minutes 370,440 views",Habesha Times,370440,370853,413
69,"Ethiopia: ዘጠነኛው ሺ - የጩቢቲ አንፍር😂 ቀልዶች | Ye Chubaw Qeldoch (Part 2) by Habesha Times 1 year ago 16 minutes 49,201 views",Habesha Times,49201,49405,204
70,"Ethiopia: ዘጠነኛው ሺ - የጩቢቲ አንፍር😂 ቀልዶች | Ye Chubaw Qeldoch (Part 1) by Habesha Times 1 year ago 16 minutes 64,880 views",Habesha Times,64880,65241,361
71,"Elias Teshome - Alwashim | አልዋሽም - New Ethiopian Music 2020 (Lyrics) by Habesha Times 1 year ago 3 minutes, 42 seconds 56,387 views",Habesha Times,56387,57207,820
72,"🔴 ኢንስታግራም ላይ በመቶ ሺ የሚቆጠሩ ተከታዮችን ያፈሩ ሴት አርቲስቶች | Top 10 Ethiopian Women Artists On Instagram | 2020 by Habesha Times 1 year ago 10 minutes, 10 seconds 1,868 views",Habesha Times,1868,1868,0
73,"Neway Debebe & Tsehaye Yohannes | Doro Wiha Xemtuat (ዶሮ ውሀ ጠምቷት) Lyrics by Habesha Times 1 year ago 6 minutes, 4 seconds 58,266 views",Habesha Times,58266,59594,1328
74,"Henok Abebe (ሔኖክ አበበ) - Qena Enbel (ቀና እንበል) | Full Album by Habesha Times 2 years ago 52 minutes 18,530 views",Habesha Times,18530,18759,229
75,"Teref Kasahun - Demo na | ደሞ'ና -New Ethiopian Music 2020 (Lyrics) by Habesha Times 2 years ago 4 minutes, 34 seconds 2,898 views",Habesha Times,2898,2901,3
76,"Hewan Gebrewold (Jano Band) Ane | ኣነ - New Ethiopian Music 2020 (Lyrics) by Habesha Times 2 years ago 4 minutes, 9 seconds 5,100 views",Habesha Times,5100,5144,44
77,"Merkeb Bonitua F.t Fana & Mesfen - Marsh Keyr (Lyrics) | ማርሽ ቐይር (ግጥም) by Habesha Times 2 years ago 4 minutes, 35 seconds 3,077 views",Habesha Times,3077,3091,14
78,"Sara Takele (Sirtana) Ft Gildo - Bekagn (በቃኝ) Lyrics by Habesha Times 2 years ago 3 minutes, 22 seconds 3,804 views",Habesha Times,3804,3828,24
79,"Yegna Band - Sima Belew ስማ በለው by Habesha Zefen 6 years ago 4 minutes, 45 seconds 4,735 views",Habesha Zefen,4735,4740,5
80,"Dan Admasu - Wede Huwala Lyrics Video , ዳን አድማሱ - ወደ ኋላ by Habesha Zefen 6 years ago 5 minutes, 2 seconds 36,476 views",Habesha Zefen,36476,36529,53
81,"Teddy Yo Addis Abeba Official Video   New Ethiopian Music 2015 by Habesha Zefen 6 years ago 3 minutes, 22 seconds 938 views",Habesha Zefen,938,942,4
82,"Mulugeta Lema   Yaya   Official Music Video   New Ethiopian Music 2015 by Habesha Zefen 6 years ago 5 minutes, 59 seconds 568 views",Habesha Zefen,568,569,1
83,"Ethiopia   Biniam Shifa   Nebise   Official Music Video   New Ethiopian Music 2015 by Habesha Zefen 6 years ago 5 minutes, 9 seconds 1,788 views",Habesha Zefen,1788,1793,5
84,"Deme Lula Ader Bane Official Music Video New Ethiopian Music 2015 by Habesha Zefen 6 years ago 4 minutes, 48 seconds 897 views",Habesha Zefen,897,897,0
85,"Dawit Alemayehu   Yizenbal   Official Music Video   New Ethiopian Music 2015 by Habesha Zefen 6 years ago 5 minutes, 13 seconds 534 views",Habesha Zefen,534,534,0
86,"Yidnekachew Tsegaye Alew Negir Official Music Video New Ethiopian Music 2015 by Habesha Zefen 6 years ago 5 minutes, 11 seconds 605 views",Habesha Zefen,605,605,0
87,"Dina Anteneh   Nama   Official Music Video   New Ethiopian Music 2015 by Habesha Zefen 6 years ago 4 minutes, 38 seconds 1,399 views",Habesha Zefen,1399,1399,0
88,"Kifle Eshetu   Afekreshalhu   Offical Music Video   Ethiopian music by Habesha Zefen 6 years ago 4 minutes, 48 seconds 197 views",Habesha Zefen,197,197,0
89,"Mamila Lukas   Harerga   Official Music Video   New Ethiopian Music 2015 by Habesha Zefen 6 years ago 5 minutes, 50 seconds 13,341 views",Habesha Zefen,13341,13355,14
90,"Haftom Mola   Keheba´yea   Official Music Video   New Ethiopian music 2015 by Habesha Zefen 6 years ago 5 minutes, 51 seconds 831 views",Habesha Zefen,831,837,6
91,"Mentesnot Tilahun   Yekelkel   Official Music Video   New Ethiopian Music 2015 by Habesha Zefen 6 years ago 5 minutes, 4 seconds 330 views",Habesha Zefen,330,330,0
92,"Bethelem Asefa and Fikeru Tal Adrga   Enwerared   Official Music Video   New Ethiopian Music 2015 by Habesha Zefen 6 years ago 4 minutes, 20 seconds 307 views",Habesha Zefen,307,308,1
93,"Getish Mamo   Kezih Belay   Official Music Video   New Ethiopian Music 2015 by Habesha Zefen 6 years ago 4 minutes, 43 seconds 3,491 views",Habesha Zefen,3491,3515,24
94,"Ephrem Zelalem Papi   Qaroye   official Music Video   New Ethiopian Music 2015 by Habesha Zefen 6 years ago 4 minutes, 27 seconds 444 views",Habesha Zefen,444,444,0
95,"Eniyachew Fanto and Messay Goa   Regga Hawassa   Official Music Video   New Ethiopian Music 2015 by Habesha Zefen 6 years ago 5 minutes, 51 seconds 92 views",Habesha Zefen,92,92,0
96,"Dan Admasu   Keftosh endalay   Official Audio Video   New Ethiopian Music 2015 by Habesha Zefen 6 years ago 5 minutes, 29 seconds 632 views",Habesha Zefen,632,632,0
97,"Frezer Aregahegn Werash   Tez Alegn Yetentu   Official Music Video   New Ethiopian Music 2015 by Habesha Zefen 6 years ago 5 minutes, 19 seconds 166 views",Habesha Zefen,166,166,0
98,"Dan Ademasu  Zebenay   Official Audio Video   New Ethiopian Music 2015 by Habesha Zefen 6 years ago 5 minutes, 21 seconds 420 views",Habesha Zefen,420,420,0
99,"Bre Bright   Mearey    Official Music Video   New Ethiopian Music 2015 by Habesha Zefen 6 years ago 5 minutes, 11 seconds 305 views",Habesha Zefen,305,305,0
100,"Binny Lastta   Alohe   Official Audio Video   New Ethiopian Music 2015 by Habesha Zefen 6 years ago 7 minutes, 48 seconds 305 views",Habesha Zefen,305,305,0
101,"Bethlehem Altaye   Himema   Official Music Video   New Ethiopian Music 2015 by Habesha Zefen 6 years ago 4 minutes, 15 seconds 564 views",Habesha Zefen,564,565,1
102,"Abinet Agonafir   Maal Naa Wayaa   Official Audio Video   New Ethiopian Music 2015 by Habesha Zefen 6 years ago 5 minutes, 39 seconds 776 views",Habesha Zefen,776,777,1
103,"Abeselom Behonegn Weye Weye   Sidet Wegene   Official Audio Video   New Ethiopian Music by Habesha Zefen 6 years ago 4 minutes, 26 seconds 438 views",Habesha Zefen,438,438,0
104,"Abinet Agonafir   Manew Yalew   Official Music Video   New Ethiopian Music 2015 by Habesha Zefen 6 years ago 5 minutes, 41 seconds 338 views",Habesha Zefen,338,338,0
105,"Beak Mesganaw   Konjo   New Official Music Video   New Ethiopian music 2015 by Habesha Zefen 6 years ago 4 minutes, 37 seconds 73 views",Habesha Zefen,73,73,0
106,"BIbi Kabtamu   Ababicho   Official Music Video   New Ethiopian Music 2015 by Habesha Zefen 6 years ago 4 minutes, 55 seconds 195 views",Habesha Zefen,195,195,0
107,"Yohanes Jona   Fidel   Official Music Video   New Ethiopian Music 2015 by Habesha Zefen 6 years ago 3 minutes, 39 seconds 363 views",Habesha Zefen,363,363,0
108,"Zekarias Asamrew and Chernet G michael   Official Music Video New Ethiopian Music 2015 by Habesha Zefen 6 years ago 4 minutes, 39 seconds 413 views",Habesha Zefen,413,414,1
109,"Tsehaye Wolde   Zim Kum   Official Music Video   New Ethiopian Music 2015 by Habesha Zefen 6 years ago 5 minutes, 10 seconds 197 views",Habesha Zefen,197,197,0
110,"Yohanes Girma   Melahi   Official Music Video   New Ethiopian Music 2015 by Habesha Zefen 6 years ago 5 minutes, 41 seconds 475 views",Habesha Zefen,475,475,0
111,"Tomi Zuk   Sika Endayat   Official Musik Video   New Ethiopian Music 2015 by Habesha Zefen 6 years ago 4 minutes, 53 seconds 249 views",Habesha Zefen,249,250,1
112,"Mekdes Abebe   Ende helm   New Ethiopian Music 2015 by Habesha Zefen 6 years ago 6 minutes, 20 seconds 6,377 views",Habesha Zefen,6377,6397,20
113,"Selemon Shanko   Awanday   Official Music Video   New Ethiopian Music 2015 by Habesha Zefen 6 years ago 5 minutes, 46 seconds 368 views",Habesha Zefen,368,368,0
114,"Rahel Haile   Awdeamtena   Official Music Video   New Music Video 2015 by Habesha Zefen 6 years ago 5 minutes, 59 seconds 26,282 views",Habesha Zefen,26282,26343,61
115,"Mieraf Assefa   Wendime Hunegn Alechign   Official Music Video   New Ethiopian Music 2015 by Habesha Zefen 6 years ago 5 minutes, 46 seconds 1,907 views",Habesha Zefen,1907,1924,17
116,"Mamila Lukas   Zago   Official Music Video New Ethiopian Music 2015 by Habesha Zefen 6 years ago 6 minutes, 4 seconds 356 views",Habesha Zefen,356,356,0
117,"Daniel Sintayehu   Fereche   Official Music Video   New Ethiopian Music 2015 by Habesha Zefen 6 years ago 5 minutes, 25 seconds 1,183 views",Habesha Zefen,1183,1187,4
118,"Dawit Nega   Kem Gelgele Meskel   Official Music Video   New äthiopischen Musik 2015 by Habesha Zefen 6 years ago 6 minutes, 5 seconds 472 views",Habesha Zefen,472,472,0
119,"Izak Asefa   Ney Jima   Official Music Video   New Ethiopian Music 2015 by Habesha Zefen 6 years ago 5 minutes, 33 seconds 480 views",Habesha Zefen,480,480,0
120,"Behailu Bayou   Feta Feta   Official Music Video New Ethiopian Music 2015 by Habesha Zefen 6 years ago 4 minutes, 58 seconds 864 views",Habesha Zefen,864,864,0
121,"Belay Melesie    Yangolela Nat   Official Music Video   New Ethiopian Music 2015 by Habesha Zefen 6 years ago 6 minutes, 35 seconds 709 views",Habesha Zefen,709,710,1
122,"Aschenaki Bekele   Nana Official New Video New Ethiopian Music 2015 by Habesha Zefen 6 years ago 4 minutes, 52 seconds 4,428 views",Habesha Zefen,4428,4428,0
123,"BIbi Kabtamu Ababicho Official Music Video   New Ethiopian Music 2015 by Habesha Zefen 6 years ago 5 minutes, 44 seconds 720 views",Habesha Zefen,720,720,0
124,"Alemya Getachew   Bey Kora   Official Music Video New Ethiopian Music 2015 by Habesha Zefen 7 years ago 5 minutes, 35 seconds 1,545 views",Habesha Zefen,1545,1554,9
125,"Enkutatash Beshah   Eshi Bel Official Music Video New Ethiopian Music 2015 by Habesha Zefen 7 years ago 4 minutes, 3 seconds 250 views",Habesha Zefen,250,250,0
126,"Daniel Mehrte   Lalo   Official Music Video New Ethiopian Music 2015 by Habesha Zefen 7 years ago 4 minutes, 34 seconds 464 views",Habesha Zefen,464,464,0
127,"Fitsum Gebretsadik   Were Official Music Video   New Ethiopian music 2015 by Habesha Zefen 7 years ago 4 minutes, 5 seconds 2,220 views",Habesha Zefen,2220,2222,2
128,"Mekdes Hailu   Min Libleh Offical Music Video New Ethiopian Music 2015 by Habesha Zefen 7 years ago 4 minutes, 9 seconds 938 views",Habesha Zefen,938,947,9
129,"Frehiwot Sleshi   Asamenegn   Official Music Video New Ethiopian Music 2015 by Habesha Zefen 7 years ago 4 minutes, 33 seconds 575 views",Habesha Zefen,575,579,4
130,"Ras Mule   Des alew leban   Official Music Video New Ethiopian Music 2015 by Habesha Zefen 7 years ago 4 minutes, 41 seconds 1,177 views",Habesha Zefen,1177,1198,21
131,"Sami Tesfiye  Sami Habesha   Maleda   Official Music Video New Ethiopian Music 2015 by Habesha Zefen 7 years ago 4 minutes, 51 seconds 4,369 views",Habesha Zefen,4369,4376,7
132,"Best New Ethiopian Music 2014  Amesyas Solomon DJ Amy Alchelema by Habesha Zefen 8 years ago 5 minutes, 7 seconds 1,278 views",Habesha Zefen,1278,1278,0
133,"Hot New Ethiopian Music Arbin Ervin Ben 2014 Magna by Habesha Zefen 8 years ago 3 minutes, 50 seconds 288 views",Habesha Zefen,288,288,0
134,"Betoch Part 44 Ethiopian Drama by Habesha Zefen 8 years ago 19 minutes 210,476 views",Habesha Zefen,210476,210504,28
135,"Hot New Ethiopian Music 2014 Selamawit Nega Silenate by Habesha Zefen 8 years ago 6 minutes, 4 seconds 1,421 views",Habesha Zefen,1421,1422,1
136,"Best Ethiopian Music 2014 Tesfaye Mamo Nitsuh Fikir 1 by Habesha Zefen 8 years ago 4 minutes, 30 seconds 490 views",Habesha Zefen,490,490,0
137,"New Hot Ethiopian Music 2014  Mahlet Demere Habesha by Habesha Zefen 8 years ago 4 minutes, 18 seconds 253 views",Habesha Zefen,253,254,1
138,"Best New Ethiopian music 2014 Tefe Lali Kakaten by Habesha Zefen 8 years ago 4 minutes, 55 seconds 568 views",Habesha Zefen,568,568,0
139,"NEW Birhanu Tezera Ekoralehu Enji እኮራለሁ እንጂ New 2014 by Habesha Zefen 8 years ago 4 minutes, 15 seconds 318 views",Habesha Zefen,318,318,0
140,"Best New Ethiopian music 2014 Yegna Temnet by Habesha Zefen 8 years ago 5 minutes, 14 seconds 690 views",Habesha Zefen,690,690,0
141,"Best Ethiopian Guragegna Music 2014 Teka Asefa Ft Yetagesu Melesse Yangut by Habesha Zefen 8 years ago 4 minutes, 49 seconds 1,168 views",Habesha Zefen,1168,1168,0
142,"Best Ethiopian Music 2014 Maheder Zeleke Eyew Na Ena by Habesha Zefen 8 years ago 4 minutes, 24 seconds 526 views",Habesha Zefen,526,526,0
143,"Best New Ethiopian Music 2014 Workye Getachew Elil Bey by Habesha Zefen 8 years ago 4 minutes, 31 seconds 7,712 views",Habesha Zefen,7712,7730,18
144,"Best New Ethiopian Music 2014 Samuel Sinshaw Sami Ayne by Habesha Zefen 8 years ago 5 minutes, 6 seconds 790 views",Habesha Zefen,790,791,1
145,"Best New Ethiopian music 2014 Yene Adam Tsige Tesfaye Sara Lemon by Habesha Zefen 8 years ago 4 minutes, 57 seconds 2,787 views",Habesha Zefen,2787,2793,6
146,"Best New Ethiopian music 2014 Bini Lali Zaleyewa Lali Habesha by Habesha Zefen 8 years ago 4 minutes, 28 seconds 834 views",Habesha Zefen,834,835,1
147,"Best New Ethiopian Music 2014 Jerry Asfaw Jenenew by Habesha Zefen 8 years ago 5 minutes, 51 seconds 304 views",Habesha Zefen,304,305,1
148,"Hanan Berihun ft Edidiya Ayele Feta Feta ፈታ ፈታ New Hot Ethiopian Music 2014 by Habesha Zefen 8 years ago 4 minutes, 16 seconds 522 views",Habesha Zefen,522,523,1
149,"Hot Ethiopian Reggae music 2014 Haftom Abraha Telele by Habesha Zefen 8 years ago 3 minutes, 58 seconds 167 views",Habesha Zefen,167,168,1
150,"Betoch Part 43 ''ቤቶች'' Ethiopian Drama by Habesha Zefen 8 years ago 22 minutes 60,034 views",Habesha Zefen,60034,60042,8
151,"2014 Hot New Ethiopian Traditional Music Emebet Negasi Senda Bel by Habesha Zefen 8 years ago 5 minutes, 16 seconds 688 views",Habesha Zefen,688,688,0
152,"2014 Hot New Ethiopian music Henok Amare stota nesh by Habesha Zefen 8 years ago 5 minutes, 8 seconds 463 views",Habesha Zefen,463,464,1
153,"HOT 2014 New Ethiopian music Mike Solo Eshruru by Habesha Zefen 8 years ago 2 minutes, 37 seconds 844 views",Habesha Zefen,844,844,0
154,"2014 Hot New Ethiopian Music Hanan Berihun Feta Feta by Habesha Zefen 8 years ago 4 minutes, 16 seconds 429 views",Habesha Zefen,429,432,3
155,"Tamrat Kahsay ft Samigoend Tedi Raga fikirs kanchi Gar NEW Ethiopian Music 2014 by Habesha Zefen 8 years ago 5 minutes, 7 seconds 423 views",Habesha Zefen,423,424,1
156,"Beckham Kebede & Naol Debele Kurat NEW Ethiopian Music 2014 by Habesha Zefen 8 years ago 3 minutes, 53 seconds 1,290 views",Habesha Zefen,1290,1290,0
157,"SmizZ Mayle MARKOGNAL ስሚዝ ማይሌ ማርኮኛል New Hot Ethiopian Music 2014 by Habesha Zefen 8 years ago 6 minutes, 8 seconds 160 views",Habesha Zefen,160,160,0
158,"Fitawrary Kibromma Zanigaba NEW Ethiopian Hip Hop 2014 by Habesha Zefen 8 years ago 3 minutes, 49 seconds 230 views",Habesha Zefen,230,230,0
159,"Seble Tadesse Demamaye NEW Ethiopian Music 2014 by Habesha Zefen 8 years ago 4 minutes, 21 seconds 1,267 views",Habesha Zefen,1267,1267,0
160,"Sami ሳሚ Tezemite ተዘሚተ New Hot Tigrigna Song 2014 by Habesha Zefen 8 years ago 5 minutes, 24 seconds 229 views",Habesha Zefen,229,229,0
161,"Yegna ft Aster Aweke Taitu ጣይቱ New Ethiopian music 2014 by Habesha Zefen 8 years ago 5 minutes, 5 seconds 2,043 views",Habesha Zefen,2043,2044,1
162,"New Ethiopian Music Tibebu Workye 2014 by Habesha Zefen 8 years ago 7 minutes, 5 seconds 1,030 views",Habesha Zefen,1030,1032,2
163,"Yegna Abet Ezih Bet Ft Haile Roots Ethiopia's First Girl Band by Habesha Zefen 8 years ago 4 minutes, 41 seconds 29,049 views",Habesha Zefen,29049,29049,0
164,"Yegna Band Wudassie  ውዳሴ Best Ethiopian Music by Habesha Zefen 8 years ago 4 minutes, 24 seconds 27,954 views",Habesha Zefen,27954,27968,14
165,"Yegna Band Andinetachin ft Jah Lude by Habesha Zefen 8 years ago 4 minutes, 24 seconds 22,090 views",Habesha Zefen,22090,22091,1
166,"Yegna Band Yinegal Best Ethiopian Music by Habesha Zefen 8 years ago 4 minutes, 24 seconds 3,012 views",Habesha Zefen,3012,3017,5
167,"Yegna Band Meri Kokeb Best Ethiopian Music by Habesha Zefen 8 years ago 4 minutes, 31 seconds 4,868 views",Habesha Zefen,4868,4875,7
168,"Yegna Band Esat Best Ethiopian Music by Habesha Zefen 8 years ago 4 minutes, 24 seconds 6,307 views",Habesha Zefen,6307,6310,3
169,"Yegna Band Tadelen Best Ethiopian Music by Habesha Zefen 8 years ago 4 minutes, 24 seconds 13,819 views",Habesha Zefen,13819,13827,8
170,"Yegna Band Ahoy Muna Best Ethiopian Music by Habesha Zefen 8 years ago 4 minutes, 24 seconds 6,723 views",Habesha Zefen,6723,6723,0
171,"Yegna Band Fikir New Song by Habesha Zefen 8 years ago 4 minutes, 30 seconds 4,001 views",Habesha Zefen,4001,4001,0
172,TDF ዝሓፈሶ ዓወት ብምግባር ዝገበርናዬ ተሃድሶ ። by Habtom Zeru 7 months ago 45 seconds 791 views,Habtom Zeru,791,792,1
173,"Covid 19 Tigray Community UK by Habtom Zeru 1 year ago 4 minutes, 12 seconds 44 views",Habtom Zeru,44,44,0
174,"new soft by Habtom Zeru 3 years ago 4 minutes, 46 seconds 76 views",Habtom Zeru,76,77,1
175,"Fasil Demoz and Jacky Gosee 2014   Enkokelesh Official Video by Habtom Zeru 7 years ago 7 minutes, 28 seconds 434 views",Habtom Zeru,434,434,0
176,"Dawit Nega  MUSIC 2015 Kem Gelgele Meskel ከም ገልገለ መስቀል by Habtom Zeru 7 years ago 6 minutes, 4 seconds 742 views",Habtom Zeru,742,745,3
177,"Gedamu Yezina Negash by Habtom Zeru 7 years ago 5 minutes, 4 seconds 556 views",Habtom Zeru,556,556,0
178,"Teddy Afro   Beseba Dereja በሰባ ደረጃ by Habtom Zeru 7 years ago 8 minutes, 11 seconds 409 views",Habtom Zeru,409,409,0
179,"Haimanot Girma Eishururu by Habtom Zeru 7 years ago 4 minutes, 25 seconds 421 views",Habtom Zeru,421,422,1
180,"Tigrigna Music   Tsegazeab Gebresilasse   Embeytey by Habtom Zeru 7 years ago 6 minutes, 33 seconds 802 views",Habtom Zeru,802,802,0
181,"Semahegn Belew Ethiopian New Music ere mnunn setesh by Habtom Zeru 7 years ago 7 minutes, 53 seconds 2,512 views",Habtom Zeru,2512,2512,0
182,"Helen Pawlos, ሓላውለይ Halawley   Best New 2014 Music by Habtom Zeru 7 years ago 8 minutes, 48 seconds 1,460 views",Habtom Zeru,1460,1473,13
183,"Bezuayehu Demissie   Meleyet Kifu Eta Lyrics HD 1080p by Habtom Zeru 7 years ago 7 minutes, 13 seconds 81,227 views",Habtom Zeru,81227,83390,2163
184,"Wufer Tebeges Kemzi Hizi by Habtom Zeru 7 years ago 5 minutes, 38 seconds 215 views",Habtom Zeru,215,215,0
185,"Anbessa Tekle weneye Telale by Habtom Zeru 7 years ago 5 minutes, 53 seconds 1,055 views",Habtom Zeru,1055,1055,0
186,"Mizan Tesfay Tigray Za Adey by Habtom Zeru 7 years ago 11 minutes, 10 seconds 6,301 views",Habtom Zeru,6301,6302,1
187,"Abebe araya '' Ember Tegadalay'' by Habtom Zeru 7 years ago 6 minutes, 24 seconds 12,136 views",Habtom Zeru,12136,12169,33
188,"Eyasu Berhe   Armoshesh weyanay ዓርሞሸሽ by Habtom Zeru 7 years ago 8 minutes, 32 seconds 44,557 views",Habtom Zeru,44557,44628,71
189,"TIGRIGNA MUSIC 2015 Dawit Nega Kem Gelgele Meskel ከም ገልገለ መስቀል by Habtom Zeru 7 years ago 6 minutes, 4 seconds 244,715 views",Habtom Zeru,244715,245197,482
190,"Tigray Zeadey   Traditional Tigrigna Song By Mizan Tesfay by Habtom Zeru 7 years ago 8 minutes, 16 seconds 8,845 views",Habtom Zeru,8845,8876,31
191,"Anbesa Tekele  Niesnete by Habtom Zeru 7 years ago 5 minutes, 50 seconds 792 views",Habtom Zeru,792,792,0
192,"Shewit Mezgebo  TSemaeKani Best New  2014 music by Habtom Zeru 7 years ago 5 minutes, 40 seconds 1,338 views",Habtom Zeru,1338,1338,0
193,"Negasi Melese, ሸው ንዓደይ Shew Shew NeAdey   New 2013 Tigrinya Music by Habtom Zeru 7 years ago 6 minutes, 38 seconds 838 views",Habtom Zeru,838,839,1
194,"Meles Zenawi RIP by Habtom Zeru 7 years ago 12 minutes, 34 seconds 149 views",Habtom Zeru,149,150,1
195,"I love you Son  Adonay by Habtom Zeru 7 years ago 4 minutes, 13 seconds 383 views",Habtom Zeru,383,383,0
196,"NITSNAE HIZBI ETHIOPIA In memory of Melses zenawi by Habtom Zeru 8 years ago 7 minutes, 33 seconds 649 views",Habtom Zeru,649,649,0
197,"inspiration of Africa R.I.P by Habtom Zeru 9 years ago 6 minutes, 19 seconds 459 views",Habtom Zeru,459,459,0
198,having  fun deki shire by Habtom Zeru 9 years ago 6 seconds 440 views,Habtom Zeru,440,440,0
199,"Tsehay Amare - Ahun koran - አሁን ኮራን -New Ethiopian Music 2022 Official Video by Heni Tube 1 month ago 5 minutes, 5 seconds 5,120 views",Heni Tube,5120,5389,269
200,"ጣፋጭ ጨዋታ ከአርቲስት ማስተዋል አድማሱ ጋር - Mastewal Admasu by Heni Tube 2 months ago 23 minutes 1,695 views",Heni Tube,1695,1759,64
201,"Henon Mulatu - ሄኖን ሙላቱ /ጉም አዘለ/ New Ethiopian Music 2021(Official Video) by Heni Tube 7 months ago 5 minutes, 59 seconds 5,079 views",Heni Tube,5079,5167,88
202,"Kasahun Taye (Sora) - Wedet - ካሳሁን ታዬ (ሶራ) - ወዴት ወዴት - New Ethiopian Music 2021(Official Video) by Heni Tube 8 months ago 5 minutes, 41 seconds 81,119 views",Heni Tube,81119,81413,294
203,"Vanus Zeda - ቫኑስ ዜዳ (ቫን) - ዘጋ - New Ethiopian Music 2021(Official Video) by Heni Tube 8 months ago 5 minutes, 35 seconds 17,693 views",Heni Tube,17693,17921,228
204,"Oumer Ali ( Zemuye) - ኡመር አሊ (ዘሙዬ) - ሸብረብ - New Ethiopian Music by Heni Tube 9 months ago 4 minutes, 54 seconds 31,776 views",Heni Tube,31776,32343,567
205,"National Harbor - ቅኝት በአሜሪካ by Heni Tube 1 year ago 13 minutes, 50 seconds 5,344 views",Heni Tube,5344,5350,6
206,"Old Town - Virginia - ቅኝት በአሜሪካ by Heni Tube 1 year ago 15 minutes 3,228 views",Heni Tube,3228,3235,7
207,"አዲሱ እና ተወዳጁ የዲሲ የመዝናኛ ቦታ by Heni Tube 1 year ago 13 minutes, 7 seconds 4,150 views",Heni Tube,4150,4158,8
208,"ቅኝት በ አሜሪካ - Washington, D.C. - ዋሽንግተን ዲሲ በቀን እና በምሽት ምን ትመስላለች by Heni Tube 1 year ago 28 minutes 1,708 views",Heni Tube,1708,1716,8
209,"ቅኝት በ አሜሪካ - Washington Monument and World War 2 by Heni Tube 1 year ago 8 minutes, 50 seconds 1,904 views",Heni Tube,1904,1913,9
210,"ቅኝት በአሜሪካ - Abraham Lincoln by Heni Tube 1 year ago 10 minutes, 24 seconds 1,645 views",Heni Tube,1645,1652,7
211,"54ሺ ሞተዋል ከ8ሺ በላይ ደሞ የት እንደገቡ አይታወቅም by Heni Tube 1 year ago 9 minutes, 26 seconds 2,441 views",Heni Tube,2441,2446,5
212,"አዲስ ፕሮግራም  - Coming soon by Heni Tube 1 year ago 1 minute, 24 seconds 6,472 views",Heni Tube,6472,6475,3
213,"ግብራችን ምስግና ነው  - ሊቀ ልሳናት ቀሲስ ቡሩክ በየነ by Heni Tube 1 year ago 6 minutes, 30 seconds 3,296 views",Heni Tube,3296,3302,6
214,"ቤትህን አስተካክል - በመምህር ደበበ እስጢፋኖስ by Heni Tube 1 year ago 15 minutes 1,735 views",Heni Tube,1735,1737,2
215,"የአባታችን ብፁዕ አቡነ ናትናኤል አስገራሚ ዝማሬ by Heni Tube 1 year ago 2 minutes, 20 seconds 4,817 views",Heni Tube,4817,4859,42
216,"በእርሱ የሚያምኑትን ያዉቃል _ በመምህር ደበበ እስጢፋኖስ by Heni Tube 1 year ago 14 minutes, 16 seconds 1,106 views",Heni Tube,1106,1109,3
217,"ወንድማችንን በድለን ይህ ሁሉ መከራ መጣብን - Memher Debebe Estifanos by Heni Tube 1 year ago 16 minutes 1,126 views",Heni Tube,1126,1128,2
218,"ትወገር ? - Memehir Debebe Estifanos by Heni Tube 1 year ago 15 minutes 1,266 views",Heni Tube,1266,1270,4
219,"የኮሮና በሽታ በተዋህዶ አባቶች   በመምህር ደበበ እስጢፋኖስ እና መጋቢ ሓዲስ መኮንን ወልደ ትንሳኤ -  ክፍል ሁለት by Heni Tube 1 year ago 30 minutes 1,075 views",Heni Tube,1075,1075,0
220,"የድምፃዊ ፋሲል ደሞዝ በሳቅ የሚገድሉ የቤት ውስጥ ቆይታ (ኳረንቲን) ጊዜ ገጠመኝ by Heni Tube 1 year ago 7 minutes, 6 seconds 53,704 views",Heni Tube,53704,53719,15
221,"ደስ ይበልሽ - በመምህር ደበበ እስጢፋኖስ - Memhir Debebe Estifanos by Heni Tube 1 year ago 36 minutes 1,253 views",Heni Tube,1253,1254,1
222,"ይህም ያልፋል - በመምህር ደበበ እስጢፋኖስ - Memhir Debebe Estifanos by Heni Tube 1 year ago 13 minutes, 36 seconds 2,225 views",Heni Tube,2225,2228,3
223,"በቃልህ አጠንክረኝ - በመምህር ደበበ እስጢፋኖስ / Memhir Debebe Estifanos by Heni Tube 1 year ago 11 minutes, 27 seconds 1,565 views",Heni Tube,1565,1569,4
224,"ይህችን ዓመት ደግሞ እለፋት - በመምህር ደበበ እስጢፋኖስ by Heni Tube 1 year ago 11 minutes, 55 seconds 772 views",Heni Tube,772,772,0
225,"ወጣትነት -  Wetatinet - በመምህር ደበበ እስጢፋኖስ - ክፍል  1 by Heni Tube 1 year ago 12 minutes, 34 seconds 882 views",Heni Tube,882,887,5
226,"ጥቃቅን ቀበሮዎች - በመምህር ደበበ እስጢፋኖስ - ክፍል 1 by Heni Tube 1 year ago 14 minutes, 23 seconds 1,763 views",Heni Tube,1763,1767,4
227,"የእነ ጀማነሽ እብደት - በመምህር ደበበ እስጢፋኖስ by Heni Tube 1 year ago 19 minutes 2,845 views",Heni Tube,2845,2855,10
228,"አይዟችሁ - በመምህር ደበበ እስጢፋኖስ by Heni Tube 1 year ago 12 minutes, 6 seconds 864 views",Heni Tube,864,866,2
229,በመጋቢ ሓዲስ መኮንን ወልደ ትንሳኤ - ገብርኄር by Heni Tube 1 year ago 18 minutes 625 views,Heni Tube,625,627,2
230,በመምህር ደበበ እስጢፋኖስ - ለችግራችን መፍትሔው ? by Heni Tube 1 year ago 15 minutes 938 views,Heni Tube,938,946,8
231,"የኮሮና በሽታ በተዋህዶ አባቶች - በመምህር ደበበ እስጢፋኖስ  እና መጋቢ ሓዲስ መኮንን ወልደ ትንሳኤ - ክፍል አንድ by Heni Tube 1 year ago 22 minutes 2,108 views",Heni Tube,2108,2111,3
232,"ኮሮና እና ሐሰተኛ ነብያት - በመምህር ደበበ እስጢፋኖስ - Part - 1 Kesis Debebe Estifanos by Heni Tube 1 year ago 13 minutes, 35 seconds 5,695 views",Heni Tube,5695,5708,13
233,"አስቻለው ቢያዝን - Aschalew Biyazen | በቀኝ ተነሳሁኝ - New Ethiopian Music 2020 (Official Video) by Heni Tube 1 year ago 5 minutes, 50 seconds 5,638 views",Heni Tube,5638,5655,17
234,"Abebe Desiye - አበበ ደስዬ(ወላንሳዬ) አማላይ - Ethiopian music 2020 by Heni Tube 2 years ago 5 minutes, 18 seconds 66,497 views",Heni Tube,66497,66591,94
235,"Amare Menberu - አማረ መንበሩ | አብሽር በይኝ - New Ethiopian Music 2019 (Official Video) by Heni Tube 2 years ago 6 minutes, 14 seconds 201,600 views",Heni Tube,201600,201718,118
236,"Ethiopian Music : Habtamu Tedla -  ያዉና - 2019 (Official Video) by Heni Tube 2 years ago 5 minutes, 11 seconds 38,510 views",Heni Tube,38510,38576,66
237,"Ethiopian Music : Temesgen Atnkut - ተመስገን አትንኩት ( አለኝ ጉዳይ )  2019 Official Video by Heni Tube 2 years ago 5 minutes, 44 seconds 6,286 views",Heni Tube,6286,6290,4
238,"Hayleyesus Mulugeta - ሀ/ኢየሱስ ሙሉጌታ (አማኑኤል) - አይገርመኝም - New Ethiopian Music 2019 (Official Video) by Heni Tube 2 years ago 6 minutes, 1 second 31,887 views",Heni Tube,31887,31910,23
239,"Mebre Mengste - መብሬ መንግስቴ (መዉዜር አማረኝ) / ዋ በለው /  New Ethiopian Music 2019 (Official Video) by Heni Tube 2 years ago 7 minutes, 10 seconds 1,123,428 views",Heni Tube,1123428,1128131,4703
240,"Enyew Terefe - Amelegnaw - /አመለኛው / እንየኘዉ ተረፈ / New Ethiopian Music 2019 (Official Video) by Heni Tube 2 years ago 6 minutes, 44 seconds 84,601 views",Heni Tube,84601,84655,54
241,"Habtu Getahun - ሃብቱ ጌታሁን ( ሸጌ) Ethiopian Music 2019 by Heni Tube 2 years ago 7 minutes, 2 seconds 134,279 views",Heni Tube,134279,134558,279
242,"Abeje Abenet - አበጀ አብነት ( ማርዳዬ ) New Ethiopian Music 2019 (Official Video) by Heni Tube 2 years ago 6 minutes, 4 seconds 818,182 views",Heni Tube,818182,820049,1867
243,"Ethiopian Music : Haymanot Endalamaw - የወሎ ልጅ - 2019 (Official Video) by Heni Tube 2 years ago 5 minutes, 59 seconds 57,836 views",Heni Tube,57836,57991,155
244,"Kbrti Tsehaye - በሰለጥነ ዘመን - Ethiopian music 2019 by Heni Tube 2 years ago 5 minutes, 22 seconds 12,337 views",Heni Tube,12337,12349,12
245,"Emebet Mekonen / ሻደይ / ሶለል አሸንዳዬ - New Ethiopian Music 2019 (Official Video) by Heni Tube 2 years ago 8 minutes, 5 seconds 304,439 views",Heni Tube,304439,306851,2412
246,"Atkelt Kibret /ልሻገር/ Ethiopian music 2019 by Heni Tube 2 years ago 6 minutes, 1 second 24,485 views",Heni Tube,24485,24527,42
247,"Banchiamlak Getnet - ማን ጣለ ወርቅ - New Ethiopian Music 2019 (Official Video) by Heni Tube 2 years ago 6 minutes, 24 seconds 1,862,937 views",Heni Tube,1862937,1872939,10002
248,"Sami Art - ወገን ንቃ - Ethiopian Music 2019 (Official Audio) by Heni Tube 2 years ago 4 minutes, 37 seconds 8,072 views",Heni Tube,8072,8076,4
249,"ምጥን እዉነቱ - Miten Ewunetu - ሃገሬ - Ethiopian music (official video) by Heni Tube 2 years ago 5 minutes, 51 seconds 19,178 views",Heni Tube,19178,19193,15
250,"Ethiopian Music : Seble Mezmur - ሰብለ መዝሙር (አልቀርም) - 2019(Official Video) by Heni Tube 2 years ago 8 minutes, 22 seconds 38,325 views",Heni Tube,38325,38355,30
251,"Ethiopian Music : Semahegn Belew - ሰማኸኝ በለዉ (ዲስካዉ) - 2019(Official Video) by Heni Tube 2 years ago 5 minutes, 16 seconds 1,041,941 views",Heni Tube,1041941,1044631,2690
252,"Ethiopian Music : Haymanot Endalamaw - ሃይማኖት እንዳላማዉ (ያባት አደራ) - 2019 (Official Video) by Heni Tube 2 years ago 6 minutes 37,207 views",Heni Tube,37207,37217,10
253,"Mehari Degefaw - Gitem Alegn | ግጠም አለኝ - New Ethiopian Music 2019 (Official Video) by Heni Tube 2 years ago 7 minutes, 21 seconds 7,415,649 views",Heni Tube,7415649,7458280,42631
254,"Tsega Muche - ፀጋ ሙጬ ጓሌ | ኢትዮጵያ - New Ethiopian Music 2019 (Official Video) by Heni Tube 2 years ago 4 minutes, 49 seconds 32,067 views",Heni Tube,32067,32095,28
255,"Saba Kebede - Yagere Lej | ያገሬ ልጅ - New Ethiopian Music 2019 (Official Video) by Heni Tube 2 years ago 5 minutes, 27 seconds 10,615 views",Heni Tube,10615,10624,9
256,"Ethiopian Music : Desalegn Dires ወራጅ አለ - ደሳለኝ ድረስ (መረዋ) - New Ethiopian Music 2019(Official Video) by Heni Tube 2 years ago 7 minutes, 1 second 121,711 views",Heni Tube,121711,121786,75
257,"Mulugeta Gerima | አሞኛል | New Ethiopian Music 2019 (Official Video ) by Heni Tube 2 years ago 7 minutes, 19 seconds 57,410 views",Heni Tube,57410,57432,22
258,"Yirdaw Tenaw - Bemaledaw /በማለዳው/ Ethiopian Music (Official Video) by Heni Tube 3 years ago 10 minutes, 41 seconds 1,968,055 views",Heni Tube,1968055,1993290,25235
259,"Amsal Mitike / ወይ ወሎ /  Ethiopian Music 2019 (Official Video) by Heni Tube 3 years ago 6 minutes, 35 seconds 10,000,542 views",Heni Tube,10000542,10057274,56732
260,"Seyuom Moges - አጀብ ነዉ ዛሬ - (Official Video) - 2019 by Heni Tube 3 years ago 8 minutes, 37 seconds 13,813 views",Heni Tube,13813,13835,22
261,"Mehari Degefaw -  የጎንደር ኮንሰርት - እያያ በለዉ - በ HD ጥራት 2019 by Heni Tube 3 years ago 11 minutes, 56 seconds 15,586 views",Heni Tube,15586,15615,29
262,"መሃሪ ደገፋዉ - የጎንደር ኮንሰርት - እያያ በለው - 2019 by Heni Tube 3 years ago 11 minutes, 56 seconds 4,213 views",Heni Tube,4213,4213,0
263,"Brhanu Brku - ላልይበላ ነሽ - New Ethiopian Music 2018 (Official Video) by Heni Tube 3 years ago 5 minutes, 50 seconds 48,783 views",Heni Tube,48783,48815,32
264,"Dagne Walle -Ahobel - ደብረማርቆስ ኮንሰርት 2018 by Heni Tube 3 years ago 8 minutes, 21 seconds 14,902 views",Heni Tube,14902,14911,9
265,"Fasil Demoz - በቃ ሂድልኝ - ደብረማርቆስ ኮንሰርት 2018 by Heni Tube 3 years ago 8 minutes, 21 seconds 49,671 views",Heni Tube,49671,49697,26
266,"Fasil Demoz - ጀግኖች  4ቱ  - ደብረማርቆስ  2018 by Heni Tube 3 years ago 8 minutes, 21 seconds 11,158 views",Heni Tube,11158,11169,11
267,"Dagne Walle - ዘርትሁን ደብረማርቆስ - 2018 by Heni Tube 3 years ago 7 minutes, 48 seconds 17,934 views",Heni Tube,17934,17950,16
268,"Negalign Muluken - የጀግና ማስታወሻ - New Ethiopian Music 2018 by Heni Tube 3 years ago 6 minutes, 41 seconds 218,931 views",Heni Tube,218931,219220,289
269,"Dagne Wale - Yechenekelet by Heni Tube 3 years ago 7 minutes, 3 seconds 16,453 views",Heni Tube,16453,16470,17
270,"Dagne Wale -  Ahobel  - Bahir dar Concert -2018 by Heni Tube 3 years ago 7 minutes, 12 seconds 20,191 views",Heni Tube,20191,20201,10
271,"Atkelt Kibret - የኔ ነህ- New Ethiopian Music 2018 (Official Video) by Heni Tube 3 years ago 6 minutes, 4 seconds 61,066 views",Heni Tube,61066,61077,11
272,"Fasil Demoz - Bahirdar Concert -JEGNOCH 4TU - 2018 by Heni Tube 3 years ago 6 minutes, 38 seconds 36,072 views",Heni Tube,36072,36084,12
273,"Asfaw Melese - Mamit gedam - Ethiopian new music 2018 by Heni Tube 3 years ago 6 minutes, 48 seconds 56,409 views",Heni Tube,56409,56516,107
274,"Eyerusalem Dubale - እየሩስአለም ዱባለ - Nalegn -  Ethiopian Music by Heni Tube 3 years ago 5 minutes, 7 seconds 220,293 views",Heni Tube,220293,220738,445
275,"Wagnew Ashenafi - ባንዲራዉ ደመቀ - New Ethiopian Music 2018 (Official Video) by Heni Tube 3 years ago 8 minutes, 17 seconds 932,937 views",Heni Tube,932937,933939,1002
276,"Emebet Negasi / ወንድ አለ/ New Ethiopian Music (Official Video) by Heni Tube 3 years ago 6 minutes, 22 seconds 1,465,914 views",Heni Tube,1465914,1466495,581
277,"Sami Art - Temelesh - New Ethiopian Music 2018 (Official Video) by Heni Tube 3 years ago 6 minutes, 12 seconds 7,892 views",Heni Tube,7892,7900,8
278,"Fasil Demoz - Dr Abiy Ahmed / ሰላም ነዉ ድግሱ / Ethiopian Music (Official Video) by Heni Tube 3 years ago 7 minutes, 38 seconds 2,710,301 views",Heni Tube,2710301,2712317,2016
279,"Fasil Demoz -Dr Abiy  - ፋሲል ደሞዝ - coming soon - 2018 by Heni Tube 3 years ago 48 seconds 74,397 views",Heni Tube,74397,74439,42
280,"DR Abiy Be Esayas bet -የዶክተር አብይ ተራራ ላይ የነበራቸዉ አስገራሚ ቆይታ by Heni Tube 3 years ago 12 minutes, 32 seconds 18,345 views",Heni Tube,18345,18352,7
281,"Maritu Legesse - Yegemasheral - ማሪቱ ለገሰ /ይገማሸራል - Ethiopian Music 2018 (Official Video) by Heni Tube 3 years ago 5 minutes, 49 seconds 779,994 views",Heni Tube,779994,783210,3216
282,"እዉነተኛ የተፈትሮ ድምፅ by Heni Tube 3 years ago 2 minutes, 7 seconds 15,753 views",Heni Tube,15753,15767,14
283,"Maritu Legese - ማሪቱ ለገሰ - CD Release party -  2018 by Heni Tube 3 years ago 4 minutes, 5 seconds 81,452 views",Heni Tube,81452,82113,661
284,"Eyayu Gedamu - አማን ይሁን - Ethiopian Music by Heni Tube 3 years ago 6 minutes, 15 seconds 266,924 views",Heni Tube,266924,266982,58
285,"Zeynu Mahbub - Arifaneti - Ethiopian (Official video ) by Heni Tube 3 years ago 5 minutes, 19 seconds 198,298 views",Heni Tube,198298,199612,1314
286,"Amsal Mitike  / ፍቅርን ይዤ / Ethiopian Music 2018 (Official Video) by Heni Tube 3 years ago 5 minutes, 9 seconds 5,513,523 views",Heni Tube,5513523,5531952,18429
287,"Getish Mamo 2018 - Abiyot Kasanesh - ጌትሽ ማሞ by Heni Tube 4 years ago 1 minute, 6 seconds 64,923 views",Heni Tube,64923,64935,12
288,"Andualem Ayalew - የመይሳው - Ethiopian Music (Official Video) by Heni Tube 4 years ago 4 minutes, 45 seconds 157,866 views",Heni Tube,157866,157975,109
289,"Teddy afro - ቴዲ አፍሮ - ባህርዳር ኮንሰርት - Bahirdar - 2018 by Heni Tube 4 years ago 10 minutes, 45 seconds 43,551 views",Heni Tube,43551,43582,31
290,"Habtamu Tedla - ሰዉ መሆን - Ethiopian Music (Official Video) by Heni Tube 4 years ago 5 minutes, 40 seconds 10,637 views",Heni Tube,10637,10642,5
291,"Kirubel Sheberu - Fikir Feneda by Heni Tube 4 years ago 4 minutes, 13 seconds 5,450 views",Heni Tube,5450,5454,4
292,"Alemseged Abrham [ yebekelu by Heni Tube 4 years ago 4 minutes, 10 seconds 16,940 views",Heni Tube,16940,16970,30
293,"Ethiopia - Nuni Esso - ኑኒ ኢሶ - Ethiopian Music ( Official Video ) by Heni Tube 4 years ago 5 minutes, 32 seconds 113,959 views",Heni Tube,113959,115203,1244
294,"Ethiopia - Dawuro Bana - (Official Video) by Heni Tube 4 years ago 5 minutes, 49 seconds 26,199 views",Heni Tube,26199,26351,152
295,"Ayenew Arega /ከልቤ/ Ethiopian Music  (Official Audio) by Heni Tube 4 years ago 6 minutes, 18 seconds 39,375 views",Heni Tube,39375,39478,103
296,"kifle wosene /ክፍሌ ወሰን/ Dishta Gina   New Ethiopian Music 2017 (Official Video) by Heni Tube 4 years ago 5 minutes, 47 seconds 29,270 views",Heni Tube,29270,29422,152
297,"Jacky Gosee  2017 coming soon - Menalegn yenate - ምን አለኝ የናቴ by Heni Tube 4 years ago 44 seconds 9,402 views",Heni Tube,9402,9412,10
298,"Obsime & Kediro / Eshune Gara Dubaa by Heni Tube 4 years ago 6 minutes, 29 seconds 517,116 views",Heni Tube,517116,520717,3601
299,"አየነዉ አረጋ(ሻሎን) - /ባየሽልኝ / Ethiopian Music (Official Video) by Heni Tube 4 years ago 5 minutes, 57 seconds 146,126 views",Heni Tube,146126,146210,84
300,"Wendiye Abebe ( knota ) /ወንድዬ አበበ / ኮንታ /- Wase Wase / ዋሴ ዋሴ / New Ethiopian Music 2017 (Official by Heni Tube 4 years ago 6 minutes, 55 seconds 172,514 views",Heni Tube,172514,173269,755
301,"Taddassaa Qalbeessa  - Reefu Tolchite [NEW Oromo Music Video 2017] by Heni Tube 4 years ago 4 minutes, 30 seconds 78,520 views",Heni Tube,78520,78572,52
302,"Abarraa Waraquu / EBOKE by Heni Tube 4 years ago 5 minutes, 17 seconds 6,232 views",Heni Tube,6232,6241,9
303,"Mehari Degefaw /መሀሪ ደገፋዉ/- Tana Kegna /ጣና ኬኛ/ New Ethiopian Music 2017 (Official Video) by Heni Tube 4 years ago 4 minutes, 33 seconds 584,570 views",Heni Tube,584570,584813,243
304,"Demeke bitew /ልብ አርግልኝ / Ethiopian Music  (Official Audio) by Heni Tube 4 years ago 6 minutes, 3 seconds 15,567 views",Heni Tube,15567,15583,16
305,"ታሪኩ 80 / አማን/ Ethiopian Music(Official Audio) by Heni Tube 4 years ago 5 minutes, 33 seconds 46,058 views",Heni Tube,46058,46068,10
306,"Baredu Girma  - Jahan Lode [NEW Oromo Music Video 2017] by Heni Tube 4 years ago 6 minutes, 21 seconds 590,338 views",Heni Tube,590338,594196,3858
307,"Zemenu Tadele /ዘመኑ ታደለ /Markeshaw Gojame /ማርከሻው ጐጃሜ / New Ethiopian Music 2017 (Official Video) by Heni Tube 4 years ago 5 minutes, 40 seconds 21,680 views",Heni Tube,21680,21711,31
308,"Yihun shewa Kiros / ይሁን ሸዋ ኪሮስ / Ewedatalehu / እወዳታለሁ/ New Ethiopian Music 2017 (Official Video) by Heni Tube 4 years ago 4 minutes, 2 seconds 13,049 views",Heni Tube,13049,13056,7
309,"Shambel Belayneh / ሻምበል በላይነህ / Anchi Balederi /አንቺ ባለድሪ/ New Ethiopian Music 2017 (Official Video) by Heni Tube 4 years ago 4 minutes, 58 seconds 121,238 views",Heni Tube,121238,121894,656
310,"Seyoum Moges / ስዩም ሞገስ / Zenaye / ዝናዬ / New Ethiopian Music 2017 (Official Video) by Heni Tube 4 years ago 6 minutes, 5 seconds 116,513 views",Heni Tube,116513,118253,1740
311,"Seyuom Moges - ስዩም ሞገስ- Gumaye - ጉማዬ (Official Video) by Heni Tube 4 years ago 6 minutes, 9 seconds 890,422 views",Heni Tube,890422,904625,14203
312,"Maritu Legese / ማሪቱ ለገሰ by Heni Tube 4 years ago 5 minutes, 19 seconds 43,599 views",Heni Tube,43599,43642,43
313,"Girum Kefle/ ግሩም ክፍሌ/-Ney Beluat / ነይ በሏት-Ethiopian Music by Heni Tube 4 years ago 3 minutes, 41 seconds 7,104 views",Heni Tube,7104,7111,7
314,"Yirdaw Tenaw Bemaledaw በማለዳው New Ethiopian Music 2017 Official Video by Heni Tube 4 years ago 5 minutes, 7 seconds 3,034,060 views",Heni Tube,3034060,3034557,497
315,"Seble Feleke - Marsilas - New Ethiopian Music 2017 (Official Video) by Heni Tube 4 years ago 5 minutes, 26 seconds 298,273 views",Heni Tube,298273,298360,87
316,"Heni Tube  to Subscribe 2017 by Heni Tube 4 years ago 18 seconds 2,319 views",Heni Tube,2319,2324,5
317,"Yelefegn Fasil Demoz by Heni Tube 4 years ago 5 minutes, 25 seconds 22,490 views",Heni Tube,22490,22532,42
