,Posts,Channel,Views_03/03,Views_03/12,view_delta
0,"Beki Mean - Shiba | ሺባ - New Ethiopian Music 2022 (Official Video) by Hope Music Ethiopia 21 hours ago 3 minutes, 24 seconds 16,418 views",Hope Music Entertainment,16418,45375,28957
1,"Fikru Alebachew - Alemye | አለምዬ - New Ethiopian Music 2022 (Official Video) by Hope Music Ethiopia 1 day ago 5 minutes, 13 seconds 30,145 views",Hope Music Entertainment,30145,80536,50391
2,"Sami Na - Temechign | ተመችኝ - New Ethiopian Music 2022 (Official Video) by Hope Music Ethiopia 2 days ago 5 minutes, 33 seconds 10,359 views",Hope Music Entertainment,10359,20884,10525
3,"Shimelis Berhanu - Wedjesh | ወድጀሽ - New Ethiopian Music 2022 (Official Video) by Hope Music Ethiopia 3 days ago 5 minutes, 19 seconds 36,819 views",Hope Music Entertainment,36819,87259,50440
4,"Ezra X Stif Lion - Lalay Guma | ላላይ ጉማ - New Ethiopian Music 2022 (Official Video) by Hope Music Ethiopia 4 days ago 3 minutes, 43 seconds 30,296 views",Hope Music Entertainment,30296,39000,8704
5,"Ek Mule - Man Amsh Alew | ማን አምሽ አለው - New Ethiopian Music 2022 (Official Video) by Hope Music Ethiopia 5 days ago 6 minutes, 22 seconds 24,771 views",Hope Music Entertainment,24771,37644,12873
6,"Yemker Sisay - Eje Tibebegna | እጄ ጥበበኛ - New Ethiopian Music 2022 (Official Video) by Hope Music Ethiopia 6 days ago 5 minutes, 24 seconds 35,126 views",Hope Music Entertainment,35126,54347,19221
7,"Adaanuu Geetaachoo - Mirga Galchita - New Ethiopian Oromo Music 2022 (Official Video) by Hope Music Ethiopia 7 days ago 5 minutes, 57 seconds 15,554 views",Hope Music Entertainment,15554,17875,2321
8,"Temesgen Loriso - Higya Echa - New Ethiopian Music 2022 (Official Video) by Hope Music Ethiopia 8 days ago 3 minutes, 33 seconds 53,620 views",Hope Music Entertainment,53620,65339,11719
9,"Mariintol Tolchaa - Wal Mararra - New Ethiopian Oromo  Music 2022 (Official Video) by Hope Music Ethiopia 9 days ago 6 minutes, 56 seconds 15,497 views",Hope Music Entertainment,15497,17233,1736
10,"Demis Asrat - Molalign | ሞላልኝ - New Ethiopian Music 2022 (Official Video) by Hope Music Ethiopia 9 days ago 4 minutes, 30 seconds 11,829 views",Hope Music Entertainment,11829,13621,1792
11,"Abraham Nigatu - Simesh | ስምሽ - New Ethiopian Music 2022 (Official Video) by Hope Music Ethiopia 10 days ago 5 minutes, 29 seconds 23,447 views",Hope Music Entertainment,23447,28931,5484
12,"Yitbarek Abebe - Kalakorash | ካላኮራሽ - New Ethiopian Music 2022 (Official Video) by Hope Music Ethiopia 12 days ago 3 minutes, 52 seconds 66,216 views",Hope Music Entertainment,66216,78328,12112
13,"Ak Zeraf - Libachin | ልባችን - New Ethiopian Music 2022 (Official Video) by Hope Music Ethiopia 13 days ago 4 minutes, 22 seconds 57,736 views",Hope Music Entertainment,57736,71566,13830
14,"Gelaneh Abebe - Aysetim | አይሰጥም - New Ethiopian Music 2022 (Official Video) by Hope Music Ethiopia 2 weeks ago 5 minutes, 51 seconds 48,364 views",Hope Music Entertainment,48364,51876,3512
15,"Redeat Lake - Nama | ናማ - New Ethiopian Music 2022 (Official Video) by Hope Music Ethiopia 2 weeks ago 6 minutes, 16 seconds 45,638 views",Hope Music Entertainment,45638,52829,7191
16,"Samson Tafesse - Wededikuachew | ወደድኳቸው - New Ethiopian Music 2022 (Official Video) by Hope Music Ethiopia 2 weeks ago 4 minutes, 37 seconds 23,238 views",Hope Music Entertainment,23238,24554,1316
17,"Sami & Freweini - Alsetim | አልሰጥም - New Ethiopian Music 2022 (Official Video) by Hope Music Ethiopia 2 weeks ago 5 minutes, 11 seconds 191,871 views",Hope Music Entertainment,191871,231897,40026
18,"Dagim Gudeta - Na Eegi - New Ethiopian Oromo Music 2022 (Official Video) by Hope Music Ethiopia 2 weeks ago 4 minutes, 37 seconds 82,423 views",Hope Music Entertainment,82423,83921,1498
19,"Yigzaw Belay - Beka Engedih | በቃ እንግዲህ - New Ethiopian Music 2022 (Official Video) by Hope Music Ethiopia 2 weeks ago 6 minutes 63,216 views",Hope Music Entertainment,63216,67872,4656
20,"Hagos Girmay - Xewar Aytkuni | ጸዋር ኣይትኹኒ - New Eritrean Music 2022 (Official Video) by Hope Music Ethiopia 3 weeks ago 5 minutes, 28 seconds 43,628 views",Hope Music Entertainment,43628,44983,1355
21,"Christina Melkamu - Che Belew | ቼ በለው - New Ethiopian Music 2022 (Official Video) by Hope Music Ethiopia 3 weeks ago 4 minutes, 5 seconds 145,562 views",Hope Music Entertainment,145562,157209,11647
22,"Liyat Tibebu - Wenda Wendu | ወንዳ ወንዱ - New Ethiopian Music 2022 (Official Video) by Hope Music Ethiopia 3 weeks ago 3 minutes, 50 seconds 101,310 views",Hope Music Entertainment,101310,112691,11381
23,"Bre Bright - Hiriyaa Koo - New Ethiopian Oromo Music 2022 (Official Video) by Hope Music Ethiopia 3 weeks ago 5 minutes, 14 seconds 45,833 views",Hope Music Entertainment,45833,48416,2583
24,"DIDI GAGA - WOZE | ዎዜ - New Ethiopian Music 2022 (Official Video) by Hope Music Ethiopia 3 weeks ago 4 minutes, 15 seconds 778,603 views",Hope Music Entertainment,778603,935748,157145
25,"Yisehak Assefa - Akategn | አቃተኝ - New Ethiopian Music 2022 (Official Video) by Hope Music Ethiopia 3 weeks ago 3 minutes, 41 seconds 68,884 views",Hope Music Entertainment,68884,76064,7180
26,"Zerihun Kebede - Yishal | ይሻል - New Ethiopian Music 2022 (Official Video) by Hope Music Ethiopia 1 month ago 3 minutes, 59 seconds 59,218 views",Hope Music Entertainment,59218,61301,2083
27,"Mastewal teklu - Leman Biye | ለማን ብዬ - New Ethiopian Music 2022 (Official Video) by Hope Music Ethiopia 1 month ago 5 minutes, 36 seconds 245,240 views",Hope Music Entertainment,245240,272253,27013
28,"Wale 96 - Monalisa | ሞናሊዛ - New Ethiopian Music 2022 (Official Video) by Hope Music Ethiopia 1 month ago 3 minutes, 45 seconds 163,413 views",Hope Music Entertainment,163413,178243,14830
29,"Melaku Yakob - Yenega Ken | የነጋ ቀን - New Ethiopian Music 2022 (Official Video) by Hope Music Ethiopia 1 month ago 4 minutes, 14 seconds 34,583 views",Hope Music Entertainment,34583,35216,633
30,"Berhanu Anteneh - Ayneye | አይንየ - New Ethiopian Music 2022 (Official Video) by Hope Music Ethiopia 1 month ago 5 minutes, 17 seconds 38,401 views",Hope Music Entertainment,38401,39106,705
31,"Amanuel Molla - Kene Kibrua | ከነ ክብሯ - New Ethiopian Music 2022 (Official Video) by Hope Music Ethiopia 1 month ago 5 minutes, 33 seconds 46,329 views",Hope Music Entertainment,46329,46983,654
32,"Boontuu Kabbadaa - Barii Waqaa - New Ethiopian Oromo Music 2022 (Official Video) by Hope Music Ethiopia 1 month ago 4 minutes, 55 seconds 35,497 views",Hope Music Entertainment,35497,36896,1399
33,"Fantahun Girma - Engida | እንግዳ - New Ethiopian Music 2022 (Official Video) by Hope Music Ethiopia 1 month ago 4 minutes, 1 second 92,142 views",Hope Music Entertainment,92142,97538,5396
34,"Vanus Zeda - Sakilgn | ሳቂልኝ - New Ethiopian Music 2022 (Official Video) by Hope Music Ethiopia 1 month ago 7 minutes, 59 seconds 512,602 views",Hope Music Entertainment,512602,538096,25494
35,"Toomas Iyyaasuu - Mootii Dubartootaa - New Ethiopian Oromo Music 2022 (Official Video) by Hope Music Ethiopia 1 month ago 4 minutes, 45 seconds 31,611 views",Hope Music Entertainment,31611,32567,956
36,"Abe Koke - Maal Jedhuure - New Ethiopian Oromo Music 2022 (Official Video) by Hope Music Ethiopia 1 month ago 5 minutes, 45 seconds 99,312 views",Hope Music Entertainment,99312,102824,3512
37,"Manalion - Tobiya | ጦቢያ - New Ethiopian Music 2022 (Official Video) by Hope Music Ethiopia 1 month ago 4 minutes 21,709 views",Hope Music Entertainment,21709,21994,285
38,"Melese Tezera - Endalem | እንዳለም - New Ethiopian Music 2022 (Official Video) by Hope Music Ethiopia 1 month ago 5 minutes, 49 seconds 62,011 views",Hope Music Entertainment,62011,63168,1157
39,"Yodit Mekonnen - Emamaye | እማማዬ - New Ethiopian Music 2022 (Official Video) by Hope Music Ethiopia 1 month ago 6 minutes, 24 seconds 49,432 views",Hope Music Entertainment,49432,50160,728
40,"Abenet Girma | Yohannes Berhanu | Endale Abate | Tigist Bazezew - Enatachin - Ethiopian Music 2022 by Hope Music Ethiopia 1 month ago 3 minutes, 50 seconds 24,747 views",Hope Music Entertainment,24747,25097,350
41,"Hana Girma - Keteme | ከተሜ - New Ethiopian Music 2022 (Official Video) by Hope Music Ethiopia 1 month ago 4 minutes, 47 seconds 1,031,143 views",Hope Music Entertainment,1031143,1091501,60358
42,"Tilahun Getachew - Yemar Wuha | የማር ውሃ - New Ethiopian Music 2022 (Official Video) by Hope Music Ethiopia 1 month ago 4 minutes, 26 seconds 355,071 views",Hope Music Entertainment,355071,382659,27588
43,"Anteneh Asrat - Ayfe | አይፌ - New Ethiopian Music 2021 (Official Video) by Hope Music Ethiopia 1 month ago 4 minutes, 14 seconds 29,478 views",Hope Music Entertainment,29478,29838,360
44,"Sara Alemayehu | Selam Alamirew | Betelhem Gashaw - Adirishign | አድርሽኝ - New Ethiopian Music 2022 by Hope Music Ethiopia 1 month ago 3 minutes, 39 seconds 21,980 views",Hope Music Entertainment,21980,22189,209
45,"Redeat Lake - Yasaminew Lij | ያሳምነው ልጅ - New Ethiopian Music 2022 (Official Video) by Hope Music Ethiopia 1 month ago 6 minutes, 26 seconds 146,288 views",Hope Music Entertainment,146288,150977,4689
46,"Abera Abdisa - Sikefaw Enji Ayzo Beata | ሲከፋው እንጂ አይዞ ቢያጣ - New Ethiopian Music 2022 by Hope Music Ethiopia 1 month ago 4 minutes, 10 seconds 26,620 views",Hope Music Entertainment,26620,26937,317
47,"Besufekad Tilahun - Almetam Ney | አልመጣም ነይ - New Ethiopian Music 2022 (Official Video) by Hope Music Ethiopia 1 month ago 4 minutes, 17 seconds 338,611 views",Hope Music Entertainment,338611,346188,7577
48,"Misganaw Bogale - Atenekut | አትንኩት - New Ethiopian Music 2021 (Official Video) by Hope Music Ethiopia 2 months ago 7 minutes, 22 seconds 94,587 views",Hope Music Entertainment,94587,97087,2500
49,"Caalaa Isheetee - Biqiltuu Uumamaa - New Ethiopian Oromo Music 2021 (Official Video) by Hope Music Ethiopia 2 months ago 6 minutes, 1 second 145,360 views",Hope Music Entertainment,145360,150076,4716
50,"Dawit Mengesha - Anchi Tisikialesh | አንቺ ትስቂያለሽ - New Ethiopian Music 2021 (Official Video) by Hope Music Ethiopia 2 months ago 5 minutes, 12 seconds 137,546 views",Hope Music Entertainment,137546,138945,1399
51,"Atsede Mebratu - Embi Ale | እምቢ አለ - New Ethiopian Music 2021 (Official Video) by Hope Music Ethiopia 2 months ago 7 minutes, 22 seconds 46,400 views",Hope Music Entertainment,46400,46954,554
52,"Tilahun Anbese - Dena Hugni | ደና ሁኝ - New Ethiopian Music 2021 (Official Video) by Hope Music Ethiopia 2 months ago 5 minutes, 49 seconds 270,835 views",Hope Music Entertainment,270835,291536,20701
53,"Tomas X Kebad -   Question - New Ethiopian Music 2021 (Official Video) by Hope Music Ethiopia 2 months ago 3 minutes, 13 seconds 64,906 views",Hope Music Entertainment,64906,66090,1184
54,"Atse Nati - Yalfal | ያልፋል - New Ethiopian Music 2021 (Official Video) by Hope Music Ethiopia 2 months ago 5 minutes, 1 second 40,647 views",Hope Music Entertainment,40647,41010,363
55,"Biruk Shewankitaw - Arb Lay Nen | አርብ ላይ ነን - New Ethiopian Music 2021 (Official Video) by Hope Music Ethiopia 2 months ago 6 minutes, 24 seconds 30,691 views",Hope Music Entertainment,30691,30914,223
56,"Tesfaye Sitotaw - Tekuso Aysit | ተኩሶ አይስት - New Ethiopian Music 2021 (Official Video) by Hope Music Ethiopia 2 months ago 6 minutes, 46 seconds 43,740 views",Hope Music Entertainment,43740,44111,371
57,"Gosaa Baacaa - Sansaraanne - New Ethiopian Oromo Music 2021 (Official Video) by Hope Music Ethiopia 2 months ago 5 minutes, 26 seconds 38,249 views",Hope Music Entertainment,38249,39759,1510
58,"Banchiamlak Getnet - Tekegnilet | ተቀኝለት - New Ethiopian Music 2021 (Official Video) by Hope Music Ethiopia 2 months ago 5 minutes, 32 seconds 916,970 views",Hope Music Entertainment,916970,965165,48195
59,"Gamteessaa Abbabaa - Wal Hawwine - New Ethiopian Oromo Music 2021 (Official Video) by Hope Music Ethiopia 2 months ago 5 minutes, 47 seconds 37,780 views",Hope Music Entertainment,37780,38453,673
60,"Abay Wana Wana | ዓባይ ዋና ዋና - New Ethiopian Music 2021 (Official Video) by Hope Music Ethiopia 2 months ago 2 minutes, 34 seconds 41,388 views",Hope Music Entertainment,41388,41695,307
61,"Imajik ft. Lidiya - Min Ale | ምን አለ - New Ethiopian Music 2021 (Official Video) by Hope Music Ethiopia 2 months ago 4 minutes, 20 seconds 11,831 views",Hope Music Entertainment,11831,11952,121
62,"Abebe Berihun - Mamaye | ማማዬ - New Ethiopian Music 2021 (Official Video) by Hope Music Ethiopia 2 months ago 5 minutes, 27 seconds 23,117 views",Hope Music Entertainment,23117,23518,401
63,"Suseneyos Abew - Shiw Shiw | ሽውሽው - New Ethiopian Music 2021 (Official Video) by Hope Music Ethiopia 2 months ago 5 minutes, 2 seconds 30,639 views",Hope Music Entertainment,30639,30881,242
64,"Zemene Melese - Abjalehu | አብጃለሁ - New Ethiopian Music 2021 (Official Video) by Hope Music Ethiopia 2 months ago 5 minutes, 18 seconds 12,776 views",Hope Music Entertainment,12776,12872,96
65,"Kichini Goa - Wedefit Belulet | ወደፊት በሉለት - New Ethiopian Music 2021 (Official Video) by Hope Music Ethiopia 2 months ago 4 minutes, 30 seconds 147,268 views",Hope Music Entertainment,147268,148390,1122
66,"Anteneh Asrat - Kenemaye | ከነማዬ - New Ethiopian Music 2021 (Official Video) by Hope Music Ethiopia 2 months ago 5 minutes, 5 seconds 21,315 views",Hope Music Entertainment,21315,21443,128
67,"Abinet Teshome - Alesh Kidan | አለሽ ኪዳን - New Ethiopian Music 2021 (Official Video) by Hope Music Ethiopia 2 months ago 4 minutes, 17 seconds 32,067 views",Hope Music Entertainment,32067,32222,155
68,"Melico X Dj N - Yehasabe | የሀሳቤ - New Ethiopian Music 2021 (Official Video) by Hope Music Ethiopia 2 months ago 3 minutes, 51 seconds 84,215 views",Hope Music Entertainment,84215,84807,592
69,"Tsegaye Mergiya - Bagere | ባገሬ - New Ethiopian Music 2021 (Official Video) by Hope Music Ethiopia 2 months ago 5 minutes, 41 seconds 63,764 views",Hope Music Entertainment,63764,64008,244
70,"Mekuanent Yazachew - Yeamhara Lij Fano | የአማራ ልጅ ፋኖ - New Ethiopian Music 2021 (Official Video) by Hope Music Ethiopia 2 months ago 6 minutes, 46 seconds 115,138 views",Hope Music Entertainment,115138,120756,5618
71,"Wubishet Dejene - Selam New | ሰላም ነው - New Ethiopian Music 2021 (Official Video) by Hope Music Ethiopia 2 months ago 5 minutes, 11 seconds 31,378 views",Hope Music Entertainment,31378,31624,246
72,"Belay Zeleke - Ethiopia Tineka |  ኢትዮዽያ ትነካ - New Ethiopian Music 2021 (Official Video) by Hope Music Ethiopia 3 months ago 4 minutes, 55 seconds 51,885 views",Hope Music Entertainment,51885,52497,612
73,"Darajjee Katamaa - Farda Koo - New Ethiopian Music 2021 (Official Video) by Hope Music Ethiopia 3 months ago 5 minutes, 35 seconds 20,924 views",Hope Music Entertainment,20924,21053,129
74,"Girma Admasu - Serawitachin | ሰራዊታችን - New Ethiopian Music 2021 (Official Video) by Hope Music Ethiopia 3 months ago 4 minutes, 50 seconds 53,997 views",Hope Music Entertainment,53997,54220,223
75,"Olii Yaadaa (Girmaa) - Maaliif Garuu - New Ethiopian Music 2021 (Official Video) by Hope Music Ethiopia 3 months ago 4 minutes, 30 seconds 583,498 views",Hope Music Entertainment,583498,625493,41995
76,"Eyob Weldesenbet - Ethiopiawit | ኢትዮጵያዊት - New Ethiopian Music 2021 (Official Video) by Hope Music Ethiopia 3 months ago 5 minutes, 21 seconds 17,974 views",Hope Music Entertainment,17974,18073,99
77,"Efrem Gossaye - Yene Mircha | የኔ ምርጫ - New Ethiopian Music 2021 (Official Video) by Hope Music Ethiopia 3 months ago 4 minutes, 21 seconds 71,713 views",Hope Music Entertainment,71713,72134,421
78,"Tekalign Paulos - Neka Bel | ነቃ በል - New Ethiopian Music 2021 (Official Video) by Hope Music Ethiopia 3 months ago 4 minutes, 57 seconds 46,936 views",Hope Music Entertainment,46936,47214,278
79,"Yared Berhanu - Dehna Negn | ደህና ነኝ - New Ethiopian Music 2021 (Official) by Hope Music Ethiopia 3 months ago 5 minutes, 13 seconds 23,581 views",Hope Music Entertainment,23581,23814,233
80,"Samrawit Mebratu ft. Buja Bee - New Chapter - New Ethiopian Music 2021 (Official Video) by Hope Music Ethiopia 3 months ago 3 minutes, 20 seconds 43,851 views",Hope Music Entertainment,43851,44245,394
81,"Endalik Wube - Endih New | እንዲ ነው - New Ethiopian Music 2021 (Official Video) by Hope Music Ethiopia 3 months ago 4 minutes, 16 seconds 261,569 views",Hope Music Entertainment,261569,268064,6495
82,"Mikiyas Girma - Ewedishalehu | እወድሻለሁ - New Ethiopian Music (Official Video) by Hope Music Ethiopia 3 months ago 4 minutes, 34 seconds 147,084 views",Hope Music Entertainment,147084,148714,1630
83,"YABU JC X DAVE AHADU - NEBIY BEHAGERU | ነብይ ባገሩ - New Ethiopian Music 2021 (Official Video) by Hope Music Ethiopia 3 months ago 3 minutes, 16 seconds 21,785 views",Hope Music Entertainment,21785,21898,113
84,"Buja Bee - Gura Bera - New Ethiopian Music 2021 (Official Video) by Hope Music Ethiopia 3 months ago 4 minutes, 2 seconds 24,597 views",Hope Music Entertainment,24597,24925,328
85,"Bisru Moges ft.  Betelhem Abdisa - Tesfegna | ተስፈኛ - New Ethiopian Music 2021 (Official Video) by Hope Music Ethiopia 3 months ago 3 minutes, 27 seconds 32,832 views",Hope Music Entertainment,32832,32966,134
86,"Biruktawit Worku - Edel | እድል - New Ethiopian Music 2021 (Official Video) by Hope Music Ethiopia 3 months ago 3 minutes, 51 seconds 33,097 views",Hope Music Entertainment,33097,33274,177
87,"Amanuel Shimeles - Nishan | ኒሻን - New Ethiopian Music 2021 (Official Video) by Hope Music Ethiopia 3 months ago 3 minutes, 2 seconds 38,312 views",Hope Music Entertainment,38312,38542,230
88,"Temu (Tofan) X Da - Gi - Esua Yene | እሷ የኔ - New Ethiopian Music 2021 (Official Video) by Hope Music Ethiopia 3 months ago 3 minutes, 37 seconds 87,838 views",Hope Music Entertainment,87838,88171,333
89,"Liya Mekonnen - Hiji Hiji | ሂጂ ሂጂ - New Ethiopian Music (Official Video) by Hope Music Ethiopia 3 months ago 4 minutes, 5 seconds 146,411 views",Hope Music Entertainment,146411,147042,631
90,"TZE X EZANA - TAZABI | ታዛቢ - New Ethiopian Music 2021 (Official Video) by Hope Music Ethiopia 3 months ago 2 minutes, 52 seconds 19,148 views",Hope Music Entertainment,19148,19278,130
91,"Guade Shegaw - Atenkut | አትንኩት - New Ethiopian Music 2021 (Official Video) by Hope Music Ethiopia 4 months ago 5 minutes, 33 seconds 20,027 views",Hope Music Entertainment,20027,20132,105
92,"Yeshi Tadesse - Nafekegn | ናፈቀኝ - New Ethiopian Music 2021 (Official Video) by Hope Music Ethiopia 4 months ago 5 minutes 17,730 views",Hope Music Entertainment,17730,17814,84
93,"ROBBIE2K - KENAT | ቅናት - New Ethiopian Music 2021 (Official Video) by Hope Music Ethiopia 4 months ago 2 minutes, 53 seconds 17,951 views",Hope Music Entertainment,17951,18197,246
94,"Micky Hasset - Bezemene | በዘመኔ - New Ethiopian Music 2021 (Official Video) by Hope Music Ethiopia 4 months ago 4 minutes, 47 seconds 68,561 views",Hope Music Entertainment,68561,69739,1178
95,"El Jack - Malo | ማሎ - New Ethiopian Music 2021 (Official Video) by Hope Music Ethiopia 4 months ago 2 minutes, 58 seconds 160,646 views",Hope Music Entertainment,160646,162176,1530
96,"Yeabsira Daniel - Niku Hilme | ንቁ ህልሜ - New Ethiopian Music 2021 (Official Video) by Hope Music Ethiopia 4 months ago 4 minutes, 14 seconds 25,707 views",Hope Music Entertainment,25707,25803,96
97,"Tibebu Asegidew - Yiwesdegnal | ይወስደኛል - New Ethiopian Music 2021 (Official Video) by Hope Music Ethiopia 4 months ago 5 minutes, 4 seconds 90,547 views",Hope Music Entertainment,90547,90985,438
98,"Yonta Boy - Lande | ላንዴ - New Ethiopian Music 2021 (Official Video) by Hope Music Ethiopia 4 months ago 4 minutes, 5 seconds 53,741 views",Hope Music Entertainment,53741,53966,225
99,"Abebe Girma - Siyadersesh Ney | ሲያደርስሽ ነይ - New Ethiopian Music 2021 (Official Video) by Hope Music Ethiopia 4 months ago 5 minutes, 17 seconds 14,032 views",Hope Music Entertainment,14032,14127,95
100,"Saba Berhe - Kante Ga | ካንተ ጋ - New Ethiopian Music 2021 (Official Video) by Hope Music Ethiopia 4 months ago 4 minutes, 23 seconds 58,965 views",Hope Music Entertainment,58965,59695,730
101,"Lidya Endale - Lemin | ለምን - New Ethiopian Music 2021 (Official Video) by Hope Music Ethiopia 4 months ago 4 minutes, 15 seconds 20,985 views",Hope Music Entertainment,20985,21055,70
102,"Kookeet Asaffaa - Irbuu Gootaa - New Ethiopian Oromo Music 2021 (Official Video) by Hope Music Ethiopia 4 months ago 6 minutes, 17 seconds 13,944 views",Hope Music Entertainment,13944,14058,114
103,"Antish ft. Mahi - School Life - New Ethiopian Music 2021 (Official Video) by Hope Music Ethiopia 4 months ago 5 minutes, 11 seconds 711,751 views",Hope Music Entertainment,711751,736634,24883
104,"Ermias Belete - Edelegna | እድለኛ - New Ethiopian Music 2021 (Official Video) by Hope Music Ethiopia 4 months ago 4 minutes, 15 seconds 21,952 views",Hope Music Entertainment,21952,22045,93
105,"Haimanot Awoke - Bilegn | ቢለኝ - New Ethiopian Music 2021 (Official Video) by Hope Music Ethiopia 4 months ago 4 minutes, 33 seconds 250,718 views",Hope Music Entertainment,250718,251987,1269
106,"Netsanet Lema - Teyiw Yilugnal | ተይው ይሉኛል - New Ethiopian Music 2021 (Official Video) by Hope Music Ethiopia 4 months ago 3 minutes, 41 seconds 224,596 views",Hope Music Entertainment,224596,231353,6757
107,"Dave Mesfin - School Day ft. Muna - New Ethiopian Music 2021 (Official Video) by Hope Music Ethiopia 4 months ago 3 minutes, 38 seconds 25,905 views",Hope Music Entertainment,25905,26098,193
108,"Kiros Derbe - Guma | ጉማ - New Ethiopian Music 2021 (Official Video) by Hope Music Ethiopia 4 months ago 5 minutes, 41 seconds 185,543 views",Hope Music Entertainment,185543,189796,4253
109,"Kassahun Gashaye - Bale Diriwa | ባለ ድሪዋ - New Ethiopian Music 2021 (Official Video) by Hope Music Ethiopia 4 months ago 6 minutes, 22 seconds 45,649 views",Hope Music Entertainment,45649,45903,254
110,"Aderajew Gebeyanesh - Liyamegn New | ሊያመኝ ነው - New Ethiopian Music 2021 (Official Video) by Hope Music Ethiopia 4 months ago 6 minutes, 42 seconds 148,180 views",Hope Music Entertainment,148180,149298,1118
111,"Bereket Darik (Beki) - Fikir | ፍቅር - New Ethiopian Music 2021 (Official Video) by Hope Music Ethiopia 4 months ago 5 minutes, 6 seconds 21,659 views",Hope Music Entertainment,21659,21755,96
112,"Aman Eshetu - Kibre | ክብሬ - New Ethiopian Music 2021 (Official Video) by Hope Music Ethiopia 4 months ago 6 minutes 29,043 views",Hope Music Entertainment,29043,29581,538
113,"Temesgen Kebede X Gildo Kassa - Nafkeshignal | ናፍቀሽኛል - New Ethiopian Music 2021 (Official Video) by Hope Music Ethiopia 4 months ago 4 minutes, 18 seconds 195,500 views",Hope Music Entertainment,195500,198334,2834
114,"Hype Little Kid - Baby Chocolate - New Ethiopian Music 2021 (Official Video) by Hope Music Ethiopia 4 months ago 3 minutes, 51 seconds 28,141 views",Hope Music Entertainment,28141,28281,140
115,"Zerihun Mulugeta (Kiya) - Uta Uta Jedibaye | ኡታ ኡታ ጀዲባዬ - New Ethiopian Music 2021 (Official Video) by Hope Music Ethiopia 4 months ago 4 minutes, 44 seconds 60,710 views",Hope Music Entertainment,60710,60956,246
116,"Surafel Girma - Che Endabadagnew | ቼ እንዳባዳኘው - New Ethiopian Music 2021 (Official Video) by Hope Music Ethiopia 4 months ago 5 minutes, 46 seconds 32,968 views",Hope Music Entertainment,32968,33074,106
117,"Tokkichoo Mokonnin - Biiftu Birraa - New Ethiopian Oromo Music 2021 (Official Video) by Hope Music Ethiopia 4 months ago 4 minutes, 30 seconds 22,455 views",Hope Music Entertainment,22455,22651,196
118,"Shambel Belayneh - Jegnaw Wetader | ጀግናው ወታደር  - New Ethiopian Music 2021 (Official Video) by Hope Music Ethiopia 4 months ago 6 minutes, 14 seconds 42,348 views",Hope Music Entertainment,42348,42928,580
119,"Mash ft. Saba Berhe X Gildo Kassa - Tewegn | ተወኝ - New Ethiopian Music 2021 (Official Video) by Hope Music Ethiopia 5 months ago 4 minutes, 46 seconds 231,779 views",Hope Music Entertainment,231779,233228,1449
120,"Tamiru Muluye - Yemar Wuha | የማር ውሃ - New Ethiopian Music 2021 (Official Video) by Hope Music Ethiopia 5 months ago 6 minutes, 21 seconds 61,796 views",Hope Music Entertainment,61796,62032,236
121,"Yared Ayalew - Jegnaw | ጀግናው - New Ethiopian Music 2021 (Official Video) by Hope Music Ethiopia 5 months ago 5 minutes, 11 seconds 53,373 views",Hope Music Entertainment,53373,53648,275
122,"Biniam |  Getahun |  Tamirat  - Ethiopia | ኢትዮዽያ - New Ethiopian  Music 2021 (Official Video) by Hope Music Ethiopia 5 months ago 3 minutes, 34 seconds 38,232 views",Hope Music Entertainment,38232,38294,62
123,"Dagi Boy - Nigeruat | ንገሯት - New Ethiopian Music 2021 (Official Video) by Hope Music Ethiopia 5 months ago 4 minutes, 10 seconds 139,633 views",Hope Music Entertainment,139633,141111,1478
124,"G Zegondar - Endet Neh Amhara | እንዴት ነህ አማራ - New Ethiopian Music 2021 (Official Video) by Hope Music Ethiopia 5 months ago 6 minutes, 41 seconds 79,437 views",Hope Music Entertainment,79437,80233,796
125,"Demeke Bitew - Ere Emama Zenebu | ኧረ እማማ ዘነቡ - New Ethiopian Music 2021 (Official Video) by Hope Music Ethiopia 5 months ago 5 minutes, 48 seconds 374,085 views",Hope Music Entertainment,374085,385698,11613
126,"Binuka - Gido | ጊዶ - New Ethiopian Music 2021 (Official Video) by Hope Music Ethiopia 5 months ago 4 minutes, 4 seconds 104,469 views",Hope Music Entertainment,104469,104885,416
127,"Bililign Beriso & Mekdes Kidu - Kecheleme Semay | ከጨለመ ሰማይ -  Ethiopian Music 2021 (Official Video) by Hope Music Ethiopia 5 months ago 5 minutes, 49 seconds 81,403 views",Hope Music Entertainment,81403,81520,117
128,"Fikreaddis Abeje - Yamermari | ያመርማሪ - New Ethiopian Music 2021 (Official Video) by Hope Music Ethiopia 5 months ago 5 minutes, 12 seconds 140,710 views",Hope Music Entertainment,140710,141116,406
129,"Metages Addisu - Yesatu Gumaj | የሳቱ ጉማጅ - New Ethiopian Music 2021 (Official Video) by Hope Music Ethiopia 5 months ago 5 minutes, 50 seconds 103,694 views",Hope Music Entertainment,103694,104005,311
130,"Maru Dessie - Ende Enat | እንደ እናት - New Ethiopian Music 2021 (Official Video) by Hope Music Ethiopia 5 months ago 5 minutes, 29 seconds 335,116 views",Hope Music Entertainment,335116,338638,3522
131,"Tamiru Muluye - Walta Mager | ዋልታ ማገር - New Ethiopian Music 2021 (Official Video) by Hope Music Ethiopia 5 months ago 6 minutes, 34 seconds 28,478 views",Hope Music Entertainment,28478,28597,119
132,"Abdul Keni - Habesha | ሃበሻ - New Ethiopian Music 2021 (Official Video) by Hope Music Ethiopia 5 months ago 4 minutes, 47 seconds 10,069 views",Hope Music Entertainment,10069,10138,69
133,"Daniel Edime - Fikir New | ፍቅርን ነው - New Ethiopian Music 2021 (Official Video) by Hope Music Ethiopia 5 months ago 5 minutes, 48 seconds 36,075 views",Hope Music Entertainment,36075,36224,149
134,"Getish Mamo - Kedmiya Lehager | ቅድሚያ ለሀገር - New Ethiopian Music 2021 (Official Audio) by Hope Music Ethiopia 5 months ago 5 minutes, 2 seconds 159,954 views",Hope Music Entertainment,159954,160413,459
135,"Fentaye Asmare - Abebayehush | አበባየሁሽ - New Ethiopian Music 2021 (Official Video) by Hope Music Ethiopia 5 months ago 5 minutes, 15 seconds 52,317 views",Hope Music Entertainment,52317,52409,92
136,"Gulummaa Misgaanu - Waliin Bareenna - New Ethiopian Oromo Music 2021 (Official Video) by Hope Music Ethiopia 5 months ago 5 minutes, 37 seconds 36,327 views",Hope Music Entertainment,36327,36908,581
137,"Mulisaa Dhaabaa - Bareeduu Walloo - New Ethiopian Oromo Music 2021 (Official Video) by Hope Music Ethiopia 5 months ago 6 minutes, 28 seconds 17,253 views",Hope Music Entertainment,17253,17362,109
138,"Abera Abdisa - Selam Selam | ሰላም ሰላም - New Ethiopian Music 2021 (Official Video) by Hope Music Ethiopia 5 months ago 4 minutes, 40 seconds 10,256 views",Hope Music Entertainment,10256,10291,35
139,"Gebreshet Bitew - Mekitina Belew | መክትና በለው - New Ethiopian Music 2021 (Official Video) by Hope Music Ethiopia 5 months ago 6 minutes, 25 seconds 568,736 views",Hope Music Entertainment,568736,579622,10886
140,"Biniyaam Girmaa - Eritrea - New Ethiopian Music 2021 (Official Video) by Hope Music Ethiopia 5 months ago 4 minutes, 52 seconds 11,348 views",Hope Music Entertainment,11348,11392,44
141,"Bereket Fisehaye - Yekenyeley | የቀንየለይ - New Eritrean Music 2021 (Official Video) by Hope Music Ethiopia 5 months ago 4 minutes, 38 seconds 24,634 views",Hope Music Entertainment,24634,24837,203
142,"Abel_G_ Rasmitat - Ligitua | ልጅቷ - New Ethiopian Music 2021 (Official Video) by Hope Music Ethiopia 6 months ago 3 minutes, 11 seconds 350,188 views",Hope Music Entertainment,350188,354518,4330
143,"Adonai Derbe - Ande Nen | አንድ ነን - New Ethiopian Music 2021 (Official Video) by Hope Music Ethiopia 6 months ago 6 minutes 20,962 views",Hope Music Entertainment,20962,21025,63
144,"Kefyalew Andualem - Emye | እምዬ - New Ethiopian Music 2021 (Official Video) by Hope Music Ethiopia 6 months ago 6 minutes, 40 seconds 29,737 views",Hope Music Entertainment,29737,29806,69
145,"Bazu Man - Shir Bel Begonder | ሽር ነው በጎንደር - New Ethiopian Music 2021 (Official Video) by Hope Music Ethiopia 6 months ago 6 minutes, 21 seconds 82,630 views",Hope Music Entertainment,82630,83136,506
146,"Tariku Melkamu - Hager Alegn | ሀገር አለኝ - New Ethiopian Music 2021 (Official Video) by Hope Music Ethiopia 6 months ago 5 minutes, 11 seconds 21,521 views",Hope Music Entertainment,21521,21570,49
147,"Henok Challa - Ethiopia Tenesh | ኢትዮዽያ ተነሽ - New Ethiopian Music 2021 (Official Video) by Hope Music Ethiopia 6 months ago 6 minutes, 24 seconds 17,576 views",Hope Music Entertainment,17576,17603,27
148,"Temesgen Yimer - Gesh Abay Negusu | ግሽ አባይ ንጉሱ - New Ethiopian Music 2021 (Official video) by Hope Music Ethiopia 6 months ago 5 minutes, 28 seconds 15,816 views",Hope Music Entertainment,15816,15854,38
149,"Sabawi - Yetu New | የቱ ነው - New Ethiopian Music 2021 (Official Video) by Hope Music Ethiopia 6 months ago 5 minutes, 7 seconds 20,800 views",Hope Music Entertainment,20800,20894,94
150,"Yalew Anley - Neway | ነዋይ - New Ethiopian Music 2021 (Official Video) by Hope Music Ethiopia 6 months ago 5 minutes, 48 seconds 320,295 views",Hope Music Entertainment,320295,323238,2943
151,"Kidda - Hed Yaz | ሂድ ያዝ - New Ethiopian Music 2021 (Official Video) by Hope Music Ethiopia 6 months ago 2 minutes, 39 seconds 20,977 views",Hope Music Entertainment,20977,21090,113
152,"Yeyo - Anchin | አንችን - New Ethiopian Music 2021 (Official Video) by Hope Music Ethiopia 6 months ago 3 minutes, 22 seconds 24,577 views",Hope Music Entertainment,24577,24637,60
153,"Habtamu Alemayehu - Tegefa | ተገፋ - New Ethiopian Music 2021 (Official Video) by Hope Music Ethiopia 6 months ago 5 minutes, 8 seconds 182,759 views",Hope Music Entertainment,182759,183132,373
154,"South Bwoy Nannigoad - Aterakibegn | አትራቂብኝ - New Ethiopian Music 2021 (Official Video) by Hope Music Ethiopia 6 months ago 3 minutes, 33 seconds 150,832 views",Hope Music Entertainment,150832,151184,352
155,"Yenat Fenta Zerihun (Enu) - Hasaben | ሀሳቤን - New Ethiopian Music 2021 (Official Video) by Hope Music Ethiopia 6 months ago 5 minutes, 33 seconds 42,570 views",Hope Music Entertainment,42570,42684,114
156,"Adino Ferede - Kal Yelegnim | ቃል የለኝም - New Ethiopian Music 2021 (Official Video) by Hope Music Ethiopia 6 months ago 4 minutes, 13 seconds 39,531 views",Hope Music Entertainment,39531,39679,148
157,"Dagnew Abate - Keto Aytereter | ከቶ አይጠረጠር - New Ethiopian Music 2021 (Official Video) by Hope Music Ethiopia 6 months ago 5 minutes, 54 seconds 30,880 views",Hope Music Entertainment,30880,31046,166
158,"Ruth Haile - Salkuat | ሳልኳት - New Ethiopian Music 2021 (Official Video) by Hope Music Ethiopia 6 months ago 6 minutes, 26 seconds 65,435 views",Hope Music Entertainment,65435,65616,181
159,"Wendesen Assefa - Dire | ድሬ - New Ethiopian Music 2021 (Official Video) by Hope Music Ethiopia 6 months ago 4 minutes, 52 seconds 39,797 views",Hope Music Entertainment,39797,39940,143
160,"Habtemariam Tsega - Ethiopiawiyan Nen | ኢትዮዽያዊያን ነን - New Ethiopian Music 2021 (Official Video) by Hope Music Ethiopia 7 months ago 6 minutes, 32 seconds 51,421 views",Hope Music Entertainment,51421,51528,107
161,"Eyayu Gebreselassie - Sekela | ሰከላ - New Ethiopian Music 2021 (Official Video) by Hope Music Ethiopia 7 months ago 4 minutes, 16 seconds 66,832 views",Hope Music Entertainment,66832,67034,202
162,"Workineh Tesema - Neyna | ነይና - New Ethiopian Music 2021 (Official Video) by Hope Music Ethiopia 7 months ago 3 minutes, 53 seconds 21,116 views",Hope Music Entertainment,21116,21139,23
163,"Leul Kassu - Honelish Ende | ሆነልሽ እንዴ - New Ethiopian Music 2021 (Official Video) by Hope Music Ethiopia 7 months ago 4 minutes, 35 seconds 300,994 views",Hope Music Entertainment,300994,301437,443
164,"Ras Degnet Zeleke - The Promise Land - New Ethiopian Music 2021 (Official Video) by Hope Music Ethiopia 7 months ago 11 minutes, 19 seconds 47,942 views",Hope Music Entertainment,47942,47999,57
165,"Addis Alemayehu - Tesewresh | ተሰውረሽ - New Ethiopian Music 2021 (Official Video) by Hope Music Ethiopia 7 months ago 5 minutes, 39 seconds 44,255 views",Hope Music Entertainment,44255,44333,78
166,"Mengistu Haile - Wedike Binesa | ወድቄ ብነሳ - New Ethiopian Music 2021 (Official Video) by Hope Music Ethiopia 7 months ago 6 minutes, 41 seconds 41,004 views",Hope Music Entertainment,41004,41082,78
167,"Kassahun Degefaw - Shuk Beyign | ሹክ በይኝ - New Ethiopian Music 2021 (Official Video) by Hope Music Ethiopia 7 months ago 5 minutes, 25 seconds 216,028 views",Hope Music Entertainment,216028,216496,468
168,"Yohannes Getachew - Wey Tenagro | ወይ ተናግሮ - New Ethiopian Music 2021 (Official Video) by Hope Music Ethiopia 7 months ago 4 minutes, 31 seconds 55,122 views",Hope Music Entertainment,55122,55224,102
169,"Weyneshet Ayenew - Habeshanete | ሀበሻነቴ - New Ethiopian Music 2021 (Official Video) by Hope Music Ethiopia 7 months ago 6 minutes, 10 seconds 166,410 views",Hope Music Entertainment,166410,167034,624
170,"Kezira Band - Wuha | ውሃ - New Ethiopian Music 2021 (Official Video) by Hope Music Ethiopia 7 months ago 6 minutes, 22 seconds 19,422 views",Hope Music Entertainment,19422,19462,40
171,"Jonny Almoz - Bahir Dar | ባህር ዳር - New Ethiopian Music 2021 (Official Video) by Hope Music Ethiopia 7 months ago 5 minutes, 34 seconds 96,695 views",Hope Music Entertainment,96695,96865,170
172,"Mechal Weji - Yefeteh Yaleh | የፍትህ ያለህ - New Ethiopian Music 2021 (Official Video) by Hope Music Ethiopia 7 months ago 4 minutes, 9 seconds 22,611 views",Hope Music Entertainment,22611,22642,31
173,"Abadi Kassa - Emama | እማማ - New Ethiopian Music 2021 (Official Video) by Hope Music Ethiopia 7 months ago 4 minutes, 38 seconds 38,628 views",Hope Music Entertainment,38628,38685,57
174,"Dawit Alemayehu - Deg Arege | ደግ አረገ - New Ethiopian Music 2021 (Official Video) by Hope Music Ethiopia 7 months ago 4 minutes, 58 seconds 528,321 views",Hope Music Entertainment,528321,531417,3096
175,"Senedu Alie - Weyolet | ወዮለት - New Ethiopian Music 2021 (Official Video) by Hope Music Ethiopia 7 months ago 6 minutes, 38 seconds 337,127 views",Hope Music Entertainment,337127,338161,1034
176,"Lino Afework -  Natey | ናተይ - New Ethiopian Music 2021 (Official Video) by Hope Music Ethiopia 7 months ago 4 minutes, 23 seconds 93,168 views",Hope Music Entertainment,93168,93359,191
177,"Filimon Ayalew - Fiked Gojam | ፍቀድ ጎጃም - New Ethiopian Music 2021 (Official Video) by Hope Music Ethiopia 7 months ago 7 minutes, 14 seconds 145,508 views",Hope Music Entertainment,145508,146821,1313
178,"Gebrishet Bitew - Aye Engedih | አይ እንግዲህ - New Ethiopian Music 2021 (Official Video) by Hope Music Ethiopia 7 months ago 6 minutes, 22 seconds 336,645 views",Hope Music Entertainment,336645,338955,2310
179,"Yohannes Gezahegn - Jerba Lejerba | ጀርባ ለጀርባ - New Ethiopian Music 2021 (Official Video) by Hope Music Ethiopia 8 months ago 5 minutes, 45 seconds 150,110 views",Hope Music Entertainment,150110,150316,206
180,"Aster Yimer - Amualto Yadelew | አሟልቶ ያደለው - New Ethiopian Music 2021 (Official Video) by Hope Music Ethiopia 8 months ago 5 minutes, 10 seconds 203,128 views",Hope Music Entertainment,203128,203767,639
181,"Lasta Rock - Amen | አሜን - New Ethiopian Music 2021 (Official Video) by Hope Music Ethiopia 8 months ago 3 minutes, 41 seconds 23,138 views",Hope Music Entertainment,23138,23231,93
182,"Yung Mtee - Bang Dong Kel - New Ethiopian Music 2021 (Official Video) by Hope Music Ethiopia 8 months ago 4 minutes, 42 seconds 80,824 views",Hope Music Entertainment,80824,81048,224
183,"Abebe Yitbarek - Yinegal | ይነጋል - New Ethiopian Music 2021 (Official Video) by Hope Music Ethiopia 8 months ago 4 minutes, 48 seconds 71,708 views",Hope Music Entertainment,71708,72018,310
184,"Egoo ft. Fixboy - Ani Kiina Yaa - New Ethiopian Music 2021 (Official Video) by Hope Music Ethiopia 8 months ago 4 minutes, 9 seconds 23,968 views",Hope Music Entertainment,23968,24072,104
185,"Black A - Baby Girl - New Ethiopian Music 2021 (Official Video) by Hope Music Ethiopia 8 months ago 4 minutes, 8 seconds 54,979 views",Hope Music Entertainment,54979,55063,84
186,"Abenet Teshome - Weynua | ወይኗ - New Ethiopian Music 2021 (Official Video) by Hope Music Ethiopia 8 months ago 4 minutes, 43 seconds 115,057 views",Hope Music Entertainment,115057,115279,222
187,"Habtam Nega - Besimu Litera | በስሙ ልጠራ - New Ethiopian Music 2021 (Official Video) by Hope Music Ethiopia 8 months ago 5 minutes, 25 seconds 308,246 views",Hope Music Entertainment,308246,309467,1221
188,"Nequ Wetat - Yitayegnal | ይታየኛል - New Ethiopian Music 2021 (Official Video) by Hope Music Ethiopia 8 months ago 6 minutes, 21 seconds 27,775 views",Hope Music Entertainment,27775,27799,24
189,"Mezzy Alex - Selam Lehagere | ሰላም ለሃገሬ - New Ethiopian Music 2021 (Official Video) by Hope Music Ethiopia 8 months ago 3 minutes, 58 seconds 29,027 views",Hope Music Entertainment,29027,29059,32
190,"Tokichaw - Endanehon Selam | እንዳንሆን ሰላም - New Ethiopian Music 2021 (Official Video) by Hope Music Ethiopia 8 months ago 5 minutes, 56 seconds 744,629 views",Hope Music Entertainment,744629,747486,2857
191,"Temesgen Yimer - Wuchi Badebabay | ውጪ ባደባባይ - New Ethiopian Music 2021 (Official Video) by Hope Music Ethiopia 8 months ago 5 minutes, 40 seconds 31,780 views",Hope Music Entertainment,31780,31867,87
192,"DT MAN - Kanchiga | ካንቺጋ - New Ethiopian Music 2021 (Official Video) by Hope Music Ethiopia 8 months ago 3 minutes, 39 seconds 114,430 views",Hope Music Entertainment,114430,114560,130
193,"Lasta Rock - Amen | አሜን - New Ethiopian Music 2021 (Official Video) by Hope Music Ethiopia 8 months ago 3 minutes, 27 seconds 26,068 views",Hope Music Entertainment,26068,26111,43
194,"Hiki - Erasen | እራሴን - New Ethiopian Music 2021 (Official Video) by Hope Music Ethiopia 8 months ago 2 minutes, 54 seconds 146,776 views",Hope Music Entertainment,146776,146972,196
195,"Du Twins - Esuan Beqne | እሷን በቅኔ - New Ethiopian Music 2021 (Official Video) by Hope Music Ethiopia 8 months ago 4 minutes, 53 seconds 25,280 views",Hope Music Entertainment,25280,25330,50
196,"Ashenafi T/Haimanot - Wey Gize | ወይ ጊዜ - New Ethiopian Music 2021 (Official Video) by Hope Music Ethiopia 8 months ago 6 minutes, 48 seconds 131,699 views",Hope Music Entertainment,131699,132346,647
197,"Sami Zerihun - Hewan | ሄዋን - New Eritrean & Ethiopian Music 2021 (Official Video) by Hope Music Ethiopia 8 months ago 3 minutes, 48 seconds 201,072 views",Hope Music Entertainment,201072,201292,220
198,"Dawit Bekele - Andua | አንዷ - New Ethiopian Music 2021 (Official Video) by Hope Music Ethiopia 8 months ago 5 minutes, 12 seconds 192,326 views",Hope Music Entertainment,192326,193074,748
199,"Adinew Ferede - Wezewezegn | ወዘወዘኝ - New Ethiopian Music 2021 (Official Video) by Hope Music Ethiopia 8 months ago 5 minutes, 24 seconds 50,605 views",Hope Music Entertainment,50605,50740,135
200,"Lwam Amanuel - Aynfelale | አይንፈላለ - New Eritrean Music 2021 (Official Video) by Hope Music Ethiopia 9 months ago 4 minutes, 5 seconds 44,354 views",Hope Music Entertainment,44354,44416,62
201,"Robel Tesfaselassie - Sebeay Kun | ሰብኣይ ኩን - New Eritrean Music 2021 (Official video) by Hope Music Ethiopia 9 months ago 4 minutes, 48 seconds 63,082 views",Hope Music Entertainment,63082,63155,73
202,"Clinton - Etege | እቴጌ - New Ethiopian Music 2021 (Official Video) by Hope Music Ethiopia 9 months ago 4 minutes, 11 seconds 30,028 views",Hope Music Entertainment,30028,30097,69
203,"Belsam X Alexander - Gudu Fela | ጉዱ ፈላ - New Ethiopian Music 2021 (Official video) by Hope Music Ethiopia 9 months ago 4 minutes, 15 seconds 110,738 views",Hope Music Entertainment,110738,111082,344
204,"Alazar Teklie ft. Junyad - De Bel Ande | ዴ በል አንዴ - New Ethiopian Music 2021 (Official Video) by Hope Music Ethiopia 9 months ago 4 minutes, 13 seconds 759,540 views",Hope Music Entertainment,759540,765554,6014
205,"Dallak - Ethiopiawi | ኢትዮዽያዊ - New Ethiopian Music 2021 (Official Video) by Hope Music Ethiopia 9 months ago 4 minutes, 9 seconds 100,888 views",Hope Music Entertainment,100888,101049,161
206,"Menechil Fantahun - Tigba Guadaye | ትግባ ጓዳዬ - New Ethiopian Music 2021 (Official Video) by Hope Music Ethiopia 9 months ago 6 minutes 32,624 views",Hope Music Entertainment,32624,32852,228
207,"Boruufan Dobocii (Masfin) - Biyya Koo Hin Diigu - New Ethiopian Music 2021 (Official Video) by Hope Music Ethiopia 9 months ago 6 minutes, 25 seconds 13,420 views",Hope Music Entertainment,13420,13431,11
208,"Hailemariam Alemaw - Cherekaye | ጨረቃዬ - New Ethiopian Music 2021 (Official Video) by Hope Music Ethiopia 9 months ago 5 minutes, 58 seconds 19,103 views",Hope Music Entertainment,19103,19135,32
209,"Masfin Damisuu - Abbaatu Cufata - New Ethiopian Music 2021 (Official Video) by Hope Music Ethiopia 9 months ago 5 minutes, 40 seconds 14,891 views",Hope Music Entertainment,14891,14913,22
210,"El Jack - Ande | አንዴ - New Ethiopian Music 2021 (Official Video) by Hope Music Ethiopia 9 months ago 3 minutes, 12 seconds 340,389 views",Hope Music Entertainment,340389,342604,2215
211,"Saba Berhe - Alewedem | አልወድም - New Ethiopian Music 2021 (Official Video) by Hope Music Ethiopia 9 months ago 5 minutes, 10 seconds 175,059 views",Hope Music Entertainment,175059,175458,399
212,"Estifo X @ NI - Enenete | እኔነቴ - New Ethiopian Music 2021 (Official Video) by Hope Music Ethiopia 9 months ago 4 minutes, 10 seconds 20,411 views",Hope Music Entertainment,20411,20458,47
213,"Flora Samson - Musika | ሙዚቃ - New Ethiopian Music 2021 (Official Video) by Hope Music Ethiopia 9 months ago 2 minutes, 55 seconds 37,742 views",Hope Music Entertainment,37742,37919,177
214,"Lij Michael, Fikreaddis Nekatibeb, Kuku Sebsebe, Zeritu Kebede, Sayat, Rahel Getu - Yehager Kasma by Hope Music Ethiopia 9 months ago 6 minutes, 6 seconds 117,709 views",Hope Music Entertainment,117709,118534,825
215,"Habtaamuu Galaan - Raadiyoonii Hin Quabu - New Ethiopian Oromo Music 2021 (Official Video) by Hope Music Ethiopia 9 months ago 4 minutes, 57 seconds 15,502 views",Hope Music Entertainment,15502,15561,59
216,"Betty G/Mariam - Gedamu | ገዳሙ - New Ethiopian Music 2021 (Official Video) by Hope Music Ethiopia 9 months ago 4 minutes, 6 seconds 218,544 views",Hope Music Entertainment,218544,219067,523
217,"Eyerusalem | Gelila | Negasi 7 Gize 70 | ሰባት ጊዜ ሰባ - New Ethiopian Music 2021 (Official Video) by Hope Music Ethiopia 9 months ago 4 minutes, 48 seconds 23,988 views",Hope Music Entertainment,23988,24024,36
218,"Chane Niguse - Ende Anbesa | እንደ አንበሳ - New Ethiopian Music 2021 (Official Video) by Hope Music Ethiopia 9 months ago 5 minutes, 26 seconds 49,111 views",Hope Music Entertainment,49111,49428,317
219,"Debrework Gashaw - Awdamet | አውዳመት - New Ethiopian Music 2021 (Official Video) by Hope Music Ethiopia 9 months ago 5 minutes, 12 seconds 34,613 views",Hope Music Entertainment,34613,34672,59
220,"KALS -T thewordsmith - ENAT | እናት (Feat. TRU3) (Lijeshen Tawkyalesh) - New Ethiopian Music 2021 by Hope Music Ethiopia 9 months ago 4 minutes, 33 seconds 17,936 views",Hope Music Entertainment,17936,18060,124
221,"Leul Getaneh - Asbeshalehu | አስብሻለሁ - New Ethiopian Music 2021 (Official Video) by Hope Music Ethiopia 9 months ago 4 minutes, 27 seconds 24,612 views",Hope Music Entertainment,24612,24663,51
222,"Kepaso - Anferam | አንፈራም - New Ethiopian Music 2021 (Official Video) by Hope Music Ethiopia 9 months ago 5 minutes, 27 seconds 98,718 views",Hope Music Entertainment,98718,99162,444
223,"Addis Leggesse - Enjori | እንጆሪ - New Ethiopian Music 2021 (Official Video) by Hope Music Ethiopia 9 months ago 5 minutes, 19 seconds 5,250,738 views",Hope Music Entertainment,5250738,5312969,62231
224,"Yabu Jc - 8000 Intro - New Ethiopian Music 2021 (Official Video) by Hope Music Ethiopia 9 months ago 2 minutes, 48 seconds 12,474 views",Hope Music Entertainment,12474,12516,42
225,"Birhanu Chala - Endanleyay | እንዳንለያይ - New Ethiopian Music 2021 (Official Video) by Hope Music Ethiopia 9 months ago 4 minutes, 30 seconds 147,522 views",Hope Music Entertainment,147522,147812,290
226,"Urjii Salamoon (Miilkii) - Yaa Barashee - New Ethiopian Oromo Music 2021 (Official Videos) by Hope Music Ethiopia 9 months ago 6 minutes, 15 seconds 28,008 views",Hope Music Entertainment,28008,28205,197
227,"Nahom Yohannes - Selam Kunuley | ሰላም ኩኑለይ - New Eritrean Music 2021 (Official Video) by Hope Music Ethiopia 10 months ago 4 minutes, 18 seconds 1,674,586 views",Hope Music Entertainment,1674586,1703868,29282
228,"KB + Lil Tomi - Yinegal | ይነጋል - New Ethiopian Music 2021 (Official Video) by Hope Music Ethiopia 10 months ago 3 minutes, 55 seconds 21,887 views",Hope Music Entertainment,21887,21924,37
229,"Bura Man - Terejign | ተረጂኝ - New Ethiopian Music 2021 (Official Video) by Hope Music Ethiopia 10 months ago 3 minutes, 26 seconds 130,860 views",Hope Music Entertainment,130860,130957,97
230,"Techane Getaneh - Amen Yimaresh | አሜን ይማርሽ - New Ethiopian Music 2021 (Official Video) by Hope Music Ethiopia 10 months ago 5 minutes, 33 seconds 28,278 views",Hope Music Entertainment,28278,28316,38
231,"Tatek Tamirat - Liyu Negn | ልዩ ነኝ - New Ethiopian Music 2021 (Official Video) by Hope Music Ethiopia 10 months ago 4 minutes, 29 seconds 25,847 views",Hope Music Entertainment,25847,25925,78
232,"Wesene Cheru - Alesemama | አልሰማማ - New Ethiopian Music 2021 (Official Video) by Hope Music Ethiopia 10 months ago 4 minutes, 27 seconds 42,166 views",Hope Music Entertainment,42166,42257,91
233,"Wubeshet Awegechew - Gizat | ግዛት - New Ethiopian Music 2021 (Official Video) by Hope Music Ethiopia 10 months ago 4 minutes, 45 seconds 102,649 views",Hope Music Entertainment,102649,103102,453
234,"Gizachew Teshome - Lijewa | ልጄዋ - Ethiopian Music 2021 (Official Video) | Adey TV Drama Soundtrack by Hope Music Ethiopia 10 months ago 3 minutes, 32 seconds 266,681 views",Hope Music Entertainment,266681,271807,5126
235,"Andualem Ayalew - Beshewalay Dessie | በሸዋላይ ደሴ - New Ethiopian Music 2021 (Official Video) by Hope Music Ethiopia 10 months ago 4 minutes, 47 seconds 52,690 views",Hope Music Entertainment,52690,52935,245
236,"Yabu T - Yastawkal - New Ethiopian Music 2021 (Official Video) by Hope Music Ethiopia 10 months ago 3 minutes, 54 seconds 98,781 views",Hope Music Entertainment,98781,99110,329
237,"Yabiana - Salteweh | ሳልተውህ - New Ethiopian Music 2021 (Official Video) by Hope Music Ethiopia 10 months ago 4 minutes, 29 seconds 45,686 views",Hope Music Entertainment,45686,45716,30
238,"Tesfaye | Tesfamichael | Delena | Arsema - Abay | አባይ - New Ethiopian Music 2021 (Official Video) by Hope Music Ethiopia 10 months ago 5 minutes, 52 seconds 14,381 views",Hope Music Entertainment,14381,14397,16
239,"Zeget Dejene - Selam Lehagerachin | ሰላም ለሀገራችን - New Ethiopian Music 2021 (Official Video) by Hope Music Ethiopia 10 months ago 5 minutes, 15 seconds 30,918 views",Hope Music Entertainment,30918,30984,66
240,"Bitanya - Ethiopia | ኢትዮጵያ - New Ethiopian Music 2021 (Official Video) by Hope Music Ethiopia 10 months ago 3 minutes, 40 seconds 58,002 views",Hope Music Entertainment,58002,58345,343
241,"Etu Mengistu - Wey Gude | ወይ ጉዴ - New Ethiopian Music 2021 (Official Video) by Hope Music Ethiopia 10 months ago 4 minutes, 25 seconds 28,541 views",Hope Music Entertainment,28541,28621,80
242,"Abebe Berihun - Malka | ማልካ - New Ethiopian Music 2021 (Official Video) by Hope Music Ethiopia 10 months ago 6 minutes, 58 seconds 368,648 views",Hope Music Entertainment,368648,371541,2893
243,"Takele Tsegaye - Tega Bey | ጠጋ በይ - New Ethiopian Music 2021 (Official Video) by Hope Music Ethiopia 10 months ago 3 minutes, 36 seconds 39,597 views",Hope Music Entertainment,39597,39692,95
244,"Mesfin Beze - Yeken Chelema | የቀን ጨለማ - New Ethiopian Music 2021 (Official Video) by Hope Music Ethiopia 10 months ago 5 minutes, 16 seconds 19,318 views",Hope Music Entertainment,19318,19374,56
245,"Yared Kassa - Yegize Guday | የጊዜ ጉዳይ - New Ethiopian Music 2021 (Official Video) by Hope Music Ethiopia 11 months ago 4 minutes, 26 seconds 15,729 views",Hope Music Entertainment,15729,15756,27
246,"Hewan Girmay - Nayman | ናይማን - New Ethiopian Tigrigna Music 2021 (Official Video) by Hope Music Ethiopia 11 months ago 4 minutes, 11 seconds 87,952 views",Hope Music Entertainment,87952,88032,80
247,"Simon AG - Almazeye | አልማዝዬ - New Ethiopian Music 2021 (Official Video) by Hope Music Ethiopia 11 months ago 4 minutes, 1 second 33,537 views",Hope Music Entertainment,33537,33584,47
248,"King Teddy X Passion Dance Group - Tey Birqe | ተይ ብርቄ - New Ethiopian Music 2021 (Official Video) by Hope Music Ethiopia 11 months ago 3 minutes, 15 seconds 40,802 views",Hope Music Entertainment,40802,40829,27
249,"Abeba Demeke - Gebreye | ገብርዬ - New Ethiopian Music 2021 (Official Video) by Hope Music Ethiopia 11 months ago 3 minutes, 57 seconds 55,308 views",Hope Music Entertainment,55308,55534,226
250,"J.Y ft. Nahom Mekuaria & Fixboy - Follow Me - New Ethiopian Music 2021 (Official Video) by Hope Music Ethiopia 11 months ago 3 minutes, 57 seconds 82,796 views",Hope Music Entertainment,82796,82926,130
251,"Abebaw Ayana - Yehagere LIj | የሀገሬ ልጅ - New Ethiopian Music 2021 (Official Video) by Hope Music Ethiopia 11 months ago 6 minutes, 17 seconds 47,116 views",Hope Music Entertainment,47116,47192,76
252,"Tegegne Dinberu - Enat Hagere | እናት ሃገሬ - New Ethiopian Music 2021 (Official Video) by Hope Music Ethiopia 11 months ago 5 minutes, 17 seconds 19,910 views",Hope Music Entertainment,19910,19960,50
253,"Ella Man X Abenet X YD X Kebad Anbesa - Birr | ብር - New Ethiopian Music 2021 (Official Audio) by Hope Music Ethiopia 11 months ago 3 minutes, 56 seconds 58,624 views",Hope Music Entertainment,58624,59038,414
254,"Freweini Atsbeha - Zawine | ዛዊነ - New Ethiopian Tigrigna Music 2021 (Official Video) by Hope Music Ethiopia 11 months ago 4 minutes, 24 seconds 23,632 views",Hope Music Entertainment,23632,23664,32
255,"Yeheyes Ayele - Beka | በቃ - New Ethiopian Music 2021 (Official Video) by Hope Music Ethiopia 11 months ago 4 minutes, 54 seconds 225,402 views",Hope Music Entertainment,225402,225745,343
256,"Eyob - Emawkew Esuan New | እማውቀው እሱዋን ነው - New Ethiopian Music 2021 (Official Video) by Hope Music Ethiopia 11 months ago 4 minutes, 47 seconds 15,769 views",Hope Music Entertainment,15769,15787,18
257,"Surafelab Mahteb - Ye Ehhh Nafkotu | የእህ ናፍቆቱ - New Ethiopian Music 2021 (Official Video) by Hope Music Ethiopia 11 months ago 5 minutes, 42 seconds 59,627 views",Hope Music Entertainment,59627,59750,123
258,"Yabu Jc - Ethiopia | ኢትዮጵያ - New Ethiopian Music 2021 (Official Video) by Hope Music Ethiopia 11 months ago 2 minutes, 48 seconds 23,668 views",Hope Music Entertainment,23668,23714,46
259,"Elias Teshome - Hode | ሆዴ - New Ethiopian Music 2021 (Official Video) by Hope Music Ethiopia 11 months ago 4 minutes, 30 seconds 531,494 views",Hope Music Entertainment,531494,534789,3295
260,"Wubet Mekonen - Yene Fikir | የኔ ፍቅር - New Ethiopian Music 2021 (Official Video) by Hope Music Ethiopia 11 months ago 4 minutes, 45 seconds 67,820 views",Hope Music Entertainment,67820,68024,204
261,"Addis Geetuu - Nagaa - New Ethiopian Music 2021 (Official Video) by Hope Music Ethiopia 11 months ago 5 minutes, 55 seconds 15,227 views",Hope Music Entertainment,15227,15259,32
262,"Way Squer - Waato Ta - New Ethiopian Music 2021 (Official Video) by Hope Music Ethiopia 11 months ago 4 minutes, 10 seconds 19,249 views",Hope Music Entertainment,19249,19294,45
263,"Worku Molla - Enjalign | እንጃልኝ - New Ethiopian Music 2021 (Official Video) by Hope Music Ethiopia 11 months ago 5 minutes, 10 seconds 480,253 views",Hope Music Entertainment,480253,488598,8345
264,"Yalew Anley - Gojam Wemberma | ጎጃም ወምበርማ - New Ethiopian Music 2021 (Official Video) by Hope Music Ethiopia 11 months ago 7 minutes, 55 seconds 80,507 views",Hope Music Entertainment,80507,81005,498
265,"Mulusew Addis - Gelagle | ገላግሌ - New Ethiopian Music 2021 (Official Video) by Hope Music Ethiopia 11 months ago 5 minutes, 45 seconds 54,149 views",Hope Music Entertainment,54149,54335,186
266,"Muller Mesfin - Karamara | ካራማራ - New Ethiopian Music 2021 (Official Video) by Hope Music Ethiopia 11 months ago 4 minutes, 18 seconds 27,511 views",Hope Music Entertainment,27511,27983,472
267,"Beki Buze - Eyulegn | እዩልኝ - New Ethiopian Music 2021 (Official Video) by Hope Music Ethiopia 11 months ago 5 minutes, 24 seconds 63,924 views",Hope Music Entertainment,63924,64037,113
268,"Tamirat Dereb & Yeabsera Seifu - Mekea | ሜከአ - New Ethiopian Music 2021 (Official Video) by Hope Music Ethiopia 11 months ago 5 minutes, 28 seconds 35,168 views",Hope Music Entertainment,35168,35211,43
269,"Yehualaw Admas - Feraw | ፈራው - New Ethiopian Music 2021 (Official Video) by Hope Music Ethiopia 11 months ago 5 minutes, 32 seconds 50,634 views",Hope Music Entertainment,50634,50772,138
270,"Ermias Zerihun - Habeley | ሀብለይ - New Ethiopian Music 2021 (Official Video) by Hope Music Ethiopia 1 year ago 4 minutes, 44 seconds 28,128 views",Hope Music Entertainment,28128,28160,32
271,"Esubalew Yetayew - Yichatna Lijit | ይቻትና ልጅት - New Ethiopian Music 2021 (Official Video) by Hope Music Ethiopia 1 year ago 4 minutes, 13 seconds 1,004,993 views",Hope Music Entertainment,1004993,1008307,3314
272,"Tilahun Gessesse - Kome Limerkish | ቆሜ ልመርቅሽ - New Ethiopian Music 2021 (Official Video) by Hope Music Ethiopia 1 year ago 6 minutes, 48 seconds 3,182,084 views",Hope Music Entertainment,3182084,3203062,20978
273,"Shibabaw Yehune - Yeleshim | የለሽም - New Ethiopian Music 2021 (Official Video) by Hope Music Ethiopia 1 year ago 6 minutes, 19 seconds 63,708 views",Hope Music Entertainment,63708,64024,316
274,"Elsa Mendaye - Nebelbal | ነበልባል - New Ethiopian Music 2021 (Official Video) by Hope Music Ethiopia 1 year ago 6 minutes, 18 seconds 22,708 views",Hope Music Entertainment,22708,22803,95
275,"Malkaamuu Camadaa - MAQAAKEE - New Ethiopian Music (Official Video) by Hope Music Ethiopia 1 year ago 6 minutes, 11 seconds 21,233 views",Hope Music Entertainment,21233,21248,15
276,"Mekdem Sebsebe - Yihon Wey | ይሆን ወይ - New Ethiopian Music 2021 (Official Video) by Hope Music Ethiopia 1 year ago 4 minutes, 20 seconds 33,326 views",Hope Music Entertainment,33326,33376,50
277,"Abyssinia ft. Lula Man - Neylign | ነይልኝ - New Ethiopian Music 2021 (Official Video) by Hope Music Ethiopia 1 year ago 3 minutes, 43 seconds 43,396 views",Hope Music Entertainment,43396,43499,103
278,"Delingo - Match up de place ft. Mad (Official Video) by Hope Music Ethiopia 1 year ago 3 minutes, 55 seconds 21,222 views",Hope Music Entertainment,21222,21251,29
279,"Sisay Demoz - Sew Negn | ሰው ነኝ - New Ethiopian Music 2021 (Official Video) by Hope Music Ethiopia 1 year ago 7 minutes, 8 seconds 186,608 views",Hope Music Entertainment,186608,187537,929
280,"Aynalem Asmamaw - Altazezem | አልታዘዝም - New Ethiopian Music 2021 (Official Video) by Hope Music Ethiopia 1 year ago 4 minutes, 58 seconds 148,924 views",Hope Music Entertainment,148924,149770,846
281,"Henok Ekubamichael - Sew Yaweral | ሰው ያወራል - New Ethiopian Music 2021 (Official Video) by Hope Music Ethiopia 1 year ago 5 minutes, 27 seconds 62,554 views",Hope Music Entertainment,62554,62723,169
282,"Zenebe Worku - Konjo | ቆንጆ - New Ethiopian Music 2021 (Official Video) by Hope Music Ethiopia 1 year ago 5 minutes, 59 seconds 661,660 views",Hope Music Entertainment,661660,668370,6710
283,"Ashenafi Mubarek ft. 5A - Endamelua | እንደ አመሏ - New Ethiopian Music 2021 (Official video) by Hope Music Ethiopia 1 year ago 4 minutes, 11 seconds 40,922 views",Hope Music Entertainment,40922,40950,28
284,"Blatenaw - Blatenaw | ብላቴናው - New Ethiopian Music 2021 (Official Audio) by Hope Music Ethiopia 1 year ago 3 minutes, 55 seconds 12,507 views",Hope Music Entertainment,12507,12641,134
285,"Blatenaw - Manenet | ማንነት - New Ethiopian Music 2021 (Official Audio) by Hope Music Ethiopia 1 year ago 3 minutes, 52 seconds 8,970 views",Hope Music Entertainment,8970,9068,98
286,"Blatenaw x Ed Tadesse - Sayew | ሳየው - New Ethiopian Music 2021 (Official Audio) by Hope Music Ethiopia 1 year ago 3 minutes, 37 seconds 6,568 views",Hope Music Entertainment,6568,6612,44
287,"Blatenaw x Ed Tadesse - Ersat | እርሳት - New Ethiopian Music 2021 (Official Audio) by Hope Music Ethiopia 1 year ago 3 minutes, 30 seconds 10,422 views",Hope Music Entertainment,10422,10467,45
288,"Blatenaw x Ed Tadesse - Endegebagn | እንደገባኝ - New Ethiopian Music 2021 (Official Audio) by Hope Music Ethiopia 1 year ago 3 minutes, 39 seconds 8,394 views",Hope Music Entertainment,8394,8465,71
289,"Blatenaw x Ed Tadesse  - Caredash | ኬረዳሽ - New Ethiopian Music (Official Audio) by Hope Music Ethiopia 1 year ago 3 minutes, 30 seconds 5,556 views",Hope Music Entertainment,5556,5595,39
290,"Esubalew II - Hulet Getse | ሁለት ገፅ - New Ethiopian Music 2021 (Official Video) by Hope Music Ethiopia 1 year ago 3 minutes, 28 seconds 17,144 views",Hope Music Entertainment,17144,17187,43
291,"Anteneh Mandefro - Atemechim Wey | አትመጪም ወይ - New Ethiopian Music 2021 (Official Video) by Hope Music Ethiopia 1 year ago 4 minutes, 29 seconds 19,913 views",Hope Music Entertainment,19913,19956,43
292,"Dawit Alemayehu - Yefikir Guday | የፍቅር ጉዳይ - New Ethiopian Music 2021 (Official Video) by Hope Music Ethiopia 1 year ago 7 minutes, 7 seconds 490,124 views",Hope Music Entertainment,490124,492915,2791
293,"Tesfaye Negatu - Eyamemegn | እያመመኝ - New Ethiopian Music 2021 (Official Video) by Hope Music Ethiopia 1 year ago 6 minutes, 32 seconds 159,574 views",Hope Music Entertainment,159574,160817,1243
294,"Menetamir Dilenesa - Mardaye | ማርዳዬ - New Ethiopian Music 2021 (Official Video) by Hope Music Ethiopia 1 year ago 5 minutes, 35 seconds 336,305 views",Hope Music Entertainment,336305,336914,609
295,"ZERO X EZU - Nezret New Amele | ንዝረት ነው አመሌ - New Ethiopian Music 2021 (Official Video) by Hope Music Ethiopia 1 year ago 3 minutes, 54 seconds 41,715 views",Hope Music Entertainment,41715,41743,28
296,"LK X LIA - Kedeme | ቀድሜ - New Ethiopian Music 2021 (Official Video) by Hope Music Ethiopia 1 year ago 3 minutes, 13 seconds 113,352 views",Hope Music Entertainment,113352,113547,195
297,"Eseytey Fantu - Hasab | ሀሳብ - New Ethiopian Music 2021 (Official Video) by Hope Music Ethiopia 1 year ago 4 minutes, 49 seconds 46,124 views",Hope Music Entertainment,46124,46206,82
298,"Worku Molla - Serg | ሰርግ - New Ethiopian Music 2021 (Official Video) by Hope Music Ethiopia 1 year ago 6 minutes, 26 seconds 274,699 views",Hope Music Entertainment,274699,276676,1977
299,"Sara T - Yemimosherew | የምሞሸረው - New Ethiopian Music 2021 (Official Video) by Hope Music Ethiopia 1 year ago 3 minutes, 24 seconds 1,220,916 views",Hope Music Entertainment,1220916,1223729,2813
300,"Yalew Anley - Ehete | እህቴ - New Ethiopian Music 2021 (Official Video) by Hope Music Ethiopia 1 year ago 5 minutes, 20 seconds 122,410 views",Hope Music Entertainment,122410,123099,689
301,"Girmaw Admasu - Serawitachin | ሰራዊታችን - New Ethiopian Music 2021 (Official Video) by Hope Music Ethiopia 1 year ago 6 minutes, 22 seconds 38,113 views",Hope Music Entertainment,38113,38240,127
302,"Abeba Demeke - Ezezegn | እዘዘኝ - New Ethiopian Music 2021 (Official Video) by Hope Music Ethiopia 1 year ago 4 minutes, 45 seconds 42,039 views",Hope Music Entertainment,42039,42112,73
303,"Fereweyni Atsbeha - Deqi Hanti Ado | ደቂ ሓንቲ ኣዶ - New Ethiopian Music 2021 (Official Video) by Hope Music Ethiopia 1 year ago 3 minutes, 48 seconds 28,868 views",Hope Music Entertainment,28868,28883,15
304,"Biruk Gizaw - Holla | ሆላ - New Ethiopian Music 2021 (Official Video) by Hope Music Ethiopia 1 year ago 4 minutes 66,868 views",Hope Music Entertainment,66868,67144,276
305,"Veronica Adane & Negestat - Abay mado | አባይ ማዶ - New Ethiopian Music 2021 (Official Video) by Hope Music Ethiopia 1 year ago 4 minutes, 56 seconds 1,777,675 views",Hope Music Entertainment,1777675,1786209,8534
306,"Burik - Bla Bla | ብላ ብላ - New Ethiopian Music 2021 (Official Video) by Hope Music Ethiopia 1 year ago 4 minutes, 18 seconds 2,511,910 views",Hope Music Entertainment,2511910,2536424,24514
307,"Abraham Mamo - Welawuye | ወላውዬ - New Ethiopian Music 2021 (Official Video) by Hope Music Ethiopia 1 year ago 4 minutes, 58 seconds 52,656 views",Hope Music Entertainment,52656,52733,77
308,"DJ Yemi X ATNI - Eri Bel | እሪ በል - New Ethiopian Music 2021 (Official Audio) by Hope Music Ethiopia 1 year ago 3 minutes, 43 seconds 16,241 views",Hope Music Entertainment,16241,16278,37
309,"DJ Yemi X ATNI - Yet | የት - New Ethiopian Music 2021 (Official Audio) by Hope Music Ethiopia 1 year ago 2 minutes, 54 seconds 10,602 views",Hope Music Entertainment,10602,10621,19
310,"DJ Yemi X ATNI - Wude | ውዴ - New Ethiopian Music 2021 (Official Audio) by Hope Music Ethiopia 1 year ago 2 minutes, 48 seconds 8,351 views",Hope Music Entertainment,8351,8380,29
311,"Kaleb Arayaselase - Lalaye | ላላዬ - New Ethiopian Music 2021 (Official Video) by Hope Music Ethiopia 1 year ago 4 minutes, 51 seconds 797,234 views",Hope Music Entertainment,797234,801970,4736
312,"Girum Asfaw - Kahnatu | ካህናቱ - New Ethiopian Music 2021 (Official Video) by Hope Music Ethiopia 1 year ago 6 minutes, 8 seconds 50,996 views",Hope Music Entertainment,50996,51029,33
313,"DJ Yemi X ATNI ft.  Rahel - Enate | እናቴ - New Ethiopian Music 2021 (Official Audio) by Hope Music Ethiopia 1 year ago 3 minutes, 12 seconds 14,924 views",Hope Music Entertainment,14924,14959,35
314,"DJ Yemi X ATNI ft. Emy - Nafkot | ናፍቆት - New Ethiopian Music 2021 (Official Audio) by Hope Music Ethiopia 1 year ago 3 minutes, 49 seconds 11,414 views",Hope Music Entertainment,11414,11444,30
315,"DJ Yemi X ATNI - Bendede | በንደንዴ - New Ethiopian Music 2021 (Official Audio) by Hope Music Ethiopia 1 year ago 3 minutes, 16 seconds 15,334 views",Hope Music Entertainment,15334,15393,59
316,"DJ Yemi X ATNI ft.  Stif & Burka - Jegena | ጀግና - New Ethiopian Music 2021 (Official Audio) by Hope Music Ethiopia 1 year ago 3 minutes, 13 seconds 8,637 views",Hope Music Entertainment,8637,8657,20
317,"DJ Yemi X ATNI - Tensu | ትንሱ - New Ethiopian Music 2021 (Official Audio) by Hope Music Ethiopia 1 year ago 3 minutes, 13 seconds 14,469 views",Hope Music Entertainment,14469,14505,36
318,"DJ Yemi X ATNI - Ande Leyek | አንዴ ልይክ - New Ethiopian Music 2021 (Official Audio) by Hope Music Ethiopia 1 year ago 3 minutes, 48 seconds 15,264 views",Hope Music Entertainment,15264,15330,66
319,"DJ Yemi X ATNI - Holla | ሆላ - New Ethiopian Music 2021 (Official Audio) by Hope Music Ethiopia 1 year ago 3 minutes, 32 seconds 11,793 views",Hope Music Entertainment,11793,11845,52
320,"DJ Yemi X ATNI - JEDIKA | ጀዲካ - New Ethiopian Music 2021 (Official Audio) by Hope Music Ethiopia 1 year ago 3 minutes, 49 seconds 14,334 views",Hope Music Entertainment,14334,14373,39
321,"Dag Daniel - Gonderewa | ጎንደሬዋ - New Ethiopian Music 2021 (Official Video) by Hope Music Ethiopia 1 year ago 4 minutes, 5 seconds 807,975 views",Hope Music Entertainment,807975,810316,2341
322,"Kasaye Mideksa - Dungo - New Ethiopian Music 2021 (Official Video) by Hope Music Ethiopia 1 year ago 4 minutes, 8 seconds 42,344 views",Hope Music Entertainment,42344,42375,31
323,"Yafet Beharu - Nege Ale | ነገ አለ - New Ethiopian Music 2021 (Official Video) by Hope Music Ethiopia 1 year ago 5 minutes, 40 seconds 26,474 views",Hope Music Entertainment,26474,26496,22
324,"Shime Blacky - Demaka - New Ethiopian Music 2021 (Official Video) by Hope Music Ethiopia 1 year ago 4 minutes, 54 seconds 48,803 views",Hope Music Entertainment,48803,48851,48
325,"Sintayehu Tesfaye - Ere Gud New | ኧረ ጉድ ነው - New Ethiopian Music 2021 (Official video) by Hope Music Ethiopia 1 year ago 4 minutes, 1 second 70,036 views",Hope Music Entertainment,70036,70194,158
326,"Masinga X Gildo Kassa - Maria | ማሪያ - New Ethiopian Music 2021 (Official Video) by Hope Music Ethiopia 1 year ago 4 minutes, 6 seconds 524,266 views",Hope Music Entertainment,524266,527381,3115
327,"Henok Ambaye - Ethiopiawit Enat | ኢትዮዽያዊት እናት - New Ethiopian Music 2021 (Official Video) by Hope Music Ethiopia 1 year ago 5 minutes, 8 seconds 32,879 views",Hope Music Entertainment,32879,32903,24
328,"Alemayehu Getachew - Min Endalesh | ምን እንዳለሽ - New Ethiopian Music 2021 (Official Video) by Hope Music Ethiopia 1 year ago 5 minutes, 35 seconds 25,905 views",Hope Music Entertainment,25905,25933,28
329,"Yetemwork Kebede - Betenshua Bete | በትንሿ ቤቴ - New Ethiopian Music 2021 (Oficial video) by Hope Music Ethiopia 1 year ago 4 minutes, 40 seconds 60,727 views",Hope Music Entertainment,60727,60769,42
330,"Gashaw Molla - Demo Zare | ደሞ ዛሬ - New Ethiopian Music 2021 (Official Video) by Hope Music Ethiopia 1 year ago 5 minutes, 23 seconds 1,101,101 views",Hope Music Entertainment,1101101,1123771,22670
331,"Maneyazewal Asferi - Awdamet | አውዳመት - New Ethiopian music (Official Video) by Hope Music Ethiopia 1 year ago 5 minutes, 59 seconds 42,685 views",Hope Music Entertainment,42685,42726,41
332,"Birhan Desta - Terarken | ተራርቀን - New Ethiopian Music (Official Video) by Hope Music Ethiopia 1 year ago 6 minutes, 30 seconds 850,001 views",Hope Music Entertainment,850001,858154,8153
333,"Mafi Kassa - Ethiopia | ኢትዮዽያ - New Ethiopian Music 2020 (Official Video) by Hope Music Ethiopia 1 year ago 7 minutes, 7 seconds 37,445 views",Hope Music Entertainment,37445,37468,23
334,"Kidest Tesema - Birhane | ብርሃኔ - New Ethiopian Music 2020 (Official Video) by Hope Music Ethiopia 1 year ago 4 minutes, 49 seconds 71,982 views",Hope Music Entertainment,71982,72043,61
335,"T-Man ft. Mike Puchii - ONEY ONEY - New Ethiopian Music 2020 (Official Video) by Hope Music Ethiopia 1 year ago 5 minutes, 12 seconds 40,807 views",Hope Music Entertainment,40807,40842,35
336,"Mash Dahlak - Habeshawit | ሐበሻዊት - New Ethiopian Music 2020 (Official Video) by Hope Music Ethiopia 1 year ago 4 minutes, 47 seconds 48,594 views",Hope Music Entertainment,48594,48625,31
337,"Enyew Fancho X Gildo Kassa - Bichalesh | ቢቻልሽ - New Ethiopian Music 2020 (Official Video) by Hope Music Ethiopia 1 year ago 4 minutes, 44 seconds 4,557,251 views",Hope Music Entertainment,4557251,4609695,52444
338,"Aschalew Lema - Liyuye Nat | ልዩዬ ናት - New Ethiopian Music 2020 (Official Video) by Hope Music Ethiopia 1 year ago 5 minutes, 22 seconds 55,795 views",Hope Music Entertainment,55795,55834,39
339,"Eyerusalem Asfaw | Meseret Mengistu | Menen Alene - Selam Agegnito | ሰላም አግኝቶ - New Ethiopian Music by Hope Music Ethiopia 1 year ago 5 minutes, 31 seconds 75,187 views",Hope Music Entertainment,75187,75253,66
340,"Mesi ft. Elias Gizachew - Andande | አንዳንዴ - New Ethiopian Music 2020 (Official Video) by Hope Music Ethiopia 1 year ago 4 minutes, 11 seconds 175,056 views",Hope Music Entertainment,175056,175584,528
341,"Enga Beats ft  Friat - Siyalfleh Na | ሲያልፍልህ ና - New Ethiopian Music 2020 (Official Video) by Hope Music Ethiopia 1 year ago 5 minutes, 5 seconds 109,538 views",Hope Music Entertainment,109538,109626,88
342,"Babby Ragga - Debzezesh | ደብዝዘሽ - Ethiopian Cover Music 2020 (Official Video) by Hope Music Ethiopia 1 year ago 3 minutes, 51 seconds 22,571 views",Hope Music Entertainment,22571,22625,54
343,"Dagmawi Wube X Mike Juda X Dagi - Haile Selassie - New Ethiopian Music 2020 (Official Video) by Hope Music Ethiopia 1 year ago 5 minutes, 43 seconds 52,594 views",Hope Music Entertainment,52594,52957,363
344,"Miko Mikee - Entenu | እንትኑ - New Ethiopian Music 2020 (Official Video) by Hope Music Ethiopia 1 year ago 4 minutes, 29 seconds 1,179,439 views",Hope Music Entertainment,1179439,1184076,4637
345,"Tame Onekey - Deme Malo | ደሜ ማሎ - New Ethiopian Music 2020 (Official Video) by Hope Music Ethiopia 1 year ago 3 minutes, 50 seconds 40,232 views",Hope Music Entertainment,40232,40298,66
346,"Meriam Mekonnen - Tewat Mata | ጠዋት ማታ - New Ethiopian Music 2020 (Official Video) by Hope Music Ethiopia 1 year ago 4 minutes, 18 seconds 29,565 views",Hope Music Entertainment,29565,29590,25
347,"Mitiku Bekele - Ethiopiawi Aywedim | ኢትዮዽያዊ አይወድም - New Ethiopian Music 2020 (Official Video) by Hope Music Ethiopia 1 year ago 5 minutes, 34 seconds 26,222 views",Hope Music Entertainment,26222,26301,79
348,"Girum Asfaw - Yiwalelal | ይዋልላል - New Ethiopian Music 2020 (Official Video) by Hope Music Ethiopia 1 year ago 5 minutes, 35 seconds 51,208 views",Hope Music Entertainment,51208,51234,26
349,"Mihret Mulugeta - Eketelatalehu | እከተላታለሁ - New Ethiopian Music 2020 (Official Video) by Hope Music Ethiopia 1 year ago 4 minutes, 20 seconds 100,545 views",Hope Music Entertainment,100545,100603,58
350,"Assefa Teshale - Yimegnushal | ይመኙሻል - New Ethiopian Music 2020 (Official Video) by Hope Music Ethiopia 1 year ago 4 minutes, 42 seconds 77,116 views",Hope Music Entertainment,77116,77219,103
351,"Desalegn Mersha - Atenet | አትነት - New Ethiopian Music 2020 (Official Video) by Hope Music Ethiopia 1 year ago 6 minutes, 20 seconds 101,840 views",Hope Music Entertainment,101840,103084,1244
352,"Blessedkid - MELLA | መላ - New Ethiopian Music 2020 (Official Video) by Hope Music Ethiopia 1 year ago 3 minutes, 18 seconds 56,511 views",Hope Music Entertainment,56511,56664,153
353,"Betelhem Abraham - Selamachin Yisemal | ሰላማችን ይሰማል - New Ethiopian Music 2020 (Official Video) by Hope Music Ethiopia 1 year ago 5 minutes, 51 seconds 42,371 views",Hope Music Entertainment,42371,42424,53
354,"Fasil Mekonnen - Neftegna | ነፍጠኛ - New Ethiopian Music 2020 (Official Video) by Hope Music Ethiopia 1 year ago 4 minutes, 56 seconds 236,648 views",Hope Music Entertainment,236648,237042,394
355,"Sami Getu - Fitawrari | ፊታውራሪ - New Ethiopian Music 2020 (Official Video) by Hope Music Ethiopia 1 year ago 4 minutes, 26 seconds 16,847 views",Hope Music Entertainment,16847,16871,24
356,"Sisay Demoz - Jegnaye | ጀግናዬ - New Ethiopia Music 2020 (Official Video) by Hope Music Ethiopia 1 year ago 7 minutes, 6 seconds 317,678 views",Hope Music Entertainment,317678,318357,679
357,"Biniam Tesema - Ayzosh Hagere | አይዞሽ ሀገሬ - New Ethiopian Music 2020 (Official Video) by Hope Music Ethiopia 1 year ago 5 minutes, 27 seconds 166,863 views",Hope Music Entertainment,166863,167833,970
358,"Ertibu Agegnehu - Kemeseretu | ከመሰረቱ - New Ethiopian Music 2020 (Official Video) by Hope Music Ethiopia 1 year ago 6 minutes, 34 seconds 72,180 views",Hope Music Entertainment,72180,72301,121
359,"Ruti X Yamral X Anteneh - UTOPIA - New Ethiopian Music 2020 (Official Video) by Hope Music Ethiopia 1 year ago 5 minutes, 6 seconds 21,775 views",Hope Music Entertainment,21775,21819,44
360,"Dave I - Wededkush Beka | ወደድኩሽ በቃ - New Ethiopian Music 2020 (Official Video) by Hope Music Ethiopia 1 year ago 4 minutes, 22 seconds 25,318 views",Hope Music Entertainment,25318,25353,35
361,"Mahlet | Bezabih | Nesiru | Fraol - Der Biyaber - New Ethiopian Music 2020 (Official Video) by Hope Music Ethiopia 1 year ago 5 minutes, 20 seconds 18,234 views",Hope Music Entertainment,18234,18247,13
362,"Yalew Anley - Jalo | ጃሎ - New Ethiopian Music 2020 (Official Video) by Hope Music Ethiopia 1 year ago 6 minutes, 39 seconds 60,669 views",Hope Music Entertainment,60669,60739,70
363,"Fikremariam & Yohannes - Yichi Nat Ethiopia | ይቺ ናት ኢትዮዽያ - New Ethiopian Music 2020 by Hope Music Ethiopia 1 year ago 4 minutes, 25 seconds 23,088 views",Hope Music Entertainment,23088,23123,35
364,"Abel Almaz - Tey Police | ተይ ፖሊስ - New Ethiopian Music 2020 (Official Video) by Hope Music Ethiopia 1 year ago 5 minutes, 24 seconds 98,967 views",Hope Music Entertainment,98967,99178,211
365,"Belachew Tilahun - Kef Beyilign | ከፍ በይልኝ - New Ethiopian Music 2020 (Official Video) by Hope Music Ethiopia 1 year ago 5 minutes, 49 seconds 35,343 views",Hope Music Entertainment,35343,35366,23
366,"AK Zeraf - Weto Ader | ወቶ አደር - New Ethiopian Music 2020 (Official Video) by Hope Music Ethiopia 1 year ago 4 minutes, 23 seconds 48,243 views",Hope Music Entertainment,48243,48308,65
367,"Efrem Gosaye - Aterakign | አትራቂኝ - New Ethiopian Music 2020 (Official Video) by Hope Music Ethiopia 1 year ago 4 minutes, 58 seconds 38,215 views",Hope Music Entertainment,38215,38236,21
368,"Jo Blacki - Ney Ney | ነይ ነይ  - New Ethiopian Music 2020 (Official Video) by Hope Music Ethiopia 1 year ago 4 minutes, 50 seconds 38,556 views",Hope Music Entertainment,38556,38743,187
369,"Mic Solo - Selame | ሰላሜ - New Ethiopian Music 2020 (Official Video) by Hope Music Ethiopia 1 year ago 3 minutes, 11 seconds 19,492 views",Hope Music Entertainment,19492,19736,244
370,"Abel Zeru ft. Thedani Man - Abay Mado | አባይ ማዶ - New Ethiopian Music 2020 (Official Video) by Hope Music Ethiopia 1 year ago 3 minutes, 52 seconds 249,015 views",Hope Music Entertainment,249015,249433,418
371,"Helen Tilahun - Tani Tani | ታኒ ታኒ - New Ethiopian Music 2020 (Official Video) by Hope Music Ethiopia 1 year ago 5 minutes, 23 seconds 39,577 views",Hope Music Entertainment,39577,39629,52
372,"Teshager Simachew - Yefikir Muday | የፍቅር ሙዳይ - New Ethiopian Music 2020 (Official Video) by Hope Music Ethiopia 1 year ago 4 minutes, 52 seconds 52,049 views",Hope Music Entertainment,52049,52166,117
373,"Taagaay Lammeessaa - Maaltu Maalin - New Ethiopian Music 2020 (Official Video) by Hope Music Ethiopia 1 year ago 5 minutes, 12 seconds 16,510 views",Hope Music Entertainment,16510,16524,14
374,"Kebede Berhanu - Jenenew | ጀነነው - New Ethiopian Music 2020 (Official video) by Hope Music Ethiopia 1 year ago 4 minutes, 17 seconds 35,083 views",Hope Music Entertainment,35083,35109,26
375,"Destaw Teshager - Yimta Koratu | ይምጣ ቆራጡ - New Ethiopian Music 2020 (Official Video) by Hope Music Ethiopia 1 year ago 6 minutes, 16 seconds 74,631 views",Hope Music Entertainment,74631,74750,119
376,"Ertibu Agegnehu - Besintu | በስንቱ - New Ethiopian Music 2020 (Official Video) by Hope Music Ethiopia 1 year ago 7 minutes, 8 seconds 47,754 views",Hope Music Entertainment,47754,47803,49
377,"Sona Takele - Gullallee - New Ethiopian Music 2020 (Official Video) by Hope Music Ethiopia 1 year ago 5 minutes, 20 seconds 44,684 views",Hope Music Entertainment,44684,44727,43
378,"Moges Wendimenew - Erdugn Sewech | እርዱኝ ሰዎች - New Ethiopian Music 2020 (Official Video) by Hope Music Ethiopia 1 year ago 6 minutes, 22 seconds 43,212 views",Hope Music Entertainment,43212,43235,23
379,"Mesay X Mintesinot - Tone Tone - New Ethiopian Music 2020 (Official Video) by Hope Music Ethiopia 1 year ago 3 minutes, 12 seconds 82,850 views",Hope Music Entertainment,82850,83279,429
380,"Ezzy Esayas - Yalesua | ያለ እሷ - New Ethiopian Music 2020 (Official Video) by Hope Music Ethiopia 1 year ago 3 minutes, 42 seconds 1,279,942 views",Hope Music Entertainment,1279942,1281809,1867
381,"Abebaw Kesete - Yeregnaw Misa | የእረኛው ምሳ - New Ethiopian Music 2020 (Official Video) by Hope Music Ethiopia 1 year ago 5 minutes, 37 seconds 86,177 views",Hope Music Entertainment,86177,86370,193
382,"Bop X Aty Riba - Leyu Nesh | ልዩ ነሽ - New Ethiopian Music 2020 (Official Video) by Hope Music Ethiopia 1 year ago 2 minutes, 57 seconds 108,983 views",Hope Music Entertainment,108983,109054,71
383,"Addisu Ayele - Aifagays Tawa Kucha | አይፋ ጋይስ ታአዋ ቁጫ - New Ethiopian Music 2020 (Official Video) by Hope Music Ethiopia 1 year ago 5 minutes, 55 seconds 35,238 views",Hope Music Entertainment,35238,35297,59
384,"Tolosa Dadi - Anesemam | አንሰማም - New Ethiopian Music 2020 (Official Video) by Hope Music Ethiopia 1 year ago 5 minutes, 19 seconds 41,512 views",Hope Music Entertainment,41512,41541,29
385,"Yordanos Aleme - Hid Belew Wedefit | ሂድ በለው ወደፊት - New Ethiopian Music 2020 (Official Video) by Hope Music Ethiopia 1 year ago 5 minutes, 21 seconds 135,214 views",Hope Music Entertainment,135214,135307,93
386,"Ab Beta - Almotim Bay | አልሞትም ባይ - New Ethiopian Music 2020 (Official Video) by Hope Music Ethiopia 1 year ago 3 minutes, 57 seconds 35,141 views",Hope Music Entertainment,35141,35162,21
387,"Addisu Dagne - Kelib Kemeneche | ከልብ ከመነጨ - New Ethiopian Music 2020 (Official Video) by Hope Music Ethiopia 1 year ago 5 minutes, 23 seconds 32,374 views",Hope Music Entertainment,32374,32458,84
388,"Tatek Tamirat - Ethiopia | ኢትዮጵያ - New Ethiopian Music 2020 (Official Video) by Hope Music Ethiopia 1 year ago 4 minutes, 43 seconds 27,369 views",Hope Music Entertainment,27369,27472,103
389,"Binyam Assefa - Man Yawkal | ማን ያውቃል - New Ethiopian Music 2020 (Official Video) by Hope Music Ethiopia 1 year ago 4 minutes, 31 seconds 33,465 views",Hope Music Entertainment,33465,33491,26
390,"Upon - Mabede | ማበዴ ft. Hani  - New Ethiopian Music 2020 (Official Video) by Hope Music Ethiopia 1 year ago 4 minutes, 30 seconds 41,331 views",Hope Music Entertainment,41331,41361,30
391,"Eknock - Iron Lady (Official Video) by Hope Music Ethiopia 1 year ago 4 minutes, 20 seconds 32,317 views",Hope Music Entertainment,32317,32334,17
392,"Daniel Kebede & Gildo Kassa - Sora | ሶራ - New Ethiopian Music 2020 (Official Video) by Hope Music Ethiopia 1 year ago 4 minutes, 30 seconds 139,355 views",Hope Music Entertainment,139355,139597,242
393,"Wendi Mak - Geday | ገዳይ - New Ethiopian Music 2020 (Official Video) by Hope Music Ethiopia 1 year ago 4 minutes, 55 seconds 3,340,059 views",Hope Music Entertainment,3340059,3353392,13333
394,"Azeb Hussen - Melkeh Liyu | መልክህ ልዩ - New Ethiopian Music 2020 (Official Video) by Hope Music Ethiopia 1 year ago 4 minutes, 9 seconds 37,786 views",Hope Music Entertainment,37786,37850,64
395,"Aman - Yiley | ይለይ - New Ethiopian Music 2020 (Official Audio) by Hope Music Ethiopia 1 year ago 2 minutes, 47 seconds 20,247 views",Hope Music Entertainment,20247,20954,707
396,"Aman - Ket | ቀጥ - New Ethiopian Music 2020 (Official Audio) by Hope Music Ethiopia 1 year ago 3 minutes, 30 seconds 16,379 views",Hope Music Entertainment,16379,16723,344
397,"Aman - Benante | በናንተ - New Ethiopian Music 2020 (Official Audio) by Hope Music Ethiopia 1 year ago 3 minutes, 7 seconds 12,817 views",Hope Music Entertainment,12817,12988,171
398,"Aman - Emnetey | እምነተይ - New Ethiopian Music 2020 (Official Audio) by Hope Music Ethiopia 1 year ago 3 minutes, 17 seconds 10,625 views",Hope Music Entertainment,10625,10907,282
399,"Aman - Wedo | ወዶ ft. Simon Zemas - New Ethiopian Music 2020 (Official Audio) by Hope Music Ethiopia 1 year ago 3 minutes, 5 seconds 17,749 views",Hope Music Entertainment,17749,17928,179
400,"Musse Shakur - Sitota ft. Helton Tewold - New Ethiopian Music 2020 (Official Video) by Hope Music Ethiopia 1 year ago 3 minutes, 49 seconds 104,783 views",Hope Music Entertainment,104783,104848,65
401,"Misrak Taye - Enkuanem Wededkuh | እንኳን ወደድኩህ - New Ethiopian Music 2020 (Official Video) by Hope Music Ethiopia 1 year ago 6 minutes, 12 seconds 117,419 views",Hope Music Entertainment,117419,117698,279
402,"Efrem Assefa | Endashaw Moges | Gizachew Mulatu - ENAT | እናት - New Ethiopian Music 2020 by Hope Music Ethiopia 1 year ago 5 minutes, 31 seconds 32,323 views",Hope Music Entertainment,32323,32373,50
403,"Miky Yo - Wetete Yi | ወተቴ ዪ - New Ethiopian Music 2020 (Official Video) by Hope Music Ethiopia 1 year ago 3 minutes, 47 seconds 127,235 views",Hope Music Entertainment,127235,127446,211
404,"Israel Tefera - Tanene Pehera | ታኒኔ ፔሃራ - New Ethiopian Music 2020 (Official Video) by Hope Music Ethiopia 1 year ago 4 minutes, 50 seconds 48,795 views",Hope Music Entertainment,48795,48885,90
405,"Sami Mak X Yabu Jc X Moged Beats - Senay - New Ethiopian Music 2020 (Official Video) by Hope Music Ethiopia 1 year ago 3 minutes, 21 seconds 31,960 views",Hope Music Entertainment,31960,31966,6
406,"Geetuu Damisee - Hin Dhaga'u - New Ethiopian Music 2020 (Official Video) by Hope Music Ethiopia 1 year ago 5 minutes, 18 seconds 37,417 views",Hope Music Entertainment,37417,37445,28
407,"Bereket Tesfaye - Gone New Yesua | ጎኔ ነው የሷ - New Ethiopian Music 2020 (Official Video) by Hope Music Ethiopia 1 year ago 6 minutes 45,577 views",Hope Music Entertainment,45577,45596,19
408,"Milan Jr X C Rak - Awaki - New Ethiopian Music 2020 (Official Video) by Hope Music Ethiopia 1 year ago 3 minutes, 25 seconds 384,150 views",Hope Music Entertainment,384150,386063,1913
409,"Getu Omahire - Mushiraye | ሙሽራዬ - New Ethiopian Music 2020 (Official Video) by Hope Music Ethiopia 1 year ago 4 minutes, 28 seconds 295,385 views",Hope Music Entertainment,295385,296372,987
410,"Ujulu Fera, Misikir Minday, Alemu Ayisa & Yodit Yohannes - GOFFA YELO - New Ethiopian Music 2020 by Hope Music Ethiopia 1 year ago 4 minutes, 41 seconds 49,760 views",Hope Music Entertainment,49760,49990,230
411,"Adeno Ayenew - Na Beyign | ና በይኝ - New Ethiopian Music 2020 (Official Video) by Hope Music Ethiopia 1 year ago 5 minutes, 12 seconds 68,663 views",Hope Music Entertainment,68663,68718,55
412,"Tesfaye Taye - Basket Gare | ባስኬት ጋሬ - New Ethiopian Music 2020 (Official Video) by Hope Music Ethiopia 1 year ago 5 minutes, 23 seconds 27,636 views",Hope Music Entertainment,27636,27696,60
413,"Buzayehu Techane - Awida | አውይዳ - New Ethiopian Music 2020 (Official Video) by Hope Music Ethiopia 1 year ago 4 minutes, 21 seconds 61,707 views",Hope Music Entertainment,61707,61990,283
414,"South Bwoy - Nhoaka Ni Ji ft. S.W Boy - New Ethiopian Music 2020 (Official Video) by Hope Music Ethiopia 1 year ago 3 minutes, 18 seconds 155,194 views",Hope Music Entertainment,155194,155526,332
415,"Tameralech Fente - Yene Zema | የኔ ዜማ - New Ethiopian Music 2020 (Official Video) by Hope Music Ethiopia 1 year ago 5 minutes, 26 seconds 293,180 views",Hope Music Entertainment,293180,293549,369
416,"Serawit Tadesse - Adeko | አዴኮ - New Ethiopian Music 2020 (Official Video) by Hope Music Ethiopia 1 year ago 4 minutes, 11 seconds 32,421 views",Hope Music Entertainment,32421,32443,22
417,"Buze Man (Buzayehu Kifle) - Yemola | የሞላ - New Ethiopian Music 2020 (Official Video) by Hope Music Ethiopia 1 year ago 4 minutes, 37 seconds 486,059 views",Hope Music Entertainment,486059,487948,1889
418,"Meskerem Alemayehu - Malebene | ማልበኔ - New Ethiopian Music 2020 (Official Video) by Hope Music Ethiopia 1 year ago 5 minutes, 3 seconds 21,909 views",Hope Music Entertainment,21909,21914,5
419,"Weyneshet Belew - Tazebo | ታዝቦ - New Ethiopian Music 2020 (Official Video) by Hope Music Ethiopia 1 year ago 5 minutes, 59 seconds 33,134 views",Hope Music Entertainment,33134,33172,38
420,"Mulualem Shiferaw - Anchin Wedede | አንችን ወደደ - New Ethiopian Music 2020 (Official Video) by Hope Music Ethiopia 1 year ago 5 minutes, 55 seconds 95,283 views",Hope Music Entertainment,95283,95472,189
421,"Darajjee Naggassa - Ayyaana Waggaa - New Ethiopian Music 2020 (Official Video) by Hope Music Ethiopia 1 year ago 5 minutes, 10 seconds 17,385 views",Hope Music Entertainment,17385,17399,14
422,"Woynat Addisu - Abay | አባይ - New Ethiopian Music 2020 (Official Video) by Hope Music Ethiopia 1 year ago 3 minutes, 32 seconds 25,055 views",Hope Music Entertainment,25055,25078,23
423,"Nahom Mengistu - Bichegna Negn | ብቸኛ ነኝ - New Ethiopian Music 2020 (Official Video) by Hope Music Ethiopia 1 year ago 4 minutes, 42 seconds 106,405 views",Hope Music Entertainment,106405,106484,79
424,"Kalkidan Nigussie - Arhibu | አርሂቡ - New Ethiopian Music 2020 (Official Video) by Hope Music Ethiopia 1 year ago 4 minutes, 59 seconds 366,854 views",Hope Music Entertainment,366854,368339,1485
425,"Yosef Mersha - Samign | ሳሚኝ - New Ethiopian Music 2020 (Official Video) by Hope Music Ethiopia 1 year ago 5 minutes, 48 seconds 45,778 views",Hope Music Entertainment,45778,45843,65
426,"Mistre Yonas - Gizew | ጊዜው - New Ethiopian Music 2020 (Official Video) by Hope Music Ethiopia 1 year ago 3 minutes, 36 seconds 35,123 views",Hope Music Entertainment,35123,35131,8
427,"Betelhem Tekleyohannes - Atemetam | አትመጣም - New Ethiopian Music 2020 (Official Video) by Hope Music Ethiopia 1 year ago 4 minutes, 55 seconds 104,212 views",Hope Music Entertainment,104212,104257,45
428,"TGOD (RapSta) - Tenesa | ተነሳ - New Ethiopian Music 2020 (Official Video) by Hope Music Ethiopia 1 year ago 4 minutes, 43 seconds 23,511 views",Hope Music Entertainment,23511,23541,30
429,"Beta Negash - Yene Neh | የኔ ነህ - New Ethiopian Music 2020 (Official Video) by Hope Music Ethiopia 1 year ago 3 minutes, 55 seconds 44,163 views",Hope Music Entertainment,44163,44207,44
430,"Tsionawit Mekonnen - Antew Ga | አንተው ጋ - New Ethiopian Music 2020 (Official Video) by Hope Music Ethiopia 1 year ago 4 minutes, 39 seconds 93,385 views",Hope Music Entertainment,93385,93445,60
431,"Samson Getachew - Ethiopia Awdamet | ኢትዮጵያ አውዳመት - New Ethiopian Music 2020 (Official Video) by Hope Music Ethiopia 1 year ago 5 minutes, 3 seconds 40,607 views",Hope Music Entertainment,40607,40623,16
432,"Betelhem Misganaw - Aye Bezede | አይ በዘዴ - New Ethiopian Music 2020 (Official Video) by Hope Music Ethiopia 1 year ago 4 minutes, 22 seconds 443,560 views",Hope Music Entertainment,443560,446488,2928
433,"Yared Negu - Zora | ዞራ - New Ethiopian Music 2020 (Official Video) by Hope Music Ethiopia 1 year ago 4 minutes, 44 seconds 10,240,332 views",Hope Music Entertainment,10240332,10316341,76009
434,"Muluken Taju - Yamral | ያምራል - New Ethiopian Music 2020 (Official Video) by Hope Music Ethiopia 1 year ago 4 minutes, 59 seconds 23,231 views",Hope Music Entertainment,23231,23253,22
435,"Yordanos Aleme - Serk Addis New | ሰርክ አዲስ ነው - New Ethiopian Music 2020 (Official video) by Hope Music Ethiopia 1 year ago 6 minutes, 15 seconds 56,695 views",Hope Music Entertainment,56695,56743,48
436,"Tewodros Dawit - Ete Mete | እቴ ሜቴ - New Ethiopian Music 2020 (Official Video) by Hope Music Ethiopia 1 year ago 5 minutes, 4 seconds 40,935 views",Hope Music Entertainment,40935,40996,61
437,"Arsema Girma - Enkutatash | እንቁጣጣሽ - New Ethiopian Music 2020 (Official Video) by Hope Music Ethiopia 1 year ago 5 minutes, 25 seconds 176,017 views",Hope Music Entertainment,176017,176081,64
438,"Kibret KB - Simerako | ሲመራኮ - New Ethiopian Music 2020 (Official Video) by Hope Music Ethiopia 1 year ago 3 minutes, 48 seconds 26,714 views",Hope Music Entertainment,26714,26741,27
439,"Yohannes Birhane - Gudifecha | ጉዲፈቻ - New Ethiopian Music 2020 (Official Video) by Hope Music Ethiopia 1 year ago 6 minutes, 28 seconds 104,015 views",Hope Music Entertainment,104015,104209,194
440,"Christina Melkamu - Kuhlaye | ኩሕላየ - New Ethiopian Music 2020 (Official Video) by Hope Music Ethiopia 1 year ago 4 minutes, 22 seconds 105,430 views",Hope Music Entertainment,105430,105706,276
441,"Tinsu - Daruat | ዳሯት - New Ethiopian Music 2020 (Official Video) by Hope Music Ethiopia 1 year ago 4 minutes, 1 second 50,572 views",Hope Music Entertainment,50572,50608,36
442,"Nati (Tina) - Tenes le Abay | ተነስ ለአባይ - New Ethiopian Music 2020 (Official Video) by Hope Music Ethiopia 1 year ago 3 minutes, 53 seconds 18,019 views",Hope Music Entertainment,18019,18045,26
443,"Samuel Aynalem - Bey Ney | በይ ነይ - New Ethiopian Music 2020 (Official Video) by Hope Music Ethiopia 1 year ago 3 minutes, 51 seconds 55,760 views",Hope Music Entertainment,55760,55989,229
444,"Abel Assefa - Keremela | ከረሜላ - New Ethiopian Music 2020 (Official Video) by Hope Music Ethiopia 1 year ago 4 minutes, 39 seconds 42,316 views",Hope Music Entertainment,42316,42427,111
445,"Fraol Seleshi - Betizitash | በትዝታሽ - New Ethiopian Music 2020 (Official Video) by Hope Music Ethiopia 1 year ago 5 minutes, 7 seconds 28,530 views",Hope Music Entertainment,28530,28622,92
446,"Surafel Yetem - Man Yileyenal | ማን ይለየናል - New Ethiopian Music 2020 (Official Video) by Hope Music Ethiopia 1 year ago 5 minutes, 36 seconds 100,279 views",Hope Music Entertainment,100279,100386,107
447,"Jote Deresu - Aregagiw | አረጋጊው - New Ethiopian Music 2020 (Official Video) by Hope Music Ethiopia 1 year ago 3 minutes, 59 seconds 336,128 views",Hope Music Entertainment,336128,336470,342
448,"Helina Yirga - Lela Sew | ሌላ ሰው - New Ethiopian Music 2020 (Official Video) by Hope Music Ethiopia 1 year ago 5 minutes, 1 second 130,358 views",Hope Music Entertainment,130358,130492,134
449,"Habtamu Tagese - Kanchi | ካንቺ - New Ethiopian Music 2020 (Official Video) by Hope Music Ethiopia 1 year ago 4 minutes, 49 seconds 53,268 views",Hope Music Entertainment,53268,53303,35
450,"Nahi Kid X Willy - Ola Esoba - New Ethiopian Music 2020 (Official video) by Hope Music Ethiopia 1 year ago 4 minutes, 56 seconds 58,000 views",Hope Music Entertainment,58000,58043,43
451,"Tirsiit Gazahany - Nan Deema - New Ethiopian Music 2020 (Official Video) by Hope Music Ethiopia 1 year ago 6 minutes, 24 seconds 436,841 views",Hope Music Entertainment,436841,438105,1264
452,"Abeselom Bihonegn - Abay | አባይ - New Ethiopian Music 2020 (Official Video) by Hope Music Ethiopia 1 year ago 4 minutes, 31 seconds 53,799 views",Hope Music Entertainment,53799,53820,21
453,"Ras Fikiryihun & G Key - Eyoha Abay | እዮሃ አባይ - New Ethiopian Music 2020 (Official Video) by Hope Music Ethiopia 1 year ago 4 minutes, 58 seconds 21,619 views",Hope Music Entertainment,21619,21636,17
454,"Mack Habesha - Enate | እናቴ - New Ethiopian Music 2020 (Official Video) by Hope Music Ethiopia 1 year ago 4 minutes, 25 seconds 27,065 views",Hope Music Entertainment,27065,27118,53
455,"Yalemwork Jenberu - Na Mare | ና ማሬ - New Ethiopian Music 2020 (Official Video) by Hope Music Ethiopia 1 year ago 5 minutes, 55 seconds 351,429 views",Hope Music Entertainment,351429,351831,402
456,"Dan Ab - Hugni Selam | ሁኚ ሰላም - New Ethiopian Music 2020 (Official Video) by Hope Music Ethiopia 1 year ago 5 minutes, 16 seconds 65,487 views",Hope Music Entertainment,65487,66388,901
457,"Simachew Tebekew - Yegojam Sew | የጎጃም ሰው - New Ethiopian Music 2020 (Official Video) by Hope Music Ethiopia 1 year ago 6 minutes, 4 seconds 53,599 views",Hope Music Entertainment,53599,53702,103
458,"Tasfaayee Taayyee - Liilliin Daraaree - New Ethiopian Music 2020 (Official Video) by Hope Music Ethiopia 1 year ago 4 minutes, 41 seconds 21,499 views",Hope Music Entertainment,21499,21529,30
459,"Lense Lemessa - Gebtognal Ewnetu | ገብቶኛል እውነቱ - New Ethiopian Music 2020 (Official Video) by Hope Music Ethiopia 1 year ago 5 minutes, 31 seconds 49,282 views",Hope Music Entertainment,49282,49310,28
460,"Girmaw Admasu - Abay Ena Tana | አባይ እና ጣና - New Ethiopian Music 2020 (Official Video) by Hope Music Ethiopia 1 year ago 3 minutes, 58 seconds 22,544 views",Hope Music Entertainment,22544,22553,9
461,"Belayneh Fenta - Meta Meta | መታ መታ - New Ethiopian Music 2020 (Official Video) by Hope Music Ethiopia 1 year ago 4 minutes, 32 seconds 39,459 views",Hope Music Entertainment,39459,39507,48
462,"Ayalew Kassahun - Be Ethiopia Semay Lay | በኢትዮዽያ ሰማይ ላይ - New Ethiopian Music 2020 (Official Video) by Hope Music Ethiopia 1 year ago 5 minutes, 46 seconds 27,343 views",Hope Music Entertainment,27343,27375,32
463,"Biruk Jane - Bado Negn | ባዶ ነኝ - New Ethiopian Music 2020 (Official Video) by Hope Music Ethiopia 1 year ago 4 minutes, 11 seconds 48,059 views",Hope Music Entertainment,48059,48735,676
464,"Hope Entertainment Weekly Music Chart | ምርጥ የሳምንቱ ሙዚቃዎች ስብስብ | Ethiopian Music 2020 by Hope Music Ethiopia 1 year ago 1 minute, 28 seconds 23,309 views",Hope Music Entertainment,23309,23407,98
465,"Wendeye Abebe - Yehurt Ken Lijoch | የቁርጥ ቀን ልጆች - New Ehtiopian Music 2020 (Official Video) by Hope Music Ethiopia 1 year ago 7 minutes 28,207 views",Hope Music Entertainment,28207,28330,123
466,"Natnael Tesfaye - Biruh Maleda | ብሩህ ማለዳ - New Ethiopian Music 2020 (Official Video) by Hope Music Ethiopia 1 year ago 4 minutes, 14 seconds 13,180 views",Hope Music Entertainment,13180,13219,39
467,"Mikiyas Nigussie (Miki Lala) Cover Song - New Ethiopian Music 2020 (Official Video) by Hope Music Ethiopia 1 year ago 5 minutes, 17 seconds 59,071 views",Hope Music Entertainment,59071,59121,50
468,"Werkneh Wendimu - Dumane | ዱማኔ - New Ethiopian Music 2020 (Official Video) by Hope Music Ethiopia 1 year ago 3 minutes, 38 seconds 35,193 views",Hope Music Entertainment,35193,35227,34
469,"Fikir Tefera & Afomia Tewodros - Zem Anelem | ዝም አንልም - New Ethiopian Music 2020 (Official video) by Hope Music Ethiopia 1 year ago 3 minutes, 50 seconds 80,939 views",Hope Music Entertainment,80939,80982,43
470,"Dagim Tesfaye - Ayamtaw | አያምጣው - New Ethiopian Music 2020 (Official Video) by Hope Music Ethiopia 1 year ago 4 minutes, 24 seconds 33,736 views",Hope Music Entertainment,33736,33785,49
471,"Solomon Gashabe - Sew Telash | ሰው ጠላሽ - New Ethiopian Music 2020 (Official Video) by Hope Music Ethiopia 1 year ago 4 minutes, 31 seconds 221,228 views",Hope Music Entertainment,221228,222704,1476
472,"Hayleyesus Feyssa - Emelalew | እምላለው - Ethiopian Music 2020 (Official Video) by Hope Music Ethiopia 1 year ago 5 minutes, 2 seconds 3,136,899 views",Hope Music Entertainment,3136899,3191376,54477
473,"Dr. Adil - Gedyelem | ግድየለም - New Ethiopian Music 2020 (Official Video) by Hope Music Ethiopia 1 year ago 4 minutes, 1 second 45,083 views",Hope Music Entertainment,45083,45121,38
474,"King Sued ft.  Nigist - Deep In Love - New Ethiopian Music 2020 (Official Video) by Hope Music Ethiopia 1 year ago 3 minutes, 45 seconds 36,548 views",Hope Music Entertainment,36548,36590,42
475,"Dereje Bizuwork - Yawna Yitayalena | ያውና ይታያልና - New Ethiopian Music 2020 (Official Video) by Hope Music Ethiopia 1 year ago 7 minutes, 29 seconds 284,962 views",Hope Music Entertainment,284962,288360,3398
476,"Aklilu & Yihunshewa - Yebekur Lij | የበኩር ልጅ - New Ethiopian Music 2020 (Official Video) by Hope Music Ethiopia 1 year ago 4 minutes, 23 seconds 26,766 views",Hope Music Entertainment,26766,26770,4
477,"Helen Michael - Adenen | አድነን - New Ethiopian Music 2020 (Official Video) by Hope Music Ethiopia 1 year ago 4 minutes, 52 seconds 44,077 views",Hope Music Entertainment,44077,44104,27
478,"Getachew Tadesse - Gerageru | ገራገሩ - New Ethiopian Music 2020 (Official Video) by Hope Music Ethiopia 1 year ago 6 minutes, 45 seconds 21,289 views",Hope Music Entertainment,21289,21302,13
479,"Abebe Girma - Yaleselesi - New Ethiopian Music 2020 (Official Video) by Hope Music Ethiopia 1 year ago 5 minutes, 19 seconds 130,034 views",Hope Music Entertainment,130034,130398,364
480,"Meseret Gashaw - Anteye | አንተዬ - New Ethiopian Music 2020 (Official Video) by Hope Music Ethiopia 1 year ago 3 minutes, 57 seconds 48,656 views",Hope Music Entertainment,48656,48767,111
481,"Sami Beyene - Hizbe Sima | ህዝቤ ስማ - New Ethiopian Music 2020 (Official Audio ) by Hope Music Ethiopia 1 year ago 5 minutes, 52 seconds 38,881 views",Hope Music Entertainment,38881,38899,18
482,"Filfilu & Demissie - Gidibu Yegna New | ግድቡ የኛ ነው - New Ethiopian Music 2020 (Official Video) by Hope Music Ethiopia 1 year ago 4 minutes, 38 seconds 246,026 views",Hope Music Entertainment,246026,246104,78
483,"Addisu Dagne - Wan Ofii - New Ethiopian Music 2020 (Official Video) by Hope Music Ethiopia 1 year ago 4 minutes, 18 seconds 59,228 views",Hope Music Entertainment,59228,59274,46
484,"Getachew Abraha - Halaley | ሓላለይ - New Ethiopian Music 2020 (Official Video) by Hope Music Ethiopia 1 year ago 6 minutes, 19 seconds 58,945 views",Hope Music Entertainment,58945,58965,20
485,"Ashenafi Abebe - Eri Bekentu | እሪ በከንቱ - New Ethiopian Music 2020 (Official Video) by Hope Music Ethiopia 1 year ago 5 minutes, 36 seconds 42,659 views",Hope Music Entertainment,42659,42670,11
486,"Hope Entertainment Weekly Music Chart | ምርጥ የሳምንቱ ሙዚቃዎች ስብስብ | Ethiopian Music 2020 by Hope Music Ethiopia 1 year ago 1 minute, 55 seconds 61,999 views",Hope Music Entertainment,61999,62069,70
487,"Sancho Gebre - Fiyona | ፍዮና - New Ethiopian Music 2020 (Official Video) by Hope Music Ethiopia 1 year ago 4 minutes, 53 seconds 3,461,557 views",Hope Music Entertainment,3461557,3481003,19446
488,"Static Levi - Netsanet | ነፃነት - New Ethiopian Music 2020 (Official Video) by Hope Music Ethiopia 1 year ago 3 minutes, 45 seconds 146,398 views",Hope Music Entertainment,146398,148287,1889
489,"Andualem Ayalew - Anzenaga | አንዘናጋ - New Ethiopian Music 2020 (Official Video) by Hope Music Ethiopia 1 year ago 3 minutes, 23 seconds 23,261 views",Hope Music Entertainment,23261,23271,10
490,"Mic Solo - Tesfa | ተስፋ - New Ethiopian Music 2020 (Official Video) by Hope Music Ethiopia 1 year ago 3 minutes, 19 seconds 19,589 views",Hope Music Entertainment,19589,19634,45
491,"MC Siyamregn - Metenafek | ምትናፈቅ - New Ethiopian Music 2020 (Official Video) by Hope Music Ethiopia 1 year ago 4 minutes, 12 seconds 90,664 views",Hope Music Entertainment,90664,91038,374
492,"Kabel Desalegn - Resahuat | ረሳዋት - New Ethiopian Music 2020 (Official Video) by Hope Music Ethiopia 1 year ago 4 minutes, 32 seconds 35,384 views",Hope Music Entertainment,35384,35409,25
493,"Emebet Negasi - Yakeberesh Yekber | ያከበረሽ ይክበር - New Ethiopian Music 2020 (Official Video) by Hope Music Ethiopia 1 year ago 5 minutes, 36 seconds 276,807 views",Hope Music Entertainment,276807,276949,142
494,"Various Artists - Sew Lesew | ሰው ለሰው - New Ethiopian Music 2020 (Official Video) by Hope Music Ethiopia 1 year ago 7 minutes, 18 seconds 26,056 views",Hope Music Entertainment,26056,26065,9
495,"Various Artists - Semi Manew | ሰሚ ማነው - New Ethiopian Music 2020 (Official Video) by Hope Music Ethiopia 1 year ago 4 minutes, 39 seconds 40,613 views",Hope Music Entertainment,40613,40633,20
496,"Girma Nigatu - Sidet Kifu | ስደት ክፉ - New Ethiopian Music 2020 (Official Video) by Hope Music Ethiopia 1 year ago 6 minutes, 11 seconds 48,950 views",Hope Music Entertainment,48950,48983,33
497,"Biruk Bella - Shelelo | ሼሌሎ - New Ethiopian Music 2020 (Official Video) by Hope Music Ethiopia 1 year ago 5 minutes, 7 seconds 35,651 views",Hope Music Entertainment,35651,35712,61
498,"Biruk Bekele & Helita Iticha - Sayikatel Bekitel | ሳይቃጠል በቅጠል - New Ethiopian Music 2020 by Hope Music Ethiopia 1 year ago 4 minutes, 14 seconds 43,060 views",Hope Music Entertainment,43060,43075,15
499,"Assefa Teshale - Liyu Nat | ልዩ ናት - New Ethiopian Music 2020 (Official Video) by Hope Music Ethiopia 1 year ago 3 minutes, 59 seconds 131,440 views",Hope Music Entertainment,131440,131535,95
500,"Temesgen Hailemichael - Aye Edaye | አይ እዳዬ - New Ethiopian Music 2020 (Official Video) by Hope Music Ethiopia 1 year ago 5 minutes, 14 seconds 55,274 views",Hope Music Entertainment,55274,55319,45
501,"Yene Mircha | የኔ ምርጫ - ዝነኛ እና ታዋቂ ሙዚቀኛ መሆን ይፈልጋሉ? | Ethiopian Music by Hope Music Ethiopia 1 year ago 1 minute, 8 seconds 44,410 views",Hope Music Entertainment,44410,44431,21
502,"Henok Abebaw & Solomon Tigabe - Awaj | አዋጅ - New Ethiopian Music 2020 (Official Video) by Hope Music Ethiopia 1 year ago 3 minutes, 37 seconds 51,092 views",Hope Music Entertainment,51092,51121,29
503,"Zemete Begashaw - Ayraken | አይራቀን - New Ethiopian Music 2020 (Official Video) by Hope Music Ethiopia 1 year ago 5 minutes, 12 seconds 17,782 views",Hope Music Entertainment,17782,17788,6
504,"Fitse Oda - Dammee Maaloo - New Ethiopian Music 2020 (Official Video) by Hope Music Ethiopia 1 year ago 4 minutes, 33 seconds 49,369 views",Hope Music Entertainment,49369,49501,132
505,"Various Artists - Ereketachenen Entebek | እርቀታችንን እንጠብቅ - New Ethiopian Music 2020 (Official video) by Hope Music Ethiopia 1 year ago 3 minutes, 58 seconds 27,267 views",Hope Music Entertainment,27267,27270,3
506,"Endi (Andinet Ali) - Yis Yiss - New Ethiopian Music 2020 (Official Video) by Hope Music Ethiopia 1 year ago 2 minutes, 8 seconds 22,773 views",Hope Music Entertainment,22773,22788,15
507,"Mesay Tefera - Demo Demo | ደሞ ደሞ - New Ethiopian Music 2020 (Official Video) by Hope Music Ethiopia 1 year ago 4 minutes, 25 seconds 441,283 views",Hope Music Entertainment,441283,441932,649
508,"Genet Masresha & Esubalew Adugna - Entenkek | እንጠንቀቅ - New Ethiopian Music 2020 (Official Video) by Hope Music Ethiopia 1 year ago 5 minutes, 50 seconds 203,608 views",Hope Music Entertainment,203608,203775,167
509,"Habtamu Alene - Jegnaye | ጀግናዬ - New Ethiopian Music 2020 (Official Video) by Hope Music Ethiopia 1 year ago 5 minutes, 12 seconds 106,475 views",Hope Music Entertainment,106475,106516,41
510,"Feteh Tesfa Nega - De Du Di Da | ደ.ዱ.ዲ.ዳ - New Ethiopian Music 2020 (Official Video) by Hope Music Ethiopia 1 year ago 7 minutes, 5 seconds 426,553 views",Hope Music Entertainment,426553,426802,249
511,"Berhanehiwot Tigabu - Ayne Gebash Wey | አይን ገባሽ ወይ - New Ethiopian Music 2020 (Official Video) by Hope Music Ethiopia 1 year ago 6 minutes, 3 seconds 46,436 views",Hope Music Entertainment,46436,46456,20
512,"Hanna Tesema - Yiker Belen | ይቅር በለን - New Ethiopian Music 2020 (Official Video) by Hope Music Ethiopia 1 year ago 5 minutes, 15 seconds 31,561 views",Hope Music Entertainment,31561,31569,8
513,"Sofia Shibabaw - New Ethiopian Music 2020 (Official Video) by Hope Music Ethiopia 1 year ago 5 minutes, 28 seconds 252,236 views",Hope Music Entertainment,252236,252454,218
514,"Sisco Habesha - Mewdede | መውደዴ - New Ethiopian Music 2020 (Official Video) by Hope Music Ethiopia 1 year ago 3 minutes, 53 seconds 30,812 views",Hope Music Entertainment,30812,30842,30
515,"Tsegaye Dendena - Waaqayoo - New Ethiopian Music 2020 (Official Video) by Hope Music Ethiopia 1 year ago 3 minutes, 41 seconds 71,420 views",Hope Music Entertainment,71420,71541,121
516,"Various Artists - Bezih Yibeka 2 | በዚህ ይብቃ - New Ethiopian Music 2020 (Official Video) by Hope Music Ethiopia 1 year ago 5 minutes, 32 seconds 35,168 views",Hope Music Entertainment,35168,35187,19
517,"Eden Dejene, Belachew Tilahun & Abiy Kassahun - Yalfal | ያልፋል  - New Ethiopian Music 2020 by Hope Music Ethiopia 1 year ago 3 minutes, 29 seconds 46,524 views",Hope Music Entertainment,46524,46541,17
518,"Beamlak Bishaw - Gonderewa | ጎንደሬዋ - New Ethiopian Music 2020 (Official Video) by Hope Music Ethiopia 1 year ago 6 minutes, 3 seconds 109,175 views",Hope Music Entertainment,109175,109616,441
519,"Wollo Kings - Fetenaye | ፈተናዬ - New Ethiopian Music 2020 (Official Video) by Hope Music Ethiopia 1 year ago 4 minutes, 41 seconds 28,981 views",Hope Music Entertainment,28981,29008,27
520,"Alazar Yekelem & Mohammed Koyes - Arbegnaw | አርበኛው - New Ethiopian Music 2020 (Official Video) by Hope Music Ethiopia 1 year ago 3 minutes, 46 seconds 20,197 views",Hope Music Entertainment,20197,20203,6
521,"Hayleyesus Feyssa - Fikir Tewedede | ፍቅር ተወደደ - New Ethiopian Music 2020 (Official Video) by Hope Music Ethiopia 1 year ago 6 minutes, 46 seconds 13,563,963 views",Hope Music Entertainment,13563963,13643195,79232
522,"Endegna - Yeabay Zemen Lijoch | የአባይ ዘመን ልጆች - New Ethiopian Music 2020 (Official Video) by Hope Music Ethiopia 1 year ago 3 minutes, 5 seconds 225,258 views",Hope Music Entertainment,225258,225371,113
523,"Mikiyas Legesse & Wendesen Gebre - Adera | አደራ - New Ethiopian Music 2020 (Official Video) by Hope Music Ethiopia 1 year ago 5 minutes, 38 seconds 64,583 views",Hope Music Entertainment,64583,64622,39
524,"Eshit Eshit | እሽት እሽት - New Ethiopian Music 2020 (Official Video) by Hope Music Ethiopia 1 year ago 5 minutes, 25 seconds 32,149 views",Hope Music Entertainment,32149,32212,63
525,"Yalfal | ያልፋል - New Ethiopian Music 2020 (Official Video) by Hope Music Ethiopia 1 year ago 5 minutes, 4 seconds 14,118 views",Hope Music Entertainment,14118,14132,14
526,"Temesgen Zigale - Hobel Gondar | ሆበል ጎንደር - New Ethiopian Music 2020 (Official Video) by Hope Music Ethiopia 1 year ago 6 minutes, 48 seconds 352,710 views",Hope Music Entertainment,352710,353713,1003
527,"Yordanos Aleme - Yabetew Yifenda | ያበጠው ይፈንዳ - New Ethiopian Music 2020 (Official Video) by Hope Music Ethiopia 1 year ago 8 minutes, 25 seconds 412,883 views",Hope Music Entertainment,412883,413038,155
528,"Yegizew Ewenet | የጊዜው እውነት - New Ethiopian Music 2020 (Official Video) by Hope Music Ethiopia 1 year ago 3 minutes, 55 seconds 15,854 views",Hope Music Entertainment,15854,15859,5
529,"Rahel Getu - Yagere Sew | ያገሬ ሰው - New Ethiopian Music (Official Video) by Hope Music Ethiopia 1 year ago 4 minutes, 46 seconds 2,005,158 views",Hope Music Entertainment,2005158,2008149,2991
530,"Betty G, Teref Kasahun, Vahe, Nahom, Yonas, Daniel & Des - Ayzon | አይዞን - New Ethiopian Music 2020 by Hope Music Ethiopia 1 year ago 4 minutes, 23 seconds 60,633 views",Hope Music Entertainment,60633,60656,23
531,"Dagi - Dehna | ደና - New Ethiopian Music 2020 (Official Video) by Hope Music Ethiopia 1 year ago 5 minutes, 38 seconds 41,402 views",Hope Music Entertainment,41402,41438,36
532,"Jamiil Abduu - Nurra Qabe Korona - New Ethiopian Music 2020 (Official Video) by Hope Music Ethiopia 1 year ago 5 minutes, 17 seconds 12,963 views",Hope Music Entertainment,12963,12970,7
533,"Marsawi & Melegnaw - Ged New | ግድ ነው - New Ethiopian Music 2020 (Official Video) by Hope Music Ethiopia 1 year ago 4 minutes, 25 seconds 13,749 views",Hope Music Entertainment,13749,13758,9
534,"Addisu Dagne - Maren | ማረን   - New Ethiopian Music 2020 (Official Video) by Hope Music Ethiopia 1 year ago 4 minutes, 42 seconds 53,393 views",Hope Music Entertainment,53393,53444,51
535,"Biruk Jane - Enmar | እንማር - New Ethiopian Music 2020 (Official Video) by Hope Music Ethiopia 1 year ago 3 minutes, 33 seconds 22,476 views",Hope Music Entertainment,22476,22976,500
536,"Daniel Shawel, Tigist Aschalew & Redwan Kaso - DHAGAY - New Ethiopian Music 2020 (Official Video) by Hope Music Ethiopia 1 year ago 4 minutes, 40 seconds 12,238 views",Hope Music Entertainment,12238,12260,22
537,"Mele Mesfin - Gud Serachign | ጉድ ሰራችኝ - New Ethiopian Music 2020 (Official Video) by Hope Music Ethiopia 1 year ago 4 minutes, 59 seconds 111,186 views",Hope Music Entertainment,111186,111332,146
538,"FILLY DA RUDEBOI & PRADDA - DON'T STOP (Official Video) by Hope Music Ethiopia 1 year ago 3 minutes, 12 seconds 19,931 views",Hope Music Entertainment,19931,19934,3
539,"Gandhi, Tsega. D Yemessi, Muler Mesfin & Melat Teklay - Ayzon | አይዞን - New Ethiopian Music 2020 by Hope Music Ethiopia 1 year ago 3 minutes, 51 seconds 13,550 views",Hope Music Entertainment,13550,13552,2
540,"Fasil Alemayehu & Kalkidan Yetemegn - Beka Beka | በቃ በቃ - New Ethiopian Music 2020 (Official Video) by Hope Music Ethiopia 1 year ago 3 minutes, 57 seconds 20,445 views",Hope Music Entertainment,20445,20481,36
541,"Yawiti Way - Gojeye | ጎጅዬ - New Ethiopian Music 2020 (Official Video) by Hope Music Ethiopia 1 year ago 5 minutes, 36 seconds 37,818 views",Hope Music Entertainment,37818,37836,18
542,"Fikiru Alebachew & Feteh Tesfa - Alegn Tarik | አለኝ ታሪክ - New Ethiopian Music 2020 (Official Video) by Hope Music Ethiopia 1 year ago 6 minutes, 21 seconds 41,713 views",Hope Music Entertainment,41713,41860,147
543,"Efi Mak & Abex - Ere Tew Tew | ኧረ ተው ተው - New Ethiopian Music 2020 (Official Video) by Hope Music Ethiopia 1 year ago 2 minutes, 46 seconds 30,305 views",Hope Music Entertainment,30305,30323,18
544,"Various Artists - Leken Enshager | ልቀን እንሻገር - New Ethiopian Music 2020 (Official Video) by Hope Music Ethiopia 1 year ago 5 minutes, 16 seconds 17,145 views",Hope Music Entertainment,17145,17169,24
545,"Buze Man & Maki KB - Mihretin Aweridew | ምህረትን አውርደው - New Ethiopian Music 2020 (Official Video) by Hope Music Ethiopia 1 year ago 4 minutes, 12 seconds 46,297 views",Hope Music Entertainment,46297,46331,34
546,"Roba Junior X Nati Turner - Photoshen | ፎቶሺን -  New Ethiopian Music 2020 (Official Video) by Hope Music Ethiopia 1 year ago 7 minutes, 6 seconds 2,173,857 views",Hope Music Entertainment,2173857,2179424,5567
547,"Wendi Maru - Beruku | በሩቁ - New Ethiopian Music 2020 (Official Video) by Hope Music Ethiopia 1 year ago 2 minutes, 57 seconds 37,042 views",Hope Music Entertainment,37042,37056,14
548,"Wasihun Takele - Egnaw Begnaw | እኛው በኛው (Official Video) by Hope Music Ethiopia 1 year ago 5 minutes, 6 seconds 19,529 views",Hope Music Entertainment,19529,19562,33
549,"Frezer Kenaw - Tareken | ታረቀን (Official Video) by Hope Music Ethiopia 1 year ago 3 minutes, 57 seconds 41,586 views",Hope Music Entertainment,41586,41635,49
550,"Eliana Dawit & Koket Dawit - Entebaberalen | እንተባበራለን (Official Video) by Hope Music Ethiopia 1 year ago 5 minutes, 45 seconds 16,383 views",Hope Music Entertainment,16383,16392,9
551,"Veronica Adane - Maren | ማረን (Official Video) by Hope Music Ethiopia 1 year ago 4 minutes, 27 seconds 236,837 views",Hope Music Entertainment,236837,237343,506
552,"Ras Dan (Sali Kim) ft. Ansif Kebede - Asemeslo | አስመስሎ - New Ethiopian Music 2020 by Hope Music Ethiopia 1 year ago 2 minutes, 58 seconds 21,643 views",Hope Music Entertainment,21643,21653,10
553,"Various Artists - Tsioso Nuna Mara | ፆሶ ኑና ማራ - New Ethiopian Music 2020 (Official Video) by Hope Music Ethiopia 1 year ago 4 minutes, 55 seconds 17,068 views",Hope Music Entertainment,17068,17082,14
554,"Adane Darge - Aytayugnem | አይታዩኝም - New Ethiopian Music 2020 (Official Video) by Hope Music Ethiopia 1 year ago 3 minutes, 36 seconds 147,271 views",Hope Music Entertainment,147271,147596,325
555,"Enshageralen | እንሻገራለን - New Ethiopian Music 2020 (Official Video) by Hope Music Ethiopia 1 year ago 8 minutes, 3 seconds 133,827 views",Hope Music Entertainment,133827,133888,61
556,"Sofia Shibabaw, Betty G, Zeritu Kebede, Chachi Tadesse & Israel Abel - Yeselam Sew Negn | የሰላም ሰው ነኝ by Hope Music Ethiopia 1 year ago 6 minutes, 13 seconds 1,414,435 views",Hope Music Entertainment,1414435,1416556,2121
557,"Teshome Mekonen - Yaskefelal Waga | ያስከፍላል ዋጋ - New Ethiopian Music 2020 (Official Video) by Hope Music Ethiopia 1 year ago 6 minutes, 34 seconds 165,446 views",Hope Music Entertainment,165446,165565,119
558,"Sam Yerom & Daggy Shash - Min Honenal | ምን ሆነናል - New Ethiopian Music 2020 (Official Video) by Hope Music Ethiopia 1 year ago 5 minutes, 9 seconds 30,313 views",Hope Music Entertainment,30313,30349,36
559,"Dagne Walle - Yiker Belen | ይቅር በለን - New Ethiopian Mezmur 2020 by Hope Music Ethiopia 1 year ago 7 minutes, 35 seconds 181,814 views",Hope Music Entertainment,181814,182250,436
560,"Ermias Desta & Tina Aragaw - Newer Yemayawku | ነውር የማያውቁ - New Ethiopian Music 2020 (Official Video) by Hope Music Ethiopia 1 year ago 6 minutes, 5 seconds 22,321 views",Hope Music Entertainment,22321,22327,6
561,"Yabsira 25 - Hateyat | ሃጢያት - New Ethiopian Music 2020 (Official Video) by Hope Music Ethiopia 1 year ago 6 minutes, 43 seconds 19,000 views",Hope Music Entertainment,19000,19014,14
562,"Ab Man X Henok Mewded X Kuki - Corona | ኮሮና - New Ethiopian Music 2020 (Official Video) by Hope Music Ethiopia 1 year ago 3 minutes, 8 seconds 35,042 views",Hope Music Entertainment,35042,35067,25
563,"Habtamu Kifle - Balebernosu | ባለበርኖሱ - New Ethiopian Music 2020 (Official Video) by Hope Music Ethiopia 1 year ago 7 minutes, 11 seconds 172,684 views",Hope Music Entertainment,172684,173106,422
564,"Bisrat Surafel - Temesgen | ተመስገን - New Ethiopian Mezmur 2020 by Hope Music Ethiopia 1 year ago 6 minutes, 14 seconds 680,904 views",Hope Music Entertainment,680904,683813,2909
565,"Various Artists - Mekerun Tekebel | ምክሩን ተቀበል - New Ethiopian Music 2020 (Official Video) by Hope Music Ethiopia 1 year ago 3 minutes, 37 seconds 30,782 views",Hope Music Entertainment,30782,30793,11
566,"Getahun Kindu - Endalatash | እንዳላጣሽ - New Ethiopian Music 2020 (Official Video) by Hope Music Ethiopia 1 year ago 5 minutes, 47 seconds 37,569 views",Hope Music Entertainment,37569,37592,23
567,"Admasu Wana (Bicha Weba) - Corona | ኮሮና - New Ethiopian Music 2020 (Official Video) by Hope Music Ethiopia 1 year ago 2 minutes, 54 seconds 153,888 views",Hope Music Entertainment,153888,154045,157
568,"Kabir G. Hageyo - Hin Cadhisina (Corona) - New Ethiopian Music 2020 (Official Video) by Hope Music Ethiopia 1 year ago 3 minutes, 20 seconds 15,743 views",Hope Music Entertainment,15743,15753,10
569,"Alazar Teklie - Chombe - New Ethiopian Music 2020 (Official Video) by Hope Music Ethiopia 1 year ago 3 minutes, 56 seconds 382,613 views",Hope Music Entertainment,382613,384791,2178
570,"Helen Berhe, Zebiba Girma, Abel Mulugeta & Temesgen Tafese  - Bealem Tila - New Ethiopian Music 2020 by Hope Music Ethiopia 1 year ago 5 minutes, 14 seconds 566,231 views",Hope Music Entertainment,566231,566921,690
571,"Yared Negu, Gildo Kassa & Kuni 911 - SIMU | ስሙ - New Ethiopian Music 2020 (Official video) by Hope Music Ethiopia 1 year ago 2 minutes, 28 seconds 1,016,894 views",Hope Music Entertainment,1016894,1019581,2687
572,"Andu'alam Gosaa & Kabel Desalegn - Nutti Araarami | ታረቀን - New Ethiopian Music 2020 (Official Video) by Hope Music Ethiopia 1 year ago 4 minutes, 26 seconds 71,938 views",Hope Music Entertainment,71938,72044,106
573,"Yosef Jano, Tariku Alemu & Addis Alemu - Entateb | እንታጠብ - New Ethiopian Music 2020 (Official Video) by Hope Music Ethiopia 1 year ago 2 minutes, 29 seconds 10,919 views",Hope Music Entertainment,10919,10947,28
574,"Nati ebs - Covid-19 Awareness Message To All Ethiopians | ልብ የሚነካ መልዕክት by Hope Music Ethiopia 1 year ago 1 minute, 34 seconds 30,579 views",Hope Music Entertainment,30579,30585,6
575,"Various Artists - Yitefal | ይጠፋል - New Ethiopian Music (Official Video) by Hope Music Ethiopia 1 year ago 4 minutes, 42 seconds 26,249 views",Hope Music Entertainment,26249,26264,15
576,"Various Arists - Bezih Yibeka | በዚህ ይብቃ - New Ethiopian Music 2020 (Official Video) by Hope Music Ethiopia 1 year ago 4 minutes, 49 seconds 197,098 views",Hope Music Entertainment,197098,197124,26
577,"Yetemesgen Lijoch - Beqtsebet | በቅፅበት - Ethiopian Music 2020 by Hope Music Ethiopia 1 year ago 3 minutes, 2 seconds 23,556 views",Hope Music Entertainment,23556,23562,6
578,"Yohannes Fenta - Irie | አይሬ - New Ethiopian Music 2020 (Official Video) by Hope Music Ethiopia 1 year ago 3 minutes, 52 seconds 36,970 views",Hope Music Entertainment,36970,37011,41
579,"Nahom Mekuria & Bemnet Asnake - Rak Rak | ራቅ ራቅ - New Ethiopian Music 2020 (Official Video) by Hope Music Ethiopia 1 year ago 3 minutes, 57 seconds 37,608 views",Hope Music Entertainment,37608,37640,32
580,"Various Artists - Temetetende | ተመጠጥንደ - New Ethiopian Music 2020 (Official Video) by Hope Music Ethiopia 1 year ago 4 minutes, 18 seconds 88,140 views",Hope Music Entertainment,88140,88161,21
581,"Soolan Abdii - Xawalwaallee - New Ethiopian Music 2020 (Official Video) by Hope Music Ethiopia 1 year ago 4 minutes, 18 seconds 24,645 views",Hope Music Entertainment,24645,24693,48
582,"Alamaw Chekol - Wubit | ውቢት - New Ethiopian Music 2020 (Official Video) by Hope Music Ethiopia 1 year ago 5 minutes, 22 seconds 94,773 views",Hope Music Entertainment,94773,94820,47
583,"Yeshiwas Ayana - Melkame | መልካሜ - New Ethiopian Music 2020 (Official Video) by Hope Music Ethiopia 1 year ago 5 minutes, 59 seconds 49,299 views",Hope Music Entertainment,49299,49327,28
584,"Tewodros Negash - Yeayne Tesfa | የአይኔ ተስፋ - New Ethiopian Music 2020 (Official Video) by Hope Music Ethiopia 1 year ago 4 minutes, 33 seconds 20,061 views",Hope Music Entertainment,20061,20072,11
585,"Nahom Asnake - Tew | ተው - New Ethiopian Music 2020 by Hope Music Ethiopia 1 year ago 1 minute, 33 seconds 18,441 views",Hope Music Entertainment,18441,18447,6
586,"Getahun Ayalew - Zeraf | ዘራፍ - New Ethiopian Music 2020 (Official Video) by Hope Music Ethiopia 1 year ago 6 minutes, 36 seconds 147,564 views",Hope Music Entertainment,147564,147935,371
587,"Zeleke Gessesse - Selam | ሰላም - New Ethiopian Music 2020 (Official Video) by Hope Music Ethiopia 1 year ago 4 minutes, 15 seconds 40,467 views",Hope Music Entertainment,40467,40596,129
588,"Tinsae Gobena & Mimi Muluken - EIJ ENINSA | እጅ እንንሳ - New Ethiopian Music 2020 (Official Video) by Hope Music Ethiopia 1 year ago 5 minutes, 19 seconds 1,095,787 views",Hope Music Entertainment,1095787,1097009,1222
589,"Sam Habesha - Entseley | እንፀልይ - New Ethiopian Music 2020 (Official Video) by Hope Music Ethiopia 1 year ago 2 minutes, 48 seconds 32,037 views",Hope Music Entertainment,32037,32050,13
590,"Dagof (Yeshi) - Sagegneh | ሳገኝህ - New Ethiopian Music 2020 (Official Video) by Hope Music Ethiopia 1 year ago 3 minutes, 38 seconds 31,236 views",Hope Music Entertainment,31236,31256,20
591,"Dagmawit - Tizitawoche | ትዝታዎቼ - New Ethiopian Music 2020 (Official Video) by Hope Music Ethiopia 1 year ago 4 minutes, 32 seconds 38,361 views",Hope Music Entertainment,38361,38388,27
592,"Tesfaye Taye & Aklilu Yohannes - Deraro | ደራሮ - New Ethiopian Music 2020 (Official Video) by Hope Music Ethiopia 1 year ago 5 minutes, 30 seconds 28,715 views",Hope Music Entertainment,28715,28974,259
593,"Zebenay Temesgen - Hememe | ህመሜ - New Ethiopian Music 2020 (Official Video) by Hope Music Ethiopia 1 year ago 6 minutes, 51 seconds 54,081 views",Hope Music Entertainment,54081,54168,87
594,"Tsegazeab Misganaw & Temesgen Bekele - Semiruley | ሰሚሩለይ - New Ethiopian Music 2020 by Hope Music Ethiopia 1 year ago 5 minutes, 41 seconds 46,339 views",Hope Music Entertainment,46339,46393,54
595,"Yehun - Taxi - New Ethiopian Music 2020 (Official Video) by Hope Music Ethiopia 1 year ago 4 minutes, 39 seconds 85,451 views",Hope Music Entertainment,85451,85509,58
596,"Abadi Redai (Abu) - Yisemagnal | ይሰማኛል - New Ethiopian Music 2020 (Official Video) by Hope Music Ethiopia 1 year ago 4 minutes, 51 seconds 46,750 views",Hope Music Entertainment,46750,46756,6
597,"Yonas Belayneh - Danna | ዳና - New Ethiopian Music 2020 (Official Video) by Hope Music Ethiopia 1 year ago 4 minutes, 53 seconds 47,364 views",Hope Music Entertainment,47364,47385,21
598,"Nebiyunatan - Filega | ፍለጋ - New Ethiopian Music 2020 (Official Video) by Hope Music Ethiopia 1 year ago 3 minutes, 29 seconds 33,598 views",Hope Music Entertainment,33598,33607,9
599,"Loza Wendemhun - Na Destaye | ና ደስታዬ - New Ethiopian Music 2020 (Official Video) by Hope Music Ethiopia 1 year ago 4 minutes, 49 seconds 79,827 views",Hope Music Entertainment,79827,79864,37
600,"Kanni Yohannes - Yesew Lij Kentu | የሰው ልጅ ከንቱ - New Ethiopian Music 2020 (Official Video) by Hope Music Ethiopia 1 year ago 3 minutes, 19 seconds 52,747 views",Hope Music Entertainment,52747,53141,394
601,"Kibkab Tesfaye - Dena Dena | ደና ደና - New Ethiopian Music 2020 by Hope Music Ethiopia 1 year ago 5 minutes, 21 seconds 35,381 views",Hope Music Entertainment,35381,35396,15
602,"Birhanu Chala - Cheye | ችዬ - New Ethiopian Music 2020 (Official Video) by Hope Music Ethiopia 1 year ago 5 minutes, 23 seconds 545,694 views",Hope Music Entertainment,545694,547516,1822
603,"Eden Weldemariam - Na Na | ናና - New Ethiopian Music 2020 (Official Video) by Hope Music Ethiopia 1 year ago 3 minutes, 51 seconds 38,725 views",Hope Music Entertainment,38725,38755,30
604,"Tesfaye Shiferaw & Betelhem Getachew - Bet Ensra | ቤት እንስራ - New Ethiopian Music 2020 by Hope Music Ethiopia 1 year ago 5 minutes, 9 seconds 25,214 views",Hope Music Entertainment,25214,25231,17
605,"Genenew Assefa - Dikala Aydelehum | ዲቃላ አይደለሁም - New Ethiopian Music 2020 (Official video) by Hope Music Ethiopia 1 year ago 7 minutes, 19 seconds 66,128 views",Hope Music Entertainment,66128,66139,11
606,"Dagmawi Weldemariam - Fetahuat | ፈታዋት - New Ethiopian Music 2020 (Official Video) by Hope Music Ethiopia 1 year ago 5 minutes, 19 seconds 105,465 views",Hope Music Entertainment,105465,105538,73
607,"Jossy Saba - Tazebkush | ታዘብኩሽ - New Ethiopian Music 2020 (Official Video) by Hope Music Ethiopia 1 year ago 4 minutes, 50 seconds 23,669 views",Hope Music Entertainment,23669,23679,10
608,"Mulugeta Bihonegn - Tastaweshalesh Wey | ታስታውሻለሽ ወይ - New Ethiopian Music 2020 (Official Video) by Hope Music Ethiopia 1 year ago 4 minutes, 56 seconds 48,702 views",Hope Music Entertainment,48702,48736,34
609,"Aplish Menn - Fendka | ፈንድቃ - New Ethiopian Music 2020 (Official Video) by Hope Music Ethiopia 1 year ago 3 minutes, 33 seconds 28,185 views",Hope Music Entertainment,28185,28204,19
610,"Kalkidan Hulunayehu & Hewan Birhanu  - Keayne Yawtachihu | ከአይን ያውጣችሁ - New Ethiopian Music 2020 by Hope Music Ethiopia 1 year ago 5 minutes, 1 second 49,754 views",Hope Music Entertainment,49754,49777,23
611,"Yordanos Adugna - Leyu | ልዩ - New Ethiopian Music 2020 (Official Video) by Hope Music Ethiopia 1 year ago 5 minutes, 17 seconds 26,898 views",Hope Music Entertainment,26898,26928,30
612,"NK5 - Komkugn Banchi | ቆምኩኝ ባንቺ - New Ethiopian Music 2020 (Official Video) by Hope Music Ethiopia 1 year ago 3 minutes, 48 seconds 20,756 views",Hope Music Entertainment,20756,20777,21
613,"Yami Besemesh - Tamrialesh | ታምሪያለሽ - New Ethiopian Music 2020 (Official Video) by Hope Music Ethiopia 1 year ago 7 minutes, 4 seconds 82,894 views",Hope Music Entertainment,82894,82924,30
614,"Ab Yared X Kiya ft Keamlakneh Ak & Zemas - Befikir Sim | በፍቅር ስም - New Ethiopian Music 2020 by Hope Music Ethiopia 1 year ago 4 minutes, 10 seconds 41,537 views",Hope Music Entertainment,41537,41567,30
615,"Yirdaw Chernet - Yimechish | ይመችሽ - New Ethiopian Music 2020 (Official Video) by Hope Music Ethiopia 1 year ago 5 minutes 66,537 views",Hope Music Entertainment,66537,66576,39
616,"Yemane Birhane - Tarik Seri Tewled | ታሪክ ሰሪ ትውልድ - New Ethiopian Music 2020 (Official Video) by Hope Music Ethiopia 2 years ago 3 minutes, 52 seconds 19,038 views",Hope Music Entertainment,19038,19060,22
617,"Ethiopiawinet - Wey Finkich (Dance Cover) | ወይ ፍንክች - New Ethiopian Music 2020 (official Video) by Hope Music Ethiopia 2 years ago 3 minutes, 11 seconds 64,381 views",Hope Music Entertainment,64381,64592,211
618,"Alelign Wedaje - Kelay Kelay | ከላይ ከላይ - New Ethiopian Music 2020 (Official Video) by Hope Music Ethiopia 2 years ago 4 minutes, 45 seconds 53,857 views",Hope Music Entertainment,53857,53887,30
619,"Tigist Belachew - Alegn Alekim | አለኝ አለቅም - New Ethiopian Music 2020 (Official Video) by Hope Music Ethiopia 2 years ago 5 minutes, 10 seconds 637,114 views",Hope Music Entertainment,637114,641302,4188
620,"Marsawi Kifle - Dink Sew | ድንቅ ሰው - New Ethiopian Music 2020 (Official Video) by Hope Music Ethiopia 2 years ago 5 minutes, 48 seconds 62,218 views",Hope Music Entertainment,62218,62240,22
621,"Adonay The Hit Brothers - Zore Zore | ዞሬ ዞሬ - New Ethiopian Music 2020 (Official Video) by Hope Music Ethiopia 2 years ago 3 minutes, 37 seconds 38,599 views",Hope Music Entertainment,38599,38630,31
622,"Biruktawit Taye - Aleh | አለህ - New Ethiopian Music 2020 (Official Video) by Hope Music Ethiopia 2 years ago 5 minutes, 31 seconds 86,719 views",Hope Music Entertainment,86719,86734,15
623,"Seble Worku - Semegnew Agegnew | ስመኘው አገኘው - New Ethiopian Music 2020 (Official Video) by Hope Music Ethiopia 2 years ago 4 minutes, 58 seconds 27,538 views",Hope Music Entertainment,27538,27554,16
624,"Endashaw Shenkut - Denye | ደንዬ - New Ethiopian Music 2020 (Official Video) by Hope Music Ethiopia 2 years ago 5 minutes, 28 seconds 112,209 views",Hope Music Entertainment,112209,112292,83
625,"Alphabesha - Tewled Nika | ትውልድ ንቃ - New Ethiopian Music 2020 (Official Video) by Hope Music Ethiopia 2 years ago 3 minutes, 32 seconds 79,908 views",Hope Music Entertainment,79908,79949,41
626,"Aki Habesha - Atwejignim Ende | አትወጂኝም እንዴ - New Ethiopian Music 2020 (Official Video) by Hope Music Ethiopia 2 years ago 4 minutes, 42 seconds 961,546 views",Hope Music Entertainment,961546,964847,3301
627,"Sol Romeyo - Techawechi | ተጫወቺ -  New Ethiopian Music 2020 (Official Video) by Hope Music Ethiopia 2 years ago 4 minutes, 36 seconds 43,510 views",Hope Music Entertainment,43510,43538,28
628,"Sarina - Balsema | ባልሰማ - New Ethiopian Music 2020 (Official Video) by Hope Music Ethiopia 2 years ago 5 minutes, 13 seconds 109,502 views",Hope Music Entertainment,109502,109561,59
629,"Yitagesu Baye Assefa - Gerado | ገራዶ - New Ethiopian Music 2020 (Official Video) by Hope Music Ethiopia 2 years ago 5 minutes, 58 seconds 101,915 views",Hope Music Entertainment,101915,102034,119
630,"Elias Teshome - Kiyaye | ኪያዬ - New Ethiopian Music 2020 (Official Video) by Hope Music Ethiopia 2 years ago 4 minutes, 50 seconds 4,482,016 views",Hope Music Entertainment,4482016,4528034,46018
631,"Meselu Hagos - Negadew | ነጋዴው - New Ethiopian Music (Official Video) by Hope Music Ethiopia 2 years ago 6 minutes, 21 seconds 557,204 views",Hope Music Entertainment,557204,558493,1289
632,"D97SUPER B FT.  REAL OC & JAY WALK - MAMA GAMBELLA - New Ethiopian Music 2020 (Official Video) by Hope Music Ethiopia 2 years ago 5 minutes, 27 seconds 23,738 views",Hope Music Entertainment,23738,23846,108
633,"Dawit Wordofa - Altelashim Tolo | የማልጠላሽ ቶሎ - New Ethiopian Music 2020 (Official Video) by Hope Music Ethiopia 2 years ago 4 minutes, 54 seconds 59,878 views",Hope Music Entertainment,59878,59900,22
634,"Alemtsehay Asgedom - Chenki Lemntay | ጭንቂ ንምንታይ - New Ethiopian Music 2020 (Official Video) by Hope Music Ethiopia 2 years ago 6 minutes, 11 seconds 32,937 views",Hope Music Entertainment,32937,32942,5
635,"Meselu Hagos - Hbub Bel | ህቡብ በል - New Ethiopian Music 2020 (Official Video) by Hope Music Ethiopia 2 years ago 5 minutes, 54 seconds 103,349 views",Hope Music Entertainment,103349,103544,195
636,"Aweke Abebe - Esmamalehu | እስማማለሁ - New Ethiopian Music 2020 (Official Video) by Hope Music Ethiopia 2 years ago 7 minutes, 6 seconds 175,072 views",Hope Music Entertainment,175072,178968,3896
637,"Sara Tilahun - Aynun Say | አይኑን ሳይ - New Ethiopian Music 2020 (Official Video) by Hope Music Ethiopia 2 years ago 4 minutes, 13 seconds 29,863 views",Hope Music Entertainment,29863,29881,18
638,"Yirdaw Chernet - Dejen Lay | ደጀን ላይ - New Ethiopian Music 2020 (Official Video) by Hope Music Ethiopia 2 years ago 4 minutes, 50 seconds 68,152 views",Hope Music Entertainment,68152,68240,88
639,"Henok Mewded - Esuan Beye | እሷን ብዬ - New Ethiopian Music 2020 (Official Video) by Hope Music Ethiopia 2 years ago 3 minutes, 31 seconds 58,365 views",Hope Music Entertainment,58365,58419,54
640,"Danny Shag ft. Rafa - Anchin Lene | አንችን ለኔ - New Ethiopian Music 2020 (Official Video) by Hope Music Ethiopia 2 years ago 3 minutes, 34 seconds 54,045 views",Hope Music Entertainment,54045,54262,217
641,"Dere Hab - Kerebish | ቀረብሽ - New Ethiopian Music 2020 (Official Video) by Hope Music Ethiopia 2 years ago 3 minutes, 29 seconds 60,936 views",Hope Music Entertainment,60936,61202,266
642,"Endish - Haba Haba | ሀባ ሀባ - New Ethiopian Music 2020 (Official Video) by Hope Music Ethiopia 2 years ago 4 minutes, 1 second 62,528 views",Hope Music Entertainment,62528,62546,18
643,"Habtamu Tedla - Alenager | አልናገር - New Ethiopian Music 2020 (Official Video) by Hope Music Ethiopia 2 years ago 6 minutes, 26 seconds 189,635 views",Hope Music Entertainment,189635,190055,420
644,"Habtamu Geremew - Tey Gelaye | ተይ ገላዬ - New Ethiopian Music 2020 (Official Video) by Hope Music Ethiopia 2 years ago 4 minutes 47,985 views",Hope Music Entertainment,47985,48037,52
645,"Melak Woldegabriel - Genzeb Yeseba | ገንዘብ ይስባ - New Ethiopian Music 2020 (Official Video) by Hope Music Ethiopia 2 years ago 5 minutes, 22 seconds 28,548 views",Hope Music Entertainment,28548,28555,7
646,"Alemtsehay Takele - Sew Mehon | ሰው መሆን - New Ethiopian Music 2020 (Official Video) by Hope Music Ethiopia 2 years ago 5 minutes, 31 seconds 146,162 views",Hope Music Entertainment,146162,146362,200
647,"Wendesen Agegnehu - Etewa | እቴዋ - New Ethiopian Music 2020 (Official Video) by Hope Music Ethiopia 2 years ago 7 minutes, 27 seconds 212,290 views",Hope Music Entertainment,212290,212611,321
648,"Selamawit Girma - Na | ና - New Ethiopian Music 2020 (Official Video) by Hope Music Ethiopia 2 years ago 5 minutes, 35 seconds 586,949 views",Hope Music Entertainment,586949,587977,1028
649,"Tsegaw Teklu - Man Libel | ማን ልበል - New Ethiopian Music 2020 (Official Video) by Hope Music Ethiopia 2 years ago 4 minutes, 35 seconds 60,280 views",Hope Music Entertainment,60280,60300,20
650,"Semahegn belew ft. Henok Kibru - Yagebanal | ያገባናል - New Ethiopian Music 2020 (Official Video) by Hope Music Ethiopia 2 years ago 6 minutes, 36 seconds 138,954 views",Hope Music Entertainment,138954,139180,226
651,"Meskerem Asrat - Min Lihun | ምን ልሁን - New Ethiopian Music 2020 (Official Video) by Hope Music Ethiopia 2 years ago 3 minutes, 31 seconds 52,077 views",Hope Music Entertainment,52077,52122,45
652,"Ethiopia Bekelech - Angaliya | አንጋሊያ - New Ethiopian Music 2020 (Official Video) by Hope Music Ethiopia 2 years ago 5 minutes, 33 seconds 45,238 views",Hope Music Entertainment,45238,45540,302
653,"Salit Huber - Abayey | ዓባየይ - New Eritrean Music 2020 (Official Video) by Hope Music Ethiopia 2 years ago 4 minutes, 21 seconds 18,843 views",Hope Music Entertainment,18843,18902,59
654,"Tadese Bekele - Ethiopia | ኢትዮዽያ - New Ethiopian Music 2020 (Official Video) by Hope Music Ethiopia 2 years ago 6 minutes, 29 seconds 41,694 views",Hope Music Entertainment,41694,41712,18
655,"Berhe Abraha - Meizeteway | ምዕዝትዋይ - New Ethiopian Music 2020 (Official Video) by Hope Music Ethiopia 2 years ago 5 minutes, 14 seconds 23,727 views",Hope Music Entertainment,23727,23732,5
656,"Zion Rebels - Tsinat | ፅናት - New Ethiopian Music 2020 (Official Video) by Hope Music Ethiopia 2 years ago 4 minutes, 17 seconds 35,187 views",Hope Music Entertainment,35187,35269,82
657,"Kefale Molla - Eda Giba Silew | እዳ ግባ ሲለው - New Ethiopian Music 2020 (Official Video) by Hope Music Ethiopia 2 years ago 4 minutes, 6 seconds 142,231 views",Hope Music Entertainment,142231,142301,70
658,"Ujulu Fera ft. Kelage & Abebe - Shambal Basha - New Ethiopian Music 2020 (Official Video) by Hope Music Ethiopia 2 years ago 5 minutes 50,059 views",Hope Music Entertainment,50059,50175,116
659,"Bre Bright - Alem New | አለም ነው - New Ethiopian Music 2020 (Official Video) by Hope Music Ethiopia 2 years ago 6 minutes, 49 seconds 62,112 views",Hope Music Entertainment,62112,62169,57
660,"Nahom Haile & Bemnet ft. Mr. Yemo - Marye | ማርዬ  - New Ethiopian Music 2020 (Official Video) by Hope Music Ethiopia 2 years ago 4 minutes, 43 seconds 327,186 views",Hope Music Entertainment,327186,328774,1588
661,"Neba - Lijet Ke'Kefa | ልጅት ከከፋ - New Ethiopian Music 2020 (Official Video) by Hope Music Ethiopia 2 years ago 3 minutes, 48 seconds 19,450 views",Hope Music Entertainment,19450,19486,36
662,"Adugna & Amen Choir - Nu Beyin | ኑ በይን - New Ethiopian Music 2020 (Official Video) by Hope Music Ethiopia 2 years ago 6 minutes, 40 seconds 63,331 views",Hope Music Entertainment,63331,63442,111
663,"26 Years X Yemi Boom - Dehena Senbit | ደህና ሰንብት - New Ethiopian Music 2020 (Official Video) by Hope Music Ethiopia 2 years ago 3 minutes, 23 seconds 28,607 views",Hope Music Entertainment,28607,28619,12
664,"ABEL Z & THE DANI MAN - LYA | ልያ - New Ethiopian Music 2020 (Official Video) by Hope Music Ethiopia 2 years ago 3 minutes, 56 seconds 57,055 views",Hope Music Entertainment,57055,57185,130
665,"Mengistu Wendemagegn - Yemarkoswa | የማርቆስዋ - New Ethiopian Music 2020 (Official Video) by Hope Music Ethiopia 2 years ago 5 minutes, 33 seconds 23,703 views",Hope Music Entertainment,23703,23711,8
666,"Elias Merawi - Endewaza | እንደዋዛ - New Ethiopian Music 2020 (Official Video) by Hope Music Ethiopia 2 years ago 4 minutes, 26 seconds 1,976,154 views",Hope Music Entertainment,1976154,1979173,3019
667,"Nati Rebel & Sami - Yetimiket Chewata | የጥምቀት ጨዋታ - New Ethiopian Music 2020 (Official Video) by Hope Music Ethiopia 2 years ago 3 minutes, 55 seconds 38,663 views",Hope Music Entertainment,38663,38686,23
668,"Dagne Walle - Wey Finkich (Yecheneke Elet 2) | ወይ ፍንክች - New Ethiopian Music 2020 (Official Video) by Hope Music Ethiopia 2 years ago 7 minutes, 20 seconds 8,179,622 views",Hope Music Entertainment,8179622,8222627,43005
669,"Various Artists - SEWAWI | ሰዋዊ - New Ethiopian Music 2020 (Official Video) by Hope Music Ethiopia 2 years ago 6 minutes, 7 seconds 759,350 views",Hope Music Entertainment,759350,760018,668
670,"Abel Almaz - Krekbeki Eye | ኽረኽበኪ'እየ - New Ethiopian Music 2020 (Official Video) by Hope Music Ethiopia 2 years ago 4 minutes, 18 seconds 68,141 views",Hope Music Entertainment,68141,68221,80
671,"Hab Engidaw - Tintuni | ቲንቱኒ - New Ethiopian Music 2020 (Official Video) by Hope Music Ethiopia 2 years ago 5 minutes 90,842 views",Hope Music Entertainment,90842,90971,129
672,"Wabii Dhaabaa - GOGROBOO - New Ethiopian Music 2020 (Official Video) by Hope Music Ethiopia 2 years ago 6 minutes, 12 seconds 418,704 views",Hope Music Entertainment,418704,420148,1444
673,"Gezahegn Wubeshet - Melkesh Aygeltseshem | መልክሽ አይገልፅሽም - New Ethiopian Music 2020 (Official Video) by Hope Music Ethiopia 2 years ago 4 minutes, 50 seconds 53,267 views",Hope Music Entertainment,53267,53281,14
674,"Syco David - Hewane | ሀዋኔ - New Ethiopian Music 2020 (Official Video) by Hope Music Ethiopia 2 years ago 3 minutes, 52 seconds 290,223 views",Hope Music Entertainment,290223,290387,164
675,"Solomon Belay ft. Soliana - Yeh New Wey Alem | ይህ ነው ወይ አለም - New Ethiopian Music 2020 by Hope Music Ethiopia 2 years ago 5 minutes, 17 seconds 93,246 views",Hope Music Entertainment,93246,93276,30
676,"Endrias Mekonnen - Ababeye | አባብዬ - New Ethiopian Music 2020 (Official Video) by Hope Music Ethiopia 2 years ago 5 minutes, 7 seconds 42,167 views",Hope Music Entertainment,42167,42310,143
677,"Demeke Bitew - Lib Aregelegn | ልብ አርግልኝ - New Ethiopian Music 2020 (Official Video) by Hope Music Ethiopia 2 years ago 5 minutes, 55 seconds 82,919 views",Hope Music Entertainment,82919,82971,52
678,"Kebede Lemma - Ahun Na | አሁን ና - New Ethiopian Music 2020 (Official Video) by Hope Music Ethiopia 2 years ago 5 minutes, 22 seconds 34,006 views",Hope Music Entertainment,34006,34025,19
679,"Abraham X Dagiopia - AKIYE | አኪዬ - New Ethiopian Music 2020 (Official Video) by Hope Music Ethiopia 2 years ago 4 minutes, 28 seconds 340,119 views",Hope Music Entertainment,340119,344129,4010
680,"Kako Getachew - Zor Zor | ዞር ዞር - New Ethiopian Music 2020 (Official Video) by Hope Music Ethiopia 2 years ago 5 minutes, 3 seconds 2,295,267 views",Hope Music Entertainment,2295267,2308171,12904
681,"Yonas Wubeshet - Wusheme | ውሽሜ - New Ethiopian Music 2020 (Official Video) by Hope Music Ethiopia 2 years ago 5 minutes, 35 seconds 49,200 views",Hope Music Entertainment,49200,49227,27
682,"Caaltuu H/Maariyaam - Ulfaataa Dha - New Ethiopian Music 2020 (Official Video) by Hope Music Ethiopia 2 years ago 4 minutes, 57 seconds 877,111 views",Hope Music Entertainment,877111,884301,7190
683,"Mabre Guangul - Besetachew Mejen | በሰጣቸው መጀን - New Ethiopian Music 2020 (Official Video) by Hope Music Ethiopia 2 years ago 4 minutes, 53 seconds 156,493 views",Hope Music Entertainment,156493,156726,233
684,"Tomas Alene - Kemetski Nabey | ክመፀኪ ናበይ - New Ethiopian Music (Official Video) by Hope Music Ethiopia 2 years ago 4 minutes, 24 seconds 20,779 views",Hope Music Entertainment,20779,20793,14
685,"Worku Molla - Ayshagnim | አይሻኝም - New Ethiopian Music 2020 (Official Video) by Hope Music Ethiopia 2 years ago 7 minutes, 11 seconds 1,251,082 views",Hope Music Entertainment,1251082,1255894,4812
686,"Mekdes Teshome - Embiyew | እምቢየው - New Ethiopian Music 2020 (Official Video) by Hope Music Ethiopia 2 years ago 4 minutes, 34 seconds 506,699 views",Hope Music Entertainment,506699,507744,1045
687,"Fasil Tilahun - Asina Birhan | አሲና ብርሃን - New Ethiopian Music 2020 (Official Video) by Hope Music Ethiopia 2 years ago 5 minutes, 23 seconds 60,659 views",Hope Music Entertainment,60659,60864,205
688,"Nuradis Seid - Baradaw | ባራዳው - New Ethiopian Music 2020 (Official Video) by Hope Music Ethiopia 2 years ago 5 minutes, 43 seconds 748,332 views",Hope Music Entertainment,748332,750135,1803
689,"Kasahun Eshetu - Minish Negn Lebelat | ምንሽ ነኝ ልበላት - New Ethiopian Music 2020 (Official Video) by Hope Music Ethiopia 2 years ago 6 minutes, 29 seconds 450,351 views",Hope Music Entertainment,450351,450762,411
690,"Molla Kassa - Gena Werfida Belew | ገና ወርፊዳ በለው - New Ethiopian Music 2020 (Official Video) by Hope Music Ethiopia 2 years ago 5 minutes, 20 seconds 97,102 views",Hope Music Entertainment,97102,97190,88
691,"Dawit Alemayehu - Alewna | አለውና - New Ethiopian Music 2020 (Official Video) by Hope Music Ethiopia 2 years ago 5 minutes, 18 seconds 1,075,654 views",Hope Music Entertainment,1075654,1079412,3758
692,"Tewodros Samuel - Firejign | ፍረጅኝ - New Ethiopian Music (Official Video) by Hope Music Ethiopia 2 years ago 5 minutes, 58 seconds 586,974 views",Hope Music Entertainment,586974,587685,711
693,"Mash Dahlak - Tafach | ጣፋጭ - New Ethiopian Music (Official Video) by Hope Music Ethiopia 2 years ago 5 minutes, 7 seconds 49,545 views",Hope Music Entertainment,49545,49698,153
694,"Alemayehu Wesen - Yegena Jenber | የገና ጀንበር - New Ethiopian Music (Official Video) by Hope Music Ethiopia 2 years ago 5 minutes, 25 seconds 453,097 views",Hope Music Entertainment,453097,454151,1054
695,"Merkeb bonitua X Fitawrari Kibromma - Elomgo | ኢሎምጎ - New Ethiopian Music (Official Video) by Hope Music Ethiopia 2 years ago 5 minutes, 11 seconds 161,134 views",Hope Music Entertainment,161134,161323,189
696,"Samson Getachew - Ete Mete | እቴ ሜቴ - New Ethiopian Music (Official Video) by Hope Music Ethiopia 2 years ago 4 minutes, 16 seconds 49,809 views",Hope Music Entertainment,49809,49862,53
697,"Efrem Altaseb - Lehid Gonder | ልሂድ ጎንደር - New Ethiopian Music (Official Video) by Hope Music Ethiopia 2 years ago 5 minutes, 21 seconds 55,300 views",Hope Music Entertainment,55300,55445,145
698,"Genet Bekele - Sehatu Dersual - New Ethiopian Music (Official Video) by Hope Music Ethiopia 2 years ago 4 minutes, 42 seconds 35,057 views",Hope Music Entertainment,35057,35079,22
699,"Gerry ft. Jonana - EGEME - New Ethiopian Music (Official Video) by Hope Music Ethiopia 2 years ago 4 minutes, 45 seconds 35,617 views",Hope Music Entertainment,35617,35635,18
700,"Samrawit Girma - Ney Kalkegn | ነይ ካልከኝ - New Ethiopian Music (Official Video) by Hope Music Ethiopia 2 years ago 6 minutes, 4 seconds 136,532 views",Hope Music Entertainment,136532,136600,68
701,"Fasil Demoz - Gintil Get | ግንጥል ጌጥ - New Ethiopian Music (Official Video) by Hope Music Ethiopia 2 years ago 8 minutes, 23 seconds 1,131,628 views",Hope Music Entertainment,1131628,1133631,2003
702,"Tewodros Asaye - Wuleta | ውለታ - Ethiopian Music (Official Video) by Hope Music Ethiopia 2 years ago 4 minutes, 48 seconds 34,056 views",Hope Music Entertainment,34056,34075,19
703,"Yohannes Yirdaw - Aynamaytu | አይናማይቱ - New Ethiopian Music (Official Video) by Hope Music Ethiopia 2 years ago 4 minutes, 28 seconds 102,046 views",Hope Music Entertainment,102046,102186,140
704,"Buze man | ቡዜ ማን - Shashemene | ሻሸመኔ - New Ethiopian Music (Official Audio) by Hope Music Ethiopia 2 years ago 3 minutes, 39 seconds 34,313 views",Hope Music Entertainment,34313,34372,59
705,"Buze man | ቡዜ ማን - Melsu | መልሱ - New Ethiopian Music (Official Audio) by Hope Music Ethiopia 2 years ago 4 minutes, 7 seconds 23,628 views",Hope Music Entertainment,23628,23664,36
706,"Buze man | ቡዜ ማን - And Ken | አንድ ቀን - New Ethiopian Music (Official Audio) by Hope Music Ethiopia 2 years ago 3 minutes, 46 seconds 31,594 views",Hope Music Entertainment,31594,31635,41
707,"Buze man | ቡዜ ማን - Yemola | የሞላ - New Ethiopian Music (Official Audio) by Hope Music Ethiopia 2 years ago 4 minutes, 22 seconds 55,159 views",Hope Music Entertainment,55159,55237,78
708,"Buze man - Man Alesh | ማን አለሽ - New Ethiopian Music (Official Audio) by Hope Music Ethiopia 2 years ago 4 minutes, 14 seconds 109,965 views",Hope Music Entertainment,109965,110189,224
709,"Buze man - Kobani Intew |  ኮባኒ ኢንተው - New Ethiopian Music (Official Audio) by Hope Music Ethiopia 2 years ago 4 minutes, 27 seconds 54,151 views",Hope Music Entertainment,54151,54230,79
710,"Buze man - Kebedual | ከብዷል - New Ethiopian Music (Official Audio) by Hope Music Ethiopia 2 years ago 4 minutes, 23 seconds 48,646 views",Hope Music Entertainment,48646,48708,62
711,"Buze man - Edeme Lanchi | ዕድሜ ላንቺ - New Ethiopian Music (Official Audio) by Hope Music Ethiopia 2 years ago 3 minutes, 47 seconds 49,347 views",Hope Music Entertainment,49347,49435,88
712,"Buze man - Atamerem | አታምርም - New Ethiopian Music (Official Audio) by Hope Music Ethiopia 2 years ago 3 minutes, 57 seconds 70,406 views",Hope Music Entertainment,70406,70531,125
713,"Buze man - Atewejignm | አትወጂኝም - New Ethiopian Music (Official Audio) by Hope Music Ethiopia 2 years ago 4 minutes, 50 seconds 170,441 views",Hope Music Entertainment,170441,170878,437
714,"Buze man - Wedefit | ወደፊት - New Ethiopian Music (Official Audio) by Hope Music Ethiopia 2 years ago 4 minutes, 56 seconds 36,358 views",Hope Music Entertainment,36358,36392,34
715,"Buze man - Bafema | ባፌማ - New Ethiopian Music (Official Audio) by Hope Music Ethiopia 2 years ago 4 minutes, 52 seconds 126,538 views",Hope Music Entertainment,126538,126743,205
716,"Buze man - Bar Bar | ባር ባር - New Ethiopian Music (Official Audio) by Hope Music Ethiopia 2 years ago 4 minutes, 28 seconds 42,605 views",Hope Music Entertainment,42605,42667,62
717,"Buze man - Alregmat | አልረግማት - New Ethiopian Music (Official Audio) by Hope Music Ethiopia 2 years ago 4 minutes, 34 seconds 52,408 views",Hope Music Entertainment,52408,52543,135
718,"Buze man - Kelolesh | ቀሎልሽ - New Ethiopian Music (Official Audio) by Hope Music Ethiopia 2 years ago 5 minutes, 14 seconds 97,074 views",Hope Music Entertainment,97074,97171,97
719,"Menale Demes - Zemede | ዘመዴ - Ethiopian Music 2019 (Official Video) by Hope Music Ethiopia 2 years ago 6 minutes, 7 seconds 44,566 views",Hope Music Entertainment,44566,44589,23
720,"Kidist Amare - Sew Ale Wey | ሰው አለ ወይ - New Ethiopian Music 2019 (Official Video) by Hope Music Ethiopia 2 years ago 4 minutes 57,703 views",Hope Music Entertainment,57703,57714,11
721,"Girum Getachew - Dil Kedil Bet Geba | ድል ከድል ቤት ገባ - New Ethiopian Music 2019 (Official Video) by Hope Music Ethiopia 2 years ago 3 minutes, 27 seconds 9,614 views",Hope Music Entertainment,9614,9620,6
722,"Gadaa Hamdaa - Muramte - New Ethiopian Music 2019 (Official Video) by Hope Music Ethiopia 2 years ago 5 minutes, 19 seconds 70,034 views",Hope Music Entertainment,70034,70365,331
723,"Zereabiruk Semaw - Mene Terefesh | ምን ተረፈሽ - New Ethiopian Music 2019 (Official Video) by Hope Music Ethiopia 2 years ago 5 minutes, 15 seconds 328,577 views",Hope Music Entertainment,328577,329564,987
724,"Alemye Getachew - Tazelo Yalgeba | ታዝሎ ያልገባ - New Ethiopian Music 2019 (Official Video) by Hope Music Ethiopia 2 years ago 6 minutes, 40 seconds 4,504,839 views",Hope Music Entertainment,4504839,4515016,10177
725,"Kuul Surre - Manaya - New Ethiopian Music 2019 (Official Video) by Hope Music Ethiopia 2 years ago 4 minutes, 55 seconds 121,441 views",Hope Music Entertainment,121441,122506,1065
726,"KB Smart - Bey Bey | በይ በይ - New Ethiopian Music 2019 (Official Video) by Hope Music Ethiopia 2 years ago 3 minutes, 56 seconds 52,818 views",Hope Music Entertainment,52818,52860,42
727,"Kadijjaa Haajii - Hayoolee - New Ethiopian Music (Official Video) by Hope Music Ethiopia 2 years ago 4 minutes, 37 seconds 29,528 views",Hope Music Entertainment,29528,29587,59
728,"Esubalew Leyeh - Gojam Baladera | ጎጃም ባላደራ - New Ethiopian Music 2019 (Official Video) by Hope Music Ethiopia 2 years ago 7 minutes, 9 seconds 100,741 views",Hope Music Entertainment,100741,100876,135
729,"Ashenafi Yishak - Emamye | እማምዬ - New Ethiopian Music 2019 (Official Video) by Hope Music Ethiopia 2 years ago 5 minutes, 9 seconds 34,594 views",Hope Music Entertainment,34594,34608,14
730,"Tamirat Kebede - Ethiopia Yegna Enat | ኢትዮጵያ የኛ እናት - New Ethiopian Music (Official Video) by Hope Music Ethiopia 2 years ago 5 minutes, 3 seconds 53,806 views",Hope Music Entertainment,53806,53830,24
731,"Noah Mulugeta - Hager Yegara | ሃገር የጋራ - New Ethiopian Music 2019 (Official Video) by Hope Music Ethiopia 2 years ago 3 minutes, 59 seconds 69,946 views",Hope Music Entertainment,69946,70375,429
732,"Rodas Workye - Shaina Meenak - New Ethiopian Music 2019 (Official Video) by Hope Music Ethiopia 2 years ago 4 minutes, 34 seconds 34,855 views",Hope Music Entertainment,34855,34865,10
733,"Kalkidan Hailesilassie - Ere Endet | ኧረ እንዴት - New Ethiopian Music 2019 (Official Video) by Hope Music Ethiopia 2 years ago 3 minutes, 56 seconds 48,000 views",Hope Music Entertainment,48000,48255,255
734,"Yonas Abate - Tsilel | ጽለል  - New Ethiopian Music 2019 (Official Video) by Hope Music Ethiopia 2 years ago 4 minutes, 4 seconds 71,758 views",Hope Music Entertainment,71758,71794,36
735,"Fikadu Tizazu - Tezazebin | ተዛዘብን - New Ethiopian Music 2019 (Official Video) by Hope Music Ethiopia 2 years ago 5 minutes 259,978 views",Hope Music Entertainment,259978,260594,616
736,"Biruk Abate - Wubete | ውበቴ - New Ethiopian Music 2019 (Official Video) by Hope Music Ethiopia 2 years ago 4 minutes, 20 seconds 31,555 views",Hope Music Entertainment,31555,31589,34
737,"Yosef Gasha - Koll'ah Eiye Neyre - New Ethiopian Music 2019 (Official Video) by Hope Music Ethiopia 2 years ago 7 minutes, 11 seconds 78,614 views",Hope Music Entertainment,78614,78631,17
738,"Merry - Weyne Gude | ወይኔ ጉዴ - New Ethiopian Music 2019 (Official Video) by Hope Music Ethiopia 2 years ago 3 minutes, 52 seconds 90,239 views",Hope Music Entertainment,90239,90284,45
739,"Rediet Weldegiorgis - Tebakish Negn | ጠባቂሽ ነኝ - New Ethiopian Music 2019 (Official Video) by Hope Music Ethiopia 2 years ago 5 minutes, 31 seconds 36,445 views",Hope Music Entertainment,36445,36461,16
740,"Misale Abraham - Nebse | ነብሴ - New Ethiopian Music 2019 (Official Video) by Hope Music Ethiopia 2 years ago 4 minutes, 54 seconds 50,891 views",Hope Music Entertainment,50891,50928,37
741,"Kaka B ft Lemlem Lijalem - Gorebete | ጎረቤቴ - New Ethiopian Music 2019 (Official Video) by Hope Music Ethiopia 2 years ago 3 minutes, 43 seconds 34,617 views",Hope Music Entertainment,34617,34647,30
742,"Bella - Kelben Gezta | ቀልቤን ገዝታ - New Ethiopian Music 2019 (Official Video) by Hope Music Ethiopia 2 years ago 3 minutes, 41 seconds 67,593 views",Hope Music Entertainment,67593,67640,47
743,"Hana Girma - Chereka | ጨረቃ - New Ethiopian Music 2019 (Official Video) by Hope Music Ethiopia 2 years ago 4 minutes, 36 seconds 2,534,765 views",Hope Music Entertainment,2534765,2542517,7752
744,"Bisrat Surafel - Yejegna Enat | የጀግና እናት - New Ethiopian Music 2019 (Official Video) by Hope Music Ethiopia 2 years ago 5 minutes, 12 seconds 482,925 views",Hope Music Entertainment,482925,483261,336
745,"Amha Sinku - Zarem Aybekam | ዛሬም አይበቃም - New Ethiopian Music 2019 (Official Video) by Hope Music Ethiopia 2 years ago 4 minutes, 51 seconds 103,111 views",Hope Music Entertainment,103111,103139,28
746,"Helina Demlew - Wudeddd | ውድድድ - New Ethiopian Music 2019 (Official Video) by Hope Music Ethiopia 2 years ago 4 minutes, 31 seconds 42,188 views",Hope Music Entertainment,42188,42204,16
747,"Yigzaw Belay - Yiragnu leweme | ይራኙ ለውመ - New Ethiopian Music 2019 (Official Video) by Hope Music Ethiopia 2 years ago 6 minutes, 9 seconds 318,338 views",Hope Music Entertainment,318338,319317,979
748,"Lila Tag - Anchin Alegn | አንችን አለኝ - New Ethiopian Music 2019 (Official Video) by Hope Music Ethiopia 2 years ago 4 minutes, 3 seconds 103,219 views",Hope Music Entertainment,103219,103320,101
749,"Dejen Issac - Believe Yourself | ነብስኻ እመን - New Eritrean Music 2019 (Official Video) by Hope Music Ethiopia 2 years ago 3 minutes, 52 seconds 35,232 views",Hope Music Entertainment,35232,35252,20
750,"Dagne Asnake - Tewedej | ተወደጂ - New Ethiopian Music 2019 (Official Video) by Hope Music Ethiopia 2 years ago 5 minutes, 19 seconds 64,868 views",Hope Music Entertainment,64868,64916,48
751,"Buze Man (Buzayehu Kifle) - Alregmat | አልረግማት - New Ethiopian Music 2019 (Official Video) by Hope Music Ethiopia 2 years ago 5 minutes, 11 seconds 2,132,306 views",Hope Music Entertainment,2132306,2143618,11312
752,"Liya Girma - Gude | ጉዴ - New Ethiopian Music 2019 (Official Video) by Hope Music Ethiopia 2 years ago 4 minutes, 6 seconds 68,281 views",Hope Music Entertainment,68281,68476,195
753,"Solomon Tigabe - Yamegnal | ያመኛል - New Ethiopian Music 2019 (Official Video) by Hope Music Ethiopia 2 years ago 6 minutes, 8 seconds 986,116 views",Hope Music Entertainment,986116,987900,1784
754,"Kitila Beyene ft. Sinaf Dejene - Magaal Walloo - New Ethiopian Music 2019 (Official Video) by Hope Music Ethiopia 2 years ago 5 minutes, 51 seconds 275,172 views",Hope Music Entertainment,275172,276043,871
755,"Habtamu Bekele - Eshi Beyign | እሺ በይኝ - New Ethiopian Music 2019 (Official Video) by Hope Music Ethiopia 2 years ago 4 minutes, 53 seconds 41,301 views",Hope Music Entertainment,41301,41330,29
756,"Aklilu Berga - Beye | ብዬ - New Ethiopian Music 2019 (Official Video) by Hope Music Ethiopia 2 years ago 4 minutes, 59 seconds 35,969 views",Hope Music Entertainment,35969,35984,15
757,"Eknock - Ojemba - New African Music 2019 (Official Video) by Hope Music Ethiopia 2 years ago 4 minutes, 29 seconds 20,722 views",Hope Music Entertainment,20722,20752,30
758,"Ferow ft. Sami Dan - Des Des | ደስ ደስ - New Ethio - Eritrean Music 2019 (Official Video) by Hope Music Ethiopia 2 years ago 4 minutes, 8 seconds 623,540 views",Hope Music Entertainment,623540,625504,1964
759,"Esubalew Yitayew - Sikefash Alwedim | ሲከፋሽ አልወድም - New Ethiopian Music 2019 (Official Video) by Hope Music Ethiopia 2 years ago 3 minutes, 59 seconds 956,212 views",Hope Music Entertainment,956212,960370,4158
760,"Birhan Wubaye - Tenes Belew | ተነስ በለው - New Ethiopian Music 2019 (Official Video) by Hope Music Ethiopia 2 years ago 5 minutes, 8 seconds 127,264 views",Hope Music Entertainment,127264,127355,91
761,"Ibsa Elemoo Ali - Akkam Jirtan Fayyaa - New Ethiopian Music 2019 (Official Video) by Hope Music Ethiopia 2 years ago 4 minutes, 19 seconds 34,376 views",Hope Music Entertainment,34376,34458,82
762,"Shewane Yemam - Hulu Amaresh | ሁሉ አማረሽ - New Ethiopian Music 2019 (Official Video) by Hope Music Ethiopia 2 years ago 4 minutes, 19 seconds 28,817 views",Hope Music Entertainment,28817,28842,25
763,"Alex Keleb - Zim Alelem | ዝም አልልም - New Ethiopian Music 2019 (Official Video) by Hope Music Ethiopia 2 years ago 5 minutes, 49 seconds 127,087 views",Hope Music Entertainment,127087,127133,46
764,"Nati ft. Wengel - Quanqua | ቋንቋ - New Ethiopian Music 2019 (Official Video) by Hope Music Ethiopia 2 years ago 4 minutes, 39 seconds 41,949 views",Hope Music Entertainment,41949,41956,7
765,"Selamawit Yohannes - Yebleni'loo | የብለኒ'ሎ - New Ethiopian Music 2019 (Official Video) by Hope Music Ethiopia 2 years ago 4 minutes, 52 seconds 21,594,873 views",Hope Music Entertainment,21594873,21691018,96145
766,"Henok Yitagesu - Degopa - New Ethiopian Music 2019 (Official Video) by Hope Music Ethiopia 2 years ago 3 minutes, 50 seconds 132,576 views",Hope Music Entertainment,132576,132786,210
767,"Mikael Tesfaye - Esat | እሳት - New Ethiopian Music 2019 (Official Video) by Hope Music Ethiopia 2 years ago 4 minutes, 32 seconds 68,472 views",Hope Music Entertainment,68472,68504,32
768,"Mulusew Addis - Yesew Yaleh | የሰው ያለህ - New Ethiopian Music 2019 (Official Video) by Hope Music Ethiopia 2 years ago 6 minutes, 17 seconds 79,213 views",Hope Music Entertainment,79213,79320,107
769,"Lil Pac - Eno Kulu | እኖ ኹሉ - New Ethiopian Music 2019 (Official Video) by Hope Music Ethiopia 2 years ago 4 minutes, 45 seconds 63,541 views",Hope Music Entertainment,63541,63591,50
770,"Temu Yeastu Lij - Kebiher Yikdem hager | ከብሄር ትቅደም ሃገር - New Ethiopian Music 2019 (Official Video) by Hope Music Ethiopia 2 years ago 4 minutes 37,844 views",Hope Music Entertainment,37844,37852,8
771,"Temesgen Berhe - Abebaye | አበባዬ - New Ethiopian Music 2019 (Official Video) by Hope Music Ethiopia 2 years ago 4 minutes, 31 seconds 41,238 views",Hope Music Entertainment,41238,41275,37
772,"Liyat Tibebu - Selamey | ሰላመይ - New Ethiopian Music 2019 (Official Video) by Hope Music Ethiopia 2 years ago 5 minutes, 2 seconds 693,276 views",Hope Music Entertainment,693276,697772,4496
773,"Tsegaye Eshetu - And Enhun | አንድ እንሁን - New Ethiopian Music 2019 (Official Video) by Hope Music Ethiopia 2 years ago 5 minutes, 38 seconds 355,648 views",Hope Music Entertainment,355648,355960,312
774,"Daniel Tilahun Gessesse - Sente | ስንቴ - New Ethiopian Music 2019 (Official Audio) by Hope Music Ethiopia 2 years ago 4 minutes, 5 seconds 12,728 views",Hope Music Entertainment,12728,12743,15
775,"Daniel Tilahun Gessesse - Yayushal | ያዩሻል - New Ethiopian Music 2019 (Official Audio) by Hope Music Ethiopia 2 years ago 4 minutes, 49 seconds 10,519 views",Hope Music Entertainment,10519,10530,11
776,"Daniel Tilahun Gessesse - Fikir Tsega New | ፍቅር ፀጋ ነው - New Ethiopian Music 2019 (Official Audio) by Hope Music Ethiopia 2 years ago 5 minutes, 3 seconds 15,126 views",Hope Music Entertainment,15126,15140,14
777,"Daniel Tilahun Gessesse - Semay Neka | ሰማይ ነካ - New Ethiopian Music 2019 (Official Audio) by Hope Music Ethiopia 2 years ago 4 minutes, 3 seconds 6,683 views",Hope Music Entertainment,6683,6694,11
778,"Daniel Tilahun Gessesse - Zemach Negn | ዘማች ነኝ - New Ethiopian Music 2019 (Audio) by Hope Music Ethiopia 2 years ago 4 minutes, 49 seconds 53,745 views",Hope Music Entertainment,53745,53931,186
779,"Daniel Tilahun Gessesse - Alga Balga | አልጋ ባልጋ - New Ethiopian Music 2019 (Official Audio) by Hope Music Ethiopia 2 years ago 4 minutes, 10 seconds 6,401 views",Hope Music Entertainment,6401,6406,5
780,"Daniel Tilahun Gessesse - Fikir New | ፍቅር ነው - New Ethiopian Music 2019 (Official Audio) by Hope Music Ethiopia 2 years ago 4 minutes, 3 seconds 8,207 views",Hope Music Entertainment,8207,8215,8
781,"Daniel Tilahun Gessesse - Almaz | አልማዝ - New Ethiopian Music 2019 (Official Audio) by Hope Music Ethiopia 2 years ago 3 minutes, 19 seconds 16,557 views",Hope Music Entertainment,16557,16621,64
782,"Daniel Tilahun Gessesse - Ehud be 10 | እሁድ ባ፲ - New Ethiopian Music 2019 (Official Audio) by Hope Music Ethiopia 2 years ago 3 minutes, 11 seconds 12,302 views",Hope Music Entertainment,12302,12359,57
783,"Daniel Tilahun Gessesse - Sew | ሰው - New Ethiopian Music 2019 (Official Audio) by Hope Music Ethiopia 2 years ago 4 minutes, 26 seconds 21,893 views",Hope Music Entertainment,21893,21906,13
784,"Daniel Tilahun Gessesse - Meleshe | መልሼ - New Ethiopian Music 2019 (Official Audio) by Hope Music Ethiopia 2 years ago 3 minutes, 34 seconds 18,820 views",Hope Music Entertainment,18820,18833,13
785,"Wubshet Dejene - Selam New | ሰላም ነው - New Ethiopian Music 2019 (Official Video) by Hope Music Ethiopia 2 years ago 5 minutes, 15 seconds 77,281 views",Hope Music Entertainment,77281,77289,8
786,"Zerihun Alemayehu - Ziyadaye Ney Ney | ዚያዳዬ ነይነይ - New Ethiopian Music 2019 (Official Video) by Hope Music Ethiopia 2 years ago 4 minutes, 12 seconds 42,982 views",Hope Music Entertainment,42982,43011,29
787,"Tesfay Measho - Aytebedeli | ኣይትበደሊ - New Ethiopian Music 2019 (Official Video) by Hope Music Ethiopia 2 years ago 3 minutes, 55 seconds 66,762 views",Hope Music Entertainment,66762,66781,19
788,"Hanan Seid - Nafekegn | ናፈቀኝ - New Ethiopian Music 2019 (Official Video) by Hope Music Ethiopia 2 years ago 5 minutes, 17 seconds 53,841 views",Hope Music Entertainment,53841,53875,34
789,"Ahadu & AB Man - Qal'oo - New Ethiopian Music 2019 (Official Video) by Hope Music Ethiopia 2 years ago 4 minutes, 21 seconds 268,634 views",Hope Music Entertainment,268634,269305,671
790,"Ashenafi Teklehaimanot - Anelakekim | አንላቀቅም - New Ethiopian Music 2019 (Official Video) by Hope Music Ethiopia 2 years ago 5 minutes, 59 seconds 100,358 views",Hope Music Entertainment,100358,100414,56
791,"Mimi Addisu - Kora Kora | ኮራ ኮራ - New Ethiopian Music 2019 (Official Video) by Hope Music Ethiopia 2 years ago 4 minutes, 17 seconds 74,579 views",Hope Music Entertainment,74579,74612,33
792,"Tade Philo - Ere Marekechign | ኧረ ማረከችኝ - New Ethiopian Music 2019 (Official Video) by Hope Music Ethiopia 2 years ago 6 minutes, 36 seconds 307,253 views",Hope Music Entertainment,307253,307704,451
793,"Tsega Muche - Berera (በረራ) - New Ethiopian Music 2019 (Official Video) by Hope Music Ethiopia 2 years ago 6 minutes, 39 seconds 149,096 views",Hope Music Entertainment,149096,149133,37
794,"Tizita Demeke - Atikina | አትቅና - New Ethiopian Music 2019 (Official Video) by Hope Music Ethiopia 2 years ago 4 minutes, 35 seconds 67,037 views",Hope Music Entertainment,67037,67095,58
795,"Tsebay Tadele - Gude | ጉዴ - New Ethiopian Music 2019 (Official Video) by Hope Music Ethiopia 2 years ago 4 minutes, 31 seconds 87,378 views",Hope Music Entertainment,87378,87541,163
796,"Robel Tilahun - Meret Ab Memesayu | መሬት ኣብ ምምሳዩ - New Ethiopian Music 2019 (Official Video) by Hope Music Ethiopia 2 years ago 4 minutes, 57 seconds 140,341 views",Hope Music Entertainment,140341,140382,41
797,"Meriyam - Yante Lihun | ያንተ ልሁን - New Ethiopian Music 2019 (Official Video) by Hope Music Ethiopia 2 years ago 4 minutes, 55 seconds 34,000 views",Hope Music Entertainment,34000,34047,47
798,"Yegna - Zim Anilim | ዝም አንልም - New Ethiopian Music 2019 (Official Video) by Hope Music Ethiopia 2 years ago 4 minutes, 40 seconds 466,873 views",Hope Music Entertainment,466873,467840,967
799,"Gaaddisaa Yaaddessaa - Shaannani - New Ethiopia  Music 2019 (Official Video) by Hope Music Ethiopia 2 years ago 5 minutes, 4 seconds 30,005 views",Hope Music Entertainment,30005,30015,10
800,"Betelhem Wendesen - Tasfelgegnaleh | ታስፈልገኛለህ - New Ethiopian Music 2019 (Official Video) by Hope Music Ethiopia 2 years ago 4 minutes, 29 seconds 44,828 views",Hope Music Entertainment,44828,44899,71
801,"Tewodros Abayneh - Bitifeker | ብትፈቀር - New Ethiopian Music 2019 (Official Video) by Hope Music Ethiopia 2 years ago 5 minutes, 1 second 31,382 views",Hope Music Entertainment,31382,31410,28
802,"Papio Belete - Kodemeko - New Ethiopian Music 2019 (Official Video) by Hope Music Ethiopia 2 years ago 4 minutes, 7 seconds 44,593 views",Hope Music Entertainment,44593,44617,24
803,"Jonana ft. 5A - Hasabe | ሀሳቤ - New Ethiopian Music 2019 (Official Video) by Hope Music Ethiopia 2 years ago 3 minutes, 25 seconds 37,642 views",Hope Music Entertainment,37642,37651,9
804,"TK - Hememish Hememe | ህመምሽ ህመሜ - New Ethiopian Music 2019 (Official Video) by Hope Music Ethiopia 2 years ago 5 minutes, 17 seconds 81,148 views",Hope Music Entertainment,81148,81180,32
805,"KIDDA X Mene - Geday | ገዳይ - New Ethiopian Music 2019 (Official Video) by Hope Music Ethiopia 2 years ago 3 minutes, 17 seconds 40,891 views",Hope Music Entertainment,40891,40957,66
806,"Ashenafi Kefyalew - Dominado - New Ethiopian Music 2019 (Official Video) by Hope Music Ethiopia 2 years ago 4 minutes, 24 seconds 65,550 views",Hope Music Entertainment,65550,65561,11
807,"Sancho Gebre X Micky Gonderegna X Gildo Kassa - Leba New | ሌባ ነው - New Ethiopian Music 2019 by Hope Music Ethiopia 2 years ago 4 minutes, 44 seconds 7,491,699 views",Hope Music Entertainment,7491699,7530375,38676
808,"Lemlem Hailemichael - Gedam | ገ'ዳም - New Ethiopian Music 2019 (Official Video) by Hope Music Ethiopia 2 years ago 4 minutes, 25 seconds 4,235,828 views",Hope Music Entertainment,4235828,4239889,4061
809,"Dawit kahsay - Kieleyo’Do | ኪኢለዮ’ዶ - New Eritrean Music 2019 (Official Video) by Hope Music Ethiopia 2 years ago 5 minutes, 54 seconds 49,539 views",Hope Music Entertainment,49539,49558,19
810,"Simon T/Wold ft Gildo Kassa - Minim Yelem | ምንም የለም - New Ethiopian Music 2019 (Official Video) by Hope Music Ethiopia 2 years ago 4 minutes, 33 seconds 331,848 views",Hope Music Entertainment,331848,332972,1124
811,"Hiwot Eyasu - Bel Nalign | በል ናልኝ - New Ethiopian Music 2019 (Official Video) by Hope Music Ethiopia 2 years ago 6 minutes, 4 seconds 394,753 views",Hope Music Entertainment,394753,396744,1991
812,"Becca - Lelam Alay | ሌላም አላይ - New Ethiopian Music 2019 (Official Video) by Hope Music Ethiopia 2 years ago 4 minutes, 34 seconds 58,391 views",Hope Music Entertainment,58391,58412,21
813,"Amlake Getaneh - Aye Metadel | አይ መታደል - New Ethiopian Music 2019 (Official Video) by Hope Music Ethiopia 2 years ago 6 minutes, 43 seconds 24,235 views",Hope Music Entertainment,24235,24235,0
814,"AK Zeraf ft. Tina - Sendelela | ሰንደሌላ - New Ethiopian Music 2019 (Official Video) by Hope Music Ethiopia 2 years ago 5 minutes, 12 seconds 24,181 views",Hope Music Entertainment,24181,24203,22
815,"Lino Afework - Ameseginalehu | አመሰግናለሁ - New Ethiopian Music 2019 (Official Video) by Hope Music Ethiopia 2 years ago 5 minutes, 45 seconds 168,738 views",Hope Music Entertainment,168738,168984,246
816,"JUDAHS Abel_G_Rasmitat X Bereka -  Keftuat Endalay | ከፍቷት እንዳላይ - New Ethiopian Music 2019 by Hope Music Ethiopia 2 years ago 4 minutes, 35 seconds 183,917 views",Hope Music Entertainment,183917,184193,276
817,"Samuel Seneshaw - Temelalash Takami | ተመላላሽ ታካሚ - New Ethiopian Music 2019 (Official Video) by Hope Music Ethiopia 2 years ago 4 minutes, 13 seconds 96,666 views",Hope Music Entertainment,96666,96888,222
818,"Getnet Alemayehu & Bekalu Alemayehu - Embign Ale | እምብኝ አለ - Ethiopian Music 2019 by Hope Music Ethiopia 2 years ago 6 minutes, 18 seconds 5,099,761 views",Hope Music Entertainment,5099761,5126340,26579
819,"Dawit Wordofa - Kibir Yigebal | ክብር ይገባል - New Ethiopian Music 2019 (Official Video) by Hope Music Ethiopia 2 years ago 6 minutes, 47 seconds 73,923 views",Hope Music Entertainment,73923,73928,5
820,"Skat Nati & Weeha - Dankira | ዳንኪራ - New Ethiopian Music 2019 (Official Video) by Hope Music Ethiopia 2 years ago 4 minutes, 4 seconds 835,395 views",Hope Music Entertainment,835395,837175,1780
821,"Firomsa Tahir - Luucciiyyee - New Ethiopian Music 2019 (Official video) by Hope Music Ethiopia 2 years ago 5 minutes, 14 seconds 53,485 views",Hope Music Entertainment,53485,53661,176
822,"Static Levi - Medi - New Ethiopian Music 2019 (Official Video) by Hope Music Ethiopia 2 years ago 3 minutes, 47 seconds 41,903 views",Hope Music Entertainment,41903,42098,195
823,"Ashenafi Solomon - Metahu | መጣሁ - New Ethiopian Music 2019 (Official Video) by Hope Music Ethiopia 2 years ago 4 minutes, 43 seconds 47,660 views",Hope Music Entertainment,47660,47681,21
824,"AB Alemu - Chocolate | ቸኮላቴ - New Ethiopian Music 2019 (Official video) by Hope Music Ethiopia 2 years ago 4 minutes, 54 seconds 87,980 views",Hope Music Entertainment,87980,88018,38
825,"Da Man - Berase meda | በራሴ ሜዳ - New Ethiopian Music 2019 (Official Video) by Hope Music Ethiopia 2 years ago 3 minutes, 44 seconds 37,947 views",Hope Music Entertainment,37947,37960,13
826,"Abyssiniya Vine - Dena Nesh Endet Neh | ደና ነሽ እንዴት ነህ - New Ethiopian Music 2019 (Official Video) by Hope Music Ethiopia 2 years ago 4 minutes, 42 seconds 5,342,127 views",Hope Music Entertainment,5342127,5361665,19538
827,"Baredu Girma - Araaroo Araara Kee - New Ethiopian Music 2019 (Official Video) by Hope Music Ethiopia 2 years ago 5 minutes, 9 seconds 84,575 views",Hope Music Entertainment,84575,84633,58
828,"Kepaso Lele - Degnete | ደግነቴ - New Ethiopian Music 2019 (Official Video) by Hope Music Ethiopia 2 years ago 4 minutes, 31 seconds 48,542 views",Hope Music Entertainment,48542,48571,29
829,"Daanyee Asaffaa - Irreecha Baranaa - New Ethiopian Music 2019 (Official Video) by Hope Music Ethiopia 2 years ago 6 minutes 143,229 views",Hope Music Entertainment,143229,143500,271
830,"Haset Bogale - Nigeregn | ንገረኝ - New Ethiopian Music 2019 (Official Video) by Hope Music Ethiopia 2 years ago 3 minutes, 57 seconds 87,230 views",Hope Music Entertainment,87230,87300,70
831,"Amansiisaa Tashoomaa - Gadaa - New Ethiopian Music 2019 (Official Video) by Hope Music Ethiopia 2 years ago 3 minutes, 57 seconds 18,546 views",Hope Music Entertainment,18546,18558,12
832,"Tsega Muche - Ajaeb | አጃኢብ - New Ethiopian Music 2019 (Official Video) by Hope Music Ethiopia 2 years ago 6 minutes, 1 second 70,024 views",Hope Music Entertainment,70024,70053,29
833,"Sisay Tufa - Ushururu - New Ethiopian Music 2019 (Official Video) by Hope Music Ethiopia 2 years ago 4 minutes, 50 seconds 171,846 views",Hope Music Entertainment,171846,172259,413
834,"Addis Gera - Hedual Alu | ሄዷል አሉ - New Ethiopian Music 2019 (Official Video) by Hope Music Ethiopia 2 years ago 4 minutes, 49 seconds 382,469 views",Hope Music Entertainment,382469,382798,329
835,"Mereid W/Semayat & Oleira Tariku - Erota | Borule - New Ethiopian Music 2019 (Official Video) by Hope Music Ethiopia 2 years ago 5 minutes, 34 seconds 21,543 views",Hope Music Entertainment,21543,21566,23
836,"IBIDDOO GALAAN - SIMBIRREE - New Ethiopian Music 2019 (Official Video) by Hope Music Ethiopia 2 years ago 5 minutes, 17 seconds 39,808 views",Hope Music Entertainment,39808,40339,531
837,"Ras Yidne - Tiyake Alegn | ጥያቄ አለኝ - New Ethiopian Music 2019 (Official Video) by Hope Music Ethiopia 2 years ago 3 minutes, 33 seconds 42,906 views",Hope Music Entertainment,42906,43098,192
838,"Salamoon Suyyuum - Goobee - New Ethiopian Music 2019 (Official Video) by Hope Music Ethiopia 2 years ago 6 minutes, 25 seconds 32,426 views",Hope Music Entertainment,32426,32453,27
839,"Endalik Wube - Tewegn | ተወኝ - New Ethiopian Music 2019 (Official Video) by Hope Music Ethiopia 2 years ago 4 minutes, 30 seconds 236,451 views",Hope Music Entertainment,236451,236839,388
840,"Amlake Setegn - Neylegn | ነይልኝ - New Ethiopian Music 2019 (Official Video) by Hope Music Ethiopia 2 years ago 5 minutes, 46 seconds 54,569 views",Hope Music Entertainment,54569,54647,78
841,"Michael Guyassa - Agbeteshal Alu | አግብተሻል አሉ - New Ethiopian Music 2019 (Official Video) by Hope Music Ethiopia 2 years ago 5 minutes, 39 seconds 418,698 views",Hope Music Entertainment,418698,420356,1658
842,"Bereket Bayu - Eyoha | እዮሃ - New Ethiopian Music 2019 (Official Video) by Hope Music Ethiopia 2 years ago 4 minutes, 14 seconds 17,222 views",Hope Music Entertainment,17222,17227,5
843,"heaven Abiy - Arada | አራዳ - New Ethiopian Music 2019 (Official Video) by Hope Music Ethiopia 2 years ago 5 minutes, 11 seconds 54,625 views",Hope Music Entertainment,54625,54655,30
844,"Fayyisaa Haayiluu - Hiibboo - New Ethiopian Music 2019 (Official Video) by Hope Music Ethiopia 2 years ago 6 minutes, 33 seconds 478,250 views",Hope Music Entertainment,478250,479008,758
845,"Yitagesu Nibretu - Kochegn Kochegn | ቆጨኝ ቆጨኝ - New Ethiopian Music 2019 (Official Video) by Hope Music Ethiopia 2 years ago 3 minutes, 50 seconds 40,457 views",Hope Music Entertainment,40457,40519,62
846,"Jennenus Dajanee - Sooree Sooree - New Ethiopian Music 2019 (Official Video) by Hope Music Ethiopia 2 years ago 7 minutes, 28 seconds 52,314 views",Hope Music Entertainment,52314,52454,140
847,"Alu Danceru ft. Hilton - Hyabey | ህያበይ - New Ethiopian Music 2019 (Official Video) by Hope Music Ethiopia 2 years ago 3 minutes, 29 seconds 26,304 views",Hope Music Entertainment,26304,26324,20
848,"Yalew Anley - Simugn | ስሙኝ - New Ethiopian Music 2019 (Official Video) by Hope Music Ethiopia 2 years ago 4 minutes, 14 seconds 26,989 views",Hope Music Entertainment,26989,27023,34
849,"Dj Kam, Ras Jany & Jerusalem JJ - Ethiopia | ኢትዮዽያ - New Ethiopian Music 2019 (Official Video) by Hope Music Ethiopia 2 years ago 4 minutes, 4 seconds 241,074 views",Hope Music Entertainment,241074,242362,1288
850,"Kumneger Amare - Karule - New Ethiopian Music 2019 (Official Video) by Hope Music Ethiopia 2 years ago 5 minutes, 7 seconds 169,784 views",Hope Music Entertainment,169784,169971,187
851,"Henok Abebaw - Dubeda | ዱብዳ - New Ethiopian Music 2019 (Official Video) by Hope Music Ethiopia 2 years ago 5 minutes, 50 seconds 43,485 views",Hope Music Entertainment,43485,43535,50
852,"Christina Melkamu - Suse | ሱሴ - New Ethiopian Music 2019 (Official Video) by Hope Music Ethiopia 2 years ago 4 minutes, 22 seconds 52,429 views",Hope Music Entertainment,52429,52501,72
853,"Kemi - Yanchihoye Gizat | የአንቺሆዬ ግዛት - New Ethiopian Music 2019 (Official Video) by Hope Music Ethiopia 2 years ago 3 minutes, 42 seconds 22,439 views",Hope Music Entertainment,22439,22570,131
854,"Gadaa Hamdaa - Aman - New Ethiopian Music 2019 (Official Video) by Hope Music Ethiopia 2 years ago 4 minutes, 58 seconds 41,553 views",Hope Music Entertainment,41553,41752,199
855,"Yared Mekonnen - Neberkugn Bante Bota - New Ethiopian Music 2019 (Official Video) by Hope Music Ethiopia 2 years ago 5 minutes, 24 seconds 16,992 views",Hope Music Entertainment,16992,16998,6
856,"Mikal J.  - Anes Wesine - New Ethiopian Music 2019 (Official Video) by Hope Music Ethiopia 2 years ago 3 minutes, 34 seconds 31,967 views",Hope Music Entertainment,31967,31983,16
857,"Manny ft. Bitik Emlaelu - Nana - New Ethiopian Music 2019 (Official Video) by Hope Music Ethiopia 2 years ago 4 minutes, 27 seconds 38,027 views",Hope Music Entertainment,38027,38044,17
858,"Badhaasoo A Kadiiroo - Hin Tuqinaa - New Ethiopian Music 2019 (Official Video) by Hope Music Ethiopia 2 years ago 6 minutes, 48 seconds 54,094 views",Hope Music Entertainment,54094,54177,83
859,"Fitse Loret - Wube Wube | ውቤ ውቤ - New Ethiopian Music 2019 (Official Video) by Hope Music Ethiopia 2 years ago 4 minutes, 11 seconds 37,424 views",Hope Music Entertainment,37424,37444,20
860,"Yabu JC - Gudegna Nat | ጉደኛ ናት - New Ethiopian Music 2019 (Official Video) by Hope Music Ethiopia 2 years ago 4 minutes, 14 seconds 72,363 views",Hope Music Entertainment,72363,72423,60
861,"Tewodros Zewale - Sewenet | ሰውነት - New Ethiopian Music 2019 (Official Video) by Hope Music Ethiopia 2 years ago 4 minutes, 31 seconds 18,543 views",Hope Music Entertainment,18543,18546,3
862,"Misikir Tilahun - Hulem Kante Gar - New Ethiopian Music 2019 (Official Video) by Hope Music Ethiopia 2 years ago 4 minutes, 53 seconds 51,290 views",Hope Music Entertainment,51290,51304,14
863,"Miki Hailu - Germaye Gafo - New Ethiopian Music 2019 (Official Video) by Hope Music Ethiopia 2 years ago 3 minutes, 45 seconds 46,081 views",Hope Music Entertainment,46081,46089,8
864,"Alemayehu Tesfaye - Awdamet | አውዳመት - New Ethiopian Music 2019 (Official Video) by Hope Music Ethiopia 2 years ago 4 minutes, 33 seconds 91,930 views",Hope Music Entertainment,91930,92009,79
865,"Yezina Negash - Enamesginachew - New Ethiopian Music 2019 (Official Video) by Hope Music Ethiopia 2 years ago 8 minutes, 46 seconds 441,809 views",Hope Music Entertainment,441809,442017,208
866,"Jano Band X Ahadu ft.  Ezra - Rega | ረጋ - New Ethiopian Music 2019 (Official Video) by Hope Music Ethiopia 2 years ago 4 minutes, 35 seconds 178,004 views",Hope Music Entertainment,178004,178194,190
867,"Abela Assefa - Ethiopiawi New | ኢትዮዽያዊ ነው - New Ethiopian Music 2019 (Official Video) by Hope Music Ethiopia 2 years ago 5 minutes, 22 seconds 194,112 views",Hope Music Entertainment,194112,194190,78
868,"Zekarias Habte - Addis Sew | አዲስ ሰው - New Ethiopian Music 2019 (Official Video) by Hope Music Ethiopia 2 years ago 2 minutes, 54 seconds 43,457 views",Hope Music Entertainment,43457,43479,22
869,"Mesay Tilahun - Addis Amet Ena Tesfa | አዲስ አመት እና ተስፋ  - New Ethiopian Music 2019 (Official Video) by Hope Music Ethiopia 2 years ago 5 minutes, 9 seconds 45,347 views",Hope Music Entertainment,45347,45376,29
870,"Yared Negu - Weye | ወዬ - New Ethiopian Music 2019 (Official Video) by Hope Music Ethiopia 2 years ago 5 minutes, 25 seconds 5,083,125 views",Hope Music Entertainment,5083125,5093177,10052
871,"Abel Berhanu - Awdamet | አውዳመት - New Ethiopian Music 2019 (Official Video) by Hope Music Ethiopia 2 years ago 5 minutes, 23 seconds 88,471 views",Hope Music Entertainment,88471,88512,41
872,"Biruk Mamo - Elilta | እልልታ - New Ethiopian Music 2019 (Official Video) by Hope Music Ethiopia 2 years ago 6 minutes 56,414 views",Hope Music Entertainment,56414,56427,13
873,"Sami Addis - Sirekitaye | ስርቅታዬ - New Ethiopian Music 2019 (Official Video) by Hope Music Ethiopia 2 years ago 6 minutes, 55 seconds 96,750 views",Hope Music Entertainment,96750,96791,41
874,"Melkam Wetat | መልካም ወጣት - New Ethiopian Music 2019 (Official Video) by Hope Music Ethiopia 2 years ago 5 minutes 134,826 views",Hope Music Entertainment,134826,135065,239
875,"Girma Tefera, Ahmed Teshome, Helen Tesfaye & Mesay Tefera - Zemenesh Yibarek - Ethiopian Music 2019 by Hope Music Ethiopia 2 years ago 4 minutes, 56 seconds 827,323 views",Hope Music Entertainment,827323,827857,534
876,"Mulugeta Lema - Tewugn | ተውኝ - New Ethiopian Music 2019 (Official Video) by Hope Music Ethiopia 2 years ago 4 minutes, 44 seconds 114,294 views",Hope Music Entertainment,114294,114392,98
877,"Beyan ft Abase - Anchin Beye | አንችን ብዬ - New Ethiopian Music 2019 (Official Video) by Hope Music Ethiopia 2 years ago 5 minutes, 1 second 54,585 views",Hope Music Entertainment,54585,54608,23
878,"Afomiya Betru - Liyu New | ልዩ ነው -  New Ethiopian Music 2019 (Official Video) by Hope Music Ethiopia 2 years ago 4 minutes, 24 seconds 38,132 views",Hope Music Entertainment,38132,38156,24
879,"Rahel Getu - Alguaguam | አልጓጓም - New Ethiopian Music 2019 (Official Video) by Hope Music Ethiopia 2 years ago 4 minutes, 30 seconds 5,743,571 views",Hope Music Entertainment,5743571,5754546,10975
880,"Zakir Abdela - Bullooy Bulloo - New Ethiopian Music 2019 (Official Video) by Hope Music Ethiopia 2 years ago 4 minutes, 50 seconds 153,319 views",Hope Music Entertainment,153319,153560,241
881,"Amha Sinku - Wube | ውቤ - New Ethiopian Music 2019 (Official Video) by Hope Music Ethiopia 2 years ago 4 minutes, 57 seconds 291,557 views",Hope Music Entertainment,291557,291667,110
882,"Aamad Khabira - Boontuu Oromoo - New Ethiopian Music 2019 (Official Video) by Hope Music Ethiopia 2 years ago 4 minutes, 46 seconds 51,029 views",Hope Music Entertainment,51029,51087,58
883,"Biniam Mengiste - Yene | የኔ - New Ethiopian Music 2019 (Official Video) by Hope Music Ethiopia 2 years ago 5 minutes, 54 seconds 46,917 views",Hope Music Entertainment,46917,46938,21
884,"Masiti - Atechegeri | ኣትቸገሪ - New Ethiopian Music 2019 (Official Video) by Hope Music Ethiopia 2 years ago 4 minutes, 39 seconds 22,677 views",Hope Music Entertainment,22677,22683,6
885,"Haymanot Adam - Nalegn Nalegn | ናልኝ ናልኝ - New Ethiopian Music 2019 (Official Video) by Hope Music Ethiopia 2 years ago 5 minutes, 12 seconds 38,900 views",Hope Music Entertainment,38900,38923,23
886,"Nebil Muhedin - Way Naanno Dhagalaasi - New Ethiopian Music 2019 (Official Video) by Hope Music Ethiopia 2 years ago 4 minutes, 38 seconds 84,912 views",Hope Music Entertainment,84912,85662,750
887,"Wendesen Belay - Eshketer | እሽክትር - New Ethiopian Music 2019 (Official Video) by Hope Music Ethiopia 2 years ago 6 minutes, 31 seconds 100,941 views",Hope Music Entertainment,100941,100981,40
888,"Matiyas Tefera - Zim Alilim | ዝም አልልም - New Ethiopian Music 2019 (Official Video) by Hope Music Ethiopia 2 years ago 5 minutes 44,963 views",Hope Music Entertainment,44963,45163,200
889,"Andu'alam Gosaa - Michuu Dhugaa - New Ethiopian Music 2019 (Official Video) by Hope Music Ethiopia 2 years ago 6 minutes, 14 seconds 3,982,897 views",Hope Music Entertainment,3982897,4025406,42509
890,"Haymanot & Yohannes - Maleda | ማለዳ - New Ethiopian Music 2019 (Official Video) by Hope Music Ethiopia 2 years ago 5 minutes, 47 seconds 793,549 views",Hope Music Entertainment,793549,795630,2081
891,"Wasihun Hunegnaw - Yamenal | ያመናል - New Ethiopian Music 2019 (Official Video) by Hope Music Ethiopia 2 years ago 5 minutes, 22 seconds 48,140 views",Hope Music Entertainment,48140,48158,18
892,"Mesfin Erestu - Addis Abebaye | አዲስ አበባዬ - New Ethiopian Music (Official Video) by Hope Music Ethiopia 2 years ago 5 minutes, 59 seconds 129,800 views",Hope Music Entertainment,129800,129990,190
893,"Dinaye - We Are One | Vi Er Ett | አንድ ነን - New Ethiopian Music 2019 (Official Video) by Hope Music Ethiopia 2 years ago 3 minutes, 33 seconds 214,542 views",Hope Music Entertainment,214542,214625,83
894,"Betelhem Mohammed - Zarem Anten | ዛሬም አንተን - New Ethiopian Music 2019 (Official Video) by Hope Music Ethiopia 2 years ago 4 minutes, 34 seconds 125,187 views",Hope Music Entertainment,125187,125262,75
895,"ZOLA - SINBARBADA - New Ethiopian Music 2019 (Official Video) by Hope Music Ethiopia 2 years ago 4 minutes, 19 seconds 140,981 views",Hope Music Entertainment,140981,142263,1282
896,"Adera Tigabu - Shibere | ሽብሬ - New Ethiopian Music 2019 (Official Video) by Hope Music Ethiopia 2 years ago 4 minutes, 50 seconds 42,879 views",Hope Music Entertainment,42879,42911,32
897,"KADIR ADISHOO (XIQQAA) - CIDHA CAAYAA ODAA - New Ethiopian Music 2019 (Official Video) by Hope Music Ethiopia 2 years ago 5 minutes, 28 seconds 27,005 views",Hope Music Entertainment,27005,27250,245
898,"Shewangizaw Mihret - Eyerusalem | እየሩሳሌም - New Ethiopian Music 2019 (Official Video) by Hope Music Ethiopia 2 years ago 5 minutes, 56 seconds 21,925 views",Hope Music Entertainment,21925,21939,14
899,"Alemayehu Getachew (Alex) - Ney Bedenget | ነይ በድንገት - New Ethiopian Music 2019 (Official Video) by Hope Music Ethiopia 2 years ago 4 minutes, 50 seconds 27,681 views",Hope Music Entertainment,27681,27687,6
900,"Khalid (Kay) - Hoya Hoye | ሆያ ሆዬ - New Ethiopian Music 2019 (Official Video) by Hope Music Ethiopia 2 years ago 3 minutes, 5 seconds 15,943 views",Hope Music Entertainment,15943,15952,9
901,"Dagim Adane - Wey Nedo | ወይ ነዶ - New Ethiopian Music 2019 (Official Video) by Hope Music Ethiopia 2 years ago 4 minutes, 13 seconds 305,177 views",Hope Music Entertainment,305177,307376,2199
902,"Igitu X Ahadu - 30:40 - New Ethiopian Music 2019 (Official Video) by Hope Music Ethiopia 2 years ago 3 minutes, 40 seconds 456,770 views",Hope Music Entertainment,456770,458058,1288
903,"Daniel Kidane - Kidus Yohannes | ቅዱስ ዮሃንስ - New Ethiopian Music 2019 (Official Video) by Hope Music Ethiopia 2 years ago 4 minutes, 5 seconds 42,397 views",Hope Music Entertainment,42397,42400,3
904,"Lion Sunday & KG Man - Selibato | ሰሊባቶ - New Ethiopian Music 2019 (Official Video) by Hope Music Ethiopia 2 years ago 5 minutes, 35 seconds 31,016 views",Hope Music Entertainment,31016,31023,7
905,"NK5 (Natnael) ft. Mule King - Wolelaye | ወለላዬ - New Ethiopian Music 2019 (Official Video) by Hope Music Ethiopia 2 years ago 4 minutes, 25 seconds 24,408 views",Hope Music Entertainment,24408,24532,124
906,"Saba Mulugeta - Keber Jeba - New Ethiopian Music 2019 (Official Video) by Hope Music Ethiopia 2 years ago 5 minutes, 58 seconds 245,465 views",Hope Music Entertainment,245465,245863,398
907,"Zekarias Habte - Addis Tsehay | አዲስ ፀሀይ - New Ethiopian Music 2019 (Official Video) by Hope Music Ethiopia 2 years ago 5 minutes, 3 seconds 21,136 views",Hope Music Entertainment,21136,21155,19
908,"Ras Nebyu - Days Later - New Ethiopian Hip Hop Music 2019 (Official Video) by Hope Music Ethiopia 2 years ago 4 minutes, 29 seconds 20,343 views",Hope Music Entertainment,20343,20382,39
909,"Roorrisaa Geetuu - Boora Koo - New Ethiopian Music 2019 (Official Video) by Hope Music Ethiopia 2 years ago 6 minutes, 1 second 20,788 views",Hope Music Entertainment,20788,20805,17
910,"Mele Zanjar - Drom - New Ethiopian Music 2019 (Official Video) by Hope Music Ethiopia 2 years ago 3 minutes, 57 seconds 14,032 views",Hope Music Entertainment,14032,14071,39
911,"Gurmeessaa Eroo - Aarsaa - New Ethiopian Music 2019 (Official Video) by Hope Music Ethiopia 2 years ago 5 minutes, 14 seconds 13,447 views",Hope Music Entertainment,13447,13456,9
912,"Tesfaye Belay - Wudye | ውድዬ - New Ethiopian Music 2019 (Official Video) by Hope Music Ethiopia 2 years ago 4 minutes, 27 seconds 21,144 views",Hope Music Entertainment,21144,21155,11
913,"Tinsae Sultan - Soliyana | ሶሊያና - New Ethiopian Music 2019 (Official Video) by Hope Music Ethiopia 2 years ago 4 minutes, 43 seconds 16,722 views",Hope Music Entertainment,16722,16733,11
914,"Kalid (Kay) - Yetameme Fikir | የታመመ ፍቅር - New Ethiopian Music 2019 (Official Video) by Hope Music Ethiopia 2 years ago 5 minutes, 18 seconds 15,443 views",Hope Music Entertainment,15443,15460,17
915,"Betty & Kehali - Ayresam | አይረሳም - New Ethiopian Music 2019 (Official Video) by Hope Music Ethiopia 2 years ago 4 minutes, 48 seconds 46,234 views",Hope Music Entertainment,46234,46327,93
916,"Abenet Demissie - Kal Ateregn | ቃል አጠረኝ - New Ethiopian Music 2019 (Official Video) by Hope Music Ethiopia 2 years ago 5 minutes, 23 seconds 274,829 views",Hope Music Entertainment,274829,276523,1694
917,"Abel X Amanuel ft. Redu - Weged | ወግድ - New Ethiopian Music 2019 (Official Video) by Hope Music Ethiopia 2 years ago 4 minutes, 15 seconds 50,935 views",Hope Music Entertainment,50935,51038,103
918,"Birhanu Kebede - Alaschileh Bilegn | አላስችልህ ቢለኝ - New Ethiopian Music 2019 (Official Video) by Hope Music Ethiopia 2 years ago 5 minutes, 41 seconds 54,206 views",Hope Music Entertainment,54206,54236,30
919,"Edel Tareke - Zoresh | ዞረሽ - New Ethiopian Music 2019 (Official Video) by Hope Music Ethiopia 2 years ago 3 minutes, 39 seconds 33,705 views",Hope Music Entertainment,33705,33728,23
920,"Desta Haileselassie - Kilte Fikri | ክልተ ፍቕሪ - New Ethiopian Music 2019 (Official Video) by Hope Music Ethiopia 2 years ago 7 minutes, 23 seconds 19,663 views",Hope Music Entertainment,19663,19674,11
921,"Tarik X Abenet - Bala (Alemye) - New Ethiopian Music 2019 (Official Video) by Hope Music Ethiopia 2 years ago 3 minutes 25,458 views",Hope Music Entertainment,25458,25570,112
922,"Mehandis Geleto - NU BEEKAA - New Ethiopian Music 2019 (Official Video) by Hope Music Ethiopia 2 years ago 5 minutes, 55 seconds 130,553 views",Hope Music Entertainment,130553,131014,461
923,"Asegid Mulugeta - Semay | ሰማይ - New Ethiopian Music 2019 (Official Video) by Hope Music Ethiopia 2 years ago 5 minutes, 47 seconds 30,745 views",Hope Music Entertainment,30745,30750,5
924,"Haymanot Matebu - And Hunu Zare | አንድ ሁኑ ዛሬ - New Ethiopian Music 2019 (Official Video) by Hope Music Ethiopia 2 years ago 4 minutes, 44 seconds 18,152 views",Hope Music Entertainment,18152,18159,7
925,"Alu Danceru - Eshururu | እሹሩሩ - New Ethiopian Music 2019 (Official Video) by Hope Music Ethiopia 2 years ago 4 minutes, 4 seconds 26,112 views",Hope Music Entertainment,26112,26131,19
926,"Dawit Senbeta - Honebin Tizita | ሆነብን ትዝታ - New Ethiopian Music 2019 (Official Video) by Hope Music Ethiopia 2 years ago 6 minutes, 54 seconds 2,084,029 views",Hope Music Entertainment,2084029,2102602,18573
927,"Niway Damtie - Yehulum Aynoch | የሁሉም አይኖች - New Ethiopian Music 2019 (Official Video) by Hope Music Ethiopia 2 years ago 4 minutes, 25 seconds 43,376 views",Hope Music Entertainment,43376,43507,131
928,"Elias Gizachew - Hyabey | ህያበይ - New Ethiopian Music 2019 (Official Video) by Hope Music Ethiopia 2 years ago 3 minutes, 54 seconds 98,090 views",Hope Music Entertainment,98090,98254,164
929,"Yirgalem Ayele - Ante Sew | አንተ ሰው - New Ethiopian Music 2019 (Official Video) by Hope Music Ethiopia 2 years ago 6 minutes, 58 seconds 67,645 views",Hope Music Entertainment,67645,67695,50
930,"Yoosaan Geetahun - Sossori - New Ethiopian Music 2019 (Official Video) by Hope Music Ethiopia 2 years ago 7 minutes, 9 seconds 1,192,286 views",Hope Music Entertainment,1192286,1204526,12240
931,"Didi Gaga - Baro Baro | ባሮ ባሮ - New Ethiopian Music 2019 (Official Video) by Hope Music Ethiopia 2 years ago 5 minutes, 4 seconds 170,109 views",Hope Music Entertainment,170109,172668,2559
932,"AKLILUU AADDISE - WARRA KANAA - New Ethiopian Music 2019 (Official Video) by Hope Music Ethiopia 2 years ago 4 minutes, 44 seconds 18,513 views",Hope Music Entertainment,18513,18519,6
933,"Amanuel Gizaw - Fikir New Gojam | ፍቅር ነው ጎጃም - New Ethiopian Music 2019 (Official Video) by Hope Music Ethiopia 2 years ago 7 minutes, 39 seconds 57,861 views",Hope Music Entertainment,57861,57905,44
934,"Ashaa Biiree - Shaagg Ormaa - New Ethiopian Music 2019 (Official Video) by Hope Music Ethiopia 2 years ago 6 minutes, 9 seconds 37,482 views",Hope Music Entertainment,37482,37501,19
935,"Tewachew Adane - Eggg... | እግግግ... - New Ethiopian Music 2019 (Official Video) by Hope Music Ethiopia 2 years ago 6 minutes, 23 seconds 721,769 views",Hope Music Entertainment,721769,723253,1484
936,"Solomon Fikre - Yamare | ያማረ - New Ethiopian Music 2019 (Official Video) by Hope Music Ethiopia 2 years ago 5 minutes, 13 seconds 73,564 views",Hope Music Entertainment,73564,73600,36
937,"Tewodros Alemayehu - Yeadam Zer Nen | የአዳም ዘር ነን - New Ethiopian Music 2019 (Official Video) by Hope Music Ethiopia 2 years ago 5 minutes, 12 seconds 11,919 views",Hope Music Entertainment,11919,11923,4
938,"Meron Ararsa - Goota Seenaa - New Ethiopian Music 2019 (Official Video) by Hope Music Ethiopia 2 years ago 4 minutes, 34 seconds 129,631 views",Hope Music Entertainment,129631,129676,45
939,"Ziggy Zaga - Yihew Metach | ይሄው መጣች - New Ethiopian Music 2019 (Official Video) by Hope Music Ethiopia 2 years ago 5 minutes, 35 seconds 178,335 views",Hope Music Entertainment,178335,178764,429
940,"Nuradis Seid - Altezegam Dosew | አልተዘጋም ዶሴው - New Ethiopian Music 2019 (Official Video) by Hope Music Ethiopia 2 years ago 7 minutes, 17 seconds 905,402 views",Hope Music Entertainment,905402,907550,2148
941,"Tarekegn Temesgen - Meshitu Birhan New | ምሽቱ ብርሃን ነው - New Ethiopian Music 2019 (Official Video) by Hope Music Ethiopia 2 years ago 3 minutes, 36 seconds 17,794 views",Hope Music Entertainment,17794,17795,1
942,"Job 27 - Yasbshal Lebe | ያስብሻል ልቤ - New Ethiopian Music 2019 (Official Video) by Hope Music Ethiopia 2 years ago 4 minutes, 33 seconds 208,321 views",Hope Music Entertainment,208321,209448,1127
943,"Esmiz Man - Nesh Selame | ነሽ ሰላሜ - New Ethiopian Music 2019 (Official Video) by Hope Music Ethiopia 2 years ago 3 minutes, 36 seconds 71,171 views",Hope Music Entertainment,71171,71201,30
944,"Dess ft. Befiyad - Fikir | ፍቅር - New Ethiopian Music 2019 (Official Video) by Hope Music Ethiopia 2 years ago 3 minutes, 53 seconds 42,145 views",Hope Music Entertainment,42145,42185,40
945,"Wendmagegn Adane - Nayate Sonde - New Ethiopian Music 2019 (Official Video) by Hope Music Ethiopia 2 years ago 4 minutes, 23 seconds 62,034 views",Hope Music Entertainment,62034,62150,116
946,"Kiya & Tarik - Beredu - New Ethiopian Music 2019 (Official Video) by Hope Music Ethiopia 2 years ago 4 minutes, 50 seconds 36,675 views",Hope Music Entertainment,36675,36683,8
947,"Ramzi Salih - Abelo Harariya - New Ethiopian Music 2019 (Official Video) by Hope Music Ethiopia 2 years ago 4 minutes, 55 seconds 86,260 views",Hope Music Entertainment,86260,87115,855
948,"Tewodros Aklilu - Kiya | ኪያ - New Ethiopian Music 2019 (Official Video) by Hope Music Ethiopia 2 years ago 4 minutes, 48 seconds 41,299 views",Hope Music Entertainment,41299,41330,31
949,"Meselu Fantahun - Sheger Gonder | ሸገር ጎንደር - New Ethiopian Music 2019 (Official Video) by Hope Music Ethiopia 2 years ago 6 minutes, 52 seconds 1,965,572 views",Hope Music Entertainment,1965572,1974915,9343
950,"Kako Getachew - Adeye | አደዬ - New Ethiopian Music 2019 (Official Video) by Hope Music Ethiopia 2 years ago 5 minutes, 8 seconds 464,548 views",Hope Music Entertainment,464548,465316,768
951,"Negasi Meles - Te'adilom | ተዓዲሎም - New Ethiopian Music 2019 (Official Video) by Hope Music Ethiopia 2 years ago 7 minutes, 2 seconds 85,775 views",Hope Music Entertainment,85775,85825,50
952,"Nahom Mekuria - Welefendi | ወለፈንዲ - New Ethiopian Music 2019 (Official Video) by Hope Music Ethiopia 2 years ago 5 minutes, 1 second 144,902 views",Hope Music Entertainment,144902,145396,494
953,"Jo Z Arkey - Sededley | ሰደድለይ - New Ethiopian Music 2019 (Official Video) by Hope Music Ethiopia 2 years ago 4 minutes, 51 seconds 18,858 views",Hope Music Entertainment,18858,18868,10
954,"Leul Tesfaye - Ergib | እርግብ - New Ethiopian Music 2019 (Official Video) by Hope Music Ethiopia 2 years ago 4 minutes, 53 seconds 665,496 views",Hope Music Entertainment,665496,666248,752
955,"Yonatan Bisrat - Felfalit Fiqri | ፈልፋሊት ፍቕሪ - New Ethiopian Music 2019 (Official Video) by Hope Music Ethiopia 2 years ago 4 minutes, 6 seconds 29,611 views",Hope Music Entertainment,29611,29618,7
956,"Zeru Bekele - Selam | ሰላም - New Ethiopian Music 2019 (Official Video) by Hope Music Ethiopia 2 years ago 4 minutes, 59 seconds 25,060 views",Hope Music Entertainment,25060,25066,6
957,"Yapi Mapi - Muna | ሙና - New Ethiopian Music 2019 (Official Video) by Hope Music Ethiopia 2 years ago 5 minutes, 27 seconds 89,088 views",Hope Music Entertainment,89088,89218,130
958,"Mr. Wina - Wushima | ውሽማ - New Ethiopian Music 2019 (Official Video) by Hope Music Ethiopia 2 years ago 5 minutes, 35 seconds 55,246 views",Hope Music Entertainment,55246,55289,43
959,"Bisrat Surafel - Man | ማን - New Ethiopian Music 2019 (Official Video) by Hope Music Ethiopia 2 years ago 5 minutes, 9 seconds 1,978,894 views",Hope Music Entertainment,1978894,1983772,4878
960,"Mafi & Muller - Lek Endene | ልክ እንደኔ - New Ethiopian Music 2019 (Official Video) by Hope Music Ethiopia 2 years ago 3 minutes, 49 seconds 1,041,320 views",Hope Music Entertainment,1041320,1043834,2514
961,"Tsega Muche - Benekakush Gize | በነካኩሽ ጊዜ - New Ethiopian Music 2019 (Official Video) by Hope Music Ethiopia 2 years ago 6 minutes, 45 seconds 164,874 views",Hope Music Entertainment,164874,164931,57
962,"Wendimagegn Chane - Meslosh New | መስሎሽ ነው - New Ethiopian Music (Official Video) by Hope Music Ethiopia 2 years ago 4 minutes, 16 seconds 63,200 views",Hope Music Entertainment,63200,63214,14
963,"Demelash Bogale - Hager Yemanat | ሃገር የማናት - New Ethiopian Music 2019 (Official Video) by Hope Music Ethiopia 2 years ago 4 minutes, 39 seconds 39,768 views",Hope Music Entertainment,39768,39785,17
964,"Surafel Solomon - Wanaye | ዋናዬ - New Ethiopian Music 2019 (Official Video) by Hope Music Ethiopia 2 years ago 4 minutes, 38 seconds 49,910 views",Hope Music Entertainment,49910,49934,24
965,"BAROO DIDHAA - XIIQIIN SIRBA - New Ethiopian Music 2019 (Official Video) by Hope Music Ethiopia 2 years ago 7 minutes, 42 seconds 77,517 views",Hope Music Entertainment,77517,77611,94
966,"Kidist Tenagne - Mar Eshete | ማር እሸቴ - New Ethiopian Music 2019 (Official Video) by Hope Music Ethiopia 2 years ago 5 minutes, 22 seconds 46,512 views",Hope Music Entertainment,46512,46572,60
967,"Alemayehu Erecha - Yet Nesh | የት ነሽ - New Ethiopian Music 2019 (Official Video) by Hope Music Ethiopia 2 years ago 4 minutes, 18 seconds 49,773 views",Hope Music Entertainment,49773,49787,14
968,"Birtukan Tsegay - Aye Siyamer | አይ ሲያምር - New Ethiopian Music 2019 (Official Video) by Hope Music Ethiopia 2 years ago 6 minutes, 5 seconds 40,830 views",Hope Music Entertainment,40830,40870,40
969,"Yehun - Jemari | ጀማሪ - New Ethiopian Music 2019 (Official Video) by Hope Music Ethiopia 2 years ago 3 minutes, 52 seconds 511,018 views",Hope Music Entertainment,511018,512027,1009
970,"Dagi Man - Selamewa | ሰላሜዋ - New Ethiopian Music 2019 (Official Video) by Hope Music Ethiopia 2 years ago 5 minutes, 25 seconds 1,341,621 views",Hope Music Entertainment,1341621,1342347,726
971,"Ertibu Agegnehu - Yinagerletal | ይናገርለታል - New Ethiopian Music 2019 (Official Video) by Hope Music Ethiopia 2 years ago 6 minutes, 25 seconds 351,490 views",Hope Music Entertainment,351490,351930,440
972,"Genet Bekele - Ere Simagn | ኧረ ስማኝ - New Ethiopian Music 2019 (Official Video) by Hope Music Ethiopia 2 years ago 6 minutes, 49 seconds 92,238 views",Hope Music Entertainment,92238,92250,12
973,"Ele Mele - Yehulachin | የሁላችን - New Ethiopian Music 2019 (Official Video) by Hope Music Ethiopia 2 years ago 6 minutes, 35 seconds 54,961 views",Hope Music Entertainment,54961,54968,7
974,"Tade Gebru - Ayresam | አይረሳም - New Ethiopian Music 2019 (Official Video) by Hope Music Ethiopia 2 years ago 4 minutes, 42 seconds 43,936 views",Hope Music Entertainment,43936,43946,10
975,"Yenenesh Melaku - Zomayewa  | ዞማዬዋ- New Ethiopian Music 2019 (Official Video) by Hope Music Ethiopia 2 years ago 5 minutes, 32 seconds 41,702 views",Hope Music Entertainment,41702,41719,17
976,"JY ft. Cocky - Wipe Your Tears - New Ethiopian Music 2019 (Official Video) by Hope Music Ethiopia 2 years ago 3 minutes, 29 seconds 51,315 views",Hope Music Entertainment,51315,51320,5
977,"Yared Asrat - Yeselam Teguazhe | የሰላም ተጓዥ - New Ethiopian Music 2019 (Official Video) by Hope Music Ethiopia 2 years ago 6 minutes, 8 seconds 25,186 views",Hope Music Entertainment,25186,25191,5
978,"Abdii Fufaa - Hidda Maraa Koo - New Ethiopian Music 2019 (Official Video) by Hope Music Ethiopia 2 years ago 5 minutes, 57 seconds 223,499 views",Hope Music Entertainment,223499,223723,224
979,"Melat Kelemework - Konjiye | ቆንጅዬ - New Ethiopian Music 2019 (Official Video) by Hope Music Ethiopia 2 years ago 4 minutes, 20 seconds 397,723 views",Hope Music Entertainment,397723,400332,2609
980,"Yisak  Walelign - Awarign | አዋሪኝ - New Ethiopian Music 2019 (Official Video) by Hope Music Ethiopia 2 years ago 4 minutes, 47 seconds 65,894 views",Hope Music Entertainment,65894,65906,12
981,"Amare Tesfaye - Atebetegnim | አትበተኝም - New Ethiopian Music 2019 (Official Video) by Hope Music Ethiopia 2 years ago 6 minutes, 8 seconds 50,967 views",Hope Music Entertainment,50967,50976,9
982,"Kidist Eyasu - Shegaw Sitnafikegn | ሸጋው ስትናፍቀኝ - New Ethiopian Music 2019 (Official Video) by Hope Music Ethiopia 2 years ago 5 minutes, 58 seconds 36,851 views",Hope Music Entertainment,36851,36919,68
983,"Ha Ge'ez - Selamawit | ሰላማዊት - New Ethiopian Music 2019 (Official Video) by Hope Music Ethiopia 2 years ago 4 minutes, 4 seconds 55,256 views",Hope Music Entertainment,55256,55267,11
984,"Nuhi ft. Abol - Setota | ስጦታ - New Ethiopian Music 2019 (Official Video) by Hope Music Ethiopia 2 years ago 3 minutes, 52 seconds 42,286 views",Hope Music Entertainment,42286,42324,38
985,"Abby Yismaw - Rak Tilacha | ራቅ ትላቻ - New Ethiopian Music 2019 (Official Video) by Hope Music Ethiopia 2 years ago 4 minutes, 12 seconds 22,423 views",Hope Music Entertainment,22423,22425,2
986,"Aschenaki Bekele ft Lili Hagos - Yashewal Gena | ያሽዋል ገና - New Ethiopian Music 2019 (Official Video) by Hope Music Ethiopia 2 years ago 4 minutes, 57 seconds 78,817 views",Hope Music Entertainment,78817,78920,103
987,"Andinet Birhane (Endy) - Ekif | እቅፍ - New Ethiopian Music 2019 (Official Video) by Hope Music Ethiopia 2 years ago 5 minutes, 9 seconds 1,671,938 views",Hope Music Entertainment,1671938,1676842,4904
988,"Mebre Mengiste, Derash Fenta & Ayanaw Tirualem - Siyamreben | ሲያምርብን - New Ethiopian Music 2019 by Hope Music Ethiopia 2 years ago 6 minutes, 33 seconds 144,356 views",Hope Music Entertainment,144356,144436,80
989,"Mekonnen Sisay - Abushete | አቡሽቴ - New Ethiopian Music 2019 (Official Video) by Hope Music Ethiopia 2 years ago 7 minutes, 13 seconds 67,655 views",Hope Music Entertainment,67655,67711,56
990,"Tesfaye Beyene - Meley | መለይ - New Ethiopian Music 2019 (Official Video) by Hope Music Ethiopia 2 years ago 4 minutes, 43 seconds 37,675 views",Hope Music Entertainment,37675,37718,43
991,"D Abe - Yagizema | ያግዜማ - New Ethiopian Music 2019 (Official Video) by Hope Music Ethiopia 2 years ago 4 minutes, 51 seconds 76,843 views",Hope Music Entertainment,76843,76873,30
992,"Asebe Godaye - Ethiopiawi | ኢትዮዽያዊ - New Ethiopian Music 2019 (Official Video) by Hope Music Ethiopia 2 years ago 6 minutes, 22 seconds 32,633 views",Hope Music Entertainment,32633,32639,6
993,"Saba Kebede - Gonder Lay | ጎንደር ላይ - New Ethiopian Music 2019 (Official Video) by Hope Music Ethiopia 2 years ago 5 minutes, 27 seconds 121,655 views",Hope Music Entertainment,121655,121776,121
994,"Tsegaye Eshetu ft. Sileshi Demissie - Min Honenal | ምን ሆነናል? - New Ethiopian Music 2019 by Hope Music Ethiopia 2 years ago 7 minutes, 17 seconds 203,508 views",Hope Music Entertainment,203508,203523,15
995,"Yalew Tariku - Abertagn Libe | አበርታኝ ልቤ - New Ethiopian Music 2019 (Official Video) by Hope Music Ethiopia 2 years ago 4 minutes, 44 seconds 36,400 views",Hope Music Entertainment,36400,36411,11
996,"Tsega muche - Yebelay | የበላይ - New Ethiopian Music 2019 (Official Video) by Hope Music Ethiopia 2 years ago 6 minutes, 43 seconds 405,370 views",Hope Music Entertainment,405370,405806,436
997,"Halima Abdurahman - Kekal Belay | ከቃል በላይ - New Ethiopian Music 2019 (Official Video) by Hope Music Ethiopia 2 years ago 5 minutes, 25 seconds 653,231 views",Hope Music Entertainment,653231,654752,1521
998,"Ezra - Hasab | ሃሳብ - New Ethiopian Music 2019 (Official Video) by Hope Music Ethiopia 2 years ago 3 minutes, 29 seconds 33,545 views",Hope Music Entertainment,33545,33649,104
999,"Hana ft. Kuni - Zigiropa - New Ethiopian Music 2019 (Official Video) by Hope Music Ethiopia 2 years ago 4 minutes, 55 seconds 30,868 views",Hope Music Entertainment,30868,30886,18
1000,"Gizachew Amera - Bitgulila | ቢትጉሊላ - New Ethiopian Music 2019 (Official Video) by Hope Music Ethiopia 2 years ago 5 minutes, 39 seconds 2,730,108 views",Hope Music Entertainment,2730108,2751071,20963
1001,"Beza Weynshet - Yilef | ይለፍ - New Ethiopian Music 2019 (Official Video) by Hope Music Ethiopia 2 years ago 6 minutes, 16 seconds 186,106 views",Hope Music Entertainment,186106,186452,346
1002,"Ephrem Molla - Negerign | ንገሪኝ - New Ethiopian Music 2019 (Official Video) by Hope Music Ethiopia 2 years ago 6 minutes, 4 seconds 266,697 views",Hope Music Entertainment,266697,267283,586
1003,"Wintana Tsige - Semah | ሰማህ - New Ethiopian Music 2019 (Official Video) by Hope Music Ethiopia 2 years ago 4 minutes, 47 seconds 125,959 views",Hope Music Entertainment,125959,126244,285
1004,"Tesfalidet Tadesse - Gud Alebat | ጉድ አለባት - New Ethiopian Music 2019 (Official Video) by Hope Music Ethiopia 2 years ago 4 minutes, 47 seconds 110,050 views",Hope Music Entertainment,110050,110167,117
1005,"Kaleb Araya Slasia - Dufen Silala - New Ethiopian Music 2019 (Official Video) by Hope Music Ethiopia 2 years ago 4 minutes, 27 seconds 273,633 views",Hope Music Entertainment,273633,273712,79
1006,"Binu Solomon - Endesu Endesua | እንደሱ እንደሷ - New Ethiopian Music 2019 (Official Video) by Hope Music Ethiopia 2 years ago 5 minutes, 2 seconds 142,500 views",Hope Music Entertainment,142500,142644,144
1007,"Fikir Yitagesu - Eziga | እዚጋ - New Ethiopian Music 2019 (Official Video) by Hope Music Ethiopia 2 years ago 5 minutes, 23 seconds 1,714,815 views",Hope Music Entertainment,1714815,1717833,3018
1008,"Kaleb Araya Slasia - Yesuwas Neger | የሷስ ነገር - New Ethiopian Music 2019 (Official Video) by Hope Music Ethiopia 2 years ago 5 minutes, 1 second 116,763 views",Hope Music Entertainment,116763,116796,33
1009,"Meharizeab Gidey (Faduma) - Amesegnalehu | አመሰግናለሁ - New Ethiopian Music 2019 (Official Video) by Hope Music Ethiopia 2 years ago 4 minutes, 51 seconds 172,127 views",Hope Music Entertainment,172127,174284,2157
1010,"Jene Tamene - Ale Wey | አለ ወይ - New Ethiopian Music 2019 (Official Video) by Hope Music Ethiopia 2 years ago 5 minutes, 44 seconds 73,230 views",Hope Music Entertainment,73230,73275,45
1011,"Ephrem Hagos - Girmbit | ግርምቢጥ - New Ethiopian Music 2019 (Official Video) by Hope Music Ethiopia 2 years ago 5 minutes, 32 seconds 61,437 views",Hope Music Entertainment,61437,61459,22
1012,"Micky Gonderegna - Fikir Yisten (Ethiopiye 2) | ፍቅር ይስጠን - New Ethiopian Music 2019 (Official Video) by Hope Music Ethiopia 2 years ago 4 minutes, 26 seconds 110,112 views",Hope Music Entertainment,110112,110179,67
1013,"Tomas Hailu (Tomy +) - Zena Larigat | ዘና ላርጋት - New Ethiopian Music 2019 (Official Video) by Hope Music Ethiopia 2 years ago 4 minutes, 46 seconds 396,832 views",Hope Music Entertainment,396832,398100,1268
1014,"Belsam X Alexander ft. Han - Yenew Nat | የኔው ናት - New Ethiopian Music 2019 (Official Video) by Hope Music Ethiopia 2 years ago 5 minutes, 7 seconds 58,300 views",Hope Music Entertainment,58300,58525,225
1015,"Zeleke Gessesse ft. Bitania & Arbin Ervin - Smile Ethiopia - Ethiopian Music 2019 (Official Video) by Hope Music Ethiopia 2 years ago 5 minutes, 8 seconds 55,818 views",Hope Music Entertainment,55818,55872,54
1016,"Daawit Dajanee - Kitaabee - New Ethiopian Music 2019 (Official Video) by Hope Music Ethiopia 2 years ago 6 minutes, 31 seconds 48,053 views",Hope Music Entertainment,48053,48060,7
1017,"Yohana - Mircha Alat | ምርቻ አላት - New Ethiopian Music 2019 (Official Video) by Hope Music Ethiopia 2 years ago 3 minutes, 37 seconds 513,268 views",Hope Music Entertainment,513268,515357,2089
1018,"Berhanhiwot - Ya Man - New Ethiopian Music 2019 (Official Video) by Hope Music Ethiopia 2 years ago 3 minutes, 23 seconds 37,548 views",Hope Music Entertainment,37548,37559,11
1019,"Eknock - Jami Laya - New African Music 2019 (Official Video) by Hope Music Ethiopia 2 years ago 4 minutes, 37 seconds 29,733 views",Hope Music Entertainment,29733,29813,80
1020,"Firehiwot Yilma - Anten Biye | አንተን ብዬ - New Ethiopian Music 2019 (Official Video) by Hope Music Ethiopia 2 years ago 5 minutes, 52 seconds 1,121,418 views",Hope Music Entertainment,1121418,1123592,2174
1021,"Getish Mamo - Sabiw (Tekebel 5) - New Ethiopian Music 2019 (Official Video) by Hope Music Ethiopia 2 years ago 6 minutes, 24 seconds 2,148,341 views",Hope Music Entertainment,2148341,2150900,2559
1022,"HUPA ft.  AFRO & CALLMEDAGGY - WER'E | ወሬ - New Ethiopian Music 2019 (Official Video) by Hope Music Ethiopia 2 years ago 4 minutes, 21 seconds 167,304 views",Hope Music Entertainment,167304,168618,1314
1023,"Enyachew Fancho - Iykoba | አይኮባ - New Ethiopian Music 2019 (Official Video) by Hope Music Ethiopia 2 years ago 4 minutes 83,288 views",Hope Music Entertainment,83288,83903,615
1024,"Kepaso Daygo & Kepaso Selam - Sema Gobez - New Ethiopian Music 2019 (Official Video) by Hope Music Ethiopia 2 years ago 3 minutes, 45 seconds 43,260 views",Hope Music Entertainment,43260,43368,108
1025,"Enat B - Wuded | ውድድድ  - New Ethiopian Music 2019 (Official Video) by Hope Music Ethiopia 2 years ago 3 minutes, 59 seconds 77,945 views",Hope Music Entertainment,77945,78083,138
1026,"Mafi Kassa - Aye Sew | አይ ሰው - New Ethiopian Music 2019 (Official Video) by Hope Music Ethiopia 2 years ago 6 minutes, 23 seconds 33,878 views",Hope Music Entertainment,33878,33924,46
1027,"Fasil Tilahun & Yadi Yosi - Maraki | ማራኪ - New Ethiopian Music 2019 (Official Video) by Hope Music Ethiopia 2 years ago 5 minutes, 10 seconds 73,208 views",Hope Music Entertainment,73208,73246,38
1028,"Mesafint Nigussie - Sewodelat | ስወድላት - New Ethiopian Music 2019 (Official Video) by Hope Music Ethiopia 2 years ago 6 minutes, 3 seconds 77,859 views",Hope Music Entertainment,77859,77893,34
1029,"Jossy Jano & Betty - Seyameye | ስያሜዬ - New Ethiopian Music 2019 (Official Video) by Hope Music Ethiopia 2 years ago 4 minutes, 2 seconds 57,226 views",Hope Music Entertainment,57226,57251,25
1030,"Rosi (Buteka) - Des Yalegn | ደስ ያለኝ - New Ethiopian Music 2019 (Official Video) by Hope Music Ethiopia 2 years ago 4 minutes, 19 seconds 242,363 views",Hope Music Entertainment,242363,242601,238
1031,"Weeha & Key Bek - Desta | ደስታ - New Ethiopian Music 2019 (Official Video) by Hope Music Ethiopia 2 years ago 4 minutes, 55 seconds 511,470 views",Hope Music Entertainment,511470,512670,1200
1032,"Yohannes Yirdaw - Zewrew | ዘውረው - New Ethiopian Music 2019 (Official Video) by Hope Music Ethiopia 2 years ago 6 minutes, 1 second 64,221 views",Hope Music Entertainment,64221,64274,53
1033,"Yeneta ft Ben X Jordan & Bek Geez - Yachat | ያቻት - New Ethiopian Music 2019 (Official Video) by Hope Music Ethiopia 2 years ago 3 minutes, 37 seconds 30,842 views",Hope Music Entertainment,30842,30870,28
1034,"Tigist Aschilegn - Des Yilegnal | ደስ ይለኛል - New Ethiopian Music 2019 (Official Video) by Hope Music Ethiopia 2 years ago 4 minutes, 52 seconds 71,084 views",Hope Music Entertainment,71084,71118,34
1035,"Tilahun Ashagre - Fenedekech | ፈነደቀች - New Ethiopian Music 2019 (Official Video) by Hope Music Ethiopia 2 years ago 6 minutes, 18 seconds 49,511 views",Hope Music Entertainment,49511,49613,102
1036,"Minyahel Demelash - Sinbole | ሲንቦሌ - New Ethiopian Music 2019 (Official Video) by Hope Music Ethiopia 2 years ago 4 minutes, 45 seconds 56,461 views",Hope Music Entertainment,56461,56471,10
1037,"Micky Hasset - Neyilegn | ነይልኝ - New Ethiopian Music 2019 (Official Video) by Hope Music Ethiopia 2 years ago 3 minutes, 27 seconds 82,356 views",Hope Music Entertainment,82356,82549,193
1038,"Andinet Ali (Endi) - Honey - New Ethiopian Music 2019 (Official Video) by Hope Music Ethiopia 2 years ago 4 minutes, 12 seconds 135,150 views",Hope Music Entertainment,135150,135311,161
1039,"Asgegnew Ashko (Asge) -  Duma Dume | ዱማ ዱሜ - New Ethiopian Music 2019 (Official Video) by Hope Music Ethiopia 2 years ago 4 minutes, 25 seconds 2,068,573 views",Hope Music Entertainment,2068573,2071960,3387
1040,"Dag Daniel - Ye Balewa Konjo | የባሌዋ ቆንጆ - New Ethiopian Music 2019 (Official Video) by Hope Music Ethiopia 2 years ago 4 minutes, 17 seconds 2,394,096 views",Hope Music Entertainment,2394096,2400510,6414
1041,"Wende Yonas - Bita | ቢታ - New Ethiopian Music 2019 (Official Video) by Hope Music Ethiopia 2 years ago 3 minutes, 50 seconds 46,998 views",Hope Music Entertainment,46998,47007,9
1042,"Sami Alexander - Tega Beyign | ጠጋ በይኝ - New Ethiopian Music 2019 (Official Video) by Hope Music Ethiopia 2 years ago 5 minutes, 28 seconds 170,740 views",Hope Music Entertainment,170740,170810,70
1043,"Yishak Assefa - Ethiopiawit | ኢትዮጵያዊት - New Ethiopian Music 2019 (Official Video) by Hope Music Ethiopia 2 years ago 6 minutes, 13 seconds 26,782 views",Hope Music Entertainment,26782,26794,12
1044,"Danawit - Nena Bochopo | ኔና ቦቾፖ - New Ethiopian Music 2019 (Official Video) by Hope Music Ethiopia 2 years ago 3 minutes, 32 seconds 56,873 views",Hope Music Entertainment,56873,56891,18
1045,"Fentaye Asmare - Kelay | ከላይ - New Ethiopian Music 2019 (Official Video) by Hope Music Ethiopia 2 years ago 5 minutes, 22 seconds 104,929 views",Hope Music Entertainment,104929,105041,112
1046,"Jossy in z house & Millen Hailu - Kokebey  - New Ethiopian & Eritrean Music 2019 (Official Video) by Hope Music Ethiopia 2 years ago 4 minutes, 48 seconds 19,810,310 views",Hope Music Entertainment,19810310,19872658,62348
1047,"Ben X Jordan & Bek Ge'ez - Layhonlen | ላይሆንልን - New Ethiopian Music 2019 (Official Video) by Hope Music Ethiopia 2 years ago 4 minutes, 36 seconds 212,224 views",Hope Music Entertainment,212224,213677,1453
1048,"Yemane Birhane - Ney Awdamet | ነይ አውዳመት - New Ethiopian Music 2019 (Official Video) by Hope Music Ethiopia 2 years ago 6 minutes, 17 seconds 48,329 views",Hope Music Entertainment,48329,48339,10
1049,"Sol Boss - Boni Bontu - New Ethiopian Music 2019 (Official Video) by Hope Music Ethiopia 2 years ago 4 minutes, 13 seconds 56,663 views",Hope Music Entertainment,56663,56678,15
1050,"Kal S ft. K West Beats - Kalshima | ካልሽማ - New Ethiopian Music 2019 (Official Video) by Hope Music Ethiopia 2 years ago 4 minutes, 29 seconds 71,968 views",Hope Music Entertainment,71968,71987,19
1051,"Samuel G/Tinsae - Tesfa Zeytbni | ተስፋ ዘይትብኒ - New Eritrean Music 2019 (Official Video) by Hope Music Ethiopia 2 years ago 7 minutes, 13 seconds 53,218 views",Hope Music Entertainment,53218,53237,19
1052,"Eshet Tsehayneh ft Soda - Alegn | አለኝ - New Ethiopian Music 2019 (Official Video) by Hope Music Ethiopia 2 years ago 5 minutes, 29 seconds 23,250 views",Hope Music Entertainment,23250,23258,8
1053,"Teshager Simachew - Tseyim Atalay | ፀይም አታላይ - New Ethiopian Music 2019 (Official Video) by Hope Music Ethiopia 2 years ago 5 minutes, 48 seconds 54,070 views",Hope Music Entertainment,54070,54125,55
1054,"Caaltuu Butoo - OBBEYYO - New Ethiopian Music 2019 (Official Video) by Hope Music Ethiopia 2 years ago 5 minutes, 39 seconds 242,634 views",Hope Music Entertainment,242634,245148,2514
1055,"Saba Kebede - Ye Dessie Lij | የደሴ ልጅ - New Ethiopian Music 2019 (Official Video) by Hope Music Ethiopia 2 years ago 5 minutes, 27 seconds 66,533 views",Hope Music Entertainment,66533,66568,35
1056,"Lense Lemessa - Imala Jaalala - New Ethiopian Music 2019 (Official Video) by Hope Music Ethiopia 2 years ago 6 minutes, 10 seconds 98,599 views",Hope Music Entertainment,98599,98675,76
1057,"Sara Takele - Yefikir Kal | የፍቅር ቃል - New Ethiopian Music 2019 (Official Video) by Hope Music Ethiopia 2 years ago 4 minutes, 6 seconds 746,657 views",Hope Music Entertainment,746657,748608,1951
1058,"Endale Admike - Amaregna | አማረኛ - New Ethiopian Music 2019 (Official Video) by Hope Music Ethiopia 2 years ago 5 minutes, 17 seconds 96,923 views",Hope Music Entertainment,96923,97173,250
1059,"Jirenya Shiferaw & Hawi - Jalalti Falagooyita - New Ethiopian Music 2019 (Official Video) by Hope Music Ethiopia 2 years ago 7 minutes, 6 seconds 1,040,938 views",Hope Music Entertainment,1040938,1044222,3284
1060,"Ashenafi Setegn - Fikir Band Lay | ፍቅር በአንድ ላይ - New Ethiopian Music 2019 (Official Video) by Hope Music Ethiopia 2 years ago 6 minutes, 50 seconds 21,736 views",Hope Music Entertainment,21736,21744,8
1061,"Hanna Tekle - Fitih | ፍትህ - New Ethiopian Music 2019 (Official Video) by Hope Music Ethiopia 2 years ago 7 minutes, 20 seconds 85,475 views",Hope Music Entertainment,85475,85682,207
1062,"Asny Raga - Ayibe Gamme (Na Tolo) | አይቢ ጋሜ - New Ethiopian Music 2019 (Official Video) by Hope Music Ethiopia 2 years ago 4 minutes, 12 seconds 31,874 views",Hope Music Entertainment,31874,31889,15
1063,"Kelemework Molla - Gira Gone | ግራ ጎኔ - New Ethiopian Music 2019 (Official Video) by Hope Music Ethiopia 2 years ago 5 minutes, 37 seconds 82,055 views",Hope Music Entertainment,82055,82098,43
1064,"Solomon Berhanu - Yehiwote Fana | የሂወቴ ፋና - New Ethiopian Music 2019 (Official Video) by Hope Music Ethiopia 2 years ago 5 minutes, 31 seconds 56,274 views",Hope Music Entertainment,56274,56295,21
1065,"Addis Alemayehu - Asheftogn | አሸፍቶኝ - New Ethiopian Music 2019 (Official Video) by Hope Music Ethiopia 2 years ago 5 minutes, 19 seconds 79,613 views",Hope Music Entertainment,79613,79680,67
1066,"Mykey Shewa - Zeb Zeb | ዘብ ዘብ - New Ethiopian Music 2019 (Official Video) by Hope Music Ethiopia 2 years ago 6 minutes, 4 seconds 443,525 views",Hope Music Entertainment,443525,444039,514
1067,"Getish Mesfin - Konjo | ቆንጆ - New Ethiopian Music 2019 (Official Video) by Hope Music Ethiopia 2 years ago 4 minutes, 6 seconds 72,535 views",Hope Music Entertainment,72535,72564,29
1068,"Maki Kb - Mekenete | መቀነቴ - New Ethiopian Music 2019 (Official Video) by Hope Music Ethiopia 2 years ago 4 minutes, 15 seconds 310,676 views",Hope Music Entertainment,310676,311949,1273
1069,"Ziggy Zaga - Destegna Negn | ደስተኛ ነኝ - New Ethiopian Music 2019 (Official Video) by Hope Music Ethiopia 2 years ago 4 minutes, 48 seconds 76,410 views",Hope Music Entertainment,76410,76468,58
1070,"Temu Alex - WANO NES - New Ethiopian Music 2019 (Official Video) by Hope Music Ethiopia 2 years ago 4 minutes, 15 seconds 69,254 views",Hope Music Entertainment,69254,69265,11
1071,"Jossy ft Veronica Adane - Nikoya | ኒኮያ - New Ethiopian Music 2019 (Official Video) by Hope Music Ethiopia 2 years ago 4 minutes, 25 seconds 95,042 views",Hope Music Entertainment,95042,95064,22
1072,"Honey Spice - Fikir Tewlegn | ፍቅር ተውልኝ - New Ethiopian Music 2019 (Official Video) by Hope Music Ethiopia 2 years ago 4 minutes, 20 seconds 331,693 views",Hope Music Entertainment,331693,332034,341
1073,"Samuel Legesse - Moto Fokari | ሞቶ ፎካሪ - New Ethiopian Music 2019 (Official Video) by Hope Music Ethiopia 2 years ago 5 minutes, 15 seconds 128,696 views",Hope Music Entertainment,128696,128718,22
1074,"DaggyShash - Setota | ስጦታ - New Ethiopian Music 2019 (Official Video) by Hope Music Ethiopia 2 years ago 4 minutes, 30 seconds 4,456,141 views",Hope Music Entertainment,4456141,4471936,15795
1075,"Geez Ataklti - Gena Gena | ገና ገና - New Ethiopian Music 2019 (Official Video) by Hope Music Ethiopia 2 years ago 4 minutes, 21 seconds 43,710 views",Hope Music Entertainment,43710,43724,14
1076,"Dj Lee - Giba Belew | ግባ በለው - New Ethiopian Music 2019 (Official Video) by Hope Music Ethiopia 2 years ago 5 minutes, 6 seconds 307,356 views",Hope Music Entertainment,307356,318360,11004
1077,"Alex Anteneh - Hewane | ሄዋኔ - New Ethiopian Music 2019 (Official Video) by Hope Music Ethiopia 2 years ago 5 minutes, 1 second 36,438 views",Hope Music Entertainment,36438,36471,33
1078,"G Gerima ft Eknock - Palm Wine - New Ethiopian Music 2019 (Official Video) by Hope Music Ethiopia 2 years ago 3 minutes, 31 seconds 41,720 views",Hope Music Entertainment,41720,41733,13
1079,"Addisu Dagne - Habeshawit | ሃበሻዊት - New Ethiopian Music 2019 (Official Video) by Hope Music Ethiopia 2 years ago 3 minutes, 57 seconds 38,853 views",Hope Music Entertainment,38853,38870,17
1080,"Mc Siyamregn - Flexin - New Ethiopian Music 2019 (Official Video) by Hope Music Ethiopia 2 years ago 4 minutes, 1 second 40,110 views",Hope Music Entertainment,40110,40188,78
1081,"Ella Man - LE ' TEZETA | ለትዝታ - New Ethiopian Music 2019 (Official Video) by Hope Music Ethiopia 2 years ago 3 minutes, 22 seconds 85,459 views",Hope Music Entertainment,85459,85672,213
1082,"Yabsira Yared - Semeani Fikrey | ስምዐኒ ፍቅረይ - New Ethiopian Music 2019 (Official Video) by Hope Music Ethiopia 2 years ago 3 minutes, 56 seconds 36,262 views",Hope Music Entertainment,36262,36304,42
1083,"Abeba Demeke - Awuya | አውያ - New Ethiopian Music 2019 (Official Video) by Hope Music Ethiopia 2 years ago 5 minutes, 1 second 124,780 views",Hope Music Entertainment,124780,126017,1237
1084,"Dinar ft Fitawrari, Meswani & Henok - Kebidkni - New Ethiopian Music 2019 (Official Video) by Hope Music Ethiopia 2 years ago 4 minutes, 47 seconds 70,183 views",Hope Music Entertainment,70183,70235,52
1085,"Sancho Gebre - Tanamo | ታናሞ - New Ethiopian Music 2019 (Official Video) by Hope Music Ethiopia 2 years ago 4 minutes, 18 seconds 7,540,807 views",Hope Music Entertainment,7540807,7570796,29989
1086,"Ziggy Zaga - Ewedishalehu | እወድሻለሁ - New Ethiopian Music 2019 (Official Audio) by Hope Music Ethiopia 2 years ago 6 minutes, 54 seconds 80,417 views",Hope Music Entertainment,80417,80722,305
1087,"Ziggy Zaga - Yihew Metach | ይኼው መጣች - New Ethiopian Music 2019 (Official Audio) by Hope Music Ethiopia 2 years ago 5 minutes, 11 seconds 11,259 views",Hope Music Entertainment,11259,11269,10
1088,"Ziggy Zaga - Shegnat | ሸኛት - New Ethiopian Music 2019 (Official Audio) by Hope Music Ethiopia 2 years ago 5 minutes, 35 seconds 8,018 views",Hope Music Entertainment,8018,8037,19
1089,"Ziggy Zaga - Serkaleme | ሰርካለሜ - New Ethiopian Music 2019 (Offical Audio) by Hope Music Ethiopia 2 years ago 4 minutes, 24 seconds 19,688 views",Hope Music Entertainment,19688,19728,40
1090,"Ziggy Zaga - Sakish - New Ethiopian Music 2019 (Official Audio) by Hope Music Ethiopia 2 years ago 4 minutes, 28 seconds 12,695 views",Hope Music Entertainment,12695,12709,14
1091,"Ziggy Zaga - Ethiopiaye | ኢትዮዽያዬ - New Ethiopian Music 2019 (Official Audio) by Hope Music Ethiopia 2 years ago 5 minutes, 30 seconds 10,879 views",Hope Music Entertainment,10879,10905,26
1092,"Ziggy Zaga - Godin | ጎዲን - New Ethiopian Music 2019 (Official Audio) by Hope Music Ethiopia 2 years ago 5 minutes, 18 seconds 9,990 views",Hope Music Entertainment,9990,10011,21
1093,"Ziggy Zaga - Korma | ኮርማ - New Ethiopian Music 2019 (Official Audio) by Hope Music Ethiopia 2 years ago 3 minutes, 49 seconds 10,217 views",Hope Music Entertainment,10217,10247,30
1094,"Ziggy Zaga - Leneko - New Ethiopian Music 2019 (Official Audio) by Hope Music Ethiopia 2 years ago 4 minutes, 52 seconds 19,524 views",Hope Music Entertainment,19524,19578,54
1095,"Ziggy Zaga - Arada | አራዳ - New Ethiopian Music 2019 (Official Audio) by Hope Music Ethiopia 2 years ago 4 minutes, 59 seconds 20,591 views",Hope Music Entertainment,20591,20631,40
1096,"Ziggy Zaga - Enayu Bayu Bet | እናዩ ባዩ ቤት - New Ethiopian Music 2019 (Official Audio) by Hope Music Ethiopia 2 years ago 3 minutes, 58 seconds 13,153 views",Hope Music Entertainment,13153,13196,43
1097,"Ziggy Zaga - Gum Semay - New Ethiopian Music 2019 (Official Audio) by Hope Music Ethiopia 2 years ago 5 minutes, 9 seconds 8,467 views",Hope Music Entertainment,8467,8493,26
1098,"Ziggy Zaga - Destegna Negn | ደስተኛ ነኝ - New Ethiopian Music 2019 (Official Audio) by Hope Music Ethiopia 2 years ago 4 minutes, 37 seconds 35,478 views",Hope Music Entertainment,35478,35598,120
1099,"Ziggy Zaga - Alehu | አለሁ - New Ethiopian Music 2019 (Official Audio) by Hope Music Ethiopia 2 years ago 5 minutes, 18 seconds 26,767 views",Hope Music Entertainment,26767,26881,114
1100,"Ziggy Zaga - Yet Yihon | የት ይሆን - New Ethiopian Music 2019 (Official Audio) by Hope Music Ethiopia 2 years ago 4 minutes, 21 seconds 57,491 views",Hope Music Entertainment,57491,57641,150
1101,"Anteneh Getachew - Man Ende Hager | ማን እንደ ሃገር - New Ethiopian Music 2019 (Official Video) by Hope Music Ethiopia 2 years ago 5 minutes, 28 seconds 55,818 views",Hope Music Entertainment,55818,55827,9
1102,"Kassahun Degefaw - Mircha | ምርጫ - New Ethiopian Music 2019 (Official Video) by Hope Music Ethiopia 2 years ago 5 minutes, 35 seconds 31,860 views",Hope Music Entertainment,31860,31886,26
1103,"Kaleb Alaho - Sew Negn | ሰው ነኝ - New Ethiopian Music 2019 (Official Video) by Hope Music Ethiopia 2 years ago 3 minutes, 34 seconds 28,621 views",Hope Music Entertainment,28621,28641,20
1104,"Meseret Mebratu - Saynor Koshita | ሳይኖር ኮሽታ - New Ethiopian Music 2019 (Official Video) by Hope Music Ethiopia 2 years ago 4 minutes, 32 seconds 128,920 views",Hope Music Entertainment,128920,128957,37
1105,"Heaven - Koinelka'do | ኮይነልካ'ዶ - New Eritrean Music 2019 (Official Video) by Hope Music Ethiopia 2 years ago 4 minutes, 36 seconds 86,552 views",Hope Music Entertainment,86552,86584,32
1106,"G Mesay Kebede - Zebibey | ዘቢበይ - New Ethiopian Music 2019 (Official Video) by Hope Music Ethiopia 2 years ago 5 minutes, 15 seconds 1,943,720 views",Hope Music Entertainment,1943720,1950478,6758
1107,"Yared Mekonnen - Jemameregn | ጀማመረኝ - New Ethiopian Music 2019 (Official Video) by Hope Music Ethiopia 2 years ago 5 minutes, 12 seconds 56,269 views",Hope Music Entertainment,56269,56287,18
1108,"Girum Wudu - Ethiopia Tikdem | ኢትዮዽያ ትቅደም - New Ethiopian Music 2019 (Official Video) by Hope Music Ethiopia 2 years ago 6 minutes, 9 seconds 693,892 views",Hope Music Entertainment,693892,694529,637
1109,"Hiwot Tebkew - Monanaye | ሞናናዬ - New Ethiopian Music 2019 (Official Video) by Hope Music Ethiopia 2 years ago 5 minutes, 49 seconds 52,309 views",Hope Music Entertainment,52309,52455,146
1110,"Amigo, Ezel & Biruk - Akabedech | አካበደች - New Ethiopian Music 2019 (Official Video) by Hope Music Ethiopia 2 years ago 4 minutes, 18 seconds 829,728 views",Hope Music Entertainment,829728,833121,3393
1111,"Eknock - Hakuna Matata - African Music 2019 (Official Video) by Hope Music Ethiopia 2 years ago 3 minutes, 9 seconds 24,285 views",Hope Music Entertainment,24285,24307,22
1112,"Minalush Reta - Wudedegn | ውደደኝ - New Ethiopian Music 2019 (Official Video) by Hope Music Ethiopia 2 years ago 5 minutes, 17 seconds 228,202 views",Hope Music Entertainment,228202,229197,995
1113,"Teklu Jenbere - Bene Derso | በኔ ደርሶ - New Ethiopian Music 2019 (Official Video) by Hope Music Ethiopia 2 years ago 4 minutes, 56 seconds 49,522 views",Hope Music Entertainment,49522,49525,3
1114,"Fikadu Manza - Malsasiya | ማልሳሲያ - New Ethiopian Music 2019 (Official Video) by Hope Music Ethiopia 2 years ago 5 minutes, 11 seconds 30,833 views",Hope Music Entertainment,30833,30848,15
1115,"Getachew Fiseha - Yimerlat | ይመርላት - New Ethiopian Music 2019 (Official Video) by Hope Music Ethiopia 2 years ago 4 minutes, 48 seconds 31,810 views",Hope Music Entertainment,31810,31819,9
1116,"Danny D - Ney Ney | ነይ ነይ - New Ethiopian Music 2019 (Official Video) by Hope Music Ethiopia 2 years ago 4 minutes, 17 seconds 93,435 views",Hope Music Entertainment,93435,93533,98
1117,"Bezawit Fikadu (Jazmin) - Yene Andegna | የኔ አንደኛ - New Ethiopian Music 2019 (Official Video) by Hope Music Ethiopia 2 years ago 4 minutes, 5 seconds 206,213 views",Hope Music Entertainment,206213,206706,493
1118,"Abel Almaz - Banenkugn | ባነንኩኝ - New Ethiopian Music 2019 (Official Video) by Hope Music Ethiopia 2 years ago 5 minutes, 41 seconds 171,474 views",Hope Music Entertainment,171474,171885,411
1119,"Mahlet Assefa - Tikna | ትቅና - New Ethiopian Music 2019 (Official Video) by Hope Music Ethiopia 2 years ago 4 minutes, 24 seconds 76,921 views",Hope Music Entertainment,76921,76945,24
1120,"Ziggy Zaga - Lene ko | ለኔ ኮ - New Ethiopian Music 2019 (Official Video) by Hope Music Ethiopia 2 years ago 5 minutes 271,865 views",Hope Music Entertainment,271865,272057,192
1121,"Bereket Teklu - Begodanaw Lay | በጎዳናው ላይ - New Ethiopian Music 2019 (Official Video) by Hope Music Ethiopia 2 years ago 4 minutes, 18 seconds 36,509 views",Hope Music Entertainment,36509,36520,11
1122,"Beti Ejig - Kemir | ከምር - New Ethiopian Music 2019 (Official Video) by Hope Music Ethiopia 2 years ago 4 minutes, 4 seconds 927,438 views",Hope Music Entertainment,927438,937350,9912
1123,"Bezawit Zeleke - Enkokelesh | እንቆቅልሽ - New Ethiopian Music 2019 (Official Video) by Hope Music Ethiopia 2 years ago 5 minutes, 32 seconds 60,112 views",Hope Music Entertainment,60112,60144,32
1124,"Firehiwot Tadesse - Yebishoftu Lij | የቢሾፍቱ ልጅ - New Ethiopian Music 2019 (Official Video) by Hope Music Ethiopia 2 years ago 5 minutes, 4 seconds 64,631 views",Hope Music Entertainment,64631,64662,31
1125,"Obsaa Raggaasaa - Dibaa Ibiddaa - New Ethiopian Music 2019 (Official Video) by Hope Music Ethiopia 2 years ago 5 minutes 52,498 views",Hope Music Entertainment,52498,52538,40
1126,"Genet Hailu - Yantema Neger | ያንተማ ነገር - New Ethiopian Music 2019 (Official Video) by Hope Music Ethiopia 2 years ago 5 minutes, 41 seconds 55,462 views",Hope Music Entertainment,55462,55487,25
1127,"Muna ft.  Abel Rasta - Fikir Tsento | ፍቅር ፀንቶ - New Ethiopian Music 2019 (Official Video) by Hope Music Ethiopia 2 years ago 4 minutes, 22 seconds 101,392 views",Hope Music Entertainment,101392,101438,46
1128,"Ephrem Hagos - Werki Zebo | ወርቂ ዘቦ - New Ethiopian Music 2019 (Official Video) by Hope Music Ethiopia 2 years ago 5 minutes, 25 seconds 56,500 views",Hope Music Entertainment,56500,56509,9
1129,"Tadesse Mekete - Selam Hagere | ሰላም ሃገሬ - New Ethiopian Music 2019 (Official Video) by Hope Music Ethiopia 2 years ago 8 minutes, 44 seconds 962,051 views",Hope Music Entertainment,962051,964348,2297
1130,"Winta Zekarias - Ene Eyalehu | እኔ እያለሁ - New Ethiopian Music 2019 (Official Video) by Hope Music Ethiopia 2 years ago 5 minutes, 40 seconds 51,157 views",Hope Music Entertainment,51157,51178,21
1131,"Jireenyaa Shifaraaw - SIIF HAA TA'U - New Ethiopian Music 2019 (Official Video) by Hope Music Ethiopia 2 years ago 3 minutes, 44 seconds 480,340 views",Hope Music Entertainment,480340,481213,873
1132,"Salih Soud - Addis Ababa | አዲስ አበባ - New Ethiopian Music 2019 (Official Video) by Hope Music Ethiopia 2 years ago 3 minutes, 41 seconds 93,798 views",Hope Music Entertainment,93798,93842,44
1133,"Dagim Jomo - Chi Chi | ቺቺ - New Ethiopian Music 2019 (Official Video) by Hope Music Ethiopia 2 years ago 3 minutes, 56 seconds 25,211 views",Hope Music Entertainment,25211,25232,21
1134,"Hab G - Yaradawa | ያራዳዋ - New Ethiopian Music 2019 (Official Video) by Hope Music Ethiopia 2 years ago 5 minutes, 34 seconds 119,052 views",Hope Music Entertainment,119052,119156,104
1135,"Helita - Abdalech | አብዳለች - New Ethiopian Music 2019 (Official Video) by Hope Music Ethiopia 2 years ago 5 minutes, 22 seconds 96,207 views",Hope Music Entertainment,96207,96240,33
1136,"Tesfaye Tilahun - Teguazh | ተጓዥ - New Ethiopian Music 2019 (Official Video) by Hope Music Ethiopia 2 years ago 5 minutes, 8 seconds 162,159 views",Hope Music Entertainment,162159,162460,301
1137,"Muluken Haregu - Yene Werk | የኔ ወርቅ - New Ethiopian Music 2019 (Official Video) by Hope Music Ethiopia 2 years ago 7 minutes, 11 seconds 23,482 views",Hope Music Entertainment,23482,23496,14
1138,"Serawitu Lema - Geno Hamba | ጌኖ ሃምባ - New Ethiopian Music 2019 (Official Video) by Hope Music Ethiopia 2 years ago 4 minutes, 58 seconds 28,033 views",Hope Music Entertainment,28033,28136,103
1139,"Bezawit Getachew - Enka Lestih | እንካ ልስጥህ - New Ethiopian Music 2019 (Official Video) by Hope Music Ethiopia 2 years ago 4 minutes, 32 seconds 2,924,592 views",Hope Music Entertainment,2924592,2933875,9283
1140,"Getachew Addis - Malefiya | ማለፊያ - New Ethiopian Music 2019 (Official Video) by Hope Music Ethiopia 2 years ago 6 minutes, 36 seconds 77,017 views",Hope Music Entertainment,77017,77097,80
1141,"Margiitu Warqina - Amma Yeroon - New Ethiopian Music 2019 (Official Video) by Hope Music Ethiopia 2 years ago 6 minutes, 24 seconds 3,441,226 views",Hope Music Entertainment,3441226,3473957,32731
1142,"Liyat Tibebu - Ayhonema | አይሆንማ - New Ethiopian Music 2019 (Official Video) by Hope Music Ethiopia 2 years ago 4 minutes, 10 seconds 128,997 views",Hope Music Entertainment,128997,129372,375
1143,"Bisrat Surafel - Adwa | አድዋ - New Ethiopian Music 2019 by Hope Music Ethiopia 2 years ago 3 minutes, 31 seconds 117,897 views",Hope Music Entertainment,117897,118649,752
1144,"Mezekir Tesfaye ft. Hailesilassie Kebede - Zemach | ዘማች - New Ethiopian Music 2019 (Official Video) by Hope Music Ethiopia 3 years ago 3 minutes, 8 seconds 17,969 views",Hope Music Entertainment,17969,17975,6
1145,"Zema Araray - Keriwun Yigermal | ቀሪውን ይገርማል - New Ethiopian Music 2019 (Official Video) by Hope Music Ethiopia 3 years ago 5 minutes, 41 seconds 29,500 views",Hope Music Entertainment,29500,29527,27
1146,"Abrham Belayneh - Ete Abay | እቴ አባይ - New Ethiopian Music 2019 (Official Video) by Hope Music Ethiopia 3 years ago 7 minutes, 2 seconds 8,011,936 views",Hope Music Entertainment,8011936,8037310,25374
1147,"Emebet Negasi - Fikir Ena Gura | ፍቅር እና ጉራ - New Ethiopian Music 2019 (Official Video) by Hope Music Ethiopia 3 years ago 5 minutes, 59 seconds 1,495,551 views",Hope Music Entertainment,1495551,1497615,2064
1148,"Ermias Zerihun - Tegabey Wedene | ጠጋበይ ወደኔ - New Ethiopian Music 2019 (Official Video) by Hope Music Ethiopia 3 years ago 5 minutes, 32 seconds 46,739 views",Hope Music Entertainment,46739,46751,12
1149,"Ras Biruk - More Fire | እቶን እሳት - New Ethiopian Music 2019 (Official Video) by Hope Music Ethiopia 3 years ago 5 minutes, 10 seconds 36,991 views",Hope Music Entertainment,36991,37039,48
1150,"Asfaw Eshetu - Bewaza | ብዋዛ - New Ethiopian Music 2019 (Official Video) by Hope Music Ethiopia 3 years ago 4 minutes, 21 seconds 64,961 views",Hope Music Entertainment,64961,64999,38
1151,"Abrham Berhe (Abrahaley) - Gdefi | ግደፊ - New Ethiopian Music 2019 (Official Video) by Hope Music Ethiopia 3 years ago 6 minutes, 17 seconds 51,270 views",Hope Music Entertainment,51270,51294,24
1152,"Enyew Metanya - Wurd Kerase | ውርድ ከራሴ - New Ethiopian Music 2019 (Official Video) by Hope Music Ethiopia 3 years ago 4 minutes, 34 seconds 23,194 views",Hope Music Entertainment,23194,23207,13
1153,"Messuwani - Englizegnashin Teyiw | እንግሊዝኛሽን ተይው - New Ethiopian Music 2019 (Official Video) by Hope Music Ethiopia 3 years ago 4 minutes, 45 seconds 73,552 views",Hope Music Entertainment,73552,73574,22
1154,"Shukri Jamal - FUNGEE - New Ethiopian Music 2019 (Official Video) by Hope Music Ethiopia 3 years ago 3 minutes, 55 seconds 672,025 views",Hope Music Entertainment,672025,675264,3239
1155,"Helen Berhe - Emen Aytemen | እመን አይትእመን - New Ethiopian Music 2019 (Official Video) by Hope Music Ethiopia 3 years ago 5 minutes, 28 seconds 4,640,658 views",Hope Music Entertainment,4640658,4651083,10425
1156,"Mesfin Berhanu - Tezez | ተዘዝ - New Ethiopian Music 2019 (Official Video) by Hope Music Ethiopia 3 years ago 5 minutes, 8 seconds 9,826,747 views",Hope Music Entertainment,9826747,9870574,43827
1157,"Mesale Abraham - Entarek | እንታረቅ - New Ethiopian Music 2019 (Official Video) by Hope Music Ethiopia 3 years ago 4 minutes, 39 seconds 28,990 views",Hope Music Entertainment,28990,29000,10
1158,"Issac ft. Yafet Tesfaye - Wedefit | ወደፊት - New Ethiopian Music 2019 (Official Video) by Hope Music Ethiopia 3 years ago 3 minutes, 42 seconds 25,861 views",Hope Music Entertainment,25861,25897,36
1159,"Endashaw Mengistu - Wey Alalshign | ወይ አላልሽኝ - New Ethiopian Music 2019 (Official Video) by Hope Music Ethiopia 3 years ago 5 minutes, 26 seconds 53,400 views",Hope Music Entertainment,53400,53418,18
1160,"Terefe Assefa - Asayena | አሳየና - New Ethiopian Music 2019 (Official Video) by Hope Music Ethiopia 3 years ago 4 minutes, 23 seconds 43,666 views",Hope Music Entertainment,43666,43685,19
1161,"Natnael Tesfaye - Ayn Bayn | አይን ባይን - New Ethiopian Music 2019 (Official Video) by Hope Music Ethiopia 3 years ago 4 minutes, 12 seconds 54,485 views",Hope Music Entertainment,54485,54523,38
1162,"Tombola Abebaw (Guadegnaye) - Wub Aleme | ውብ አለሜ - New Ethiopian Music 2019 (Official Video) by Hope Music Ethiopia 3 years ago 4 minutes, 55 seconds 89,621 views",Hope Music Entertainment,89621,89688,67
1163,"Daangaa H/Elfinesh - Qoree Suqqatee - New Ethiopian Music 2019 (Official Video) by Hope Music Ethiopia 3 years ago 3 minutes, 42 seconds 950,233 views",Hope Music Entertainment,950233,953839,3606
1164,"Seble Feleke - Wa Hagere | ዋ ሃገሬ - New Ethiopian Music 2019 (Official Video) by Hope Music Ethiopia 3 years ago 6 minutes, 7 seconds 74,901 views",Hope Music Entertainment,74901,74923,22
1165,"Nati Abraham - Kanto | ካንቶ - New Ethiopian Music 2019 (Official Video) by Hope Music Ethiopia 3 years ago 3 minutes, 40 seconds 124,879 views",Hope Music Entertainment,124879,125237,358
1166,"Werku Molla - Aybekam Wey | አይበቃም ወይ - New Ethiopian Music 2019 (Official Video) by Hope Music Ethiopia 3 years ago 5 minutes, 49 seconds 547,386 views",Hope Music Entertainment,547386,548107,721
1167,"Alemye Getachew - Kelem Shash | ቀለም ሻሽ - New Ethiopian Music 2019 (Official Video) by Hope Music Ethiopia 3 years ago 5 minutes, 23 seconds 1,034,228 views",Hope Music Entertainment,1034228,1035351,1123
1168,"Teddy Yo - Endezi Endeza | እንደዚ እንደዛ - New Ethiopian Music 2019 (Official Video) by Hope Music Ethiopia 3 years ago 3 minutes, 47 seconds 607,636 views",Hope Music Entertainment,607636,609057,1421
1169,"Christina Melkamu & Abiyot Bekele - Marewa | ማሬዋ  - New Ethiopian Music 2019 (Official Video) by Hope Music Ethiopia 3 years ago 5 minutes, 28 seconds 165,970 views",Hope Music Entertainment,165970,166170,200
1170,"Solomon Fuji - Amalay | አማላይ - New Ethiopian Music 2019 (Official Video) by Hope Music Ethiopia 3 years ago 6 minutes, 29 seconds 66,087 views",Hope Music Entertainment,66087,66138,51
1171,"Wendi Mar - Min Hona New | ምን ሆና ነው - New Ethiopian Music 2019 (Official Video) by Hope Music Ethiopia 3 years ago 3 minutes, 47 seconds 216,747 views",Hope Music Entertainment,216747,218980,2233
1172,"Zenebe Werku - Manew Yemileyew | ማነው የሚለየው - New Ethiopian Music 2019 (Official Video) by Hope Music Ethiopia 3 years ago 6 minutes, 26 seconds 119,884 views",Hope Music Entertainment,119884,119919,35
1173,"Endegna - fikir | ፍቅር - New Ethiopian Music 2019 (Official Video) by Hope Music Ethiopia 3 years ago 4 minutes, 52 seconds 5,924,836 views",Hope Music Entertainment,5924836,5943677,18841
1174,"Jote Deresu ft. Sami Go - SOBA - New Ethiopian Music 2019 (Official Video) by Hope Music Ethiopia 3 years ago 4 minutes, 25 seconds 365,951 views",Hope Music Entertainment,365951,366911,960
1175,"MIky Yo - 4 Netib | አራት ነጥብ - New Ethiopian Music 2019 (Official Video) by Hope Music Ethiopia 3 years ago 4 minutes, 2 seconds 122,529 views",Hope Music Entertainment,122529,122720,191
1176,"Yabu Mo ft. Redu - Tew | ተው - New Ethiopian Music 2019 (Official Video) by Hope Music Ethiopia 3 years ago 4 minutes, 1 second 36,289 views",Hope Music Entertainment,36289,36313,24
1177,"Papio Belete - Sam Argign | ሳም አርጊኝ - New Ethiopian Music 2019 (Official Video) by Hope Music Ethiopia 3 years ago 5 minutes 66,561 views",Hope Music Entertainment,66561,66596,35
1178,"Bereket Elias ft Dinberu Tadesse - Atinkubign | አትንኩብኝ - New Ethiopian Music 2019 (Official Video) by Hope Music Ethiopia 3 years ago 4 minutes, 57 seconds 25,205 views",Hope Music Entertainment,25205,25242,37
1179,"Biruk Dejene - Min Yishalegnal | ምን ይሻለኛል - New Ethiopian Music 2019 (Official Video) by Hope Music Ethiopia 3 years ago 4 minutes, 17 seconds 234,780 views",Hope Music Entertainment,234780,235146,366
1180,"Samuel Seneshaw - Yota | ዮታ - New Ethiopian Music 2019 (Official Video) by Hope Music Ethiopia 3 years ago 4 minutes, 8 seconds 81,736 views",Hope Music Entertainment,81736,81768,32
1181,"Muas Baba - Tewejignalesh | ትወጂኛለሽ - New Ethiopian Music 2019 (Official Video) by Hope Music Ethiopia 3 years ago 4 minutes, 28 seconds 164,178 views",Hope Music Entertainment,164178,165020,842
1182,"Ashenafi Geremew - Beza Beza | በዛ በዛ - New Ethiopian Music 2019 (Official Video) by Hope Music Ethiopia 3 years ago 4 minutes, 59 seconds 242,138 views",Hope Music Entertainment,242138,242416,278
1183,"Habtamu G/Tsadik - Jeba Bilegn | ጀባ ቢለኝ - New Ethiopian Music 2019 (Official Audio) by Hope Music Ethiopia 3 years ago 5 minutes, 54 seconds 30,122 views",Hope Music Entertainment,30122,30166,44
1184,"Habtamu G/Tsadik - Hasabe | ሃሳቤ - New Ethiopian Music 2019 (Official Audio) by Hope Music Ethiopia 3 years ago 5 minutes, 5 seconds 21,942 views",Hope Music Entertainment,21942,21969,27
1185,"Habtamu G /Tsadik - Alfeligim - New Ethiopian Music 2019 (Official Audio) by Hope Music Ethiopia 3 years ago 4 minutes, 32 seconds 27,516 views",Hope Music Entertainment,27516,27549,33
1186,"Habtamu G/Tsadik - Gin Andande | ግን አንዳንዴ - New Ethiopian Music 2019 (Official Video) by Hope Music Ethiopia 3 years ago 5 minutes, 40 seconds 82,819 views",Hope Music Entertainment,82819,83059,240
1187,"Habtamu G/Tsadik - Megale Tiya - New Ethiopian Music 2019 (Official Audio) by Hope Music Ethiopia 3 years ago 5 minutes, 23 seconds 8,179 views",Hope Music Entertainment,8179,8191,12
1188,"Habtamu G/Tsadik - Tewat | ተዋት - New Ethiopian Music 2019 (Official Audio) by Hope Music Ethiopia 3 years ago 5 minutes, 19 seconds 31,598 views",Hope Music Entertainment,31598,31668,70
1189,"Habtamu G/Tsadik - Selame | ሰላሜ - New Ethiopian Music 2019 (Official Audio) by Hope Music Ethiopia 3 years ago 4 minutes, 12 seconds 14,265 views",Hope Music Entertainment,14265,14290,25
1190,"Habtamu G/Tsadik - Dehna Hugni | ደህና ሁኝ - New Ethiopian Music 2019 (Official Audio) by Hope Music Ethiopia 3 years ago 6 minutes, 10 seconds 77,730 views",Hope Music Entertainment,77730,77979,249
1191,"Habtamu G/Tsadik - Tizita | ትዝታ - New Ethiopian Music 2019 (Official Audio) by Hope Music Ethiopia 3 years ago 4 minutes, 46 seconds 113,708 views",Hope Music Entertainment,113708,114074,366
1192,"Habtamu G/Tsadik - Yene Gela | የኔ ገላ - New Ethiopian Music 2019 (Official Audio) by Hope Music Ethiopia 3 years ago 5 minutes, 46 seconds 51,605 views",Hope Music Entertainment,51605,51756,151
1193,"Habtamu G/Tsadik - Aykedam | አይከዳም - New Ethiopian Music 2019 (Official Audio) by Hope Music Ethiopia 3 years ago 4 minutes, 6 seconds 48,222 views",Hope Music Entertainment,48222,48363,141
1194,"Habtamu G/Tsadik - Agew | አገው - New Ethiopian Music 2019 (Official Audio) by Hope Music Ethiopia 3 years ago 4 minutes, 5 seconds 22,319 views",Hope Music Entertainment,22319,22381,62
1195,"Habtamu G/Tsadik - Gojamewa | ጎጃሜዋ - New Ethiopian Music 2019 (Official Video) by Hope Music Ethiopia 3 years ago 6 minutes, 30 seconds 23,218 views",Hope Music Entertainment,23218,23252,34
1196,"Habtamu G/Tsadik - Dire | ድሬ - New Ethiopian Music 2019 (Official Audio) by Hope Music Ethiopia 3 years ago 4 minutes, 29 seconds 20,296 views",Hope Music Entertainment,20296,20320,24
1197,"Tsigereda Legesse - Selame | ሰላሜ - New Ethiopian Music 2019 (Official Video) by Hope Music Ethiopia 3 years ago 4 minutes, 55 seconds 98,499 views",Hope Music Entertainment,98499,98553,54
1198,"Stif Lion ft.  Zack - Kifu Atasib | ክፉ አታስብ - New Ethiopian Music 2019 (Official Video) by Hope Music Ethiopia 3 years ago 3 minutes, 58 seconds 31,398 views",Hope Music Entertainment,31398,31429,31
1199,"Yeneta Abebe - Yalante | ያላንተ - New Ethiopian Music 2019 (Official Video) by Hope Music Ethiopia 3 years ago 4 minutes, 13 seconds 75,660 views",Hope Music Entertainment,75660,75702,42
1200,"Destaw Teshager - Silebarekew New | ስለባረከው ነው - New Ethiopian Music 2019 (Official Video) by Hope Music Ethiopia 3 years ago 6 minutes, 35 seconds 427,925 views",Hope Music Entertainment,427925,428685,760
1201,"Jino - Ewedishalehu (Mupenzi) - New Ethiopian Music (Official Video) by Hope Music Ethiopia 3 years ago 4 minutes 51,560 views",Hope Music Entertainment,51560,51585,25
1202,"John Haftu - Shikorey 'ya | ሽኮረይ 'ያ - New Ethiopian Music 2019 (Official Video) by Hope Music Ethiopia 3 years ago 4 minutes, 36 seconds 337,387 views",Hope Music Entertainment,337387,338056,669
1203,"Yared Negu & Micky Gonderegna - Ethiopiye | ኢትዮጵዬ - New Ethiopian Music 2019 (Official Video) by Hope Music Ethiopia 3 years ago 3 minutes, 49 seconds 3,994,028 views",Hope Music Entertainment,3994028,4001080,7052
1204,"Wendesen Biru (Wendi Cash) - Wube Nat | ውብ ናት - New Ethiopian Music 2019 (Official Video) by Hope Music Ethiopia 3 years ago 4 minutes, 12 seconds 45,463 views",Hope Music Entertainment,45463,45471,8
1205,"Bini Goytom - Azmera | አዝመራ - New Ethiopian Music (Official Video) by Hope Music Ethiopia 3 years ago 5 minutes, 46 seconds 41,452 views",Hope Music Entertainment,41452,41465,13
1206,"Lion Sunday - Min Tamechalesh | ምን ታመጫለሽ - New Ethiopian Music 2019 (Official Video) by Hope Music Ethiopia 3 years ago 4 minutes, 50 seconds 28,086 views",Hope Music Entertainment,28086,28091,5
1207,"Hirphaa Gaanfuree - MEE BURRAAQII - New Ethiopian Music 2019 (Official Video) by Hope Music Ethiopia 3 years ago 7 minutes, 8 seconds 666,662 views",Hope Music Entertainment,666662,668109,1447
1208,"Armah Abila - Yametashal | ያመጣሻል - New Ethiopian Music 2019 (Official Video) by Hope Music Ethiopia 3 years ago 4 minutes 53,428 views",Hope Music Entertainment,53428,53432,4
1209,"King Teddy - Tewedaj | ተወዳጅ - New Ethiopian Music 2019 (Official Video) by Hope Music Ethiopia 3 years ago 3 minutes, 57 seconds 69,777 views",Hope Music Entertainment,69777,69828,51
1210,"Asmelash Tamirayehu - Adera | አደራ - New Ethiopian Music 2019 (Official Video) by Hope Music Ethiopia 3 years ago 5 minutes, 37 seconds 119,818 views",Hope Music Entertainment,119818,120369,551
1211,"T - Man - Shikor | ሽኮር - New Ethiopian Music 2019 (Official Video) by Hope Music Ethiopia 3 years ago 5 minutes, 12 seconds 68,462 views",Hope Music Entertainment,68462,68478,16
1212,"My Kiss ft. Gildo Kassa - Shimiyoomo - New Ethiopian Music 2019 (Official Video) by Hope Music Ethiopia 3 years ago 4 minutes, 19 seconds 44,774 views",Hope Music Entertainment,44774,44941,167
1213,"Abebaw Kesete - Lewoy Lewoye | ለወይ ለወዬ - New Ethiopian Music 2019 (Official Video) by Hope Music Ethiopia 3 years ago 6 minutes, 52 seconds 2,019,221 views",Hope Music Entertainment,2019221,2020471,1250
1214,"Minyibel Biweta - Awdamet | አውዳመት - New Ethiopian Music 2019 by Hope Music Ethiopia 3 years ago 6 minutes, 52 seconds 83,069 views",Hope Music Entertainment,83069,83099,30
1215,"Demere Legesse - Bilemo Hinbile - New Ethiopian Music 2019 by Hope Music Ethiopia 3 years ago 6 minutes, 43 seconds 127,466 views",Hope Music Entertainment,127466,128167,701
1216,"Tamene Kapite ft. Gildo Kassa - YELE YELE - New Ethiopian Music 2019 by Hope Music Ethiopia 3 years ago 3 minutes, 59 seconds 63,197 views",Hope Music Entertainment,63197,63479,282
1217,"Genet Bekele - Abiy Hasab | አብይ ሃሳብ - New Ethiopian Music 2019 by Hope Music Ethiopia 3 years ago 4 minutes, 48 seconds 53,677 views",Hope Music Entertainment,53677,53697,20
1218,"Temesgen Kassa - Yasasibal | ያሳስባል - New Ethiopian Music 2019 by Hope Music Ethiopia 3 years ago 4 minutes, 13 seconds 33,285 views",Hope Music Entertainment,33285,33308,23
1219,"Lense Lemessa - JAALALAA - New Ethiopian Music 2019 by Hope Music Ethiopia 3 years ago 4 minutes, 35 seconds 58,663 views",Hope Music Entertainment,58663,58689,26
1220,"Dagi D - Sherosa - New Ethiopian Music 2019 by Hope Music Ethiopia 3 years ago 4 minutes, 10 seconds 2,831,060 views",Hope Music Entertainment,2831060,2844864,13804
1221,"EZZY ESAYAS - NAY BEYNEY | ናይበይነይ - New Ethiopian Music 2019 by Hope Music Ethiopia 3 years ago 3 minutes, 57 seconds 80,132 views",Hope Music Entertainment,80132,80343,211
1222,"Kaleab Abraham - Hyabey | ህያበይ - New Ethiopian Music 2019 by Hope Music Ethiopia 3 years ago 4 minutes, 13 seconds 34,518 views",Hope Music Entertainment,34518,34533,15
1223,"Eshetu Mersha - Biringoye | ቢሪንጎዬ - New Ethiopian Music 2019 by Hope Music Ethiopia 3 years ago 6 minutes, 17 seconds 183,088 views",Hope Music Entertainment,183088,183605,517
1224,"Bahta Kiros - Wuqbtey | ዉቅብተይ - New Eritrean Music 2019 by Hope Music Ethiopia 3 years ago 4 minutes, 55 seconds 71,250 views",Hope Music Entertainment,71250,71302,52
1225,"Tade Gidyelew - Benega Beteba | በነጋ በጠባ - New Ethiopian Music 2019 by Hope Music Ethiopia 3 years ago 4 minutes, 58 seconds 70,608 views",Hope Music Entertainment,70608,70632,24
1226,"Yohannes Gebregziabher - Yetsion | የፅዮን  - New Ethiopian Music 2019 (Official Video) by Hope Music Ethiopia 3 years ago 6 minutes, 35 seconds 77,562 views",Hope Music Entertainment,77562,77620,58
1227,"Mule Tattoo - Yinafikegnal | ይናፍቀኛል - New Ethiopian Music 2019 (Official Video) by Hope Music Ethiopia 3 years ago 4 minutes, 38 seconds 33,547 views",Hope Music Entertainment,33547,33579,32
1228,"Wengelawit Fiseha - Techiralech | ተችራለች - New Ethiopian Music 2019 by Hope Music Ethiopia 3 years ago 4 minutes, 28 seconds 43,217 views",Hope Music Entertainment,43217,43220,3
1229,"Bemnet Eri - Mixed Emotions - New Eritrean Music 2019 by Hope Music Ethiopia 3 years ago 3 minutes, 35 seconds 84,104 views",Hope Music Entertainment,84104,84180,76
1230,"Mekdes Hailu - Zarem Kereh | ዛሬም ቀረህ - New Ethiopian Music 2019 by Hope Music Ethiopia 3 years ago 4 minutes, 36 seconds 1,304,386 views",Hope Music Entertainment,1304386,1318469,14083
1231,"Rediet Tolosa - Biya | ቢያ - New Ethiopian Music 2019 by Hope Music Ethiopia 3 years ago 4 minutes, 50 seconds 54,272 views",Hope Music Entertainment,54272,54280,8
1232,"Solomon Habte - Dehna Nesh Wey | ደህና ነሽ ወይ - New Ethiopian Music 2019 by Hope Music Ethiopia 3 years ago 5 minutes, 15 seconds 80,133 views",Hope Music Entertainment,80133,80198,65
1233,"Assefa Teshale - Kora Kora | ኮራ ኮራ - New Ethiopian Music 2019 by Hope Music Ethiopia 3 years ago 4 minutes, 21 seconds 38,926 views",Hope Music Entertainment,38926,38949,23
1234,"Berhanu Teka - Erebeshkush Ende | እረበሽኩሽ እንዴ?  - New Ethiopian Music 2019 by Hope Music Ethiopia 3 years ago 5 minutes, 40 seconds 190,450 views",Hope Music Entertainment,190450,191126,676
1235,"Shimeles Debash - Kegne Tirsagn | ቀኘ ትርሳኝ - New Ethiopian Music 2019 by Hope Music Ethiopia 3 years ago 5 minutes, 24 seconds 44,472 views",Hope Music Entertainment,44472,44489,17
1236,"Mahi ft. Sami Dan - Tenes Libe | ተነስ ልቤ - New Ethiopian Music 2019 by Hope Music Ethiopia 3 years ago 3 minutes, 38 seconds 302,843 views",Hope Music Entertainment,302843,303784,941
1237,"Guanche Berhe - Gual Baba | ጓል ባባ - New Ethiopian Music 2019 by Hope Music Ethiopia 3 years ago 5 minutes, 5 seconds 40,210 views",Hope Music Entertainment,40210,40215,5
1238,"Sol Romeyo & Yared Negu - Destaye | ደስታዬ  - New Ethiopian Music 2019 by Hope Music Ethiopia 3 years ago 3 minutes, 54 seconds 1,919,315 views",Hope Music Entertainment,1919315,1923030,3715
1239,"Asrebeb Tadege - Kerebign | ቀረብኝ - New Ethiopian Music 2019 by Hope Music Ethiopia 3 years ago 5 minutes, 54 seconds 50,047 views",Hope Music Entertainment,50047,50057,10
1240,"Habtu Ashagre - Awdamet | አውዳመት - New Ethiopian Music 2019 by Hope Music Ethiopia 3 years ago 5 minutes, 32 seconds 144,943 views",Hope Music Entertainment,144943,145009,66
1241,"Cha Cha Sami - Kijiw | ቅጅው - New Ethiopian Music 2019 by Hope Music Ethiopia 3 years ago 4 minutes, 31 seconds 1,939,236 views",Hope Music Entertainment,1939236,1941630,2394
1242,"Rodas Tamiru ft. Miky Yo - Siakebtegn | ሲያቀብጠኝ - New Ethiopian Music 2019 by Hope Music Ethiopia 3 years ago 3 minutes, 50 seconds 340,516 views",Hope Music Entertainment,340516,340541,25
1243,"Esubalew Yetayew - Zefen Mamokiya Aydelem | ዘፈን ማሞቂያ አይደለም - New Ethiopian Music 2019 by Hope Music Ethiopia 3 years ago 4 minutes, 59 seconds 2,001,371 views",Hope Music Entertainment,2001371,2009870,8499
1244,"Mikiyas Nigussie (Miki Lala) - Man Serkosh Yiwedal | ማን ሰርቆሽ ይወዳል - New Ethiopian Music 2019 by Hope Music Ethiopia 3 years ago 4 minutes, 59 seconds 318,393 views",Hope Music Entertainment,318393,319042,649
1245,"Zinash Tsegaye - Tiragn Adama | ጥራኝ አዳማ - New Ethiopian Music 2019 (Official Video) by Hope Music Ethiopia 3 years ago 5 minutes, 49 seconds 51,311 views",Hope Music Entertainment,51311,51356,45
1246,"Girmaw Admasu - And Lenatu | አንድ ለናቱ - New Ethiopian Music 2019 (Official Video) by Hope Music Ethiopia 3 years ago 6 minutes, 29 seconds 75,874 views",Hope Music Entertainment,75874,75899,25
1247,"Lidya Mekuanent - Bawkewum | ውቀውም - New Ethiopian Music 2019 (Official Video) by Hope Music Ethiopia 3 years ago 3 minutes, 39 seconds 80,792 views",Hope Music Entertainment,80792,80796,4
1248,"Mulusew Addis - Endemaru | እንደማሩ - New Ethiopian Music 2019 (Official Video) by Hope Music Ethiopia 3 years ago 6 minutes, 40 seconds 338,995 views",Hope Music Entertainment,338995,339905,910
1249,"LTD BULBUL ft. GILDO KASSA - ZEMMA NEW - New Ethiopian Music 2019 (Official Video) by Hope Music Ethiopia 3 years ago 4 minutes, 36 seconds 292,475 views",Hope Music Entertainment,292475,294020,1545
1250,"Leencoo Gammachuu - Muquxxaayee - New Ethiopian Music 2018 (Official Video) by Hope Music Ethiopia 3 years ago 7 minutes, 22 seconds 1,930,905 views",Hope Music Entertainment,1930905,1958481,27576
1251,"Tamrat kahsay - Asey | ኣሰይ (ናፍቆቴን በዜማ) - New Ethiopian Music 2018 (Official Video) by Hope Music Ethiopia 3 years ago 3 minutes, 47 seconds 70,887 views",Hope Music Entertainment,70887,70914,27
1252,"Getale Alemayehu - Ategeremim | አትገረምም - New Ethiopian Music 2018 (Official Video) by Hope Music Ethiopia 3 years ago 6 minutes, 19 seconds 1,079,331 views",Hope Music Entertainment,1079331,1081100,1769
1253,"Temesgen Gebregziabher (Temu) - Zemaye | ዜማዬ - New Ethiopian Music 2018 (Official Video) by Hope Music Ethiopia 3 years ago 5 minutes, 3 seconds 1,246,981 views",Hope Music Entertainment,1246981,1250011,3030
1254,"Andy Amare - Bontu | ቦንቱ - New Ethiopian Music 2018 (Official Video) by Hope Music Ethiopia 3 years ago 5 minutes, 3 seconds 79,578 views",Hope Music Entertainment,79578,79596,18
1255,"Alu Danceru ft. Mr. Wina & Sewi - Neka Neka | ነቃ ነቃ - New Ethiopian Music 2018 (Official Video) by Hope Music Ethiopia 3 years ago 4 minutes, 50 seconds 38,476 views",Hope Music Entertainment,38476,38508,32
1256,"Weyni Hailemariam - Dimtsi Fikri | ድምፂ ፍቅሪ - New Ethiopian Music 2018 (Official Video) by Hope Music Ethiopia 3 years ago 3 minutes, 55 seconds 58,623 views",Hope Music Entertainment,58623,58649,26
1257,"Betelhem Darsema - Befikir Teddy ፩ | በፍቅር ቴዲ ፩ - New Ethiopian Music 2018 (Official Video) by Hope Music Ethiopia 3 years ago 6 minutes, 3 seconds 206,266 views",Hope Music Entertainment,206266,206278,12
1258,"Mulatu Lema - Degusew | ደጉ ሰው - New Ethiopian Music 2018 (Official Video) by Hope Music Ethiopia 3 years ago 5 minutes, 30 seconds 39,176 views",Hope Music Entertainment,39176,39182,6
1259,"D Abe - Erere | ኧረረረ... - New Ethiopian Music 2018 (Official Video) by Hope Music Ethiopia 3 years ago 5 minutes, 51 seconds 194,242 views",Hope Music Entertainment,194242,194360,118
1260,"H - ዮጵ - Bekonjo Lij  - New Ethiopian Music 2018 (Official Video) by Hope Music Ethiopia 3 years ago 5 minutes, 55 seconds 57,522 views",Hope Music Entertainment,57522,57723,201
1261,"Selamawit Yohannes - Hambel | ሃምበል - New Ethiopian Music 2019 (Official Video) by Hope Music Ethiopia 3 years ago 5 minutes, 3 seconds 19,395,146 views",Hope Music Entertainment,19395146,19455947,60801
1262,"Fetilework Tesfaye - Yene Fikir | የኔ ፍቅር - New Ethiopian Music 2018 (Official Video) by Hope Music Ethiopia 3 years ago 4 minutes, 55 seconds 63,132 views",Hope Music Entertainment,63132,63206,74
1263,"Jino ft. Cream - Tora Bora | ጨጓራዬ - New Ethiopian Music 2018 (Official Video) by Hope Music Ethiopia 3 years ago 4 minutes, 28 seconds 133,417 views",Hope Music Entertainment,133417,133755,338
1264,"Moflix X Dave - Shiftaw Libua | ሽፍታው ልቧ - New Ethiopian Music 2018 (Official Video) by Hope Music Ethiopia 3 years ago 4 minutes, 16 seconds 38,414 views",Hope Music Entertainment,38414,38429,15
1265,"Maritu Tamalew - Hageren Atinku | ሃገሬን አትንኩ - New Ethiopian Music 2018 (Official Video) by Hope Music Ethiopia 3 years ago 6 minutes, 47 seconds 1,384,799 views",Hope Music Entertainment,1384799,1387933,3134
1266,"Zantana - Aderech Arada | አደረች አራዳ - New Ethiopian Music 2018 (Official Video) by Hope Music Ethiopia 3 years ago 5 minutes, 10 seconds 23,911 views",Hope Music Entertainment,23911,23929,18
1267,"Loza Wendimhun - Zim | ዝም - New Ethiopian Music 2018 (Official Video) by Hope Music Ethiopia 3 years ago 5 minutes, 12 seconds 108,545 views",Hope Music Entertainment,108545,108592,47
1268,"Yenenesh Belete - Mashallah New | ማሻላ ነው - New Ethiopian Music 2018 (Official Video) by Hope Music Ethiopia 3 years ago 6 minutes, 36 seconds 91,802 views",Hope Music Entertainment,91802,91864,62
1269,"Mesfin Hailemariam - Wogane | ዎጋኔ - New Ethiopian Music 2018 (Official Video) by Hope Music Ethiopia 3 years ago 5 minutes, 6 seconds 50,037 views",Hope Music Entertainment,50037,50485,448
1270,"Yeheyes Ayele - Salay Bay | ሳላይ ባይ  - New Ethiopian Music 2018 (Official Video) by Hope Music Ethiopia 3 years ago 3 minutes, 38 seconds 69,442 views",Hope Music Entertainment,69442,69471,29
1271,"Rahel Gemechu - Belay lay | በላይ ላይ - New Ethiopian Music 2018 (Official Video) by Hope Music Ethiopia 3 years ago 3 minutes, 41 seconds 27,583 views",Hope Music Entertainment,27583,27611,28
1272,"Heny One - Roman | ሮማን - New Ethiopian Music 2018 (Official Video) by Hope Music Ethiopia 3 years ago 4 minutes, 25 seconds 44,685 views",Hope Music Entertainment,44685,44710,25
1273,"Maki Kb ft. Didi Gaga - America | አሜሪካ - New Ethiopian Music 2018 (Official Video) by Hope Music Ethiopia 3 years ago 4 minutes, 33 seconds 593,841 views",Hope Music Entertainment,593841,597659,3818
1274,"Woldemariam Getahun - Dumba | ዱምባ - New Ethiopian Music 2018 (Official Video) by Hope Music Ethiopia 3 years ago 4 minutes, 55 seconds 25,053 views",Hope Music Entertainment,25053,25098,45
1275,"Asegid Eshetu - Nafkeshgnal | ናፍቀሽኛል - New Ethiopian Music 2018 (Official Video) by Hope Music Ethiopia 3 years ago 5 minutes, 15 seconds 858,593 views",Hope Music Entertainment,858593,860826,2233
1276,"Semahegn Eshetu (Sam) - Yaz Yaz | ያዝ ያዝ - New Ethiopian Music 2018 (Official Video) by Hope Music Ethiopia 3 years ago 5 minutes, 25 seconds 26,476 views",Hope Music Entertainment,26476,26492,16
1277,"Alemayehu Edmealem - Liben Manaye | ልቤን ማንአየ - New Ethiopian Music 2018 (Official Video) by Hope Music Ethiopia 3 years ago 3 minutes, 42 seconds 63,341 views",Hope Music Entertainment,63341,63383,42
1278,"Tekalign Abebe - Keremekuata | ከረመኳታ - New Ethiopia Music 2018 (Official Video) by Hope Music Ethiopia 3 years ago 6 minutes, 15 seconds 54,091 views",Hope Music Entertainment,54091,54136,45
1279,"EEKAA - Kuul Surre - New Ethiopian Music 2018 (Official Video) by Hope Music Ethiopia 3 years ago 3 minutes, 54 seconds 107,960 views",Hope Music Entertainment,107960,108210,250
1280,"Yohannes Werku - Arenguade Meret | አረንጓዴ መሬት - New Ethiopian Music 2018 (Official Video) by Hope Music Ethiopia 3 years ago 5 minutes 28,187 views",Hope Music Entertainment,28187,28196,9
1281,"Menbere T/Silassie - Liy Wey Lela | ልይ ወይ ሌላ - New Ethiopian Music 2018 (Official Video) by Hope Music Ethiopia 3 years ago 5 minutes, 22 seconds 19,843 views",Hope Music Entertainment,19843,19848,5
1282,"Betelhem Abebe - Hule Na | ሁሌ ና - New Ethiopian Music 2018 (Official Video) by Hope Music Ethiopia 3 years ago 5 minutes, 6 seconds 28,312 views",Hope Music Entertainment,28312,28326,14
1283,"Ras Jany - Hule Hule (Alle Boom) ft. Jerusalem (JJ) - New Ethiopian Music 2018 (Official Video) by Hope Music Ethiopia 3 years ago 4 minutes, 41 seconds 362,665 views",Hope Music Entertainment,362665,363782,1117
1284,"Ambachew Berhan - Endalatash | እንዳላጣሽ - New Ethiopian Music 2018 (Official Video) by Hope Music Ethiopia 3 years ago 4 minutes, 40 seconds 132,714 views",Hope Music Entertainment,132714,133220,506
1285,"Zemas - Dr Abiy Ahmed | ዶ/ር አብይ አህመድ - New Ethiopian Music 2018 (Official Video) by Hope Music Ethiopia 3 years ago 4 minutes, 1 second 76,465 views",Hope Music Entertainment,76465,76609,144
1286,"Yitbarek Abebe T - Esuaga | እሷጋ - New Ethiopian Music 2018 (Official Video) by Hope Music Ethiopia 3 years ago 4 minutes, 30 seconds 239,022 views",Hope Music Entertainment,239022,240854,1832
1287,"Eske - Metaw | መጣው - New Ethiopian Music 2018 (Official Video) by Hope Music Ethiopia 3 years ago 5 minutes, 4 seconds 69,983 views",Hope Music Entertainment,69983,70006,23
1288,"Znar Zema - Tewbeshal | ተውበሻል  - New Ethiopian Music 2018 (Official Video) by Hope Music Ethiopia 3 years ago 5 minutes, 17 seconds 470,095 views",Hope Music Entertainment,470095,471658,1563
1289,"Eyerus Anteneh - Aye Sew | አይ ሰው - New Ethiopian Music 2018 (Official Video) by Hope Music Ethiopia 3 years ago 4 minutes, 6 seconds 91,727 views",Hope Music Entertainment,91727,91772,45
1290,"Gawlaro Menda - Ayaya | አያያ - New Ethiopian Music 2018 (Official Video) by Hope Music Ethiopia 3 years ago 3 minutes, 49 seconds 40,547 views",Hope Music Entertainment,40547,41471,924
1291,"Ashenafi Zeberga - Tegem | ቴገም - New Ethiopian Music 2018 (Official Video) by Hope Music Ethiopia 3 years ago 4 minutes, 27 seconds 124,731 views",Hope Music Entertainment,124731,124929,198
1292,"Tesfaye Kebede - Hilm Mesay | ህልም መሳይ - New Ethiopian Music 2018 (Official Video) by Hope Music Ethiopia 3 years ago 5 minutes, 57 seconds 36,564 views",Hope Music Entertainment,36564,36575,11
1293,"Abraham Ante - Demo Ho - New Ethiopian Music 2018 (Official Video) by Hope Music Ethiopia 3 years ago 3 minutes, 53 seconds 72,685 views",Hope Music Entertainment,72685,72748,63
1294,"Alemtsehay Asrat - Awey Awey Yesu Gela | አዎይ አዎይ የሱ ገላ - New Ethiopian Music 2018 (Official Video) by Hope Music Ethiopia 3 years ago 4 minutes, 38 seconds 57,214 views",Hope Music Entertainment,57214,57224,10
1295,"Wende Tone - Duma | ዱማ - New Ethiopian Music 2018 (Official Video) by Hope Music Ethiopia 3 years ago 5 minutes, 21 seconds 70,352 views",Hope Music Entertainment,70352,70366,14
1296,"Israel Kidanu - Letena Yarglign | ለጤና ያርግልኝ - New Ethiopian Music 2018 (Official Video) by Hope Music Ethiopia 3 years ago 4 minutes, 22 seconds 58,484 views",Hope Music Entertainment,58484,58794,310
1297,"Mahder Getahun - Tim | ትም - New Ethiopian Music 2018 (Official Video) by Hope Music Ethiopia 3 years ago 5 minutes, 7 seconds 99,115 views",Hope Music Entertainment,99115,99187,72
1298,"Merewa Choir - Tsigereda | ፅጌሬዳ - New Ethiopian Music 2018 (Official Video) by Hope Music Ethiopia 3 years ago 5 minutes, 59 seconds 492,920 views",Hope Music Entertainment,492920,494838,1918
1299,"Sara Desta | ሳራ ደስታ - Gize Alewo Ayni | ግዜ ኣለዎ ዓይኒ - Tigrigna Music 2018 (Official Video) by Hope Music Ethiopia 3 years ago 4 minutes, 53 seconds 35,572 views",Hope Music Entertainment,35572,35585,13
1300,"Mulugeta Alemu - Yebechaye | የብቻዬ - New Ethiopian Music 2018 (Official Video) by Hope Music Ethiopia 3 years ago 4 minutes, 59 seconds 184,916 views",Hope Music Entertainment,184916,185144,228
1301,"Wendimu Jira - Keras Gar | ከራስ ጋር - New Ethiopian Music 2018 (Official Video) by Hope Music Ethiopia 3 years ago 5 minutes, 21 seconds 423,531 views",Hope Music Entertainment,423531,425360,1829
1302,"Dagim Adane - Entarek | እንታረቅ - New Ethiopian Music 2018 (Official Video) by Hope Music Ethiopia 3 years ago 4 minutes, 14 seconds 109,570 views",Hope Music Entertainment,109570,109869,299
1303,"Christina Melkamu - Honelgn | ሆነልኝ - New Ethiopian Music 2018 (Official Video) by Hope Music Ethiopia 3 years ago 6 minutes, 2 seconds 377,463 views",Hope Music Entertainment,377463,377771,308
1304,"Sami Beyene - Hello Asmera | ሄሎ ኣስመራ - New Ethiopian Music 2018 (Official Video) by Hope Music Ethiopia 3 years ago 5 minutes, 1 second 261,322 views",Hope Music Entertainment,261322,261432,110
1305,"Debe Alemseged - Anchin | አንቺን - New Ethiopian Music 2018 (Official Video) by Hope Music Ethiopia 3 years ago 4 minutes, 55 seconds 3,835,018 views",Hope Music Entertainment,3835018,3859575,24557
1306,"Eden Gebreselassie - Aytneknkni | ኣይትነቅንቅኒ - New Ethiopian Music 2018 (Official Video) by Hope Music Ethiopia 3 years ago 4 minutes, 53 seconds 4,480,070 views",Hope Music Entertainment,4480070,4506752,26682
1307,"Aschalew Fetene - Belay Zeleke | በላይ ዘለቀ - New Ethiopian Music 2018 (Official Video) by Hope Music Ethiopia 3 years ago 6 minutes, 26 seconds 700,056 views",Hope Music Entertainment,700056,702298,2242
1308,"Fitsum Merzo - Yene Enbuchuchu | የኔ እንቡቹቹ - New Ethiopian Music 2018 (Official Video) by Hope Music Ethiopia 3 years ago 5 minutes, 13 seconds 407,077 views",Hope Music Entertainment,407077,407267,190
1309,"Aweke Nure - Hagere | ሃገሬ - New Ethiopian Music 2018 (Official Video) by Hope Music Ethiopia 3 years ago 6 minutes, 41 seconds 317,654 views",Hope Music Entertainment,317654,317830,176
1310,"Kefale molla - Derbaba | ደርባባ - New Ethiopian Music 2018 (Official Video) by Hope Music Ethiopia 3 years ago 5 minutes, 52 seconds 114,815 views",Hope Music Entertainment,114815,114925,110
1311,"Kalkidan Hulunayehu (Maya Kal) - Yiker | ይቅር - New Ethiopian Music 2018 (Official Video) by Hope Music Ethiopia 3 years ago 4 minutes, 14 seconds 57,686 views",Hope Music Entertainment,57686,57739,53
1312,"Luci - Sanesasah | ሳነሳሳህ - New Ethiopian Music 2018 (Official Video) by Hope Music Ethiopia 3 years ago 4 minutes, 41 seconds 198,653 views",Hope Music Entertainment,198653,198719,66
1313,"Zadam Keke ft. J. Holiday - Honey - New Ethiopian Music 2018 (Official Video) by Hope Music Ethiopia 3 years ago 3 minutes, 47 seconds 105,252 views",Hope Music Entertainment,105252,105337,85
1314,"Tsedi - Lishenef | ልሸነፍ - New Ethiopian Music 2018 (Official Video) by Hope Music Ethiopia 3 years ago 4 minutes, 56 seconds 778,088 views",Hope Music Entertainment,778088,780974,2886
1315,"Addis Mulat - Hageren 2 - New Ethiopian Music 2018 (Official Video) by Hope Music Ethiopia 3 years ago 7 minutes, 4 seconds 1,981,707 views",Hope Music Entertainment,1981707,1984323,2616
1316,"Markon - Helina | ህሊና - New Ethiopian Music 2018 (Official Video) by Hope Music Ethiopia 3 years ago 3 minutes, 55 seconds 155,626 views",Hope Music Entertainment,155626,156231,605
1317,"Menibel Biweta - Kal Ateregn | ቃል አጠረኝ - New Ethiopian Music 2018 (Official Video) by Hope Music Ethiopia 3 years ago 5 minutes, 35 seconds 72,292 views",Hope Music Entertainment,72292,72327,35
1318,"Ameha Sinku - Endezihem Ale Wey  | እንደዚህም አለ ወይ- New Ethiopian Music 2018 (Official Video) by Hope Music Ethiopia 3 years ago 4 minutes, 51 seconds 1,695,972 views",Hope Music Entertainment,1695972,1697078,1106
1319,"Kibur Weldegiorgis - Jemeregn | ጀመረኝ - New Ethiopian Music 2018 (Official Video) by Hope Music Ethiopia 3 years ago 6 minutes, 10 seconds 77,592 views",Hope Music Entertainment,77592,77724,132
1320,"Keren Melesse - Sinamir | ስናምር - New Ethiopian Music 2018 (Official Video) by Hope Music Ethiopia 3 years ago 4 minutes, 21 seconds 78,206 views",Hope Music Entertainment,78206,78241,35
1321,"Tefera Werku - Neylegn | ነይልኝ - New Ethiopian Music 2018 (Official Video) by Hope Music Ethiopia 3 years ago 4 minutes, 1 second 78,383 views",Hope Music Entertainment,78383,78411,28
1322,"Tesfalidet Tadesse - Hanway | ሃንዋይ - New Ethiopian Music 2018 (Official Video) by Hope Music Ethiopia 3 years ago 4 minutes, 28 seconds 56,426 views",Hope Music Entertainment,56426,56428,2
1323,"Sintayehu Fantu - Tekes | ጠቀስ - New Ethiopian Music 2018 (Official Video) by Hope Music Ethiopia 3 years ago 6 minutes, 31 seconds 80,568 views",Hope Music Entertainment,80568,80597,29
1324,"Samrawit Belete - Alwedem | አልወድም - New Ethiopian Music 2018 (Official Video) by Hope Music Ethiopia 3 years ago 5 minutes, 3 seconds 131,698 views",Hope Music Entertainment,131698,131734,36
1325,"Mule Rootz - Enwerared | እንወራረድ - New Ethiopian Music 2018 (Official Video) by Hope Music Ethiopia 3 years ago 6 minutes, 21 seconds 743,012 views",Hope Music Entertainment,743012,744289,1277
1326,"Neima Ahmed - Eketelewalehu | እከተለዋለሁ - New Ethiopian Music 2018 (Official Video) by Hope Music Ethiopia 3 years ago 5 minutes, 27 seconds 437,789 views",Hope Music Entertainment,437789,438044,255
1327,"Kaleab Getaneh - Bye Bye | ባይ ባይ - New Ethiopian Music 2018 (Official Video) by Hope Music Ethiopia 3 years ago 4 minutes, 3 seconds 56,416 views",Hope Music Entertainment,56416,56480,64
1328,"Abebe Alemu - Lije | ልጄ - New Ethiopian Music 2018 (Official Video) by Hope Music Ethiopia 3 years ago 5 minutes, 36 seconds 56,708 views",Hope Music Entertainment,56708,56794,86
1329,"Yoosaan Geetahun - keenya Yeroon - New Ethiopian Music 2018 (Official Video) by Hope Music Ethiopia 3 years ago 6 minutes, 29 seconds 3,667,515 views",Hope Music Entertainment,3667515,3703661,36146
1330,"Abenet Teshome - Ya Gize | ያ ጊዜ - New Ethiopian Music 2018 (Official Video) by Hope Music Ethiopia 3 years ago 5 minutes, 6 seconds 112,040 views",Hope Music Entertainment,112040,112107,67
1331,"Heran Gediyon - Bye Bye | ባይ ባይ - New Ethiopian Music 2018 (Official Video) by Hope Music Ethiopia 3 years ago 4 minutes, 56 seconds 14,706,937 views",Hope Music Entertainment,14706937,14813107,106170
1332,"Amarech Alemu - Ere Gedam | ኧረ ገዳም - New Ethiopian Music 2018 (Official Video) by Hope Music Ethiopia 3 years ago 6 minutes, 9 seconds 154,661 views",Hope Music Entertainment,154661,154793,132
1333,"Mesay Geremew - Fikir Terarko | ፍቅር ተራርቆ - New Ethiopian Music 2018 (Official Video) by Hope Music Ethiopia 3 years ago 5 minutes, 42 seconds 121,710 views",Hope Music Entertainment,121710,121737,27
1334,"Etsegenet Hailemariam - MALALES - New Ethiopian Music 2018 (Official Video) by Hope Music Ethiopia 3 years ago 4 minutes, 34 seconds 715,730 views",Hope Music Entertainment,715730,717489,1759
1335,"Michael Seleshi - Hamus | ሀሙስ - New Ethiopian Music 2018 (Official Video) by Hope Music Ethiopia 3 years ago 6 minutes, 17 seconds 59,405 views",Hope Music Entertainment,59405,59441,36
1336,"Fikadu Tizazu - Abro Adege | አብሮ አደጌ - New Ethiopian Music 2018 (Official Video) by Hope Music Ethiopia 3 years ago 6 minutes, 39 seconds 2,077,107 views",Hope Music Entertainment,2077107,2102875,25768
1337,"Yalew Anley - Gud New | ወይ ጉድ - New Ethiopian Music 2018 (Official Video) by Hope Music Ethiopia 3 years ago 3 minutes, 42 seconds 64,048 views",Hope Music Entertainment,64048,64060,12
1338,"Habte Abraham - Yawkbetal | ያውቅበታል - New Ethiopian Music 2018 (Official Vido) by Hope Music Ethiopia 3 years ago 5 minutes, 39 seconds 224,981 views",Hope Music Entertainment,224981,225128,147
1339,"Sam G - Metechalehu | መጥቻለሁ - New Ethiopian Music 2018 (Official Video) by Hope Music Ethiopia 3 years ago 3 minutes, 33 seconds 25,133 views",Hope Music Entertainment,25133,25149,16
1340,"Endish Endish - Hareriya | ሀረሪያ - New Ethiopian Music 2018 (Official Video) by Hope Music Ethiopia 3 years ago 4 minutes, 48 seconds 109,942 views",Hope Music Entertainment,109942,110117,175
1341,"Tesfamariam Gebremeskel - Enqua Des Belekum | እንቋዕ ደስ በለኩም - New Ethiopian Music 2018 by Hope Music Ethiopia 3 years ago 6 minutes, 28 seconds 28,753 views",Hope Music Entertainment,28753,28761,8
1342,"Tade Philo - Tsegereda | ፅጌረዳ - New Ethiopian Music 2018 (Official Video) by Hope Music Ethiopia 3 years ago 4 minutes, 22 seconds 100,122 views",Hope Music Entertainment,100122,100198,76
1343,"Mihret Teshome - Guluma | ጉሉማ - New Ethiopian Music 2018 (Official Video) by Hope Music Ethiopia 3 years ago 3 minutes, 39 seconds 121,743 views",Hope Music Entertainment,121743,121777,34
1344,"Habtamu Alemayehu - Chilo Yenore | ችሎ የኖረ - New Ethiopian Music 2018 (Official Video) by Hope Music Ethiopia 3 years ago 5 minutes, 32 seconds 215,484 views",Hope Music Entertainment,215484,215653,169
1345,"Guade Shegaw - Demo | ደሞ - New Ethiopian Music 2018 (Official Video) by Hope Music Ethiopia 3 years ago 6 minutes, 57 seconds 160,342 views",Hope Music Entertainment,160342,160482,140
1346,"Farhaan sulee (baddeeysaa) & ashiitaa nuuree - Karra teeysan dura - New Ethiopian Music 2018 by Hope Music Ethiopia 3 years ago 5 minutes, 14 seconds 8,728,264 views",Hope Music Entertainment,8728264,8820642,92378
1347,"Tamiru Tesfaye - Yemir | የምር - New Ethiopian Music 2018 (Official Video) by Hope Music Ethiopia 3 years ago 4 minutes, 26 seconds 49,046 views",Hope Music Entertainment,49046,49059,13
1348,"Beki Habesha - Asmera Tsaeda | አሰመራ ፃእዳ - New Eritrean Music 2018 (Official Video) by Hope Music Ethiopia 3 years ago 3 minutes, 29 seconds 62,856 views",Hope Music Entertainment,62856,62912,56
1349,"Hiwot Shiko - Jegnaye | ጀግናዬ - New Ethiopian Music 2018 (Official Video) by Hope Music Ethiopia 3 years ago 4 minutes, 7 seconds 47,904 views",Hope Music Entertainment,47904,47915,11
1350,"Adnew Bekele - Shir | ሽር - New Ethiopian Music 2018 (Official Video) by Hope Music Ethiopia 3 years ago 5 minutes, 6 seconds 47,444 views",Hope Music Entertainment,47444,47453,9
1351,"Bini Goytom - Yeteleyesh | የተለየሽ - New Ethiopian Music 2018 (Official Video) by Hope Music Ethiopia 3 years ago 4 minutes, 48 seconds 32,992 views",Hope Music Entertainment,32992,33002,10
1352,"Tadesse Eyayu - Jano | ጃኖ - New Ethiopian Music 2018 (Official Video) by Hope Music Ethiopia 3 years ago 6 minutes, 44 seconds 164,468 views",Hope Music Entertainment,164468,164669,201
1353,"Nahom Mekuria - ONA | ኦና- New Ethiopian Music 2018 (Official Video) by Hope Music Ethiopia 3 years ago 4 minutes, 17 seconds 37,184 views",Hope Music Entertainment,37184,37318,134
1354,"Deme Lula - Adey Loga | አደይ ሎጋ - New Ethiopian Music 2018 (Official Video) by Hope Music Ethiopia 3 years ago 5 minutes, 39 seconds 98,711 views",Hope Music Entertainment,98711,98802,91
1355,"Sityana Teni - Agul Abay | አጉል አባይ - New Ethiopian Music 2018 (Official Video) by Hope Music Ethiopia 3 years ago 4 minutes, 2 seconds 146,817 views",Hope Music Entertainment,146817,146955,138
1356,"Mahlet Gebregiorgis & Ehsan Abduselam - Betizita | በትዝታ - New Ethiopian Music 2018 (Official Video) by Hope Music Ethiopia 3 years ago 5 minutes, 18 seconds 309,626 views",Hope Music Entertainment,309626,310070,444
1357,"G Mesay Kebede - Bleney | ብሌነይ - New Ethiopian Music 2018 (Official Video) by Hope Music Ethiopia 3 years ago 4 minutes, 39 seconds 645,738 views",Hope Music Entertainment,645738,646609,871
1358,"Tewodros Kassahun - Tamrialesh | ታምሪያለሽ - New Ethiopian Music 2018 (Official Video) by Hope Music Ethiopia 3 years ago 6 minutes, 31 seconds 85,238 views",Hope Music Entertainment,85238,85289,51
1359,"Haymanot Aweke - Mesay | መሳይ - New Ethiopian Music 2018 (Official Video) by Hope Music Ethiopia 3 years ago 4 minutes, 59 seconds 181,368 views",Hope Music Entertainment,181368,181666,298
1360,"Haimanot Adam - Linger | ልንገር - New Ethiopian Music 2018 (Official Video) by Hope Music Ethiopia 3 years ago 4 minutes, 23 seconds 84,893 views",Hope Music Entertainment,84893,84995,102
1361,"Desalegn Berhanu - Embi Gelele | እምቢ ገለሌ - New Ethiopian Music 2018 (Official Video) by Hope Music Ethiopia 3 years ago 4 minutes, 58 seconds 60,426 views",Hope Music Entertainment,60426,60475,49
1362,"Gedena Aynekulu - Dawnasake | ዳውናሳኬ - New Ethiopian Music 2018 (Official Video) by Hope Music Ethiopia 3 years ago 4 minutes, 41 seconds 35,987 views",Hope Music Entertainment,35987,36029,42
1363,"Teddy Yo ft. Lij Eyasu - Alehu Belegn | አለሁ በለኝ - New Ethiopian Music 2018 (Official Video) by Hope Music Ethiopia 3 years ago 3 minutes, 46 seconds 121,739 views",Hope Music Entertainment,121739,122089,350
1364,"Nuradis Seid - Ataleshignal | አታለሽኛል - New Ethiopian Music 2018 (Official Video) by Hope Music Ethiopia 3 years ago 7 minutes, 56 seconds 2,961,429 views",Hope Music Entertainment,2961429,2968931,7502
1365,"Nebiyu Mulu - Taw Yanea | ታው ያኔ - New Ethiopian Music 2018 (Official Video) by Hope Music Ethiopia 3 years ago 5 minutes, 45 seconds 45,455 views",Hope Music Entertainment,45455,45488,33
1366,"Getachew Melese - Abebaye | አበባዬ - New Ethiopian Music 2018 (Official Video) by Hope Music Ethiopia 3 years ago 5 minutes, 3 seconds 111,545 views",Hope Music Entertainment,111545,111593,48
1367,"Abenet Demissie - Belu Enji | በሉ እንጅ - New Ethiopian Music 2018 (Official Video) by Hope Music Ethiopia 3 years ago 4 minutes, 32 seconds 5,467,701 views",Hope Music Entertainment,5467701,5492960,25259
1368,"Sara T - Largleh | ላርግልህ - New Ethiopian Music 2018 (Official Video) by Hope Music Ethiopia 3 years ago 4 minutes, 24 seconds 5,074,768 views",Hope Music Entertainment,5074768,5081489,6721
1369,"Kalkidan Meshesha - Gofta Kiya | ጎፍታ ኪያ - New Ethiopian Music 2018 (Official Video) by Hope Music Ethiopia 3 years ago 5 minutes, 51 seconds 406,682 views",Hope Music Entertainment,406682,407207,525
1370,"Solomon Berihun - Jemerkut | ጀመርኩት - New Ethiopian Music 2018 (Official Video) by Hope Music Ethiopia 3 years ago 5 minutes, 58 seconds 110,608 views",Hope Music Entertainment,110608,110707,99
1371,"Debas Zerabruk - Kem Dlayki | ከም ድላይኪ - New Eritrean Music 2018 (Official Video) by Hope Music Ethiopia 3 years ago 6 minutes, 1 second 43,089 views",Hope Music Entertainment,43089,43116,27
1372,"Tewodros Getachew - Ney Demama | ነይ ደማማ - New Ethiopian Music 2018 (Official Video) by Hope Music Ethiopia 3 years ago 4 minutes, 21 seconds 34,734 views",Hope Music Entertainment,34734,34768,34
1373,"Roza Yitbarek - Naeni | ናዓኒ - New Ethiopian Tigrigna Music 2018 (Official Video) by Hope Music Ethiopia 3 years ago 6 minutes, 21 seconds 48,859 views",Hope Music Entertainment,48859,48878,19
1374,"Ashenafi Kahsay - Demi Benu - New Ethiopian Music 2018 (Official Video) by Hope Music Ethiopia 3 years ago 5 minutes, 20 seconds 101,474 views",Hope Music Entertainment,101474,101541,67
1375,"Aki Habesha - Wey Yene Eda | ወይ የኔ እዳ - New Ethiopian Music 2018 (Official Video) by Hope Music Ethiopia 3 years ago 3 minutes, 51 seconds 1,069,241 views",Hope Music Entertainment,1069241,1074417,5176
1376,"Desalegn Reta - Kanchi Yeteshale | ካንቺ የተሻለ - New Ethiopian Music 2018 (Official Video) by Hope Music Ethiopia 3 years ago 4 minutes, 34 seconds 59,698 views",Hope Music Entertainment,59698,59710,12
1377,"Ziggy Zaga ft. Abebe Kefeni - Ajaiba | አጃኢባ - New Ethiopian Music 2018 (Official Video) by Hope Music Ethiopia 3 years ago 5 minutes, 33 seconds 799,419 views",Hope Music Entertainment,799419,800667,1248
1378,"Mikiyas Mohammed -  Altew Alegn | አልተው አለኝ - New Ethiopian Music 2018 (Official Video) by Hope Music Ethiopia 3 years ago 5 minutes, 9 seconds 26,801 views",Hope Music Entertainment,26801,26809,8
1379,"Mukur Weldu - Weleba | ወለባ - New Ethiopian Tigrigna Music 2018 (Official Video) by Hope Music Ethiopia 3 years ago 5 minutes, 15 seconds 99,923 views",Hope Music Entertainment,99923,100071,148
1380,"Weeha - Tiragn Besimeh | ጥራኝ በስምህ - New Ethiopian Music 2018 (Official Video) by Hope Music Ethiopia 3 years ago 3 minutes, 44 seconds 1,729,824 views",Hope Music Entertainment,1729824,1734240,4416
1381,"Znabu Kiros (Zenach) - Embeytey | እምበይተይ - New Ethiopian Tigrigna Music 2018 (Official Video) by Hope Music Ethiopia 3 years ago 5 minutes, 4 seconds 722,943 views",Hope Music Entertainment,722943,724725,1782
1382,"Molla Kassa - Ney Gibilgn | ነይ ግቢልኝ - New Ethiopian Music 2018 (Official Video) by Hope Music Ethiopia 3 years ago 5 minutes, 38 seconds 72,940 views",Hope Music Entertainment,72940,73018,78
1383,"Tombola Abebaw - Simish Yazefinal | ስምሽ ያዘፍናል - New Ethiopian Musc 2018 (Official Video) by Hope Music Ethiopia 3 years ago 5 minutes, 4 seconds 68,684 views",Hope Music Entertainment,68684,68745,61
1384,"Eyerusalem Abraham - Layih New | ላይህ ነው - New Ethiopian Music 2018 (Official Video) by Hope Music Ethiopia 3 years ago 4 minutes, 43 seconds 105,646 views",Hope Music Entertainment,105646,105684,38
1385,"Tewodros Samuel - Musheraye | ሙሽራዬ - New Ethiopian Music 2018 (Official Video) by Hope Music Ethiopia 3 years ago 4 minutes, 58 seconds 54,814 views",Hope Music Entertainment,54814,54857,43
1386,"Yibeltal Desalegn - Eyign Demo | እይኝ ደሞ - New Ethiopian Music 2018 (Official Video) by Hope Music Ethiopia 3 years ago 6 minutes, 1 second 77,824 views",Hope Music Entertainment,77824,77882,58
1387,"Henok Getachew - Libe Ena Afe | ልቤ እና አፌ - New Ethiopian Music 2018 (Official Video) by Hope Music Ethiopia 3 years ago 5 minutes, 12 seconds 475,638 views",Hope Music Entertainment,475638,478509,2871
1388,"Aklilu Adise - Kene Kene - New Ethiopian Oromo Music 2018 (Official Video) by Hope Music Ethiopia 3 years ago 4 minutes, 43 seconds 34,984 views",Hope Music Entertainment,34984,35001,17
1389,"Solomon Teklya - Gual Tigrigna | ጓል ትግርኛ - New Eritrean Music 2018 (Official Video) by Hope Music Ethiopia 3 years ago 4 minutes, 52 seconds 116,360 views",Hope Music Entertainment,116360,116521,161
1390,"Asher habesha - pheki pheko - New Ethiopian Music 2018 (Official Video) by Hope Music Ethiopia 3 years ago 4 minutes, 28 seconds 75,181 views",Hope Music Entertainment,75181,75212,31
1391,"Eskedar Wedaje - Yihe Libe | ይሄ ልቤ - New Ethiopian Music 2018 (Official Video) by Hope Music Ethiopia 3 years ago 4 minutes, 47 seconds 212,907 views",Hope Music Entertainment,212907,213676,769
1392,"Ittiiqaa Tafarii - Tolen Jedhu - New Ethiopian Oromo Music 2018 (Official Video) by Hope Music Ethiopia 3 years ago 7 minutes, 22 seconds 485,139 views",Hope Music Entertainment,485139,486496,1357
1393,"Desalegn Abebe - Fikir Bicha | ፍቅር ብቻ - New Ethiopian Music 2018 (Official Video) by Hope Music Ethiopia 3 years ago 5 minutes, 36 seconds 81,578 views",Hope Music Entertainment,81578,81672,94
1394,"Tigist Gari - Alem Bire Ney Ney | አለም ብሬ ነይ ነይ - New Ethiopian Music 2018 (Official Video) by Hope Music Ethiopia 3 years ago 4 minutes, 45 seconds 327,607 views",Hope Music Entertainment,327607,335483,7876
1395,"Hencok Daniel - Amile Landa | አሚለ ላንዳ - New Ethiopian Music 2018 (Official Video) by Hope Music Ethiopia 3 years ago 4 minutes, 51 seconds 379,970 views",Hope Music Entertainment,379970,382080,2110
1396,"Birraa - Birraa - New Ethiopian Oromo Music 2018 (Official Video) by Hope Music Ethiopia 3 years ago 5 minutes, 58 seconds 115,075 views",Hope Music Entertainment,115075,115294,219
1397,"Mamila Lukas - Be Adis Amet | በአዲስ አመት - New Ethiopian Music 2018 (Official Video) by Hope Music Ethiopia 3 years ago 5 minutes, 47 seconds 216,583 views",Hope Music Entertainment,216583,216866,283
1398,"Tsige Dingle Admase - Ethiopia | ኢትዮዽያ - New Ethiopian Music 2018 (Official Video) by Hope Music Ethiopia 3 years ago 3 minutes, 48 seconds 42,871 views",Hope Music Entertainment,42871,42880,9
1399,"Zenebe Worku - Man Zim Yilal | ማን ዝም ይላል - New Ethiopian Music 2018 (Official Video) by Hope Music Ethiopia 3 years ago 6 minutes, 22 seconds 144,081 views",Hope Music Entertainment,144081,144258,177
1400,"Demissie Teka - Shado Shorko | ሻዶ ሾርኮ - New Ethiopian Music 2018 (Official Video) by Hope Music Ethiopia 3 years ago 5 minutes, 50 seconds 227,926 views",Hope Music Entertainment,227926,229256,1330
1401,"Alemye Getachew - Akuaye | አኳዬ - New Ethiopian Music 2018 (Official Video) by Hope Music Ethiopia 3 years ago 4 minutes, 58 seconds 3,926,345 views",Hope Music Entertainment,3926345,3932546,6201
1402,"Tekle Negasi - Habruni - New Eritrean Music 2018 (Official Video) by Hope Music Ethiopia 3 years ago 5 minutes, 6 seconds 162,636 views",Hope Music Entertainment,162636,162885,249
1403,"Mahlet Abadi - Bahgey | ባህገይ - New Ethiopian Tigrigna Music 2018 (Official Video) by Hope Music Ethiopia 3 years ago 6 minutes, 41 seconds 57,348 views",Hope Music Entertainment,57348,57383,35
1404,"Sisay Demoz - Kidus | ቅዱስ - New Ethiopian Music 2018 (Official Video) by Hope Music Ethiopia 3 years ago 5 minutes, 29 seconds 794,640 views",Hope Music Entertainment,794640,795373,733
1405,"Efrem Gebremichael - Mehazay Meley | ማሓዛይ መለይ - New Ethiopian Music 2018 (Official Video) by Hope Music Ethiopia 3 years ago 5 minutes, 8 seconds 78,511 views",Hope Music Entertainment,78511,78733,222
1406,"Behailu Bayou ft. Yared Negu - Yiwedishal | ይወድሻል - New Ethiopian Music 2018 (Official Video) by Hope Music Ethiopia 3 years ago 4 minutes, 4 seconds 765,233 views",Hope Music Entertainment,765233,767237,2004
1407,"Henok Abebaw - Tenes | ተነስ - New Ethiopian Music 2018 (Official Video) by Hope Music Ethiopia 3 years ago 6 minutes, 5 seconds 265,418 views",Hope Music Entertainment,265418,265765,347
1408,"Abudie & Mister - Fikir Engida New | ፍቅር እንግዳ ነው - New Ethiopian Music 2018 (Official Video) by Hope Music Ethiopia 3 years ago 4 minutes, 9 seconds 38,325 views",Hope Music Entertainment,38325,38329,4
1409,"Roza Yitbarek - Hezim | ሕዝም - New Ethiopian Tigrigna Music 2018 (Official Video) by Hope Music Ethiopia 3 years ago 6 minutes, 55 seconds 35,333 views",Hope Music Entertainment,35333,35349,16
1410,"Yosef Bekele - Aye Edaye | አይ እዳዬ - New Ethiopian Music 2018 (Official Video) by Hope Music Ethiopia 3 years ago 6 minutes, 2 seconds 64,371 views",Hope Music Entertainment,64371,64418,47
1411,"Ephrem Assefa - Abo Sarem | አቦ ሳሬም - New Ethiopian Music 2018 (Official Video) by Hope Music Ethiopia 3 years ago 3 minutes, 43 seconds 54,059 views",Hope Music Entertainment,54059,54081,22
1412,"Dagi Man - Destegna | ደስተኛ - New Ethiopian Music 2018 (Official Video) by Hope Music Ethiopia 3 years ago 4 minutes, 49 seconds 252,805 views",Hope Music Entertainment,252805,252842,37
1413,"Nahom Tesfaye - Hawi Leyto | ሓዊ ለይቶ - New Eritrean Music 2018 (Official Video) by Hope Music Ethiopia 3 years ago 5 minutes, 48 seconds 194,816 views",Hope Music Entertainment,194816,194947,131
1414,"Hiwot Ayalew - Endamele | እንዳመሌ - New Ethiopian Music 2018 (Official Video) by Hope Music Ethiopia 3 years ago 5 minutes, 34 seconds 52,377 views",Hope Music Entertainment,52377,52415,38
1415,"Rahel Gemechu - Esu Tibebegna | እሱ ጥበበኛ - New Ethiopian Music 2018 (Official Video) by Hope Music Ethiopia 3 years ago 4 minutes, 32 seconds 35,184 views",Hope Music Entertainment,35184,35191,7
1416,"Dagim Adane - Brambar | ብርአምባር - New Ethiopian Music 2018 (Official Video) by Hope Music Ethiopia 3 years ago 7 minutes, 4 seconds 138,892 views",Hope Music Entertainment,138892,139022,130
1417,"Nina - Addis Getse | አዲስ ገፅ - New Ethiopian Music 2018 (Official Video) by Hope Music Ethiopia 3 years ago 4 minutes, 2 seconds 79,711 views",Hope Music Entertainment,79711,79991,280
1418,"Zebider Assefa - Aletah | አልጣህ - New Ethiopian Music 2018 (Official Video) by Hope Music Ethiopia 3 years ago 6 minutes, 22 seconds 48,487 views",Hope Music Entertainment,48487,48530,43
1419,"Mulatua Abate - Enkutatash | እንቁጣጣሽ - New Ethiopian Music 2018 (Official Video) by Hope Music Ethiopia 3 years ago 4 minutes, 28 seconds 32,841 views",Hope Music Entertainment,32841,32859,18
1420,"Helen Argaw - Zim Atebelegn | ዝም አትበለኝ - New Ethiopian Music 2018 (Official Video) by Hope Music Ethiopia 3 years ago 5 minutes, 25 seconds 184,549 views",Hope Music Entertainment,184549,184663,114
1421,"Mekdes Hailu - Bel Nikaw | በል ንካው - New Ethiopian Music 2018 (Official Video) by Hope Music Ethiopia 3 years ago 4 minutes, 49 seconds 2,051,532 views",Hope Music Entertainment,2051532,2067491,15959
1422,"Urgesa Eshetu - Ayyaana Waggaa - New Ethiopian Oromo Music 2018 (Official Video) by Hope Music Ethiopia 3 years ago 6 minutes, 4 seconds 75,079 views",Hope Music Entertainment,75079,75239,160
1423,"Tesfahun Yebresh Lij - Ney Ney Bawdametu | ነይ ነይ በአውዳመቱ - New Ethiopian Music 2018 (Official Video) by Hope Music Ethiopia 3 years ago 6 minutes, 22 seconds 48,049 views",Hope Music Entertainment,48049,48052,3
1424,"Asegid Eshetu - Yeawdamet Chewata | የአውዳመት ጨዋታ - New Ethiopian Music 2018 (Official Video) by Hope Music Ethiopia 3 years ago 5 minutes, 25 seconds 51,548 views",Hope Music Entertainment,51548,51591,43
1425,"Muez G/Silassie - Nifaker Nisane | ንፋቐር ንሳነ - New Ethiopian Tigrigna Music 2018 (Official Video) by Hope Music Ethiopia 3 years ago 6 minutes, 17 seconds 275,566 views",Hope Music Entertainment,275566,275611,45
1426,"Mestawet Adgeh - Kef Yibel | ከፍ ይበል - New Ethiopian Music 2018 (Official Video) by Hope Music Ethiopia 3 years ago 4 minutes, 2 seconds 54,903 views",Hope Music Entertainment,54903,54920,17
1427,"Tadese Bekele - Amet Bahlachin | አመትባህላችን - New Ethiopian Music 2018 (Official Video) by Hope Music Ethiopia 3 years ago 5 minutes, 48 seconds 252,710 views",Hope Music Entertainment,252710,252844,134
1428,"Abel Mulugeta - Mela Mela | መላ መላ - New Ethiopian Music 2018 by Hope Music Ethiopia 3 years ago 5 minutes, 20 seconds 95,568 views",Hope Music Entertainment,95568,95597,29
1429,"Mesay Tefera - Fashion | ፋሽን - New Ethiopian Music (Official Video) by Hope Music Ethiopia 3 years ago 4 minutes, 27 seconds 997,137 views",Hope Music Entertainment,997137,998979,1842
1430,"Banteyihun Aregawi - Yihe New Bahlish | ይሄ ነው ባህልሽ - New Ethiopian Music 2018 (Official Video) by Hope Music Ethiopia 3 years ago 5 minutes, 36 seconds 60,291 views",Hope Music Entertainment,60291,60294,3
1431,"Yidnekachew Tsegaye - And Honen Meta | አንድ ሆነን መታ - New Ethiopian Music 2018 (Official Video) by Hope Music Ethiopia 3 years ago 5 minutes, 16 seconds 61,196 views",Hope Music Entertainment,61196,61220,24
1432,"Micky Hasset - Wudye | ውድዬ - New Ethiopian Music 2018 (Official Video) by Hope Music Ethiopia 3 years ago 3 minutes, 7 seconds 68,142 views",Hope Music Entertainment,68142,68242,100
1433,"Mulatu Lema - Enat Alem Guada | እናት አለም ጓዳ - New Ethiopian Music 2018 (Official Video) by Hope Music Ethiopia 3 years ago 5 minutes, 31 seconds 57,658 views",Hope Music Entertainment,57658,57673,15
1434,"Dawit Tsige - Aman Yihun |  አማን ይሁን - New Ethiopian Music 2018 (Official Video) by Hope Music Ethiopia 3 years ago 5 minutes, 54 seconds 3,140,284 views",Hope Music Entertainment,3140284,3143578,3294
1435,"Dawit Shiferaw - Yene | የኔ - New Ethiopian Music 2018 (Official Video) by Hope Music Ethiopia 3 years ago 4 minutes, 49 seconds 97,973 views",Hope Music Entertainment,97973,98033,60
1436,"Nuru Modi - Awdamet | አውዳመት - New Ethiopian Music 2018 (Official Video) by Hope Music Ethiopia 3 years ago 6 minutes, 1 second 105,277 views",Hope Music Entertainment,105277,105359,82
1437,"Yohannes Birhane - Bersabeh | ቤርሳቤህ - New Ethiopian Music 2018 (Official Video) by Hope Music Ethiopia 3 years ago 6 minutes, 13 seconds 150,713 views",Hope Music Entertainment,150713,150825,112
1438,"Melaku Berhanu - Selam | ሰላም - New Ethiopian Music 2018 (Official Video) by Hope Music Ethiopia 3 years ago 7 minutes, 46 seconds 54,888 views",Hope Music Entertainment,54888,54894,6
1439,"Misrak Taye - Ethiopia | ኢትዮዽያ - New Ethiopian Music 2018 (Official Video) by Hope Music Ethiopia 3 years ago 6 minutes, 57 seconds 82,965 views",Hope Music Entertainment,82965,83040,75
1440,"Fikru Yilkal - Yegeta Nebiy | የጌታ ነብይ - New Ethiopian Music 2018 (Official Video) by Hope Music Ethiopia 3 years ago 5 minutes, 55 seconds 76,519 views",Hope Music Entertainment,76519,76544,25
1441,"Bewketu Sewmehon - Esachew | እሳቸው - New Ethiopian Music 2018 (Official Video) by Hope Music Ethiopia 3 years ago 5 minutes, 33 seconds 900,218 views",Hope Music Entertainment,900218,902975,2757
1442,"Ermias Begashaw ft. Markos Fikru - Kerebish | ቀረብሽ - New Ethiopian Music 2018 (Official Video) by Hope Music Ethiopia 3 years ago 4 minutes, 49 seconds 134,585 views",Hope Music Entertainment,134585,134654,69
1443,"Geremew Gualu - Geremegn | ገረመኝ - New Ethiopian Music 2018 (Official Video) by Hope Music Ethiopia 3 years ago 6 minutes, 46 seconds 118,260 views",Hope Music Entertainment,118260,118356,96
1444,"Getu Tasew - Kanchi New | ካንቺ ነው - New Ethiopian Music 2018 (Official Video) by Hope Music Ethiopia 3 years ago 5 minutes, 56 seconds 53,245 views",Hope Music Entertainment,53245,53254,9
1445,"Biniam Tesema - Tizitaye | ትዝታዬ - New Ethiopian Music 2018 (Official Video) by Hope Music Ethiopia 3 years ago 5 minutes 252,494 views",Hope Music Entertainment,252494,252704,210
1446,"Helen Berhe & Ali Birra - SIIYAADEE - New Ethiopian Music 2018 (Official Video) by Hope Music Ethiopia 3 years ago 5 minutes, 26 seconds 9,872,799 views",Hope Music Entertainment,9872799,9914262,41463
1447,"Million Abebe - Belibe Lay | በልቤ ላይ - New Ethiopian Music 2018 (Official Video) by Hope Music Ethiopia 3 years ago 4 minutes, 13 seconds 82,430 views",Hope Music Entertainment,82430,82501,71
1448,"Abraham Ante - Abe Yee - New Ethiopian Music 2018 (Official Video) by Hope Music Ethiopia 3 years ago 4 minutes, 30 seconds 161,816 views",Hope Music Entertainment,161816,162136,320
1449,"Mesay Berhanu - Alchalku Ena | አልቻልኩ እኔ - New Ethiopian Music 2018 (Official Video) by Hope Music Ethiopia 3 years ago 5 minutes, 33 seconds 49,311 views",Hope Music Entertainment,49311,49344,33
1450,"Dina Anteneh - Eduma | ኤዱማ - New Ethiopian Music 2018 (Official Video) by Hope Music Ethiopia 3 years ago 4 minutes, 28 seconds 505,226 views",Hope Music Entertainment,505226,506080,854
1451,"Maditu Weday - Negodguadu Beza | ነጎድጓዱ በዛ - New Ethiopian Music 2018 (Official Video) by Hope Music Ethiopia 3 years ago 5 minutes, 57 seconds 3,714,282 views",Hope Music Entertainment,3714282,3724602,10320
1452,"Abel Abera ft. Mela Zanjar - Almelesm | አልመለስም - New Ethiopian Music 2018 (Official Video) by Hope Music Ethiopia 3 years ago 4 minutes, 32 seconds 112,130 views",Hope Music Entertainment,112130,112511,381
1453,"Mikiyas Negani - Sisite | ስስቴ - New Ethiopian Music 2018 (Official Video) by Hope Music Ethiopia 3 years ago 5 minutes 1,508,164 views",Hope Music Entertainment,1508164,1510368,2204
1454,"Selamawit Kelelom & Hareg Heluf - Yeiwey Welelaka | ያዓወይ ወለላካ - New Ethiopian Tigrigna Music 2018 by Hope Music Ethiopia 3 years ago 5 minutes, 1 second 208,112 views",Hope Music Entertainment,208112,208253,141
1455,"Tesfaye Lebena (walkot) - Takoya | ታኮያ - New Ethiopian Music 2018 (Official Video) by Hope Music Ethiopia 3 years ago 3 minutes, 54 seconds 60,231 views",Hope Music Entertainment,60231,60235,4
1456,"Desalegn Mersha - Betotot | በቶቶት - New Ethiopian Music 2018 (Official Video) by Hope Music Ethiopia 3 years ago 5 minutes, 20 seconds 185,078 views",Hope Music Entertainment,185078,185845,767
1457,"Tariku Shamena - Enema | እኔማ - New Ethiopian Music 2018 (Official Video) by Hope Music Ethiopia 3 years ago 4 minutes, 59 seconds 2,311,528 views",Hope Music Entertainment,2311528,2331769,20241
1458,"Yonas Afera ft. Solomon Yikunoamlak & Wedi Fitaw - Asadu - New Ethiopian Tigrigna Music 2018 by Hope Music Ethiopia 3 years ago 5 minutes, 43 seconds 67,835 views",Hope Music Entertainment,67835,67898,63
1459,"Henok, Nati & Dani -  Hoya Hoye | ሆያ ሆዬ - New Ethiopian Music 2018 (Official Video) by Hope Music Ethiopia 3 years ago 4 minutes, 10 seconds 51,420 views",Hope Music Entertainment,51420,51447,27
1460,"Demx - Sak Lekso | ሳቅ ለቅሶ - New Ethiopian Music 2018 (Official Video) by Hope Music Ethiopia 3 years ago 5 minutes, 18 seconds 145,602 views",Hope Music Entertainment,145602,145638,36
1461,"Tesfaye Adugna - Balaye | ባላዬ - New Ethiopian Music 2018 (Official Video) by Hope Music Ethiopia 3 years ago 5 minutes, 8 seconds 2,972,128 views",Hope Music Entertainment,2972128,2995074,22946
1462,"Abraham Nigussie - Teketye | ተከትዬ - New Ethiopian Music 2018 (Official Video) by Hope Music Ethiopia 3 years ago 6 minutes, 14 seconds 62,954 views",Hope Music Entertainment,62954,62985,31
1463,"Rahwa K/Mariam, Danait Alemayehu & Yordanos G/Meskel - Metset | መፀት - New Ethiopian Music 2018 by Hope Music Ethiopia 3 years ago 8 minutes, 32 seconds 127,338 views",Hope Music Entertainment,127338,127437,99
1464,"Daniel Shawel - Hoya Hoye | ሆያ ሆዬ - New Ethiopian Music 2018 (Official Video) by Hope Music Ethiopia 3 years ago 4 minutes, 9 seconds 143,171 views",Hope Music Entertainment,143171,143260,89
1465,"Halewat Hagos G/Hiwot - Anten Biye | አንተን ብዬ - New Ethiopian Music 2018 (Official Video) by Hope Music Ethiopia 3 years ago 4 minutes, 16 seconds 104,991 views",Hope Music Entertainment,104991,105173,182
1466,"Getnet Habtamu - Zomawa | ዞማዋ - New Ethiopian Music 2018 (Official Video) by Hope Music Ethiopia 3 years ago 6 minutes, 2 seconds 95,434 views",Hope Music Entertainment,95434,95760,326
1467,"Sosna Belete - Endaygelegn | እንዳይገለኝ - New Ethiopian Music 2018 (Official Video) by Hope Music Ethiopia 3 years ago 5 minutes, 36 seconds 86,579 views",Hope Music Entertainment,86579,86611,32
1468,"Helen Kindu - Kante Beker | ካንተ በቀር - New Ethiopian Music 2018 (Official Video) by Hope Music Ethiopia 3 years ago 5 minutes, 10 seconds 70,467 views",Hope Music Entertainment,70467,70497,30
1469,"Asgegnew Ashko (Asge) - Lade | ላዴ - New Ethiopian Music 2018 (Official Video) by Hope Music Ethiopia 3 years ago 4 minutes, 6 seconds 477,760 views",Hope Music Entertainment,477760,479065,1305
1470,"Abel Mulugeta - Embagaliano | እምባጋሊያኖ - New Ethiopian Music 2018 (Official Video) by Hope Music Ethiopia 3 years ago 4 minutes, 42 seconds 730,472 views",Hope Music Entertainment,730472,731050,578
1471,"Endrias Mekonnen - Enate Be Eritrea | እናቴ በኤርትራ - New Ethiopian Music 2018 (Official Video) by Hope Music Ethiopia 3 years ago 5 minutes, 29 seconds 67,278 views",Hope Music Entertainment,67278,67297,19
1472,"Teklit Kidane - Gual Zemen | ጓል ዘመን - New Eritrean Music 2018 (Official Video) by Hope Music Ethiopia 3 years ago 5 minutes, 54 seconds 40,709 views",Hope Music Entertainment,40709,40721,12
1473,"Neima Ahmed - Tedeschalehu | ተደስቻለሁ - New Ethiopian Music 2018 (Official Video) by Hope Music Ethiopia 3 years ago 5 minutes, 37 seconds 199,042 views",Hope Music Entertainment,199042,199076,34
1474,"Hamza - Alem Ayehu | አለም አየሁ - New Ethiopian Music 2018 (Official Video) by Hope Music Ethiopia 3 years ago 5 minutes, 40 seconds 40,243 views",Hope Music Entertainment,40243,40289,46
1475,"Maramawit Ageze - KURU GONDERE | ኩሩ ጎንደሬ - New Ethiopian Music 2018 (Official Video) by Hope Music Ethiopia 3 years ago 6 minutes, 12 seconds 909,405 views",Hope Music Entertainment,909405,912125,2720
1476,"Original & Naod - Wolloyewa | ወሎየዋ - New Ethiopian Music 2018 (Official Video) by Hope Music Ethiopia 3 years ago 5 minutes, 15 seconds 94,031 views",Hope Music Entertainment,94031,94208,177
1477,"Mekbeb Mekoya - Sendele | ሰንደሌ - New Ethiopian Music 2018 (Official Video) by Hope Music Ethiopia 3 years ago 4 minutes, 29 seconds 76,697 views",Hope Music Entertainment,76697,76707,10
1478,"Nitsuh Zer Tezera - Yibelegn | ይበለኝ - New Ethiopian Music 2018 (Official Video) by Hope Music Ethiopia 3 years ago 5 minutes, 39 seconds 43,440 views",Hope Music Entertainment,43440,43451,11
1479,"Jan Crew - Yabajalew | ያባጃሌው - New Ethiopian Music 2018 (Official Video) by Hope Music Ethiopia 3 years ago 6 minutes, 6 seconds 205,046 views",Hope Music Entertainment,205046,205320,274
1480,"Alex Sheger - Enbi Beli | እንቢ በሊ - New Ethiopian Music 2018 (Official Video) by Hope Music Ethiopia 3 years ago 5 minutes, 5 seconds 53,029 views",Hope Music Entertainment,53029,53040,11
1481,"Wasihun Reta - Enkuan Des Alesh | እንኳን ደስ አለሽ - New Ethiopian Music 2018 (Official Video) by Hope Music Ethiopia 3 years ago 4 minutes, 45 seconds 123,545 views",Hope Music Entertainment,123545,123581,36
1482,"Buze Man (Buzayehu Kifle) - kedameyti | ቀዳመይቲ - New Ethiopian Music 2018 (Official Video) by Hope Music Ethiopia 3 years ago 4 minutes, 28 seconds 1,587,217 views",Hope Music Entertainment,1587217,1592089,4872
1483,"Tommy Zuk - Shir Bey | ሽር በይ - New Ethiopian Music 2018 (Official Video) by Hope Music Ethiopia 3 years ago 4 minutes, 34 seconds 101,392 views",Hope Music Entertainment,101392,101442,50
1484,"Serawitu Lema - Ethiopia | ኢትዮዽያ - New Ethiopian Music 2018 (Official Video) by Hope Music Ethiopia 3 years ago 5 minutes, 38 seconds 142,015 views",Hope Music Entertainment,142015,142059,44
1485,"Dani Roma - Mamaye | ማማዬ - New Ethiopian Music 2018 (Official Video) by Hope Music Ethiopia 3 years ago 5 minutes, 53 seconds 104,639 views",Hope Music Entertainment,104639,104672,33
1486,"Sisay Demoz - Wulu Tefabign | ውሉ ጠፋኝ - New Ethiopian Music Dedicated to Engineer Simegnew Bekele by Hope Music Ethiopia 3 years ago 6 minutes, 30 seconds 199,303 views",Hope Music Entertainment,199303,199652,349
1487,"Solomon Beyene - Gaafa Tokko - New Ethiopian Oromo Music 2018 (Official Video) by Hope Music Ethiopia 3 years ago 5 minutes, 56 seconds 48,586 views",Hope Music Entertainment,48586,48607,21
1488,"Merkeb Baryagabir ft. Adiam Sibhatu - Nie Che Che | ንዒ ቸቸ - New Tigrigna Music 2018 (Official Video) by Hope Music Ethiopia 3 years ago 4 minutes, 15 seconds 1,726,287 views",Hope Music Entertainment,1726287,1729568,3281
1489,"Melaku Sisay - Tedemer | ተደመር - New Ethiopian Music 2018 (Official Video) by Hope Music Ethiopia 3 years ago 7 minutes, 18 seconds 3,360,624 views",Hope Music Entertainment,3360624,3364610,3986
1490,"Ephrem Gossaye - Libe Alegn Nana | ልቤ አለኝ ናና - New Ethiopian Music 2018 (Official Video) by Hope Music Ethiopia 3 years ago 5 minutes, 39 seconds 86,232 views",Hope Music Entertainment,86232,86252,20
1491,"Mahamude - Esele | እሰሌ - New Ethiopian Tigrigna Music Dedicated to Abiy Ahmed by Hope Music Ethiopia 3 years ago 5 minutes, 28 seconds 43,338 views",Hope Music Entertainment,43338,43343,5
1492,"Yetem Beyene - Halaftak Ya Gelbi - New Sudanese Music 2018 (Official Video) by Hope Music Ethiopia 3 years ago 6 minutes, 17 seconds 157,677 views",Hope Music Entertainment,157677,158543,866
1493,"Tizita Mekonnen - Yene Alem | የኔ አለም - New Ethiopian Music 2018 (Official Video) by Hope Music Ethiopia 3 years ago 5 minutes, 57 seconds 63,008 views",Hope Music Entertainment,63008,63071,63
1494,"Yared Halefom -  Yitsbeleku | ይፅበ'ለኹ - New Ethiopian Tigrigna Music 2018 (Official Video) by Hope Music Ethiopia 3 years ago 4 minutes, 57 seconds 189,478 views",Hope Music Entertainment,189478,189583,105
1495,"Menbere T/ Silassie - Tedemirenal | ተደምረናል - New Ethiopian Music Dedicated to Dr Abiy Ahmed by Hope Music Ethiopia 3 years ago 5 minutes, 12 seconds 112,390 views",Hope Music Entertainment,112390,112402,12
1496,"Tsedi - Maneh | ማነህ - New Ethiopian Music 2018 (Official Video) by Hope Music Ethiopia 3 years ago 3 minutes, 44 seconds 4,011,318 views",Hope Music Entertainment,4011318,4025620,14302
1497,"Dina Anteneh - Yehone Neger | የሆነ ነገር - New Ethiopian Music 2018 (Official Video) by Hope Music Ethiopia 3 years ago 6 minutes, 37 seconds 1,419,860 views",Hope Music Entertainment,1419860,1423132,3272
1498,"Andu'alam Gosaa -  GADAATU KEETI - New Ethiopian Oromo Music 2018 (Official Video) by Hope Music Ethiopia 3 years ago 5 minutes, 9 seconds 2,747,514 views",Hope Music Entertainment,2747514,2766788,19274
1499,"Paulos PK & Merry Mak - Ethiopia Aradegna | ኢትዮዽያ አራድኛ - New Ethiopian Music 2018 (Official Video) by Hope Music Ethiopia 3 years ago 5 minutes, 11 seconds 31,666 views",Hope Music Entertainment,31666,31670,4
1500,"Yigrem Assefa - Tergebegebe Ayne | ተርገበገበ አይኔ - New Ethiopian Music Dedicated to Dr Abiy Ahmed by Hope Music Ethiopia 3 years ago 4 minutes, 58 seconds 137,815 views",Hope Music Entertainment,137815,137833,18
1501,"Helera Tesfaye - Ethiopia Hagere | ኢትዮጵያ ሃገሬ - New Ethiopian Music 2018 (Official Video) by Hope Music Ethiopia 3 years ago 4 minutes, 40 seconds 53,738 views",Hope Music Entertainment,53738,53764,26
1502,"Mulusew Babey - Selam Ethiopia | ሰላም ኢትዮዽያ - New Ethiopian Music Dedicated to Dr Abiy Ahmed by Hope Music Ethiopia 3 years ago 4 minutes, 46 seconds 67,110 views",Hope Music Entertainment,67110,67122,12
1503,"Matias Tefera (Mati) - Ethiopiayen Adera |  ኢትዮዽያዬን አደራ - New Ethiopian Music 2018 (Official Video) by Hope Music Ethiopia 3 years ago 5 minutes, 9 seconds 155,510 views",Hope Music Entertainment,155510,155552,42
1504,"Tigist Asmare - Amelegnaw | አመለኛው - New Ethiopian Music Dedicated to Dr Abiy Ahmed by Hope Music Ethiopia 3 years ago 6 minutes, 49 seconds 1,116,831 views",Hope Music Entertainment,1116831,1117904,1073
1505,"Bisrat Surafel - Ethiopiawi Negn | ኢትዮጵያዊ ነኝ - New Ethiopian Music Dedicated to Dr Abiy Ahmed by Hope Music Ethiopia 3 years ago 5 minutes, 8 seconds 243,698 views",Hope Music Entertainment,243698,243903,205
1506,"Mykey Shewa - Yenewa Hagere | የኔዋ ሃገሬ - New Ethiopian Music Dedicated to Dr Abiy Ahmed by Hope Music Ethiopia 3 years ago 4 minutes, 34 seconds 328,881 views",Hope Music Entertainment,328881,329188,307
1507,"Ethio Man - Nkidn Do | ንኺድን'ዶ - New Tigrigna Music 2018 (Official Video) by Hope Music Ethiopia 3 years ago 4 minutes, 59 seconds 1,859,484 views",Hope Music Entertainment,1859484,1860041,557
1508,"Abush Zeleke - Anekan | አነቃን - New Ethiopian Music Dedicated to Dr Abiy Ahmed by Hope Music Ethiopia 3 years ago 6 minutes, 24 seconds 1,171,828 views",Hope Music Entertainment,1171828,1173140,1312
1509,"Abdi Yasin - Tedemrenal | ተደምረናል - New Ethiopian Music Dedicated to Dr Abiy Ahmed by Hope Music Ethiopia 3 years ago 5 minutes, 16 seconds 643,225 views",Hope Music Entertainment,643225,643369,144
1510,"Amanuel Yemane - Dlayey | ድላየይ - New Ethiopian Tigrigna Music 2018 (Official Video) by Hope Music Ethiopia 3 years ago 5 minutes, 22 seconds 8,029,798 views",Hope Music Entertainment,8029798,8059515,29717
1511,"Fisum T -  Bandira | ባንዲራ - New Ethiopian Music Dedicated to Dr Abiy Ahmed by Hope Music Ethiopia 3 years ago 4 minutes, 44 seconds 92,055 views",Hope Music Entertainment,92055,92101,46
1512,"Sisay Demoz - Amarebish Zare | አማረብሽ ዛሬ - New Ethiopian Music Dedicated to Dr Abiy Ahmed by Hope Music Ethiopia 3 years ago 5 minutes, 45 seconds 4,058,265 views",Hope Music Entertainment,4058265,4065931,7666
1513,"Daniel Shawel - Min Agebagn | ምን አገባኝ  - New Ethiopian Music 2018 (Official Video) by Hope Music Ethiopia 3 years ago 6 minutes, 12 seconds 148,696 views",Hope Music Entertainment,148696,148747,51
1514,"Igitu - Lebe Mala | ልቤ ማላ - New Ethiopian Music 2018 (Official Video) by Hope Music Ethiopia 3 years ago 4 minutes, 45 seconds 3,026,945 views",Hope Music Entertainment,3026945,3034984,8039
1515,"Wendi Mak - Bewyiyit | በውይይት - New Ethiopian Music 2018 (Official Video) by Hope Music Ethiopia 3 years ago 6 minutes, 28 seconds 4,562,792 views",Hope Music Entertainment,4562792,4572879,10087
1516,"Mesay Tefera - Yisemal | ይሰማል - New Ethiopian Music Dedicated to Dr Abiy Ahmed by Hope Music Ethiopia 3 years ago 4 minutes, 2 seconds 586,753 views",Hope Music Entertainment,586753,586857,104
1517,"Smizz Mayle - Kershado | ኬርሻዶ - New Ethiopian Music Dedicated to Dr Abiy Ahmed by Hope Music Ethiopia 3 years ago 4 minutes, 21 seconds 54,542 views",Hope Music Entertainment,54542,54548,6
1518,"Addis Mulat - Hageren | ሃገሬን - New Ethiopian Music Dedicated to Dr Abiy Ahmed by Hope Music Ethiopia 3 years ago 6 minutes, 40 seconds 5,684,850 views",Hope Music Entertainment,5684850,5690029,5179
1519,"Abel Mulugeta - And Sew Setonal | አንድ ሰው ሰቶናል - New Ethiopian Dedicated to  Dr Abiy Ahmed by Hope Music Ethiopia 3 years ago 5 minutes, 55 seconds 1,026,998 views",Hope Music Entertainment,1026998,1027190,192
1520,"Dagne Walle - Zertihun Gonder | ዘርትሁን ጎንደር - New Ethiopian Music 2018 (Official Video) by Hope Music Ethiopia 3 years ago 7 minutes, 6 seconds 3,823,780 views",Hope Music Entertainment,3823780,3832725,8945
1521,"Zemas - Fikir Yetalesh | ፍቅር የታለሽ - New Ethiopian Music 2018 (Official Video) by Hope Music Ethiopia 3 years ago 4 minutes, 48 seconds 1,526,036 views",Hope Music Entertainment,1526036,1535191,9155
1522,"Biruk Dejene - Yimtabign | ይምጣብኝ - New Ethiopian Music 2018 (Official Video) by Hope Music Ethiopia 3 years ago 4 minutes, 41 seconds 334,300 views",Hope Music Entertainment,334300,334598,298
1523,"Mahi Solomon -  Kazanchis | ካዛንቺስ - New Ethiopian Music 2018 (Official Video) by Hope Music Ethiopia 3 years ago 6 minutes, 1 second 102,431 views",Hope Music Entertainment,102431,102466,35
1524,"Habtamu G/tsadik - Dehna Hugni | ደህና ሁኚ - New Ethiopian Music 2018 (Official Video) by Hope Music Ethiopia 3 years ago 6 minutes, 17 seconds 168,782 views",Hope Music Entertainment,168782,169002,220
1525,"Selamawit Tesfa - Dimunmun | ድሙንሙን - New Ethiopian Music 2018 (Official Video) by Hope Music Ethiopia 3 years ago 5 minutes, 42 seconds 129,038 views",Hope Music Entertainment,129038,129143,105
1526,"Getnet Demissie - Yene Jegna | የኔ ጀግና - New Ethiopian Music 2018 (Official Video) by Hope Music Ethiopia 3 years ago 4 minutes, 7 seconds 33,825 views",Hope Music Entertainment,33825,33842,17
1527,"Mr Wina ft. Elu Panda - Magnaye | ማኛዬ - New Ethiopian Music 2018 (Official Video) by Hope Music Ethiopia 3 years ago 4 minutes, 53 seconds 888,006 views",Hope Music Entertainment,888006,889083,1077
1528,"Henok Ekubamichael - Kenash Wey | ቀናሽ ወይ - New Ethiopian Music 2018 (Official Video) by Hope Music Ethiopia 3 years ago 4 minutes, 40 seconds 1,445,882 views",Hope Music Entertainment,1445882,1457295,11413
1529,"Millena Biniam - Wedajen | ወዳጄን - New Ethiopian Music 2018 (Official Video) by Hope Music Ethiopia 3 years ago 3 minutes, 48 seconds 59,554 views",Hope Music Entertainment,59554,59564,10
1530,"Hanan Abdu - Yazugn Likekugn | ያዙኝ ልቀቁኝ - New Ethiopian Music 2018 (Official Video) by Hope Music Ethiopia 3 years ago 4 minutes, 46 seconds 187,181 views",Hope Music Entertainment,187181,188842,1661
1531,"Sintayehu Sefane - Neshetegn | ነሸጠኝ - New Ethiopian Music 2018 (Official Video) by Hope Music Ethiopia 3 years ago 6 minutes, 36 seconds 149,590 views",Hope Music Entertainment,149590,149802,212
1532,"Fikir Yitagesu - Weta Geba | ወጣ ገባ - New Ethiopian Music 2018 (Official Video) by Hope Music Ethiopia 3 years ago 4 minutes, 46 seconds 718,018 views",Hope Music Entertainment,718018,719836,1818
1533,"Abraham Sira - Selam - New Tigrigna Music 2018 (Official Video) by Hope Music Ethiopia 3 years ago 5 minutes, 41 seconds 424,693 views",Hope Music Entertainment,424693,424788,95
1534,"Dawit Wordofa - And Lay Nen - New Ethiopian Music 2018 (Official Video) by Hope Music Ethiopia 3 years ago 5 minutes, 7 seconds 36,543 views",Hope Music Entertainment,36543,36552,9
1535,"Biruktawit Taye (Vicky) - Tega Tega - New Ethiopian Music 2018 (Official Video) by Hope Music Ethiopia 3 years ago 3 minutes, 33 seconds 128,956 views",Hope Music Entertainment,128956,129008,52
1536,"Endegna - Leman Biye - New Ethiopian Music 2018 (Official Video) by Hope Music Ethiopia 3 years ago 4 minutes, 39 seconds 4,287,585 views",Hope Music Entertainment,4287585,4294545,6960
1537,"Heni Jam x Bellabel - Shikorina - New Ethiopian Music 2018 (Official Video) by Hope Music Ethiopia 3 years ago 3 minutes, 31 seconds 108,800 views",Hope Music Entertainment,108800,109086,286
1538,"Haftom Alem - Ketsali - New Tigrigna Music 2018 (Official Video) by Hope Music Ethiopia 3 years ago 6 minutes, 27 seconds 33,177 views",Hope Music Entertainment,33177,33180,3
1539,"Amanuel X Abel ft. Redu - Asnekiw - New Ethiopian Music 2018 (Official Video) by Hope Music Ethiopia 3 years ago 4 minutes, 36 seconds 104,317 views",Hope Music Entertainment,104317,104407,90
1540,"Abel Mulugeta - Selame - New Ethiopian Music 2018 (Official Video) by Hope Music Ethiopia 3 years ago 5 minutes, 4 seconds 135,086 views",Hope Music Entertainment,135086,135185,99
1541,"Biniam Eshetu - Chila - New Ethiopian Music 2018 (Official Video) by Hope Music Ethiopia 3 years ago 3 minutes, 29 seconds 48,807 views",Hope Music Entertainment,48807,48822,15
1542,"King Simba Nate ft. Wintana - Awkshalew - New Ethiopian Music 2018 (Official Video) by Hope Music Ethiopia 3 years ago 6 minutes, 36 seconds 77,548 views",Hope Music Entertainment,77548,77557,9
1543,"Habtamu G/ Tsadik - Blene - New Ethiopian Music 2018 by Hope Music Ethiopia 3 years ago 4 minutes, 54 seconds 52,365 views",Hope Music Entertainment,52365,52389,24
1544,"Eyob Yenew - Hememe - New Ethiopian Music 2018 (Official Video) by Hope Music Ethiopia 3 years ago 5 minutes, 33 seconds 292,161 views",Hope Music Entertainment,292161,292569,408
1545,"Solomon Tuemay - Mejemeriya kal - New Ethiopian Music 2018 (Official Video) by Hope Music Ethiopia 3 years ago 5 minutes, 19 seconds 17,490 views",Hope Music Entertainment,17490,17499,9
1546,"Abeselom Tsegaye - Anchin Bicha - New Ethiopian Music 2018 (Official Video) by Hope Music Ethiopia 3 years ago 4 minutes, 21 seconds 49,289 views",Hope Music Entertainment,49289,49320,31
1547,"Eyerusalem Melese - Ergib Damay - New Ethiopian Music 2018 (Official Video) by Hope Music Ethiopia 3 years ago 4 minutes, 26 seconds 42,928 views",Hope Music Entertainment,42928,42934,6
1548,"Almaz Yimer - Mengedegna - New Ethiopian Music 2018 (Official Video) by Hope Music Ethiopia 3 years ago 4 minutes, 59 seconds 40,583 views",Hope Music Entertainment,40583,40590,7
1549,"Yilma Shewakena - Mulualeme - New Ethiopian Music 2018 (Official Video) by Hope Music Ethiopia 3 years ago 5 minutes, 22 seconds 33,738 views",Hope Music Entertainment,33738,33751,13
1550,"Ezil & Rim - Rotalew - New Ethiopian Music 2018 (Official Video) by Hope Music Ethiopia 3 years ago 3 minutes, 27 seconds 146,770 views",Hope Music Entertainment,146770,146884,114
1551,"Marta Solomon - Jalele Ko - New Ethiopia Music 2018 (Official Video) by Hope Music Ethiopia 3 years ago 5 minutes, 2 seconds 273,078 views",Hope Music Entertainment,273078,273135,57
1552,"Aklilu Getahun - Sadule - New Ethiopian Music 2018 (Official Video) by Hope Music Ethiopia 3 years ago 6 minutes, 26 seconds 53,509 views",Hope Music Entertainment,53509,53522,13
1553,"Kaleab Kifle - Wub Des Yemil - New Ethiopian Music 2018 (Official Video) by Hope Music Ethiopia 3 years ago 4 minutes, 27 seconds 26,198 views",Hope Music Entertainment,26198,26204,6
1554,"Tewodros Mengesha - Arhibu | አርሂቡ - New Ethiopian Music (Official Video) by Hope Music Ethiopia 3 years ago 4 minutes, 41 seconds 56,673 views",Hope Music Entertainment,56673,56710,37
1555,"Ashenafi Adefres - Libe Alegn Tenesa - New Ethiopian Music 2018 (Official Video) by Hope Music Ethiopia 3 years ago 5 minutes, 58 seconds 79,633 views",Hope Music Entertainment,79633,79667,34
1556,"G Mesay Kebede - Endatay | እንዳታይ - New Ethiopian Music 2018 (Official Video) by Hope Music Ethiopia 3 years ago 4 minutes, 25 seconds 406,662 views",Hope Music Entertainment,406662,406996,334
1557,"Yosef Teferi - Kekal Belay | ከቃል በላይ - New Ethiopian Music 2018 (Official Video) by Hope Music Ethiopia 3 years ago 5 minutes, 3 seconds 141,901 views",Hope Music Entertainment,141901,141933,32
1558,"Suk Suke - Dunba Dunba | ዱንባ ዱንባ - New Ethiopian Music 2018 (Official Video) by Hope Music Ethiopia 3 years ago 4 minutes, 28 seconds 33,640 views",Hope Music Entertainment,33640,33666,26
1559,"Gashaw Molla - Ayehu | አየሁ - New Ethiopian Music 2018 (Official Video) by Hope Music Ethiopia 3 years ago 5 minutes, 38 seconds 59,153 views",Hope Music Entertainment,59153,59229,76
1560,"Genet Tefera - Jegnaye | ጀግናዬ - New Ethiopian Music 2018 (Official Video) by Hope Music Ethiopia 3 years ago 5 minutes, 54 seconds 86,630 views",Hope Music Entertainment,86630,86700,70
1561,"Yitbarek Kassahun - Korma | ኮርማ - New Ethiopian Music 2018 (Official Video) by Hope Music Ethiopia 3 years ago 5 minutes, 51 seconds 41,781 views",Hope Music Entertainment,41781,41794,13
1562,"Ataklti Techane - Mesilni | መሲልኒ - New Ethiopian Tigrigna Music 2018 (Official Video) by Hope Music Ethiopia 3 years ago 5 minutes, 24 seconds 18,907 views",Hope Music Entertainment,18907,18915,8
1563,"Nati Haile - Alo 2 Wiyo | አሎ 2 ዊዮ - New Ethiopian Music 2018 (Official Video) by Hope Music Ethiopia 3 years ago 5 minutes, 6 seconds 107,812 views",Hope Music Entertainment,107812,107897,85
1564,"Berehanu Taye - Yetana Ferte | የጣና ፈርጥ - New Ethiopian Music 2018 (Official Video) by Hope Music Ethiopia 3 years ago 6 minutes, 27 seconds 29,357 views",Hope Music Entertainment,29357,29375,18
1565,"Alemnesh  Yemane - Teharafi | ተሃራፊ - New Ethiopian Tigrigna Music 2018 (Official Video) by Hope Music Ethiopia 3 years ago 5 minutes, 38 seconds 40,087 views",Hope Music Entertainment,40087,40103,16
1566,"Frehiwot Yilma - Yenenima | የኔንማ - New Ethiopian Music 2018 (Official Video) by Hope Music Ethiopia 3 years ago 5 minutes, 36 seconds 104,086 views",Hope Music Entertainment,104086,104142,56
1567,"Yidne Oslo & Bini - Maleda | ማለዳ - New Ethiopian Music 2018 (Official Video) by Hope Music Ethiopia 3 years ago 5 minutes, 21 seconds 2,684,892 views",Hope Music Entertainment,2684892,2693609,8717
1568,"Bisrat Surafel - Yebet Sira | የቤት ስራ - New Ethiopian Music 2018 (Official Video) by Hope Music Ethiopia 3 years ago 5 minutes, 25 seconds 6,563,520 views",Hope Music Entertainment,6563520,6581719,18199
1569,"Mafi Leul - Shiri Beyina | ሽሪ በይና - New Ethiopian Music 2018 (Official Video) by Hope Music Ethiopia 3 years ago 4 minutes, 26 seconds 311,250 views",Hope Music Entertainment,311250,314529,3279
1570,"Miky Yo - Dureye New Fitu | ዱርዬ ነው ፊቱ - New Ethiopian Music 2018 (Official Video) by Hope Music Ethiopia 3 years ago 3 minutes, 26 seconds 1,877,524 views",Hope Music Entertainment,1877524,1884673,7149
1571,"Bisrat Surafel - Weynye | ወይንዬ - New Ethiopian Music 2018 (Official Audio) by Hope Music Ethiopia 3 years ago 4 minutes, 7 seconds 411,409 views",Hope Music Entertainment,411409,412043,634
1572,"Bisrat Surafel ft. Lij Michael - Atenekuat | አትንኳት - New Ethiopian Music 2018 (Official Audio) by Hope Music Ethiopia 3 years ago 4 minutes, 39 seconds 1,333,847 views",Hope Music Entertainment,1333847,1336752,2905
1573,"Bisrat Surafel - Eyuat | እዩዋት - New Ethiopian Music 2018 (Official Audio) by Hope Music Ethiopia 3 years ago 4 minutes, 36 seconds 589,202 views",Hope Music Entertainment,589202,592143,2941
1574,"Bisrat Surafel - Zarem Kehuala | ዛሬም ከኋላ - New Ethiopian Music 2018 (Official Audio) by Hope Music Ethiopia 3 years ago 5 minutes, 12 seconds 434,428 views",Hope Music Entertainment,434428,435037,609
1575,"Bisrat Surafel - Ethiopiawi Negn | ኢትዮጵያዊ ነኝ - New Ethiopian Music 2018 (Official Audio) by Hope Music Ethiopia 3 years ago 4 minutes, 40 seconds 148,003 views",Hope Music Entertainment,148003,148159,156
1576,"Bisrat Surafel - Godanaw | ጎዳናው - New Ethiopian Music 2018 (Official Audio) by Hope Music Ethiopia 3 years ago 5 minutes, 21 seconds 1,390,660 views",Hope Music Entertainment,1390660,1393606,2946
1577,"Bisrat Surafel ft. Jah Lude - Afalgugn | አፋልጉኝ - New Ethiopian Music 2018 (Official Audio) by Hope Music Ethiopia 3 years ago 4 minutes, 2 seconds 209,236 views",Hope Music Entertainment,209236,209698,462
1578,"Bisrat Surafel - Ehedalehu | እሄዳለሁ - New Ethiopian Music 2018 (Official Audio) by Hope Music Ethiopia 3 years ago 4 minutes, 19 seconds 268,098 views",Hope Music Entertainment,268098,268642,544
1579,"Bisrat Surafel - Ansimalee | አንሲመሌ - New Ethiopian Music 2018 (Official Audio) by Hope Music Ethiopia 3 years ago 4 minutes, 20 seconds 525,353 views",Hope Music Entertainment,525353,527190,1837
1580,"Bisrat Surafel - Zim Yalewin Firaw | ዝም ያለውን ፍራው - New Ethiopian Music 2018 (Official Audio) by Hope Music Ethiopia 3 years ago 4 minutes, 28 seconds 206,635 views",Hope Music Entertainment,206635,206920,285
1581,"Bisrat Surafel - Kal Bekal | ቃል በቃል - New Ethiopian Music 2018 (Official Audio) by Hope Music Ethiopia 3 years ago 5 minutes, 20 seconds 1,597,449 views",Hope Music Entertainment,1597449,1599954,2505
1582,"Gezae Fitwi - Kem Tmnitey | ከም ትምንተይ - New Ethiopian Music 2018 (Official Video) by Hope Music Ethiopia 3 years ago 5 minutes, 31 seconds 61,894 views",Hope Music Entertainment,61894,61995,101
1583,"Tararanga - Natbaro - New Ethiopian Music 2018 (Official Video) by Hope Music Ethiopia 3 years ago 6 minutes, 12 seconds 82,955 views",Hope Music Entertainment,82955,83160,205
1584,"Netsanet Abere - Kal Gibalign | ቃል ግባልኝ - New Ethiopian Music 2018 (Official Video) by Hope Music Ethiopia 3 years ago 6 minutes, 26 seconds 1,278,156 views",Hope Music Entertainment,1278156,1281371,3215
1585,"Netsanet Melkamu ft. Jino - Security - New Ethiopian Music 2018 (Official Video) by Hope Music Ethiopia 3 years ago 4 minutes, 36 seconds 1,630,222 views",Hope Music Entertainment,1630222,1638248,8026
1586,"Haylay Gebru - Meley Meleye | መለይ መለየ - New Ethiopian Tigrigna Music 2018 (Official Video) by Hope Music Ethiopia 3 years ago 6 minutes, 31 seconds 75,650 views",Hope Music Entertainment,75650,76953,1303
1587,"Buze Man, Mulualem Takele, Kaleab Mulugeta, Millena Biniam & Wendi mar - And Nen - Ethiopian Music by Hope Music Ethiopia 3 years ago 5 minutes, 50 seconds 724,810 views",Hope Music Entertainment,724810,725852,1042
1588,"Bisrat Surafel - Kal Bekal | ቃል በቃል - New Ethiopian Music Album Promo 2018 by Hope Music Ethiopia 3 years ago 1 minute, 33 seconds 42,538 views",Hope Music Entertainment,42538,42559,21
1589,"Kibra Moges - Semonun | ሰሞኑን - New Ethiopian Music 2018 (Official Video) by Hope Music Ethiopia 3 years ago 5 minutes, 12 seconds 285,691 views",Hope Music Entertainment,285691,285744,53
1590,"Biruk Tsegaye - Yehiwote Mieraf | የህይወቴ ምዕራፍ - New Ethiopian Music 2018 (Official Video) by Hope Music Ethiopia 3 years ago 4 minutes, 41 seconds 57,030 views",Hope Music Entertainment,57030,57039,9
1591,"Melaku Tilaye - Yayishal | ያይሻል - New Ethiopian Music 2018 (Official Video) by Hope Music Ethiopia 3 years ago 4 minutes, 48 seconds 42,454 views",Hope Music Entertainment,42454,42471,17
1592,"Samuel Mengistu - Tiz Bilegn | ትዝ ቢለኝ - New Ethiopian Music 2018 (Official Video) by Hope Music Ethiopia 3 years ago 4 minutes, 58 seconds 302,115 views",Hope Music Entertainment,302115,302156,41
1593,"Bling - Temelesh | ተመለሽ - New Ethiopian Music 2018 (Official Video) by Hope Music Ethiopia 3 years ago 5 minutes, 10 seconds 106,404 views",Hope Music Entertainment,106404,106540,136
1594,"Wendi Tone - Yalanchi | ያላንቺ - New Ethiopian Music 2018 (Official Video) by Hope Music Ethiopia 3 years ago 5 minutes, 9 seconds 56,431 views",Hope Music Entertainment,56431,56447,16
1595,"Mesay Berhanu - Tayibet | ታይበት - New Ethiopian Music 2018 (Official Video) by Hope Music Ethiopia 3 years ago 6 minutes, 1 second 221,232 views",Hope Music Entertainment,221232,221283,51
1596,"Gashaw Molla - Silalu | ስላሉ - New Ethiopian Music 2018 (Official Video) by Hope Music Ethiopia 3 years ago 5 minutes, 26 seconds 133,001 views",Hope Music Entertainment,133001,133090,89
1597,"Befkadu Yadete - Hagere | ሀገሬ - New Ethiopian Music 2018 (Official Video) by Hope Music Ethiopia 3 years ago 6 minutes, 24 seconds 1,046,554 views",Hope Music Entertainment,1046554,1047807,1253
1598,"Gizachew Solomon - Qoriruni | ቆሪሩኒ - New Ethiopian Tigrigna Music 2018 (Official Video) by Hope Music Ethiopia 3 years ago 5 minutes, 16 seconds 342,479 views",Hope Music Entertainment,342479,343140,661
1599,"Fisum T - Pretty Woman - New Ethiopian Music 2018 (Official Video) by Hope Music Ethiopia 3 years ago 4 minutes, 17 seconds 2,310,060 views",Hope Music Entertainment,2310060,2317781,7721
1600,"Muas Baba - Amaregn | አማረኝ - New Ethiopian Music 2018 (Official Video) by Hope Music Ethiopia 3 years ago 4 minutes, 42 seconds 80,716 views",Hope Music Entertainment,80716,80756,40
1601,"Misgena Goytom - Newenesela | ንወነሰላ - New Ethiopian Tigrigna Music 2018 (Official Video) by Hope Music Ethiopia 3 years ago 5 minutes, 8 seconds 55,366 views",Hope Music Entertainment,55366,55383,17
1602,"Lense Lemessa - NA NA | ና ና - New Ethiopian Music 2018 (Official Video) by Hope Music Ethiopia 3 years ago 6 minutes, 41 seconds 336,766 views",Hope Music Entertainment,336766,336918,152
1603,"Nuradis Seid - Etatu | እታቱ - New Ethiopian Music 2018 (Official Video) by Hope Music Ethiopia 3 years ago 5 minutes, 11 seconds 1,830,211 views",Hope Music Entertainment,1830211,1846711,16500
1604,"Yeabsira Samuel - Tenageri | ተናገሪ - New Ethiopian Music 2018 (Official Video) by Hope Music Ethiopia 3 years ago 5 minutes, 7 seconds 48,907 views",Hope Music Entertainment,48907,48913,6
1605,"Yohannes Gebregziabher - Guayla Adey | ጓይላ ዓደይ - New Ethiopian Tigrigna Music 2018 (Official Video) by Hope Music Ethiopia 3 years ago 6 minutes, 8 seconds 212,848 views",Hope Music Entertainment,212848,213232,384
1606,"Haimi Asrat - Lante New | ላንተ ነው - New Ethiopian Music 2018 (Official Video) by Hope Music Ethiopia 3 years ago 3 minutes, 27 seconds 172,730 views",Hope Music Entertainment,172730,173022,292
1607,"Abebe Kefeni - Jiraaree - New Ethiopian Oromo Music 2018 (Official Video) by Hope Music Ethiopia 3 years ago 5 minutes, 18 seconds 117,664 views",Hope Music Entertainment,117664,117841,177
1608,"Yared Negu ft. Esayas Fikadu - Aleye | አልዬ - New Ethiopian Music 2018 (Official Video) by Hope Music Ethiopia 3 years ago 4 minutes, 31 seconds 2,206,018 views",Hope Music Entertainment,2206018,2209705,3687
1609,"Dereje Bizuwork - Marye Ney | ማርዬ ነይ - New Ethiopian Music 2018 (Official Video) by Hope Music Ethiopia 3 years ago 6 minutes, 44 seconds 226,128 views",Hope Music Entertainment,226128,227076,948
1610,"Yitbarek Abebe Temtim - Temechachi | ተመቻቺ - New Ethiopian Music 2018 (Official Video) by Hope Music Ethiopia 3 years ago 4 minutes, 7 seconds 130,661 views",Hope Music Entertainment,130661,130788,127
1611,"Sintayehu Haile - Mela | መላ - New Ethiopian Music 2018 (Official Video) by Hope Music Ethiopia 3 years ago 5 minutes, 12 seconds 117,455 views",Hope Music Entertainment,117455,117589,134
1612,"Filmon Alem - Aytelieliley | ኣይተልዕልለይ - New Tigrigna Music 2018 (Official Video) by Hope Music Ethiopia 3 years ago 5 minutes, 49 seconds 213,853 views",Hope Music Entertainment,213853,213922,69
1613,"Abelo DX - Gonder | ጎንደር - New Ethiopian Music 2018 (Official Video) by Hope Music Ethiopia 3 years ago 4 minutes, 40 seconds 57,926 views",Hope Music Entertainment,57926,57962,36
1614,"Goitom Gebreye - Azmarino | ኣዝማሪኖ - New Ethiopian Tigrigna Music 2018 (Official Video) by Hope Music Ethiopia 3 years ago 5 minutes, 50 seconds 289,546 views",Hope Music Entertainment,289546,289971,425
1615,"Fitsum G/Tsadik - Yegna Emama | የኛ እማማ - New Ethiopian Music 2018 (Official Video) by Hope Music Ethiopia 3 years ago 3 minutes, 49 seconds 69,096 views",Hope Music Entertainment,69096,69120,24
1616,"Semere A/Giorgis - Litay | ልታይ - New Ethiopian Music 2018 (Official Video) by Hope Music Ethiopia 3 years ago 5 minutes, 46 seconds 78,278 views",Hope Music Entertainment,78278,78299,21
1617,"Biruk Wendaferaw - Lewsedish | ልውሰድሽ - New Ethiopian Music 2018 (Official Video) by Hope Music Ethiopia 3 years ago 5 minutes, 42 seconds 270,524 views",Hope Music Entertainment,270524,270918,394
1618,"Getu Omahire - Endanleyay | እንዳንለያይ - New Ethiopian Music 2018 (Official Video) by Hope Music Ethiopia 3 years ago 5 minutes, 29 seconds 1,768,757 views",Hope Music Entertainment,1768757,1784363,15606
1619,"Rahwa Gali - Mesaka | ምሳኻ - New Ethiopian Tigrigna Music 2018 (Official Video) by Hope Music Ethiopia 3 years ago 5 minutes, 12 seconds 2,869,251 views",Hope Music Entertainment,2869251,2872229,2978
1620,"Teddy Yo - LO'O LO'O | ሎኦ ሎኦ - New Ethiopian Music 2018 (Official Video) by Hope Music Ethiopia 3 years ago 4 minutes, 17 seconds 3,316,113 views",Hope Music Entertainment,3316113,3323951,7838
1621,"Bisrat Surafel - Yebet Sira | የቤት ስራ - New Ethiopian Music 2018 (Official Video) by Hope Music Ethiopia 3 years ago 4 minutes, 46 seconds 1,774,122 views",Hope Music Entertainment,1774122,1775335,1213
1622,"AndyB ft. Dawit Bosco - Yaz Yaz | ያዝ ያዝ - New Ethiopian Music 2018 (Official Video) by Hope Music Ethiopia 3 years ago 5 minutes, 29 seconds 48,664 views",Hope Music Entertainment,48664,48667,3
1623,"Mulualem Takele & Ephrem Amare - Teshenfialehu | ተሸንፌያለሁ - New Ethiopian Music 2018 (Official Video) by Hope Music Ethiopia 3 years ago 5 minutes, 13 seconds 19,680,245 views",Hope Music Entertainment,19680245,19762130,81885
1624,"Habtamu G/Tsadik - Ethiopia | ኢትዮጽያ - New Ethiopian Music 2018 (Official Video) by Hope Music Ethiopia 3 years ago 5 minutes, 34 seconds 73,509 views",Hope Music Entertainment,73509,73515,6
1625,"Wave Slassian ft. Sami Go - Ere Menieyu - New Ethiopian Tigrigna Music 2018 (Official Video) by Hope Music Ethiopia 3 years ago 4 minutes, 29 seconds 101,678 views",Hope Music Entertainment,101678,101761,83
1626,"Solomon Kassa ft. Jacob & AP - Eskis Enibel | እስክስ እንበል - New Ethiopian Music 2018 (Official Video) by Hope Music Ethiopia 3 years ago 5 minutes, 6 seconds 46,294 views",Hope Music Entertainment,46294,46321,27
1627,"Habtamu Alene - Awdumba | አውዱምባ - New Ethiopian Music 2018 (Official Video) by Hope Music Ethiopia 3 years ago 5 minutes, 6 seconds 105,085 views",Hope Music Entertainment,105085,105151,66
1628,"Betelhem Zerfu - Nikaw | ንካው - New Ethiopian Music 2018 (Official Video) by Hope Music Ethiopia 3 years ago 4 minutes, 31 seconds 460,633 views",Hope Music Entertainment,460633,461038,405
1629,"Tsigabu Teshale - Komies | ኮሚዒስ - New Ethiopian Tigrigna Music 2018 (Official Video) by Hope Music Ethiopia 3 years ago 7 minutes, 59 seconds 730,443 views",Hope Music Entertainment,730443,733139,2696
1630,"Selamawit Yohannes - Hanen | ሃነን - New Ethiopian Music 2018 (Official Video) by Hope Music Ethiopia 3 years ago 5 minutes, 16 seconds 16,653,175 views",Hope Music Entertainment,16653175,16704180,51005
1631,"Roza Negash - Felege | ፈልጌ - New Ethiopian Music 2018 (Official Video) by Hope Music Ethiopia 3 years ago 4 minutes, 57 seconds 297,972 views",Hope Music Entertainment,297972,298184,212
1632,"Yidnekachew Tsegaye - Segirato | ሰጊራቶ - New Ethiopian Tigrigna Music 2018 (Official Video) by Hope Music Ethiopia 3 years ago 4 minutes, 21 seconds 106,918 views",Hope Music Entertainment,106918,106931,13
1633,"ED Tadesse ft. Belatenaw - Engenagn Simesh | እንገናኝ ሲመሽ - New Ethiopian Music 2018 (Official Video) by Hope Music Ethiopia 3 years ago 3 minutes, 56 seconds 25,505 views",Hope Music Entertainment,25505,25523,18
1634,"Issac K/Mariam - Nerakhebelu | ንራኸበሉ - New Ethiopian Tigrigna Music 2018 (Official Video) by Hope Music Ethiopia 3 years ago 5 minutes, 58 seconds 35,587 views",Hope Music Entertainment,35587,35596,9
1635,"Mr. Yemo - Layew | ላየው - New Ethiopian Music 2018 (Official Video) by Hope Music Ethiopia 3 years ago 5 minutes, 11 seconds 75,331 views",Hope Music Entertainment,75331,75338,7
1636,"Fiseha Wedaj - Lasta Lalibela | ላስታ ላሊበላ - New Ethiopian Music 2018 (Official Video) by Hope Music Ethiopia 3 years ago 5 minutes, 47 seconds 206,610 views",Hope Music Entertainment,206610,206965,355
1637,"Gebremariam Asnakew - Anguaba Anguaba | አንጓባ አንጓባ - New Ethiopian Music 2018 (Official Video) by Hope Music Ethiopia 3 years ago 6 minutes, 11 seconds 101,965 views",Hope Music Entertainment,101965,102179,214
1638,"Hana Asmamaw - Nalign | ናልኝ - New Ethiopian Music 2018 (Official Video) by Hope Music Ethiopia 3 years ago 3 minutes, 33 seconds 58,692 views",Hope Music Entertainment,58692,58724,32
1639,"Michael Aregay - Neaki Hize | ነዓኺ ሒዘ - New Ethiopian Tigrigna Music 2018 (Official Video) by Hope Music Ethiopia 3 years ago 5 minutes, 10 seconds 48,890 views",Hope Music Entertainment,48890,48914,24
1640,"Khalid Kebir - Akale Wube | አካሌ ውቤ - New Ethiopian Music 2018 (Official Video) by Hope Music Ethiopia 3 years ago 5 minutes, 39 seconds 73,738 views",Hope Music Entertainment,73738,73788,50
1641,"Dereje Belay - Sasebish Adralehu | ሳስብሽ አድራለሁ - New Ethiopian Music 2018 (Official Video) by Hope Music Ethiopia 3 years ago 5 minutes, 54 seconds 505,478 views",Hope Music Entertainment,505478,507251,1773
1642,"John Feta - Feta Bel | ፈታ በል - New Ethiopian Tigrigna Music 2018 (Official Video) by Hope Music Ethiopia 3 years ago 5 minutes, 20 seconds 97,953 views",Hope Music Entertainment,97953,98004,51
1643,"Ismael Abdu - Beykirta | በይቅርታ - New Ethiopian Music 2018 (Official Video) by Hope Music Ethiopia 3 years ago 5 minutes, 3 seconds 216,126 views",Hope Music Entertainment,216126,216139,13
1644,"Nuradis Seid & Tilahun Ale - Sesi Guma | ሰሲ ጉማ - New Ethiopian Music 2018 (Official Video) by Hope Music Ethiopia 3 years ago 6 minutes, 11 seconds 2,634,261 views",Hope Music Entertainment,2634261,2645335,11074
1645,"Abdisa Sida - Temeleshi | ተመለሺ - New Ethiopian Music 2018 (Official Video) by Hope Music Ethiopia 3 years ago 5 minutes, 53 seconds 263,045 views",Hope Music Entertainment,263045,263547,502
1646,"Sintayehu Tesfaye - Nishan | ኒሻን - New Ethiopian Music 2018 (Official Video) by Hope Music Ethiopia 3 years ago 5 minutes, 44 seconds 128,189 views",Hope Music Entertainment,128189,128256,67
1647,"Abel Mulugeta - Yehager Tibeb | የሃገር ጥበብ - New Ethiopian Music 2018 (Official Video) by Hope Music Ethiopia 3 years ago 6 minutes, 26 seconds 561,283 views",Hope Music Entertainment,561283,561708,425
1648,"Jirenya Shiferaw - Hundan Siibita - New Ethiopian Oromo Music 2018 (Official Video) by Hope Music Ethiopia 3 years ago 7 minutes, 8 seconds 2,653,774 views",Hope Music Entertainment,2653774,2667090,13316
1649,"Azeb Abebe - Zeraf | ዘራፍ - New Ethiopian Music 2018 (Official Video) by Hope Music Ethiopia 3 years ago 4 minutes, 55 seconds 63,149 views",Hope Music Entertainment,63149,63162,13
1650,"Tadesse Mekonen - Zegeyesh | ዘገዬሽ - New Ethiopian Music 2018 (Official Video) by Hope Music Ethiopia 3 years ago 6 minutes, 54 seconds 48,523 views",Hope Music Entertainment,48523,48568,45
1651,"Hirut Tsegaye - Enhun Zemenay | እንሁን ዘመናይ - New Ethiopian Music 2018 (Official Video) by Hope Music Ethiopia 3 years ago 5 minutes, 53 seconds 180,845 views",Hope Music Entertainment,180845,180940,95
1652,"Solomon Gash Abe -  Shamo | ሻሞ - New Ethiopian Music 2018 (Official Video) by Hope Music Ethiopia 3 years ago 4 minutes, 26 seconds 96,931 views",Hope Music Entertainment,96931,96971,40
1653,"Sam Seyoum - Wubet Ande Neber | ውበት አንድ ነበር - New Ethiopian Music 2018 (Official Video) by Hope Music Ethiopia 3 years ago 4 minutes, 23 seconds 54,404 views",Hope Music Entertainment,54404,54413,9
1654,"Yeshi Desalegn - Hasabe | ሀሳቤ - New Ethiopian Music 2018 (Official Video) by Hope Music Ethiopia 3 years ago 5 minutes, 20 seconds 73,251 views",Hope Music Entertainment,73251,73273,22
1655,"Sam Habesha - Hoya Gashe | ሆያ ጋሼ - New Ethiopian Music 2018 (Official Video) by Hope Music Ethiopia 3 years ago 5 minutes, 54 seconds 63,915 views",Hope Music Entertainment,63915,63926,11
1656,"Mahlet Gebregiorgis - Na | ና - New Ethiopian Tigrigna Music 2018 (Official Video) by Hope Music Ethiopia 3 years ago 6 minutes, 3 seconds 7,332,477 views",Hope Music Entertainment,7332477,7356761,24284
1657,"Girum Wudu - Yeshashwerk Belay | የሻሽወርቅ በላይ - New Ethiopian Music 2018 (Official Video) by Hope Music Ethiopia 3 years ago 6 minutes, 9 seconds 280,278 views",Hope Music Entertainment,280278,280492,214
1658,"Berhe Wedi Marse - Saeri Lemalim | ሳዕሪ ለማልም - New Ethiopian Tigrigna Music 2018 (Official Video) by Hope Music Ethiopia 3 years ago 6 minutes, 50 seconds 447,628 views",Hope Music Entertainment,447628,448249,621
1659,"Abel Almaz - Debdaben Bezema | ደብዳቤን በዜማ - New Ethiopian Music 2018 (Official Video) by Hope Music Ethiopia 3 years ago 6 minutes, 3 seconds 1,849,709 views",Hope Music Entertainment,1849709,1859235,9526
1660,"Solomon Getahun - Welela | ወለላ - New Ethiopian Music 2018 (Official Video) by Hope Music Ethiopia 3 years ago 4 minutes, 59 seconds 29,681 views",Hope Music Entertainment,29681,29695,14
1661,"Meri Frisky ft. Merkeb Bonitua -  Kenieni - New Ethiopian Tigrigna Music 2018 (Official Video) by Hope Music Ethiopia 3 years ago 5 minutes, 57 seconds 301,976 views",Hope Music Entertainment,301976,302241,265
1662,"Ezzy ft. Markan - I Luv U - New Ethiopian Music 2018 (Official Video) by Hope Music Ethiopia 3 years ago 3 minutes, 45 seconds 173,788 views",Hope Music Entertainment,173788,174059,271
1663,"Asnake Gebreyes - Alasaznshim | አላሳዝንሺም - New Ethiopian Music 2018 (Official Video) by Hope Music Ethiopia 3 years ago 6 minutes, 43 seconds 529,919 views",Hope Music Entertainment,529919,532829,2910
1664,"Yohannes Berhanu - Sint Jegna Alefe | ስንት ጀግና አለፈ - New Ethiopian Music 2018 (Official Video) by Hope Music Ethiopia 3 years ago 8 minutes, 50 seconds 96,730 views",Hope Music Entertainment,96730,96842,112
1665,"Skat Nati - Sira | ስራ - New Ethiopian Music 2018 (Official Video) by Hope Music Ethiopia 3 years ago 3 minutes, 42 seconds 1,320,286 views",Hope Music Entertainment,1320286,1324062,3776
1666,"Ashenafi Geremew - Degmen Engaba | ደግመን እንጋባ - New Ethiopian Music 2018 (Official Video) by Hope Music Ethiopia 3 years ago 5 minutes, 18 seconds 227,477 views",Hope Music Entertainment,227477,227813,336
1667,"Teddy Yo ft. Abraham (Shalaye) -  Medhanit - New Ethiopian Music 2018 (Official Audio W/Lyrics) by Hope Music Ethiopia 3 years ago 2 minutes, 26 seconds 19,944 views",Hope Music Entertainment,19944,19982,38
1668,"Teddy Yo ft. Jo Lax, Godana & Yemaryam - Andegna | አንደኛ - New Ethiopian Music 2018 (Official Audio) by Hope Music Ethiopia 3 years ago 3 minutes, 53 seconds 16,732 views",Hope Music Entertainment,16732,16761,29
1669,"Teddy Yo - Banchi Miknyat | ባንች ምክንያት - New Ethiopian Music 2018 (Official Audio W/Lyrics) by Hope Music Ethiopia 3 years ago 4 minutes, 29 seconds 344,394 views",Hope Music Entertainment,344394,346060,1666
1670,"Teddy Yo ft. Lij Eyasu, Alex & J Matik - Habesha Hip Hop - New Ethiopian Music 2018 (Official Audio) by Hope Music Ethiopia 3 years ago 4 minutes, 39 seconds 36,975 views",Hope Music Entertainment,36975,37198,223
1671,"Teddy Yo - Endezi Endeza | እንደዚ እንደዛ - New Ethiopian Music 2018 (Official Audio W/Lyrics) by Hope Music Ethiopia 3 years ago 3 minutes, 18 seconds 65,919 views",Hope Music Entertainment,65919,66036,117
1672,"Teddy Yo ft. Jo Lax & Bitanya - Ketsehay Betach - New Ethiopian Music 2018 (Official Audio W/Lyrics) by Hope Music Ethiopia 3 years ago 4 minutes, 13 seconds 36,725 views",Hope Music Entertainment,36725,36775,50
1673,"Teddy Yo - Esregna | እስረኛ -  New Ethiopian Music 2018 (Official Audio W/Lyrics) by Hope Music Ethiopia 3 years ago 3 minutes, 25 seconds 138,185 views",Hope Music Entertainment,138185,138425,240
1674,"Teddy Yo ft. Lij Eyasu - Chisu | ጭሱ - New Ethiopian Music 2018 (Official Audio W/Lyrics) by Hope Music Ethiopia 3 years ago 3 minutes, 20 seconds 209,374 views",Hope Music Entertainment,209374,210534,1160
1675,"Teddy Yo ft. Ziggy Zagga - Werea | ወሬ - New Ethiopian Music 2018 (Official Audio W/Lyrics) by Hope Music Ethiopia 3 years ago 3 minutes, 21 seconds 71,724 views",Hope Music Entertainment,71724,71789,65
1676,"Teddy Yo - Lo’o Lo’o | ሎኦ ሎኦ - New Ethiopian Music 2018 (Official Audio W/Lyrics) by Hope Music Ethiopia 3 years ago 3 minutes, 30 seconds 66,441 views",Hope Music Entertainment,66441,66496,55
1677,"Teddy Yo ft. Lij Eyasu - Alew belegn | አለው በለኝ - New Ethiopian Music 2018 (Official Audio W/Lyrics) by Hope Music Ethiopia 3 years ago 3 minutes, 56 seconds 70,614 views",Hope Music Entertainment,70614,70852,238
1678,"Teddy Yo & Gentleman ft King Kong & Yemaryam - Africa - New Ethiopian Music 2018 (Audio W/Lyrics) by Hope Music Ethiopia 3 years ago 3 minutes, 30 seconds 52,003 views",Hope Music Entertainment,52003,52114,111
1679,"Teddy Yo - Amalay | አማላይ - New Ethiopian Music 2018 (Official Audio W/Lyrics) by Hope Music Ethiopia 3 years ago 3 minutes, 57 seconds 182,865 views",Hope Music Entertainment,182865,183297,432
1680,"Teddy Yo ft Get Anley - WA! | ዋ! - New Ethiopian Music 2018 (Official Audio W/Lyrics) by Hope Music Ethiopia 3 years ago 3 minutes, 54 seconds 87,359 views",Hope Music Entertainment,87359,87509,150
1681,"Biruktawit Fantahun ft. Wendye Abebe - Temenaye | ቴመናዬ - New Ethiopian Music 2018 (Official Video) by Hope Music Ethiopia 3 years ago 4 minutes, 58 seconds 39,057 views",Hope Music Entertainment,39057,39070,13
1682,"Lij Wubeshet Fikadu - Hule | ሁሌ - New Ethiopian Music 2018 (Official Video) by Hope Music Ethiopia 3 years ago 5 minutes, 5 seconds 36,725 views",Hope Music Entertainment,36725,36730,5
1683,"Netsanet Sultan ft. Sami Go - ABAYA | አባያ - New Ethiopian Music 2018 (Official Video) by Hope Music Ethiopia 3 years ago 5 minutes, 24 seconds 3,389,859 views",Hope Music Entertainment,3389859,3399849,9990
1684,"Haimanot Mateb - Kengedi | ከእንግዲህ - New Ethiopian Music 2018 (Official Video) by Hope Music Ethiopia 3 years ago 6 minutes, 20 seconds 49,130 views",Hope Music Entertainment,49130,49132,2
1685,"Samson Yaynu - Bunaw Lay | ቡናው ላይ - New Ethiopian Music 2018 (Official Video) by Hope Music Ethiopia 3 years ago 6 minutes, 42 seconds 118,234 views",Hope Music Entertainment,118234,118282,48
1686,"Tesfahun Hailu - Anchi Yagere Lij  | አንቺ ያገሬ ልጅ - New Ethiopian Music 2018 (Official Video) by Hope Music Ethiopia 3 years ago 5 minutes, 37 seconds 91,885 views",Hope Music Entertainment,91885,91921,36
1687,"Solo Wuletaw - Saro | ሳሮ - New Ethiopian Music 2018 (Official Video) by Hope Music Ethiopia 3 years ago 3 minutes, 45 seconds 295,412 views",Hope Music Entertainment,295412,296643,1231
1688,"E Dove - Moode | ሙዴ - New Ethiopian Music 2018 (Official Video) by Hope Music Ethiopia 3 years ago 4 minutes, 4 seconds 49,939 views",Hope Music Entertainment,49939,49954,15
1689,"Lakech Mebratu - Agegnehuat | አገኘዋለሁ - New Ethiopian Music 2018 (Official Video) by Hope Music Ethiopia 3 years ago 7 minutes, 3 seconds 160,163 views",Hope Music Entertainment,160163,160288,125
1690,"Essayas Yukuno - Endieleye | እንድዕለየ - New Eritrean Music 2018 (Official Video) by Hope Music Ethiopia 3 years ago 5 minutes, 39 seconds 134,940 views",Hope Music Entertainment,134940,134969,29
1691,"Mulu Gossaye - Gizeyen Sitegn | ጊዜዬን ስጠኝ - New Ethiopian Music 2018 (Official Video) by Hope Music Ethiopia 3 years ago 4 minutes, 15 seconds 100,525 views",Hope Music Entertainment,100525,100545,20
1692,"Demelash Haile - Kichinba | ክችንባ - New Ethiopian Music 2018 (Official Video) by Hope Music Ethiopia 3 years ago 4 minutes, 3 seconds 52,943 views",Hope Music Entertainment,52943,52967,24
1693,"Azeb Seyoum - Selam | ሰላም - New Ethiopian Music 2018 (Official Video) by Hope Music Ethiopia 3 years ago 6 minutes, 18 seconds 82,854 views",Hope Music Entertainment,82854,82869,15
1694,"Tadilo Boled ft. Mekuanent Melesse - Nekaktesh | ነካክተሽ - New Ethiopian Music 2018 (Official Video) by Hope Music Ethiopia 3 years ago 5 minutes, 36 seconds 210,062 views",Hope Music Entertainment,210062,210274,212
1695,"Syco David - Lakolamitat | ላቆላምጣት - New Ethiopian Music 2018 (Official Video) by Hope Music Ethiopia 3 years ago 4 minutes, 1 second 32,525 views",Hope Music Entertainment,32525,32553,28
1696,"Eshetu Mersha - Moyzerye | ሞይዘርዬ - New Ethiopian Music 2018 (Official Video) by Hope Music Ethiopia 3 years ago 6 minutes, 19 seconds 356,729 views",Hope Music Entertainment,356729,357468,739
1697,"Bekele Endalamaw - Wesedat | ወሰዳት - New Ethiopian Music 2018 (Official Video) by Hope Music Ethiopia 3 years ago 3 minutes, 57 seconds 33,913 views",Hope Music Entertainment,33913,33918,5
1698,"Sintayehu Ameha  - Nieshtoye | ንእሽቶየ -  New Ethiopian Tigrigna Music 2018 (Official Video) by Hope Music Ethiopia 3 years ago 5 minutes, 47 seconds 1,257,789 views",Hope Music Entertainment,1257789,1263776,5987
1699,"Eyerusalem Ashebir - Sitamregn | ስታምረኝ - New Ethiopian Music 2018 (Official Video) by Hope Music Ethiopia 4 years ago 5 minutes, 37 seconds 258,266 views",Hope Music Entertainment,258266,258350,84
1700,"Bekele Arega & Mestawet Adegeh - Zeraf | ዘራፍ - New Ethiopian Music 2018 (Official Video) by Hope Music Ethiopia 4 years ago 5 minutes, 4 seconds 74,315 views",Hope Music Entertainment,74315,74371,56
1701,"Teddy Yo - Arada | አራዳ - New Ethiopian Music Album Promo 2018 by Hope Music Ethiopia 4 years ago 1 minute, 12 seconds 73,467 views",Hope Music Entertainment,73467,73552,85
1702,"Emebet Negasi - Begize | በጊዜ - New Ethiopian Music 2018 (Official Video) by Hope Music Ethiopia 4 years ago 6 minutes, 13 seconds 802,182 views",Hope Music Entertainment,802182,805202,3020
1703,"Addis Negash - Yene Funga | የኔ ፉንጋ - New Ethiopian Music 2018 (Official Video) by Hope Music Ethiopia 4 years ago 4 minutes, 35 seconds 68,840 views",Hope Music Entertainment,68840,68879,39
1704,"Tesfalidet Tadesse - Kebrer Yalech | ቀብረር ያለች - New Ethiopian Music 2018 (Official Video) by Hope Music Ethiopia 4 years ago 5 minutes, 8 seconds 118,534 views",Hope Music Entertainment,118534,118570,36
1705,"Missa Mesele - Mis Deki Adey | ምስ ደቂ አደይ - New Ethiopian Tigrigna Music 2018 (Official Video) by Hope Music Ethiopia 4 years ago 6 minutes, 29 seconds 184,516 views",Hope Music Entertainment,184516,184622,106
1706,"Fitsum Belete - Bera | በራ - New Ethiopian Music 2017 (Official Video) by Hope Music Ethiopia 4 years ago 4 minutes, 47 seconds 85,477 views",Hope Music Entertainment,85477,85494,17
1707,"Berhanu Tefaye ft. Veronica Adane -  Yet Teftesh New - New Ethiopian Music 2018 (Official Video) by Hope Music Ethiopia 4 years ago 4 minutes, 10 seconds 217,658 views",Hope Music Entertainment,217658,217774,116
1708,"Alex ft. Ella Man & Teddy Yo - Wegebua | ወገቧ - New Ethiopian Music 2018 (Official Video) by Hope Music Ethiopia 4 years ago 3 minutes, 23 seconds 585,354 views",Hope Music Entertainment,585354,586678,1324
1709,"Abebe Girma - Somaw | ሶማው - New Ethiopian Music 2018 (Official Video) by Hope Music Ethiopia 4 years ago 6 minutes, 3 seconds 275,733 views",Hope Music Entertainment,275733,276079,346
1710,"Isaac Kidanemariam - Fenan | ፍናን - New Ethiopian Tigrigna Music 2018 (Official Video) by Hope Music Ethiopia 4 years ago 6 minutes, 6 seconds 37,835 views",Hope Music Entertainment,37835,37848,13
1711,"Emnet Mesay - Guro Weshebaye | ጉሮ ወሸባዬ - New Ethiopian Music 2018 (Official Video) by Hope Music Ethiopia 4 years ago 5 minutes, 10 seconds 90,626 views",Hope Music Entertainment,90626,90645,19
1712,"Gerush Yalem - Deki Adey | ደቂ አደይ - New Ethiopian Tigrigna Music 2018 (Official Video) by Hope Music Ethiopia 4 years ago 5 minutes, 40 seconds 82,477 views",Hope Music Entertainment,82477,82508,31
1713,"Wubshet Dejene - Konjo Nesh | ቆንጆ ነሽ - New Ethiopian Music 2018 (Official Video) by Hope Music Ethiopia 4 years ago 3 minutes, 7 seconds 94,756 views",Hope Music Entertainment,94756,94774,18
1714,"Habtamu Kassaye - Lichal Gid Yelem | ልቻል ግድ የለም - New Ethiopian Music 2018 (Official Video) by Hope Music Ethiopia 4 years ago 4 minutes, 43 seconds 85,881 views",Hope Music Entertainment,85881,85954,73
1715,"Yigrem Assefa - Shakimalle | ሸኪመሌ - New Ethiopian Oromo Music 2018 (Official Video) by Hope Music Ethiopia 4 years ago 6 minutes, 8 seconds 129,165 views",Hope Music Entertainment,129165,129257,92
1716,"Seble Aregawi - Weyza Hadarey | ወይዛ ሓዳረይ - New Ethiopian Tigrigna Music 2018 (Official Video) by Hope Music Ethiopia 4 years ago 4 minutes, 21 seconds 366,489 views",Hope Music Entertainment,366489,366615,126
1717,"Misrak Taye - Marakiye | ማራኪዬ - New Ethiopian Music 2018 (Official Video) by Hope Music Ethiopia 4 years ago 6 minutes, 10 seconds 303,710 views",Hope Music Entertainment,303710,304009,299
1718,"Anteneh Asrat - Ney Lafta | ነይ ላፍታ - New Ethiopian Music 2018 (Official Video) by Hope Music Ethiopia 4 years ago 5 minutes, 30 seconds 172,894 views",Hope Music Entertainment,172894,172931,37
1719,"Michael Melaku - Dudu | ዱዱ - New Ethiopian Music 2018 (Official Video) by Hope Music Ethiopia 4 years ago 5 minutes, 16 seconds 401,520 views",Hope Music Entertainment,401520,401679,159
1720,"Eskedar Wedaje - Yisemah | ይሰማህ - New Ethiopian Music 2018 (Official Video) by Hope Music Ethiopia 4 years ago 5 minutes, 28 seconds 255,725 views",Hope Music Entertainment,255725,255934,209
1721,"Eyobed X Jordan Musika - Alayeshim Embayen | አላየሺም እምባየን - New Ethiopian Music 2018 (Official Video) by Hope Music Ethiopia 4 years ago 4 minutes, 36 seconds 104,255 views",Hope Music Entertainment,104255,104418,163
1722,"Yami Brhane - Abziatey | ኣብዚኣተይ - New Ethiopian Tigrigna Music 2018 (Official Video) by Hope Music Ethiopia 4 years ago 5 minutes, 2 seconds 300,718 views",Hope Music Entertainment,300718,300953,235
1723,"Dagne Walle - Yecheneke Elet (Wub Abeba 2) | የጨነቀለት - New Ethiopian Music 2018 (Official Video) by Hope Music Ethiopia 4 years ago 7 minutes, 3 seconds 9,302,414 views",Hope Music Entertainment,9302414,9339097,36683
1724,"Asgegnew Ashko (Asge) - Nudere Gamo Gofa - New Ethiopian Music 2018 (Official Video) by Hope Music Ethiopia 4 years ago 5 minutes, 18 seconds 1,114,772 views",Hope Music Entertainment,1114772,1122759,7987
1725,"Amanuel Yemane & Yapi Mapi - Gud Gerkni | ጉድጌርክኒ - Ethiopian Tigrigna Music 2018 (Official Video) by Hope Music Ethiopia 4 years ago 6 minutes, 1 second 1,349,258 views",Hope Music Entertainment,1349258,1354154,4896
1726,"Tiemtu Gebrehiwet - Kuhlo | ኩሕሎ - New Ethiopian Tigrigna Music 2018 (Official Video) by Hope Music Ethiopia 4 years ago 5 minutes, 50 seconds 137,412 views",Hope Music Entertainment,137412,137505,93
1727,"Tewodros Assefa - Akukulu | አኩኩሉ - New Ethiopian Music 2018 (Official Video) by Hope Music Ethiopia 4 years ago 5 minutes, 9 seconds 154,036 views",Hope Music Entertainment,154036,154092,56
1728,"Endrias Mekonnen - Libe Libe | ልቤ ልቤ - New Ethiopian Music 2018 (Official Video) by Hope Music Ethiopia 4 years ago 5 minutes, 24 seconds 489,622 views",Hope Music Entertainment,489622,489892,270
1729,"Fikremariam Gebru - Gefa Gefa | ገፋ ገፋ - New Ethiopian Music 2018 (Official Video) by Hope Music Ethiopia 4 years ago 6 minutes, 7 seconds 256,441 views",Hope Music Entertainment,256441,256739,298
1730,"Kako Getachew - Aroge Arada 2 | አሮጌ አራዳ #2 - New Ethiopian Music 2018 (Official Video) by Hope Music Ethiopia 4 years ago 4 minutes, 52 seconds 5,320,446 views",Hope Music Entertainment,5320446,5356482,36036
1731,"Eyerus Anteneh - Sayih Beruk | ሳይህ በሩቅ - New Ethiopian Music 2018 (Official Video) by Hope Music Ethiopia 4 years ago 4 minutes, 34 seconds 153,768 views",Hope Music Entertainment,153768,153801,33
1732,"Sami Dan - Hayal (Remix) | ሃያል - New Ethiopian Music 2018 (Official Video) by Hope Music Ethiopia 4 years ago 4 minutes, 47 seconds 160,146 views",Hope Music Entertainment,160146,160535,389
1733,"Kidus Metye ft Gildo kassa - Koyadayas | ኮያዳያስ - New Ethiopian Music 2018 (Official Video) by Hope Music Ethiopia 4 years ago 4 minutes, 8 seconds 87,102 views",Hope Music Entertainment,87102,87317,215
1734,"Kefey Hagos - Ata Gerami | ኣታ ገራሚ - New Ethiopian Tigrigna Music 2018 (Official Video) by Hope Music Ethiopia 4 years ago 6 minutes, 42 seconds 493,000 views",Hope Music Entertainment,493000,493077,77
1735,"Tesfaye Adugna - Des Aylegnim | ደስ አይለኝም - New Ethiopian Music 2018 (Official Video) by Hope Music Ethiopia 4 years ago 6 minutes, 1 second 820,430 views",Hope Music Entertainment,820430,823186,2756
1736,"Dawit Alemayehu - Alayehushim | አላየሁሽም - New Ethiopian Music 2018 (Official Video) by Hope Music Ethiopia 4 years ago 5 minutes, 29 seconds 1,882,600 views",Hope Music Entertainment,1882600,1887801,5201
1737,"Bewketu Sewmehon - Meneshaye | መነሻዬ - New Ethiopian Music 2018 (Official Video) by Hope Music Ethiopia 4 years ago 6 minutes, 3 seconds 2,854,036 views",Hope Music Entertainment,2854036,2861495,7459
1738,"Etsegenet Hailemariam ft. Asgegnew Ashko (Asge) - Mahelando - New Ethiopian Music  (Official Video) by Hope Music Ethiopia 4 years ago 5 minutes, 39 seconds 6,997,520 views",Hope Music Entertainment,6997520,7012866,15346
1739,"Meselu Fantahun - Welelaw | ወለላው - New Ethiopian Music 2018 (Official Video) by Hope Music Ethiopia 4 years ago 4 minutes, 56 seconds 3,062,855 views",Hope Music Entertainment,3062855,3088538,25683
1740,"Adera Tigabu - Tolo Ney | ቶሎ ነይ - New Ethiopian Tigrigna Music 2018 (Official Video) by Hope Music Ethiopia 4 years ago 4 minutes, 54 seconds 68,592 views",Hope Music Entertainment,68592,68645,53
1741,"Messuwani - Atsgeba | ኣፅገባ - New Ethiopian Tigrigna Music 2018 (Official Video) by Hope Music Ethiopia 4 years ago 5 minutes, 13 seconds 131,580 views",Hope Music Entertainment,131580,131914,334
1742,"Kalye - Likora | ሊኮራ - New Ethiopian Music 2018 (Official Video) by Hope Music Ethiopia 4 years ago 4 minutes, 20 seconds 112,982 views",Hope Music Entertainment,112982,113029,47
1743,"Niway Damte (Suke) - Tenesabign | ተነሳብኝ - New Ethiopian Music 2018 (Official Video) by Hope Music Ethiopia 4 years ago 5 minutes, 42 seconds 380,218 views",Hope Music Entertainment,380218,380433,215
1744,"Micky Gonderegna ft. Yared Negu X Jordan & Bek Ge'ez - Shege | ሸጌ - Ethiopian Music (Official Video) by Hope Music Ethiopia 4 years ago 4 minutes, 41 seconds 1,985,270 views",Hope Music Entertainment,1985270,1987543,2273
1745,"Redet Tolosa - Melaw Bitefagn | መላው ቢጠፋብኝ - New Ethiopian Music 2018 (Official Video) by Hope Music Ethiopia 4 years ago 4 minutes, 26 seconds 58,881 views",Hope Music Entertainment,58881,58892,11
1746,"Mukur Weldu - Ayni Fenjaley | ኣይኒ ፍንጃለይ - New  Ethiopian Tigrigna Music 2018 (Official Video) by Hope Music Ethiopia 4 years ago 4 minutes, 58 seconds 70,122 views",Hope Music Entertainment,70122,70163,41
1747,"Addis Gurmesa - Konjit | ቆንጂት - New Ethiopian Music 2018 (Official Video) by Hope Music Ethiopia 4 years ago 5 minutes, 27 seconds 2,002,172 views",Hope Music Entertainment,2002172,2013087,10915
1748,"Mesfin Berhanu - Selam Alewa | ሰላም ኣለዋ - New Tigrigna Music 2018 (Official Video) by Hope Music Ethiopia 4 years ago 7 minutes, 16 seconds 11,408,969 views",Hope Music Entertainment,11408969,11437867,28898
1749,"Abebe Teka & Henok Ekubamichael - Wede Kibir Midir - New Ethiopian Music 2018 (Official Video) by Hope Music Ethiopia 4 years ago 7 minutes, 55 seconds 367,323 views",Hope Music Entertainment,367323,367627,304
1750,"Buze Man (Buzayehu Kifle) - Tirngoye | ትርንጎዬ - New Ethiopian Music 2018 (Official Video) by Hope Music Ethiopia 4 years ago 5 minutes, 10 seconds 1,265,785 views",Hope Music Entertainment,1265785,1268870,3085
1751,"Weeha ft. Key Bek X Jordan & Bek Ge'ez -  Fikir | ፍቅር - New Ethiopian Music 2018 (Official Video) by Hope Music Ethiopia 4 years ago 4 minutes, 44 seconds 2,146,721 views",Hope Music Entertainment,2146721,2151682,4961
1752,"Mulugeta Mesfin - Melkua | መልኳ - New Ethiopian Music 2018 (Official Video) by Hope Music Ethiopia 4 years ago 4 minutes, 13 seconds 67,673 views",Hope Music Entertainment,67673,67685,12
1753,"Timnit Welday - Weni | ወኒ - New Ethiopian Tigrigna Music 2018 (Official Video) by Hope Music Ethiopia 4 years ago 4 minutes, 52 seconds 10,205,549 views",Hope Music Entertainment,10205549,10243167,37618
1754,"Rahel Getachew - Beal Gaesi | በዓል ጋዕሲ - Ethiopian Tigrigna Music 2018 (Official Video) by Hope Music Ethiopia 4 years ago 5 minutes, 44 seconds 290,167 views",Hope Music Entertainment,290167,290236,69
1755,"Gizachew Teklemariam - Ligabaw Beyene | ሊጋባው በየነ - New Ethiopian Music 2018 (Official Video) by Hope Music Ethiopia 4 years ago 8 minutes, 33 seconds 6,288,198 views",Hope Music Entertainment,6288198,6316325,28127
1756,"Dereje Shewakena - Awdamet | አውደአመት - New Ethiopian Music 2018 (Official Video) by Hope Music Ethiopia 4 years ago 6 minutes, 43 seconds 1,222,542 views",Hope Music Entertainment,1222542,1223826,1284
1757,"Mr. Wina ft. Semon & Kall - Tewedeshal | ተወደሻል - New Ethiopian Music 2018 (Official Video) by Hope Music Ethiopia 4 years ago 5 minutes, 5 seconds 159,902 views",Hope Music Entertainment,159902,160034,132
1758,"Andualem Ayalew - Awdamet | አውደአመት - New Ethiopian Music 2018 (Official Video) by Hope Music Ethiopia 4 years ago 5 minutes, 43 seconds 258,402 views",Hope Music Entertainment,258402,258476,74
1759,"Kira Abigaro - Kisaraye | ኪሳራዬ - New Ethiopian Music 2018 (Official Video) by Hope Music Ethiopia 4 years ago 4 minutes, 55 seconds 193,786 views",Hope Music Entertainment,193786,194050,264
1760,"Merkeb Baryagabir - Borom Borom | ቦሮም ቦሮም - New Ethiopian Tigrigna Music 2018 (Official Video) by Hope Music Ethiopia 4 years ago 4 minutes, 43 seconds 3,461,911 views",Hope Music Entertainment,3461911,3473439,11528
1761,"Abel Teklemariam - Enchi | እንቺ - New Ethiopian Music 2017 (Official Video) by Hope Music Ethiopia 4 years ago 4 minutes, 49 seconds 161,029 views",Hope Music Entertainment,161029,161055,26
1762,"Melese & Asmelash - Selam Nat | ሰላምናት - New Ethiopian Music 2017 (Official Video) by Hope Music Ethiopia 4 years ago 5 minutes, 19 seconds 108,159 views",Hope Music Entertainment,108159,108177,18
1763,"Rahel Haile - Aklilelu | ኣቕልለሉ - New Ethiopian Tigrigna Music 2017 (Official Video) by Hope Music Ethiopia 4 years ago 5 minutes, 1 second 7,262,002 views",Hope Music Entertainment,7262002,7292950,30948
1764,"Solomon Fikre - Tizitash | ትዝታሽ - New Ethiopian Music 2017 (Official Video) by Hope Music Ethiopia 4 years ago 6 minutes, 4 seconds 238,962 views",Hope Music Entertainment,238962,239028,66
1765,"Maereg Tilaye ft. Mergitu - Mela Mela | መላ መላ - New Ethiopian Music 2017 (Official Video) by Hope Music Ethiopia 4 years ago 5 minutes, 11 seconds 38,601 views",Hope Music Entertainment,38601,38643,42
1766,"Gebrehiwot Hadush - Tsehayki Berikua | ፀሓይኪ በሪቓ - New Ethiopian Tigrigna Music 2017 (Official Video) by Hope Music Ethiopia 4 years ago 5 minutes, 20 seconds 174,375 views",Hope Music Entertainment,174375,174513,138
1767,"Fisum T -  Demama | ድማማ - New Ethiopian Music 2017 (Official Video) by Hope Music Ethiopia 4 years ago 5 minutes, 1 second 608,225 views",Hope Music Entertainment,608225,609342,1117
1768,"Senait Birhanu - Wa | ዋ!!! - New Ethiopian Music 2017 (Official Video) by Hope Music Ethiopia 4 years ago 6 minutes, 54 seconds 119,903 views",Hope Music Entertainment,119903,119972,69
1769,"Lij Yared - Endemude | እንደሙዴ - New Ethiopian Music 2017 (Official Video) by Hope Music Ethiopia 4 years ago 4 minutes, 10 seconds 154,110 views",Hope Music Entertainment,154110,154210,100
1770,"Job 27 - Nishan | ኒሻን - New Ethiopian Music 2017 (Official Video) by Hope Music Ethiopia 4 years ago 3 minutes, 43 seconds 860,724 views",Hope Music Entertainment,860724,864539,3815
1771,"Enyew Metanya - Wub Aleme | ውብ አለሜ - New Ethiopian Music 2017 (Official Video) by Hope Music Ethiopia 4 years ago 4 minutes, 47 seconds 184,319 views",Hope Music Entertainment,184319,184334,15
1772,"Fish ft. Samon - Mizer | ሚዘር - New Ethiopian Tigrigna Music 2017 (Official Video) by Hope Music Ethiopia 4 years ago 5 minutes, 47 seconds 164,679 views",Hope Music Entertainment,164679,164771,92
1773,"Bewketu Sewmehon - Amen | አሜን - New Ethiopian Music 2017 (Official Video) by Hope Music Ethiopia 4 years ago 6 minutes, 37 seconds 521,750 views",Hope Music Entertainment,521750,523630,1880
1774,"Million Eshetu -  Niendo Nabay  | ንዕን'ዶ ናባይ - New Ethiopian Tigrigna Music 2017 (Official Video) by Hope Music Ethiopia 4 years ago 4 minutes, 32 seconds 3,260,531 views",Hope Music Entertainment,3260531,3262619,2088
1775,"Yidnekachew Girma - Weaysirile | ወሃይሲርሌ - New Ethiopian Music 2017 (Official Video) by Hope Music Ethiopia 4 years ago 4 minutes, 57 seconds 79,530 views",Hope Music Entertainment,79530,79602,72
1776,"Teshale Gebrelibanos - Wesedet | ወሰደት - New Ethiopian Tigrigna Music 2017 (Official Video) by Hope Music Ethiopia 4 years ago 5 minutes, 22 seconds 102,696 views",Hope Music Entertainment,102696,102724,28
1777,"Netsanet Lema - Tolo Na | ቶሎ ና - New Ethiopian Music 2017 (Official Video) by Hope Music Ethiopia 4 years ago 4 minutes, 16 seconds 795,281 views",Hope Music Entertainment,795281,801749,6468
1778,"Mebrat Nigussie - Liben Setehu | ልቤን ሰተሁ - New Ethiopian Music 2017 (Official Video) by Hope Music Ethiopia 4 years ago 3 minutes, 56 seconds 30,796 views",Hope Music Entertainment,30796,30808,12
1779,"Nati Haile - Alo | አሎ - New Ethiopian Music 2017 (Official Video) by Hope Music Ethiopia 4 years ago 5 minutes, 30 seconds 1,820,273 views",Hope Music Entertainment,1820273,1827609,7336
1780,"Sintayehu Fantu - Ledegagim New | ልደጋግም ነው - New Ethiopian Music 2017 (Official Video) by Hope Music Ethiopia 4 years ago 5 minutes, 53 seconds 38,600 views",Hope Music Entertainment,38600,38610,10
1781,"Frezer Kenaw - Dershaye | ድርሻዬ - New Ethiopian Music 2017 (Official Video) by Hope Music Ethiopia 4 years ago 5 minutes, 4 seconds 143,420 views",Hope Music Entertainment,143420,143790,370
1782,"Henok Mehari - Am In Love - New Ethiopian Music 2017 (Official Video) by Hope Music Ethiopia 4 years ago 3 minutes, 21 seconds 111,385 views",Hope Music Entertainment,111385,111507,122
1783,"Kichini Goa - Demariye | ዴማሪዬ - New Ethiopian Music 2017 (Official Video) by Hope Music Ethiopia 4 years ago 3 minutes, 31 seconds 168,843 views",Hope Music Entertainment,168843,169066,223
1784,"Yitagesu Nibretu - Gude | ጉዴ - New Ethiopian Music 2017 (Official Video) by Hope Music Ethiopia 4 years ago 5 minutes, 27 seconds 84,890 views",Hope Music Entertainment,84890,84910,20
1785,"Mulugeta Lema - Aleme | አለሜ - New Ethiopian Music 2017 (Official Video) by Hope Music Ethiopia 4 years ago 3 minutes, 56 seconds 52,591 views",Hope Music Entertainment,52591,52605,14
1786,"Naafkoo Sobbooqaa - Assasaa - New Ethiopian Music 2017 (Official Video) by Hope Music Ethiopia 4 years ago 6 minutes, 26 seconds 50,460 views",Hope Music Entertainment,50460,50512,52
1787,"Indris Hussein - Zatua | ዛቷ - New Ethiopian Music 2017 (Official Video) by Hope Music Ethiopia 4 years ago 6 minutes, 15 seconds 68,174 views",Hope Music Entertainment,68174,68231,57
1788,"Gete Anley - Yekey Tikur Teyim (Ashenefech) - New Ethiopian Music 2017 (Official Video) by Hope Music Ethiopia 4 years ago 5 minutes, 37 seconds 333,441 views",Hope Music Entertainment,333441,334531,1090
1789,"Honey Spice - Kena Beye | ቀና ብዬ - New Ethiopian Music 2017 (Official Video) by Hope Music Ethiopia 4 years ago 2 minutes, 50 seconds 61,273 views",Hope Music Entertainment,61273,61349,76
1790,"Mikias Chernet - And New Demachin | አንድ ነው ደማችን - New Ethiopian Music 2017 (Official Video) by Hope Music Ethiopia 4 years ago 5 minutes, 35 seconds 167,007 views",Hope Music Entertainment,167007,167094,87
1791,"Tarekegn Mulu - Smiyachew | ስሚያቸው - New Ethiopian Music 2017 (Official Video) by Hope Music Ethiopia 4 years ago 6 minutes, 20 seconds 1,796,244 views",Hope Music Entertainment,1796244,1799743,3499
1792,"Gebru Gebremedhin - Beal Kebero | ባዓል ከበሮ - New Ethiopian Tigrigna Music 2017 (Official Video) by Hope Music Ethiopia 4 years ago 5 minutes, 6 seconds 589,855 views",Hope Music Entertainment,589855,590259,404
1793,"Yigrem Assefa - Handere | ሀንደሬ - New Ethiopian Music 2017 (Official Video) by Hope Music Ethiopia 4 years ago 5 minutes, 6 seconds 72,907 views",Hope Music Entertainment,72907,72958,51
1794,"Birhane Tefera - Koottu Siin Yaada - New Ethiopian Music 2017 (Official Video) by Hope Music Ethiopia 4 years ago 3 minutes, 53 seconds 72,534 views",Hope Music Entertainment,72534,72598,64
1795,"Abel Tarekegn - Acham Yelat | አቻም የላት - New Ethiopian Music 2017 (Official Video) by Hope Music Ethiopia 4 years ago 5 minutes, 26 seconds 146,958 views",Hope Music Entertainment,146958,147074,116
1796,"Wendmagegn Mitku - Zim | ዝም - New Ethiopian Music 2017 (Official Video) by Hope Music Ethiopia 4 years ago 5 minutes, 18 seconds 41,352 views",Hope Music Entertainment,41352,41354,2
1797,"Zemach - Shekerker | ሽቅርቅር - New Ethiopian Music 2017 (Official Video) by Hope Music Ethiopia 4 years ago 4 minutes, 27 seconds 136,088 views",Hope Music Entertainment,136088,136134,46
1798,"Azmera Chekol - Heruy | ሕሩይ - New Ethiopian Tigrigna Music 2017 (Official Video) by Hope Music Ethiopia 4 years ago 6 minutes, 8 seconds 111,475 views",Hope Music Entertainment,111475,111505,30
1799,"Abush Zeleke X Jordan & Bek Ge'ez - Maaloo Intaloo - New Ethiopian Music 2017 (Official Video) by Hope Music Ethiopia 4 years ago 4 minutes, 39 seconds 3,098,043 views",Hope Music Entertainment,3098043,3107615,9572
1800,"Wendi Mak & Hahu Beatz - Anchi Shegere | አንቺ ሸገሬ - New Ethiopian Music 2017 (Official Video) by Hope Music Ethiopia 4 years ago 4 minutes, 12 seconds 2,077,206 views",Hope Music Entertainment,2077206,2081896,4690
1801,"Sancho Gebre ft. Gildo Kassa - Atasayugn | አታሳዩኝ - New Ethiopian Music 2017 (Official Video) by Hope Music Ethiopia 4 years ago 3 minutes, 59 seconds 15,543,454 views",Hope Music Entertainment,15543454,15619024,75570
1802,"Biniam Weldu - Maleda | ማለዳ - New Ethiopian Music 2017 (Official Video) by Hope Music Ethiopia 4 years ago 5 minutes, 42 seconds 602,186 views",Hope Music Entertainment,602186,602652,466
1803,"Yabu Jc ft. Dave Ahadu -  Kene Lela | ከኔ ሌላ - New Ethiopian Music 2017 (Official Video) by Hope Music Ethiopia 4 years ago 3 minutes, 35 seconds 94,212 views",Hope Music Entertainment,94212,94236,24
1804,"Mulualem Welde - Eyamaregn | እያማረኝ - New Ethiopian Music 2017 (Official Video) by Hope Music Ethiopia 4 years ago 4 minutes, 52 seconds 268,447 views",Hope Music Entertainment,268447,268482,35
1805,"Amir Dawud - Sehaba Nate | ሰሓባ ' ናቴ - New Ethiopian Tigrigna Music 2017 (Official Video) by Hope Music Ethiopia 4 years ago 6 minutes, 24 seconds 658,164 views",Hope Music Entertainment,658164,659206,1042
1806,"Abeba Demeke - Belilign Gorded | በልልኝ ጎርደድ - New Ethiopian music 2017 (Official Video) by Hope Music Ethiopia 4 years ago 5 minutes, 2 seconds 49,240 views",Hope Music Entertainment,49240,49253,13
1807,"Dagim Adane - Yewah | የዋህ - New Ethiopian Music 2017 (Official Video) by Hope Music Ethiopia 4 years ago 4 minutes, 25 seconds 2,712,252 views",Hope Music Entertainment,2712252,2723423,11171
1808,"Bereket Aklilu - Alkerm | አልቀርም - New Ethiopian Music 2017 (Official Video) by Hope Music Ethiopia 4 years ago 4 minutes, 54 seconds 68,910 views",Hope Music Entertainment,68910,68921,11
1809,"Dawit Alemayehu - Welela | ወለላ - New Ethiopian Tigrigna Music 2017 (Official Video) by Hope Music Ethiopia 4 years ago 4 minutes, 12 seconds 3,500,696 views",Hope Music Entertainment,3500696,3507598,6902
1810,"Bewketu Sewmehon - Yebetezemedu | የቤተዘመዱ - New Ethiopian Music 2017 (Official Video) by Hope Music Ethiopia 4 years ago 6 minutes, 37 seconds 1,633,193 views",Hope Music Entertainment,1633193,1645464,12271
1811,"Beky B - Woldia | ወልድያ - New Ethiopian Music 2017 (Official Video) by Hope Music Ethiopia 4 years ago 4 minutes, 15 seconds 142,172 views",Hope Music Entertainment,142172,142310,138
1812,"Efrem Assefa - Solyana | ሶልያና - New Ethiopian Music 2017 (Official Video) by Hope Music Ethiopia 4 years ago 4 minutes, 54 seconds 64,002 views",Hope Music Entertainment,64002,64047,45
1813,"Emebet Negasi - Yasazinal | ያሳዝናል - New Ethiopian Music 2017 (Official Video) by Hope Music Ethiopia 4 years ago 6 minutes, 40 seconds 3,917,491 views",Hope Music Entertainment,3917491,3931943,14452
1814,"Yonas Abate - Hulum Silat | ሁሉም ሲላት - New Ethiopian Music 2017 (Official Video) by Hope Music Ethiopia 4 years ago 3 minutes, 56 seconds 76,227 views",Hope Music Entertainment,76227,76256,29
1815,"Aschenaki Bekele - Lewal | ልዋል - New Ethiopian Music 2017 (Official Video) by Hope Music Ethiopia 4 years ago 4 minutes, 21 seconds 127,131 views",Hope Music Entertainment,127131,127284,153
1816,"Demere Legesse & Asrebeb Tadege - Bela Libelha | በላ ልበልሃ - New Ethiopian Music 2017 (Official Video) by Hope Music Ethiopia 4 years ago 8 minutes 661,595 views",Hope Music Entertainment,661595,661871,276
1817,"Gedion Daniel - Bewedat | ብወዳት - New Ethiopian Music 2017 (Official Video) by Hope Music Ethiopia 4 years ago 4 minutes, 37 seconds 1,112,492 views",Hope Music Entertainment,1112492,1114384,1892
1818,"Girmaw Admasu - Embi | እምቢ - New Ethiopian Music 2017 (Official Video) by Hope Music Ethiopia 4 years ago 5 minutes, 48 seconds 109,904 views",Hope Music Entertainment,109904,109934,30
1819,"kingo - Konjoya | ቆንጆያ - New Ethiopian Music 2017 (Official Video) by Hope Music Ethiopia 4 years ago 4 minutes, 15 seconds 203,673 views",Hope Music Entertainment,203673,203713,40
1820,"Fitsum Gebretsadik - Saydewl | ሳይደውል - New Ethiopian Music 2017 (Official Video) by Hope Music Ethiopia 4 years ago 3 minutes, 52 seconds 316,647 views",Hope Music Entertainment,316647,316794,147
1821,"Geremew Gualu - Sim Alew Gonder | ስም አለው ጎንደር - New Ethiopian Music 2017 (Official Video) by Hope Music Ethiopia 4 years ago 5 minutes, 47 seconds 188,230 views",Hope Music Entertainment,188230,188554,324
1822,"Sam G & Gerry - Kanchi Gar | ካንቺ ጋር - New Ethiopian Music 2017 (Official Video) by Hope Music Ethiopia 4 years ago 3 minutes, 50 seconds 1,592,626 views",Hope Music Entertainment,1592626,1594904,2278
1823,"Keren Melesse - Ene Gondere Negn | እኔ ጎንደሬ ነኝ - New Ethiopian Music 2017 (Official Video) by Hope Music Ethiopia 4 years ago 5 minutes, 56 seconds 751,971 views",Hope Music Entertainment,751971,752390,419
1824,"Firehiwot & Fikadu - Enkilfen Deribeh | እንቅልፌን ደርበህ - New Ethiopian Music 2017 (Official Video) by Hope Music Ethiopia 4 years ago 5 minutes, 57 seconds 6,165,907 views",Hope Music Entertainment,6165907,6197422,31515
1825,"Etenesh Demeke - Yaselam | ያሰላም - New Ethiopian Music 2017 (Official Video) by Hope Music Ethiopia 4 years ago 5 minutes, 56 seconds 352,026 views",Hope Music Entertainment,352026,352440,414
1826,"Tadele Roba ft. Gash Abera Molla - Mamakusa | ማማኩሳ - New Ethiopian Music 2017 (Official Video) by Hope Music Ethiopia 4 years ago 4 minutes, 52 seconds 201,716 views",Hope Music Entertainment,201716,201809,93
1827,"Michael Abebe - Dershe | ደርሼ - New Ethiopian Music 2017 (Official Video) by Hope Music Ethiopia 4 years ago 4 minutes, 27 seconds 58,137 views",Hope Music Entertainment,58137,58147,10
1828,"Eskedar Birhane - Misay Naenay | ምሳይ ናዓናይ - New Ethiopian Music 2017 (Official Video) by Hope Music Ethiopia 4 years ago 5 minutes, 11 seconds 198,609 views",Hope Music Entertainment,198609,198625,16
1829,"Helina Demlew - Adihuas | አዲኋስ - New Ethiopian Music 2017 (Official Video) by Hope Music Ethiopia 4 years ago 4 minutes, 34 seconds 118,610 views",Hope Music Entertainment,118610,119146,536
1830,"Tewodros Kassahun - Dumba | ዱምባ - New Ethiopian Music 2017 (Official Video) by Hope Music Ethiopia 4 years ago 6 minutes, 47 seconds 614,955 views",Hope Music Entertainment,614955,615964,1009
1831,"Tsega Leul Hailemariam - Weyno | ወይኖ - New Ethiopian Music (Official Video) by Hope Music Ethiopia 4 years ago 7 minutes 173,396 views",Hope Music Entertainment,173396,173613,217
1832,"Efrem Yohannes - Mela Kalesh | መላ ካለሽ - New Ethiopian Music 2017 (Official Video) by Hope Music Ethiopia 4 years ago 4 minutes, 45 seconds 52,292 views",Hope Music Entertainment,52292,52300,8
1833,"Daniel Tilahun Gessesse - Wuha Atchemribet | ውሃ አትጨምሪበት - New Ethiopian Music 2017 (Official Video) by Hope Music Ethiopia 4 years ago 4 minutes, 23 seconds 25,099 views",Hope Music Entertainment,25099,25115,16
1834,"Ismael Mohammed - Tenegrolet | ተነግሮለት - New Ethiopian Music 2017 (Official Video) by Hope Music Ethiopia 4 years ago 6 minutes, 27 seconds 312,918 views",Hope Music Entertainment,312918,313168,250
1835,"Mastewal Chane - Balagerua | ባላገሯ - New Ethiopian Music 2017 (Official Video) by Hope Music Ethiopia 4 years ago 4 minutes, 23 seconds 413,801 views",Hope Music Entertainment,413801,414274,473
1836,"Matias Kidane - Ewedish | እወድሽ - New Ethiopian Music 2017 (Official Video) by Hope Music Ethiopia 4 years ago 5 minutes, 7 seconds 248,410 views",Hope Music Entertainment,248410,248428,18
1837,"Wendi Mak - Aba Dama | አባ ዳማ - New Ethiopian Music 2017 (Official Video) by Hope Music Ethiopia 4 years ago 6 minutes, 4 seconds 20,605,198 views",Hope Music Entertainment,20605198,20661713,56515
1838,"Teddy Yo - Yene Nesh | የኔ ነሽ - New Ethiopian Music 2017 (Official Video) by Hope Music Ethiopia 4 years ago 4 minutes, 20 seconds 762,968 views",Hope Music Entertainment,762968,764559,1591
1839,"Zuriash Alemayehu - Sumeyada | ሱመያዳ - New Ethiopian Music 2017 (Official Video) by Hope Music Ethiopia 4 years ago 4 minutes, 33 seconds 36,909 views",Hope Music Entertainment,36909,36918,9
1840,"Mekdes Abera - Min Teshale | ምን ተሻለ - New Ethiopian Music 2017 (Official Video) by Hope Music Ethiopia 4 years ago 4 minutes, 4 seconds 68,491 views",Hope Music Entertainment,68491,68552,61
1841,"Nebyu Mulu ft. Jino Edwalo - Azala Etesi - New Ethiopian Music 2017 (Official Video) by Hope Music Ethiopia 4 years ago 4 minutes, 24 seconds 82,766 views",Hope Music Entertainment,82766,82878,112
1842,"Dagne Walle & Solomon Demle - Tana Tamual Alu | ጣና ታሟል አሉ - New Ethiopian Music 2017 by Hope Music Ethiopia 4 years ago 6 minutes, 49 seconds 388,252 views",Hope Music Entertainment,388252,388436,184
1843,"Tesfay Gidey - Biwenamey | ብወናመይ - New Ethiopian Music 2017 (Official Video) by Hope Music Ethiopia 4 years ago 5 minutes, 23 seconds 119,728 views",Hope Music Entertainment,119728,119765,37
1844,"Weldemihret Gidey - Nigisti | ንግስቲ - New Ethiopian Music 2017 (Official Video) by Hope Music Ethiopia 4 years ago 5 minutes, 55 seconds 156,170 views",Hope Music Entertainment,156170,156226,56
1845,"Dag Daniel - Tayebish Kuta | ታየብሽ ቁጣ - New Ethiopian Music 2017 (Official Video) by Hope Music Ethiopia 4 years ago 3 minutes, 58 seconds 245,705 views",Hope Music Entertainment,245705,246932,1227
1846,"Ismael (Miz Jimi) - Wey Bey | ወይ በይ - New Ethiopian Music 2017 (Official Video) by Hope Music Ethiopia 4 years ago 4 minutes, 30 seconds 83,801 views",Hope Music Entertainment,83801,83855,54
1847,"Yitbarek Abebe Temtim - Ende Tsegereda | እንደጽጌሬዳ - New Ethiopian Music 2017 (Official Video) by Hope Music Ethiopia 4 years ago 4 minutes, 24 seconds 464,133 views",Hope Music Entertainment,464133,465080,947
1848,"Alemayehu Tesfaye - Gonder | ጎንደር - New Ethiopian Music 2017 (Official Video) by Hope Music Ethiopia 4 years ago 6 minutes, 16 seconds 286,698 views",Hope Music Entertainment,286698,287113,415
1849,"Abebe Berihun - Arbegna Nat | አርበኛ ናት - New Ethiopian Music 2017 (Official Video) by Hope Music Ethiopia 4 years ago 4 minutes, 37 seconds 72,837 views",Hope Music Entertainment,72837,72891,54
1850,"Tesfaye Adugna - Weleba | ወለባ - New Ethiopian Music 2017 (Official Video) by Hope Music Ethiopia 4 years ago 5 minutes, 43 seconds 500,345 views",Hope Music Entertainment,500345,501477,1132
1851,"Fikeru Yilkal - Arada | አራዳ - New Ethiopian Music 2017 (Official Video) by Hope Music Ethiopia 4 years ago 6 minutes, 43 seconds 484,143 views",Hope Music Entertainment,484143,485490,1347
1852,"Mulualem Takele - Demkesh Sitwechi | ደምቀሽ ስትወጪ -  New Ethiopian Music 2017 (Official Video) by Hope Music Ethiopia 4 years ago 4 minutes, 22 seconds 684,485 views",Hope Music Entertainment,684485,688348,3863
1853,"Jote Deresu - Salaka Salakasa | ሳላካ ሳላካሳ - New Ethiopian Music 2017 (Official Video) by Hope Music Ethiopia 4 years ago 4 minutes, 5 seconds 1,772,319 views",Hope Music Entertainment,1772319,1780265,7946
1854,"Estifanos Getahun - Shala Mala | ሻላ ማላ - New Ethiopian Music 2017 (Official Video) by Hope Music Ethiopia 4 years ago 5 minutes, 43 seconds 153,791 views",Hope Music Entertainment,153791,153849,58
1855,"Mamila Lukas - Selo | ሴሎ - New Ethiopian Music 2017 (Official Video) by Hope Music Ethiopia 4 years ago 5 minutes, 3 seconds 741,805 views",Hope Music Entertainment,741805,744692,2887
1856,"Mestawut  Adgeh - Sela | ሰላ - New Ethiopian Music 2017 (Official Video) by Hope Music Ethiopia 4 years ago 5 minutes, 8 seconds 298,363 views",Hope Music Entertainment,298363,298493,130
1857,"Yami - Zmtaye | ዝምታዬ - New Ethiopian Music 2017 (Official Video) by Hope Music Ethiopia 4 years ago 3 minutes, 55 seconds 92,014 views",Hope Music Entertainment,92014,92032,18
1858,"Alemayehu Hafte - Mashilu | ማሽሉ - New Ethiopian Music2017 (Official Video) by Hope Music Ethiopia 4 years ago 6 minutes, 34 seconds 790,689 views",Hope Music Entertainment,790689,796096,5407
1859,"Wasihun Hunegnaw - Ney Ney | ነይ ነይ - New Ethiopian Music 2017 (Official Video) by Hope Music Ethiopia 4 years ago 5 minutes, 36 seconds 69,787 views",Hope Music Entertainment,69787,69811,24
1860,"Bedilu Esayas - Shi Biweded | ሺ ቢወደድ - New Ethiopian Music 2017 (Official Video) by Hope Music Ethiopia 4 years ago 4 minutes, 30 seconds 673,553 views",Hope Music Entertainment,673553,675499,1946
1861,"Mahlet Demere - Manen Limen | ማንን ልመን - New Ethiopian Music 2017 (Official Video) by Hope Music Ethiopia 4 years ago 4 minutes, 53 seconds 356,523 views",Hope Music Entertainment,356523,356669,146
1862,"Efrem Gebremichael - Tadye | ታድዬ - New Ethiopian Music 2017 (Official Video) by Hope Music Ethiopia 4 years ago 5 minutes, 7 seconds 311,802 views",Hope Music Entertainment,311802,312179,377
1863,"Tigist Addisu - Wefe Lala | ወፌ ላላ - New Ethiopian Music 2017 (Official Video) by Hope Music Ethiopia 4 years ago 5 minutes, 44 seconds 621,917 views",Hope Music Entertainment,621917,622689,772
1864,"Berhe Wedi Marse - Weyley | ወይለይ - New Ethiopian Music 2017 (Official Video) by Hope Music Ethiopia 4 years ago 6 minutes, 33 seconds 724,270 views",Hope Music Entertainment,724270,724975,705
1865,"Fikremariam Gebru - Mamye | ማምዬ - New Ethiopian Music 2017 (Official Video) by Hope Music Ethiopia 4 years ago 4 minutes, 40 seconds 373,634 views",Hope Music Entertainment,373634,373729,95
1866,"Alemu Tafesse - Shiluk Bey | ሽሉክ ቤ - New Ethiopian Music 2017 (Official Video) by Hope Music Ethiopia 4 years ago 5 minutes, 21 seconds 81,548 views",Hope Music Entertainment,81548,81711,163
1867,"Sertsebirhan Tadesse - Welelo | ወለሎ - New Ethiopian Music 2017 (Official Video) by Hope Music Ethiopia 4 years ago 6 minutes, 25 seconds 292,284 views",Hope Music Entertainment,292284,292738,454
1868,"Merkeb Baryagabir - Agerchiw | ኣግርጭው - New Ethiopian Music 2017 (Official Video) by Hope Music Ethiopia 4 years ago 4 minutes, 35 seconds 5,893,014 views",Hope Music Entertainment,5893014,5906555,13541
1869,"Fantish Bekele - Zimtegnaw Geday | ዝምተኛው ገዳይ - New Ethiopian Music 2017 (Official Video) by Hope Music Ethiopia 4 years ago 6 minutes, 51 seconds 2,645,145 views",Hope Music Entertainment,2645145,2648761,3616
1870,"Habtamu G/Tsadik - Tiya Tinya | ቲያ ቲንያ - New Ethiopian Music 2017 (Official Video) by Hope Music Ethiopia 4 years ago 5 minutes, 8 seconds 38,699 views",Hope Music Entertainment,38699,38709,10
1871,"Tomas Hilu (Tomy+) - Tiwejina | ትወጂና - New Ethiopian Music 2017 (Official Video) by Hope Music Ethiopia 4 years ago 4 minutes, 44 seconds 2,461,337 views",Hope Music Entertainment,2461337,2474417,13080
1872,"Leul Zerihun - Eyoha | እዮሃ - New Ethiopian Music 2017 (Official Video) by Hope Music Ethiopia 4 years ago 5 minutes, 52 seconds 43,642 views",Hope Music Entertainment,43642,43644,2
1873,"Selam Mitiku - Eyale Fikir | እያለ ፍቅር -  New Ethiopian Music 2017 (Official Video) by Hope Music Ethiopia 4 years ago 5 minutes, 9 seconds 147,294 views",Hope Music Entertainment,147294,147349,55
1874,"Hailye Tadesse - Bezemene | በዘመኔ - New Ethiopian Music 2017 (Official Video) by Hope Music Ethiopia 4 years ago 6 minutes, 9 seconds 563,331 views",Hope Music Entertainment,563331,564647,1316
1875,"Fasil Semuni ft. Joan - Diaspora | ዲአስፖራ - New Ethiopian Music 2017 (Official Video) by Hope Music Ethiopia 4 years ago 4 minutes, 27 seconds 12,246 views",Hope Music Entertainment,12246,12250,4
1876,"Adem Mohammed - Siyaamee - New Ethiopian Music 2017 (Official Video) by Hope Music Ethiopia 4 years ago 4 minutes, 55 seconds 34,381 views",Hope Music Entertainment,34381,34507,126
1877,"Kira Abigaro - Ere... Lash | ኧረ ላሽ - New Ethiopian Music 2017 (Official Video) by Hope Music Ethiopia 4 years ago 5 minutes, 42 seconds 983,036 views",Hope Music Entertainment,983036,983692,656
1878,"Michaele Berhe (Miki) - Geramit ya | ገራሚት ያ - New Ethiopian Music 2017 (Official Video) by Hope Music Ethiopia 4 years ago 5 minutes, 4 seconds 188,179 views",Hope Music Entertainment,188179,188231,52
1879,"Dawit Wordofa - Minu Yegud New | ምኑ የጉድ ነው - New Ethiopian Music 2017 (Official Video) by Hope Music Ethiopia 4 years ago 7 minutes, 2 seconds 925,116 views",Hope Music Entertainment,925116,925656,540
1880,"Tizazu & Etagegnehu - Senor Wuletashin | ስኖር ውለታሽን - New Ethiopian Music 2017 (Official Video) by Hope Music Ethiopia 4 years ago 5 minutes, 10 seconds 86,429 views",Hope Music Entertainment,86429,86485,56
1881,"Eskiyas Mezemir - Koo Ta'i - New Ethiopian Music 2017 (Official Video) by Hope Music Ethiopia 4 years ago 6 minutes, 8 seconds 272,777 views",Hope Music Entertainment,272777,273837,1060
1882,"Zeni Tizazu - Zeraf | ዘራፍ - New Ethiopian Music 2017 (Official Video) by Hope Music Ethiopia 4 years ago 5 minutes, 2 seconds 76,304 views",Hope Music Entertainment,76304,76363,59
1883,"Kassahun Degefaw - Bej Bey | በእጅ በይ - New Ethiopian Music 2017 (Official Video) by Hope Music Ethiopia 4 years ago 6 minutes, 2 seconds 82,782 views",Hope Music Entertainment,82782,82834,52
1884,"Aster Kebede - Selantiya | ስላንቲያ - New Ethiopian Music 2017 (Official Video) by Hope Music Ethiopia 4 years ago 5 minutes, 53 seconds 201,728 views",Hope Music Entertainment,201728,202441,713
1885,"Bilisummaa Raggaasaa - Goobee - New Ethiopian Music 2017 (Official Video) by Hope Music Ethiopia 4 years ago 5 minutes, 42 seconds 218,308 views",Hope Music Entertainment,218308,219995,1687
1886,"Zinabu Gebresilassie - Awdamet | አውዳመት - New Ethiopian Music 2017 (Official Video) by Hope Music Ethiopia 4 years ago 5 minutes, 41 seconds 222,846 views",Hope Music Entertainment,222846,222893,47
1887,"Maritu Legesse - Addis Amet | አዲስ አመት - New Ethiopian Music 2017 (Official Video) by Hope Music Ethiopia 4 years ago 5 minutes, 16 seconds 1,433,318 views",Hope Music Entertainment,1433318,1434523,1205
1888,"Abela - Ney Bete | ነይ ቤቴ - New Ethiopian Music 2017 (Official Video) by Hope Music Ethiopia 4 years ago 7 minutes, 3 seconds 222,906 views",Hope Music Entertainment,222906,222941,35
1889,"Messay Bekele & Biruk Tenaw - Beal New Zare | በአል ነው ዛሬ - New Ethiopian Music 2017 (Official Video) by Hope Music Ethiopia 4 years ago 5 minutes, 51 seconds 536,912 views",Hope Music Entertainment,536912,537012,100
1890,"Temesgen Gebregziabher (Temu) - Hana | ሀና - New Ethiopian Music 2017 (Official Video) by Hope Music Ethiopia 4 years ago 4 minutes, 16 seconds 8,197,080 views",Hope Music Entertainment,8197080,8209754,12674
1891,"Aregahegn Worash - Atahu Amalaj | አጣሁ አማላጅ - New Ethiopian Music 2017 (Official Video) by Hope Music Ethiopia 4 years ago 5 minutes, 50 seconds 4,351,668 views",Hope Music Entertainment,4351668,4362276,10608
1892,"Buze Man (Buzayehu Kifle) - Awdamet Meta | አውዳመት መጣ - New Ethiopian Music 2017 (Official Video) by Hope Music Ethiopia 4 years ago 4 minutes, 59 seconds 542,792 views",Hope Music Entertainment,542792,543442,650
1893,"Asgegnew Ashko (Asge) ft. Betty G - Zono Zoka | ዞኖ ዞካ - New Ethiopian Music 2017 (Official Video) by Hope Music Ethiopia 4 years ago 3 minutes, 52 seconds 4,755,266 views",Hope Music Entertainment,4755266,4767249,11983
1894,"Gashaw Tesfa - Awdamet | አውዳመት - New Ethiopian Music 2017 (Official Video) by Hope Music Ethiopia 4 years ago 5 minutes, 22 seconds 364,964 views",Hope Music Entertainment,364964,365142,178
1895,"Goytom Tamrat - Welelay | ወለላይ - New Ethiopian Music 2017 (Official Video) by Hope Music Ethiopia 4 years ago 5 minutes, 20 seconds 390,141 views",Hope Music Entertainment,390141,390287,146
1896,"Abush Zeleke X Jordan & Bek Ge'ez - Maaloo Intaloo - New Ethiopian Music 2017 (Official Audio) by Hope Music Ethiopia 4 years ago 4 minutes, 40 seconds 170,406 views",Hope Music Entertainment,170406,170474,68
1897,"G Mesay kebede - Badis Amet | ባዲስ አመት - New Ethiopian Music 2017 (Official Video) by Hope Music Ethiopia 4 years ago 4 minutes, 38 seconds 532,664 views",Hope Music Entertainment,532664,533058,394
1898,"Dagnachew Lema - Kehualash | ከኋላሽ - New Ethiopian Music 2017 (Official Video) by Hope Music Ethiopia 4 years ago 4 minutes, 55 seconds 78,333 views",Hope Music Entertainment,78333,78351,18
1899,"Tombola Abebaw - Guadegnaye | ጓደኛዬ - New Ethiopian Music 2017 (Official Video) by Hope Music Ethiopia 4 years ago 4 minutes, 48 seconds 120,877 views",Hope Music Entertainment,120877,122184,1307
1900,"Sam Habesha - Yene Nat | የኔ ናት - New Ethiopian Music 2017 (Official Video) by Hope Music Ethiopia 4 years ago 4 minutes, 9 seconds 154,946 views",Hope Music Entertainment,154946,155101,155
1901,"Wendimu Abera - Alsemam | አልሰማም - New Ethiopian Music 2017 (Official Video) by Hope Music Ethiopia 4 years ago 4 minutes, 49 seconds 167,028 views",Hope Music Entertainment,167028,167074,46
1902,"Mule Rootz - Shewitey | ሸዊተይ - New Ethiopian Music 2017 (Official Video) by Hope Music Ethiopia 4 years ago 5 minutes, 25 seconds 1,278,324 views",Hope Music Entertainment,1278324,1280881,2557
1903,"Nuradis Seid - Ho Bel | ሆበል - New Ethiopian Music 2017 (Official Video) by Hope Music Ethiopia 4 years ago 5 minutes, 42 seconds 3,484,894 views",Hope Music Entertainment,3484894,3513671,28777
1904,"Yohannes Bayru - Zyaday | ዝያዳይ - New Ethiopian Music 2017 (Official Video) by Hope Music Ethiopia 4 years ago 4 minutes, 26 seconds 820,200 views",Hope Music Entertainment,820200,820875,675
1905,"Samuel Legesse - Fichign | ፍችኝ - New Ethiopian Music 2017 (Official Video) by Hope Music Ethiopia 4 years ago 4 minutes, 39 seconds 408,800 views",Hope Music Entertainment,408800,408894,94
1906,"Meseret Belete - Welelae | ወለሌ - New Ethiopian Music 2017 (Official Video) by Hope Music Ethiopia 4 years ago 6 minutes, 23 seconds 468,425 views",Hope Music Entertainment,468425,469068,643
1907,"Bewketu Sewmehon - Gojam | ጎጃም - New Ethiopian Music 2017 (Official Video) by Hope Music Ethiopia 4 years ago 6 minutes, 44 seconds 5,232,145 views",Hope Music Entertainment,5232145,5245074,12929
1908,"Samuel Derib - Markogn New | ማርኮኝ ነው - New Ethiopian Music 2017 (Official Video) by Hope Music Ethiopia 4 years ago 4 minutes, 28 seconds 38,014 views",Hope Music Entertainment,38014,38035,21
1909,"Sasahulish Berga - Gena | ገና - New Ethiopian Music 2017 (Official Video) by Hope Music Ethiopia 4 years ago 4 minutes, 53 seconds 2,869,803 views",Hope Music Entertainment,2869803,2888819,19016
1910,"Tsegay Haregot - Michiw Elela | ምችው ኢለላ - New Ethiopian Music 2017 (Official Video) by Hope Music Ethiopia 4 years ago 6 minutes, 14 seconds 802,870 views",Hope Music Entertainment,802870,803457,587
1911,"Mulugeta Kahsay - Shikorina | ሺኮሪና - New Ethiopian Music 2017 (Official Video) by Hope Music Ethiopia 4 years ago 7 minutes, 12 seconds 323,664 views",Hope Music Entertainment,323664,324333,669
1912,"Rahel Getachew - Le Ashenda Leykone | ል ኣሸንዳ ለይኮነ - New Ethiopian Music 2017 (Official Video) by Hope Music Ethiopia 4 years ago 7 minutes, 28 seconds 176,784 views",Hope Music Entertainment,176784,176926,142
1913,"Sami Ahmed - Selam Le Ethiopia | ሰላም ለኢትዮዽያ - New Ethiopian Music 2017 (Official Video) by Hope Music Ethiopia 4 years ago 5 minutes, 23 seconds 64,305 views",Hope Music Entertainment,64305,64335,30
1914,"Mesfin Bekele - Ebo Maru | ኤቦ ማሩ - New Ethiopian Music 2017 (Official Video) by Hope Music Ethiopia 4 years ago 5 minutes, 17 seconds 1,609,074 views",Hope Music Entertainment,1609074,1610862,1788
1915,"Eden Gebreselassie, Trhas Tareke and Rahel Haile - Ashenda | ኣሸንዳ - New Ethiopian Music 2017 by Hope Music Ethiopia 4 years ago 9 minutes, 4 seconds 5,872,869 views",Hope Music Entertainment,5872869,5886577,13708
1916,"Endish, Dani, Sisay and Tesfaye - Hoya Gobe | ሆያ ጎቤ - New Ethiopian Music 2017 (Official Video) by Hope Music Ethiopia 4 years ago 4 minutes, 26 seconds 242,450 views",Hope Music Entertainment,242450,242467,17
1917,"Bisrat Surafel - Tenkuakua | ተንኳኳ - New Ethiopian Music 2017 (Official Video) by Hope Music Ethiopia 4 years ago 4 minutes, 4 seconds 3,092,697 views",Hope Music Entertainment,3092697,3099365,6668
1918,"Sisay Aklilu (Sisko) - Kesekesegn | ቀሰቀሰኝ - New Ethiopian Music 2017 (Official Video) by Hope Music Ethiopia 4 years ago 5 minutes, 41 seconds 118,094 views",Hope Music Entertainment,118094,118135,41
1919,"Tsrity Alemayehu - Ashenda | ኣሸንዳ - New Ethiopian Music 2017 (Official Video) by Hope Music Ethiopia 4 years ago 4 minutes, 42 seconds 169,886 views",Hope Music Entertainment,169886,169920,34
1920,"Muluken Dawit - Seber Seka | ሰበር ሰካ - New Ethiopian Music 2017 (Official Video) by Hope Music Ethiopia 4 years ago 5 minutes, 12 seconds 138,563 views",Hope Music Entertainment,138563,138617,54
1921,"Simon T/Wold - Yehagere Semay | የሀገሬ ሰማይ - New Ethiopian Music 2017 (Offcial Video) by Hope Music Ethiopia 4 years ago 4 minutes, 40 seconds 24,661 views",Hope Music Entertainment,24661,24666,5
1922,"Tararanga - Chiimari - New Ethiopian Music 2017 (Official Video) by Hope Music Ethiopia 4 years ago 5 minutes, 20 seconds 209,997 views",Hope Music Entertainment,209997,210687,690
1923,"Papi ft.Temesgen Gebregziabher - Banchi Male | ባንቺ ማለ - New Ethiopian Music 2017 (Official Video) by Hope Music Ethiopia 4 years ago 3 minutes, 57 seconds 1,446,067 views",Hope Music Entertainment,1446067,1447931,1864
1924,"Getahun T/Medihin - Masmesel | ማስመሰል? - New Ethiopian Music 2017 (Official Video) by Hope Music Ethiopia 4 years ago 5 minutes, 57 seconds 145,716 views",Hope Music Entertainment,145716,145769,53
1925,"Tsedenia G/ Markos - Abet Yachin Elet | አቤት ያቺን እለት - New Ethiopian Music 2017 (Official Video) by Hope Music Ethiopia 4 years ago 6 minutes, 15 seconds 302,022 views",Hope Music Entertainment,302022,302721,699
1926,"Bewketu Misganaw ft.Abel Rasta - Yene Konjo | የኔ ቆንጆ - New Ethiopian Music 2017 (Official Video) by Hope Music Ethiopia 4 years ago 4 minutes, 38 seconds 46,844 views",Hope Music Entertainment,46844,46868,24
1927,"Samson Seyoum - Wesidkeya | ወሲድክያ - New Ethiopian Music 2017 (Official Video) by Hope Music Ethiopia 4 years ago 4 minutes, 58 seconds 230,925 views",Hope Music Entertainment,230925,231005,80
1928,"Mafi Leul - Lewiyo | ሌዊዮ - New Ethiopian Music 2017 (Official Video) by Hope Music Ethiopia 4 years ago 5 minutes, 18 seconds 5,043,783 views",Hope Music Entertainment,5043783,5077902,34119
1929,"Abdi Ahmed - Werehabul | ወረሃቡል - New Ethiopian Music 2017 (Official Video) by Hope Music Ethiopia 4 years ago 5 minutes, 56 seconds 58,355 views",Hope Music Entertainment,58355,58369,14
1930,"Nebiyu Solomon - Emiye | እምዬ - New Ethiopian Music 2017 (Official Video) by Hope Music Ethiopia 4 years ago 5 minutes, 29 seconds 51,186 views",Hope Music Entertainment,51186,51208,22
1931,"Hab Engidaw - Yamribetal | ያምርበታል - New Ethiopian Music 2017 (Official Video) by Hope Music Ethiopia 4 years ago 5 minutes, 30 seconds 151,000 views",Hope Music Entertainment,151000,151056,56
1932,"Tefe Lali - Ere Ney | ኧረ ነይ - New Ethiopian Music 2017 (Official Video) by Hope Music Ethiopia 4 years ago 6 minutes, 19 seconds 147,065 views",Hope Music Entertainment,147065,147144,79
1933,"Wendi Mar - Weye Weye | ወዬ ወዬ - New Ethiopian Music 2017 (Official Video) by Hope Music Ethiopia 4 years ago 5 minutes, 16 seconds 478,245 views",Hope Music Entertainment,478245,479332,1087
1934,"Biruk Wendaferew - Siwadedu Leka | ሲዋደዱ ለካ - New Ethiopian Music 2017 (Official Video) by Hope Music Ethiopia 4 years ago 5 minutes, 9 seconds 756,608 views",Hope Music Entertainment,756608,757433,825
1935,"Temesgen Zegeye - Kotsli Momona | ቆፅሊ ሞሞና - New Ethiopian Tigrigna Music 2017 (Official Video) by Hope Music Ethiopia 4 years ago 5 minutes, 18 seconds 61,902 views",Hope Music Entertainment,61902,61937,35
1936,"Tommy Zuk - Bisobishale | ብሶብሻል - New Ethiopian Music 2017 (Official Video) by Hope Music Ethiopia 4 years ago 5 minutes, 8 seconds 76,127 views",Hope Music Entertainment,76127,76139,12
1937,"Rosa Negash ft. Sami Go - Leke New | ልኬ ነው - New Ethiopian Music 2017 (Official Video) by Hope Music Ethiopia 4 years ago 4 minutes, 17 seconds 107,668 views",Hope Music Entertainment,107668,107766,98
1938,"Bini Lali - Kadelegn | ካደለኝ - New Ethiopian Music 2017 (Official Video) by Hope Music Ethiopia 4 years ago 5 minutes, 21 seconds 77,125 views",Hope Music Entertainment,77125,77135,10
1939,"Habtamu G/ Tsadik - Gojam | ጎጃም - New Ethiopian Music 2017 (Official Video) by Hope Music Ethiopia 4 years ago 6 minutes, 40 seconds 115,424 views",Hope Music Entertainment,115424,115506,82
1940,"Kibrom Birhane - Gual Embeytey | ጓል እምበይተይ - New Ethiopian Music 2017 (Official Video) by Hope Music Ethiopia 4 years ago 5 minutes, 33 seconds 776,781 views",Hope Music Entertainment,776781,777768,987
1941,"Million Abebe (ዘንዬ አራዳ) - Yebet Kiray | የቤት ኪራይ - New Ethiopian Music 2017 (Official Video) by Hope Music Ethiopia 4 years ago 5 minutes, 58 seconds 2,492,406 views",Hope Music Entertainment,2492406,2512841,20435
1942,"Afewerki G/ Kidan - Mizer | ሚዘር - New Ethiopian Tigrigna Music 2017 (Official Video) by Hope Music Ethiopia 4 years ago 5 minutes, 2 seconds 143,974 views",Hope Music Entertainment,143974,144033,59
1943,"Leul Alemu - Tinafkignalesh | ትናፍቂኛለሺ - New Ethiopian Music 2017 (Official Video) by Hope Music Ethiopia 4 years ago 5 minutes, 49 seconds 115,499 views",Hope Music Entertainment,115499,115529,30
1944,"Znar Zema - Yene Set | የኔ ሴት - New Ethiopian Music 2017 (Official Video) by Hope Music Ethiopia 4 years ago 5 minutes, 30 seconds 1,170,637 views",Hope Music Entertainment,1170637,1177626,6989
1945,"Alebachew Chebero - Efuye Gella | እፉየ ገላ - New Ethiopian Music 2017 (Official Video) by Hope Music Ethiopia 4 years ago 4 minutes, 16 seconds 35,642 views",Hope Music Entertainment,35642,35650,8
1946,"Yared Negu - Yagute | ያጉቴ - New Ethiopian Music 2017 (Official Video) by Hope Music Ethiopia 4 years ago 5 minutes, 2 seconds 8,975,800 views",Hope Music Entertainment,8975800,8990291,14491
1947,"Alemayehu Tesfaye - Tasmute | ጣዝሙቴ - New Ethiopian Music 2017 (Official Audio) by Hope Music Ethiopia 4 years ago 4 minutes, 21 seconds 43,686 views",Hope Music Entertainment,43686,43713,27
1948,"Alemayehu Tesfaye - Sitamri | ስታምሪ - New Ethiopian Music 2017 (Official Audio) by Hope Music Ethiopia 4 years ago 5 minutes, 8 seconds 47,213 views",Hope Music Entertainment,47213,47251,38
1949,"Alemayehu Tesfaye - Leke | ልኬ - New Ethiopian Music 2017 (Official Audio) by Hope Music Ethiopia 4 years ago 4 minutes, 16 seconds 35,008 views",Hope Music Entertainment,35008,35048,40
1950,"Alemayehu Tesfaye - Gibilgn | ግቢልኝ - New Ethiopian Music 2017 (Official Audio) by Hope Music Ethiopia 4 years ago 5 minutes, 29 seconds 32,212 views",Hope Music Entertainment,32212,32238,26
1951,"Alemayehu Tesfaye - Fano | ፋኖ - New Ethiopian Music 2017 (Official Audio) by Hope Music Ethiopia 4 years ago 4 minutes, 35 seconds 37,614 views",Hope Music Entertainment,37614,37665,51
1952,"Alemayehu Tesfaye - Amrual Zufanu | አምሯል ዙፋኑ - New Ethiopian Music 2017 (Official Audio) by Hope Music Ethiopia 4 years ago 5 minutes, 5 seconds 15,463 views",Hope Music Entertainment,15463,15473,10
1953,"Alemayehu Tesfaye - Yene | የኔ - New Ethiopian Music 2017 (Official Audio) by Hope Music Ethiopia 4 years ago 7 minutes, 1 second 97,287 views",Hope Music Entertainment,97287,97362,75
1954,"Alemayehu Tesfaye - Delashgn | ደላሽኝ - New Ethiopian Music 2017 (Official Audio) by Hope Music Ethiopia 4 years ago 5 minutes, 57 seconds 57,828 views",Hope Music Entertainment,57828,57887,59
1955,"Alemayehu Tesfaye - Wereketu | ወረቀቱ - New Ethiopian Music 2017 (Official Audio) by Hope Music Ethiopia 4 years ago 5 minutes, 13 seconds 122,681 views",Hope Music Entertainment,122681,122737,56
1956,"Alemayehu Tesfaye - Gonder | ጎንደር - New Ethiopian Music 2017 (Official Audio) by Hope Music Ethiopia 4 years ago 6 minutes, 21 seconds 84,632 views",Hope Music Entertainment,84632,84660,28
1957,"Mekuanent Melesse - Kesew Negrede | ቀሰው ነግሬደ (ጊዜው ጥሩ ነው) - New Ethiopian Music 2017 (Official Video) by Hope Music Ethiopia 4 years ago 4 minutes, 18 seconds 506,497 views",Hope Music Entertainment,506497,507808,1311
1958,"Tsion Demisse - Yigbagn | ይግባኝ - New Ethiopian Music 2017 (Official Video) by Hope Music Ethiopia 4 years ago 5 minutes, 7 seconds 83,836 views",Hope Music Entertainment,83836,83844,8
1959,"Mesfin Bekele - Yigermal | ይገርማል - New Ethiopian Music 2017 (Official Video) by Hope Music Ethiopia 4 years ago 5 minutes, 39 seconds 4,341,431 views",Hope Music Entertainment,4341431,4357922,16491
1960,"Aster Girma - Enat Ena Abate | እናት እና አባቴ - New Ethiopian Music 2017 (Official Video) by Hope Music Ethiopia 4 years ago 4 minutes, 46 seconds 372,217 views",Hope Music Entertainment,372217,372415,198
1961,"Mesi Demelash - Degme | ደግሜ - New Ethiopian Music 2017 (Official Video) by Hope Music Ethiopia 4 years ago 5 minutes, 6 seconds 226,921 views",Hope Music Entertainment,226921,227030,109
1962,"Kassahun Wendmu - Basebgn | ባሰብኝ - New Ethiopian Music 2017 (Official Video) by Hope Music Ethiopia 4 years ago 5 minutes, 18 seconds 91,889 views",Hope Music Entertainment,91889,91918,29
1963,"Tesfaye Tilahun - Dehna | ደህና - New Ethiopian Music 2017 (Official Video) by Hope Music Ethiopia 4 years ago 5 minutes, 28 seconds 1,031,753 views",Hope Music Entertainment,1031753,1033262,1509
1964,"Abraham Maru - Lowazu | ሎዋዙ - New Ethiopian Music 2017 (Official Video) by Hope Music Ethiopia 4 years ago 5 minutes, 39 seconds 172,692 views",Hope Music Entertainment,172692,173080,388
1965,"Mesfin Bekele - Yigermal | ይገርማል - New Ethiopian Music Teaser Clip 2017 (Official Video) by Hope Music Ethiopia 4 years ago 2 minutes 384,253 views",Hope Music Entertainment,384253,384576,323
1966,"Wendi Mak - Tagebignalesh Wey | ታገቢግኛለሽ ወይ - New Ethiopian Music 2017 (Official Video) by Hope Music Ethiopia 4 years ago 5 minutes, 8 seconds 5,132,780 views",Hope Music Entertainment,5132780,5143193,10413
1967,"Henok Berhanu - Yibel Bered | ይበል በረድ - New Ethiopian Music 2017 (Official Video) by Hope Music Ethiopia 4 years ago 5 minutes, 48 seconds 120,270 views",Hope Music Entertainment,120270,120317,47
1968,"Samuel Mekebo - Weyew Weyew | ወየው ወየው - New Ethiopian Music 2017 (Official Video) by Hope Music Ethiopia 4 years ago 5 minutes, 33 seconds 519,285 views",Hope Music Entertainment,519285,520088,803
1969,"Ze Aman Girmay - Sendayo Gerekiros | ስንዳዮ ገረኺሮስ - New Ethiopian Tigrigna Music 2017 (Official Video) by Hope Music Ethiopia 4 years ago 7 minutes, 2 seconds 183,472 views",Hope Music Entertainment,183472,183837,365
1970,"Ahmed Teshome, Ezel Biruk & Rim Teshome  - Zema Zena - New Ethiopian Music 2017 (Official Video) by Hope Music Ethiopia 4 years ago 4 minutes, 6 seconds 492,565 views",Hope Music Entertainment,492565,493460,895
1971,"Lij Michael ft. Hune - Anchin Lene | አንቺን ለኔ - New Ethiopian Music 2017 (Official Video) by Hope Music Ethiopia 4 years ago 3 minutes, 59 seconds 1,065,102 views",Hope Music Entertainment,1065102,1069039,3937
1972,"Dawit Alemayehu - Ha Lemene | ሀ ለምኔ - New Ethiopian Music 2017 (Official Video) by Hope Music Ethiopia 4 years ago 5 minutes, 35 seconds 11,168,395 views",Hope Music Entertainment,11168395,11237422,69027
1973,"Wehib Dino - Behilm Alem | በህልም አለም - New Ethiopian Music 2017 (Official Video) by Hope Music Ethiopia 4 years ago 3 minutes, 51 seconds 42,910 views",Hope Music Entertainment,42910,42915,5
1974,"D Abe - Kabay Wediya Mado | ከአባይ ወዲያ ማዶ - New Ethiopian Music 2017 (Official Video) by Hope Music Ethiopia 4 years ago 6 minutes, 16 seconds 3,878,170 views",Hope Music Entertainment,3878170,3897581,19411
1975,"King Teddy - Blen | ብሌን - New Ethiopian Music 2017 (Official Video) by Hope Music Ethiopia 4 years ago 3 minutes, 27 seconds 104,532 views",Hope Music Entertainment,104532,104587,55
1976,"John Haftu - Lemide Lemide | ለሚደ ለሚደ - New Ethiopian Music 2017 (Official Video) by Hope Music Ethiopia 4 years ago 5 minutes, 27 seconds 802,355 views",Hope Music Entertainment,802355,823969,21614
1977,"Mamila Lukas - Zim New | ዝም ነው - New Ethiopian Music 2017 (Official Video) by Hope Music Ethiopia 4 years ago 6 minutes, 56 seconds 627,313 views",Hope Music Entertainment,627313,627755,442
1978,"Tewodros Kassahun - Weni Weni | ወኒ ወኒ - New Ethiopian Music 2017 (Official Video) by Hope Music Ethiopia 4 years ago 5 minutes, 2 seconds 639,281 views",Hope Music Entertainment,639281,639509,228
1979,"Genet Mulugeta - Tizita | ትዝታ - New Ethiopian Music 2017 (Official Video) by Hope Music Ethiopia 4 years ago 5 minutes, 25 seconds 366,143 views",Hope Music Entertainment,366143,366312,169
1980,"Buze Man (Buzayehu Kifle) - Tey Manesh | ተይ ማነሽ - New Ethiopian Music 2017 (Official Video) by Hope Music Ethiopia 4 years ago 6 minutes, 11 seconds 2,827,201 views",Hope Music Entertainment,2827201,2845282,18081
1981,"Muley Teshager - Rigbtey | ርግቢተይ - New Ethiopian Music 2017 (Official Video) by Hope Music Ethiopia 4 years ago 5 minutes, 47 seconds 33,541 views",Hope Music Entertainment,33541,33550,9
1982,"Haimanot Matebu - Yelbe Zufan | የልቤ ዙፋን - New Ethiopian Music 2017 (Official Video) by Hope Music Ethiopia 4 years ago 5 minutes, 3 seconds 101,985 views",Hope Music Entertainment,101985,101993,8
1983,"Debe Alemseged ft. Jacky Gosee - Min Lihun - New Ethiopian Music 2017 (Official Video) by Hope Music Ethiopia 4 years ago 4 minutes, 27 seconds 8,742,602 views",Hope Music Entertainment,8742602,8778541,35939
1984,"Mekibib Mekoya  - Sekem Sekem | ሰከም ሰከም - New Ethiopian Music 2017 (Official Video) by Hope Music Ethiopia 4 years ago 5 minutes, 35 seconds 65,381 views",Hope Music Entertainment,65381,65392,11
1985,"Yemane Sebagades - Likim | ልቅም - New Ethiopian New Music 2017 (Official Video) by Hope Music Ethiopia 4 years ago 5 minutes, 30 seconds 151,745 views",Hope Music Entertainment,151745,151768,23
1986,"Samuel Seneshaw ft Emu - Min Ale | ምን አለ - New Ethiopian Music 2017 (Official Video) by Hope Music Ethiopia 4 years ago 4 minutes, 32 seconds 1,579,424 views",Hope Music Entertainment,1579424,1581700,2276
1987,"Mathias Yilma - Kotu Konjo | ኮቱ ቆንጆ - New Ethiopian Music 2017 (Official Video) by Hope Music Ethiopia 4 years ago 5 minutes, 6 seconds 684,706 views",Hope Music Entertainment,684706,684762,56
1988,"Yonas Aschalew - Herey | ሄረይ - New Ethiopian Music 2017 (Official Video) by Hope Music Ethiopia 4 years ago 4 minutes, 32 seconds 36,496 views",Hope Music Entertainment,36496,36502,6
1989,"Abiyot Bekele - Fikirish Kebedegn | ፍቅርሽ ከበደኝ - New Ethiopian Music 2017 (Official Video) by Hope Music Ethiopia 4 years ago 6 minutes, 10 seconds 54,352 views",Hope Music Entertainment,54352,54355,3
1990,"Gedena Aynekul - Mubah | ሙባሕ - New Ethiopian Music 2017 (Official Video) by Hope Music Ethiopia 4 years ago 6 minutes, 2 seconds 352,459 views",Hope Music Entertainment,352459,352938,479
1991,"Kokebe Abdu - Abo Jeba | አቦ ጀባ - New Ethiopian Music 2017 (Official Video) by Hope Music Ethiopia 4 years ago 3 minutes, 53 seconds 193,532 views",Hope Music Entertainment,193532,193574,42
1992,"Sisay Aklilu - Tewena | ተወና - New Ethiopian Music 2017 (Official Video) by Hope Music Ethiopia 4 years ago 5 minutes, 16 seconds 312,887 views",Hope Music Entertainment,312887,312975,88
1993,"Alemtsehay Arage - Tewbay Begelaye | ተውባይ በገላየ - New Ethiopian Music (Official Video) by Hope Music Ethiopia 4 years ago 6 minutes, 32 seconds 62,151 views",Hope Music Entertainment,62151,62158,7
1994,"Selamawit Dejene - Dera Dera | ደራ ደራ - New Ethiopian Music 2017 (Official Video) by Hope Music Ethiopia 4 years ago 4 minutes, 30 seconds 175,915 views",Hope Music Entertainment,175915,175966,51
1995,"Kibrom Haftu & Biruk Shewa - Ney Wudewa | ነይ ውዴዋ - New Ethiopian Music 2017 (Official Video) by Hope Music Ethiopia 4 years ago 4 minutes, 57 seconds 36,116 views",Hope Music Entertainment,36116,36124,8
1996,"Feleke Maru - Hayloge | ሀይሎጌ - New Ethiopian Music 2017 (Official Video) by Hope Music Ethiopia 4 years ago 5 minutes, 21 seconds 394,868 views",Hope Music Entertainment,394868,397683,2815
1997,"Yared Teshale - Michi Bey Neyna | ምቺ በይ ነይና - New Ethiopian Music 2017 (Official Video) by Hope Music Ethiopia 4 years ago 5 minutes, 31 seconds 181,446 views",Hope Music Entertainment,181446,181490,44
1998,"Getish Mamo - Enkebaber (Tekebel 2) | እንከባበር - New Ethiopian Music 2017 (Official Video) by Hope Music Ethiopia 4 years ago 6 minutes, 34 seconds 13,914,564 views",Hope Music Entertainment,13914564,13946417,31853
1999,"Alex Edme - Endegena | እንደገና - New Ethiopian Music 2017 (Official Video) by Hope Music Ethiopia 4 years ago 5 minutes, 16 seconds 394,602 views",Hope Music Entertainment,394602,394685,83
2000,"Legesse Hailemariam - Selam Eyu Gezmna | ሰላምዩ ገዝምና - New Ethiopian Tigrigna Music (Official Video) by Hope Music Ethiopia 4 years ago 6 minutes, 54 seconds 460,728 views",Hope Music Entertainment,460728,460917,189
2001,"Engdawork Fikre - Nanaye | ናናዬ - New Ethiopian Music 2017 (Official Video) by Hope Music Ethiopia 4 years ago 5 minutes, 8 seconds 140,766 views",Hope Music Entertainment,140766,140799,33
2002,"Mieraf Assefa - Munanaye | ሙናናየ - New Ethiopian Music 2017 (Official Video) by Hope Music Ethiopia 4 years ago 5 minutes, 45 seconds 219,630 views",Hope Music Entertainment,219630,219783,153
2003,"Zenawi hailemariam - Tsiryitey | ፅርይተይ - New Ethiopian Music 2017 (Official Video) by Hope Music Ethiopia 4 years ago 4 minutes, 58 seconds 157,902 views",Hope Music Entertainment,157902,157939,37
2004,"Fikadu Tizazu - Lay Layun | ላይ ላዩን - New Ethiopian Music 2017 (Official Video) by Hope Music Ethiopia 4 years ago 4 minutes, 32 seconds 240,504 views",Hope Music Entertainment,240504,240725,221
2005,"Abraham Hailemariam - Atsemiwkyo | ኣፀሚውክዮ - New Ethiopian Music 2017 (Official Video) by Hope Music Ethiopia 4 years ago 6 minutes, 23 seconds 72,209 views",Hope Music Entertainment,72209,72221,12
2006,"Michael Melaku - Kentegna | ቄንጠኛ - New Ethiopian Music 2017 (Official Video) by Hope Music Ethiopia 4 years ago 3 minutes, 55 seconds 79,515 views",Hope Music Entertainment,79515,79545,30
2007,"Netsanet Mekonen - Agegnehu | አገኘሁ - New Ethiopian Music 2017 (Official Video) by Hope Music Ethiopia 4 years ago 6 minutes, 2 seconds 1,355,672 views",Hope Music Entertainment,1355672,1357465,1793
2008,"Yonas Afera ft. Mulualem Takele & Gildo Kassa - Yene Shega - New Ethiopian Music (Official Video) by Hope Music Ethiopia 4 years ago 3 minutes, 56 seconds 50,112 views",Hope Music Entertainment,50112,50164,52
2009,"Betelhem Genetu - Tegegnehu | ተገኘሁ - New Ethiopian Music 2017 (Official Video) by Hope Music Ethiopia 4 years ago 4 minutes, 55 seconds 66,470 views",Hope Music Entertainment,66470,66481,11
2010,"Tewodros Assefa - Bemela | በመላ - New Ethiopian Music 2017 (Official Video) by Hope Music Ethiopia 4 years ago 4 minutes, 50 seconds 37,272 views",Hope Music Entertainment,37272,37296,24
2011,"Merkeb Baryagabir - Tegomtsets | ተጎምፀፅ - New Ethiopian Music 2017 (Official Video) by Hope Music Ethiopia 4 years ago 4 minutes 5,063,887 views",Hope Music Entertainment,5063887,5075786,11899
2012,"Tariku Gashaw - Telamdesh | ተላምደሽ - New Ethiopian Music 2017 (Official Video) by Hope Music Ethiopia 4 years ago 4 minutes, 32 seconds 140,348 views",Hope Music Entertainment,140348,140406,58
2013,"Jacky Gosee & Debe Alemseged - Min Lihun - New Ethiopian Music Teaser Clip 2017 (Official Video) by Hope Music Ethiopia 4 years ago 1 minute, 34 seconds 1,371,813 views",Hope Music Entertainment,1371813,1372565,752
2014,"Mulubrhan Fisseha - Mekelle Shikor | መቐለ ሽኮር - New Ethiopian Music 2017 (Official Video) by Hope Music Ethiopia 4 years ago 6 minutes, 44 seconds 1,946,522 views",Hope Music Entertainment,1946522,1962825,16303
2015,"Meseret Belete - Ante Gondere | አንተ ጎንደሬ - New Ethiopian Music 2017 (Official Video) by Hope Music Ethiopia 4 years ago 6 minutes, 38 seconds 716,366 views",Hope Music Entertainment,716366,716769,403
2016,"Zemen Alemseged - Fanusey | ፋኑሰይ - Ethiopian Music 2017 (Official Video) by Hope Music Ethiopia 4 years ago 4 minutes, 49 seconds 4,395,331 views",Hope Music Entertainment,4395331,4414428,19097
2017,"Tizita Dawit & Tadese Gebru - Endih New Gabicha - New Ethiopian Music 2017 (Official Video) by Hope Music Ethiopia 4 years ago 5 minutes, 9 seconds 43,552 views",Hope Music Entertainment,43552,43577,25
2018,"Tsega Abadi - Girma Hadar | ግርማ ሓዳር - New Ethiopian Music 2017 (Official Video) by Hope Music Ethiopia 4 years ago 5 minutes, 42 seconds 184,624 views",Hope Music Entertainment,184624,184660,36
2019,"Millena Biniam - Yeken kidus | የቀን ቅዱስ - New Ethiopian Music 2017 (Official Video) by Hope Music Ethiopia 4 years ago 4 minutes, 8 seconds 238,775 views",Hope Music Entertainment,238775,238862,87
2020,"Stif Lion - Konjo | ቆንጆ - New Ethiopian Music 2017 (Official Video) by Hope Music Ethiopia 4 years ago 3 minutes, 13 seconds 102,264 views",Hope Music Entertainment,102264,102423,159
2021,"Demekech Jenberu - Zomye | ዞምየ - New Ethiopian Music 2017 (Official Video) by Hope Music Ethiopia 4 years ago 6 minutes, 10 seconds 360,298 views",Hope Music Entertainment,360298,360615,317
2022,"Ermias Kahsay - Lomi Mishet | ሎሚ ምሸት - New Ethiopian Music 2017 (Official Video) by Hope Music Ethiopia 4 years ago 6 minutes, 18 seconds 565,996 views",Hope Music Entertainment,565996,566295,299
2023,"Mykey Shewa - Abey Ala | ኣበይ ኣላ - New Ethiopian Tigrigna Music 2017 (Official Video) by Hope Music Ethiopia 4 years ago 5 minutes, 7 seconds 2,693,624 views",Hope Music Entertainment,2693624,2699265,5641
2024,"Nigist Hawaz - Adalalehu | አዳላለሁ - New Ethiopian Music 2017 (Official Video) by Hope Music Ethiopia 4 years ago 5 minutes, 51 seconds 34,950 views",Hope Music Entertainment,34950,34959,9
2025,"Sam Habesha - Man Yilekishal | ማን ይለቅሻል - New Ethiopian Music 2017 (Official Video) by Hope Music Ethiopia 4 years ago 5 minutes, 3 seconds 423,870 views",Hope Music Entertainment,423870,424029,159
2026,"Eyob Yeshanew - Habesha | ሐበሻ - New Ethiopian Music 2017 (Official Video) by Hope Music Ethiopia 4 years ago 4 minutes, 2 seconds 154,613 views",Hope Music Entertainment,154613,154729,116
2027,"Abdi Jemal - Saki | ሳቂ - New Ethiopian Music 2017 (Official Video) by Hope Music Ethiopia 4 years ago 4 minutes, 10 seconds 68,124 views",Hope Music Entertainment,68124,68151,27
2028,"Yosef Dolcho - Kelay | ከላይ - New Ethiopian Music 2017 (Official Video) by Hope Music Ethiopia 4 years ago 5 minutes, 10 seconds 176,116 views",Hope Music Entertainment,176116,176135,19
2029,"Tadele Kefyalew - Wude | ውዴ - New Ethiopian Music 2017 (Official Video) by Hope Music Ethiopia 4 years ago 4 minutes, 54 seconds 25,193 views",Hope Music Entertainment,25193,25200,7
2030,"Solomon Beyene - Bilome | ቢሎሜ - New Ethiopian Music 2017 (Official Video) by Hope Music Ethiopia 4 years ago 4 minutes, 32 seconds 1,063,777 views",Hope Music Entertainment,1063777,1065789,2012
2031,"Frehiwot Girma - Hello |  ሄሎ - New Ethiopian Music 2017 (Official Video) by Hope Music Ethiopia 4 years ago 5 minutes, 10 seconds 3,402,606 views",Hope Music Entertainment,3402606,3407862,5256
2032,"Sisay Feyisa - Yekenfer Wedaje | የፍቅር ወዳጄ - New Ethiopian Music 2017 (Official Video) by Hope Music Ethiopia 4 years ago 5 minutes, 39 seconds 75,212 views",Hope Music Entertainment,75212,75241,29
2033,"Solomon Demle - Welelaye | ወለላዬ - New Ethiopian Music 2017 (Official Video) by Hope Music Ethiopia 4 years ago 5 minutes, 45 seconds 233,267 views",Hope Music Entertainment,233267,233376,109
2034,"Sulamatif & Habtom Neway - Keledebgn | ቀለደብኝ - New Ethiopian Music 2017 (Official Video) by Hope Music Ethiopia 4 years ago 4 minutes, 27 seconds 69,906 views",Hope Music Entertainment,69906,69928,22
2035,"Mihret Teshome - Koba Kiya | ኮባ ኪያ - New Ethiopian Music 2017 (Official Video) by Hope Music Ethiopia 4 years ago 4 minutes, 37 seconds 65,280 views",Hope Music Entertainment,65280,65300,20
2036,"Meseret Belete - Erikum Zemeda | እሪኩም ዘመዳ - New Ethiopian Music (Official Video) by Hope Music Ethiopia 4 years ago 6 minutes, 59 seconds 5,435,532 views",Hope Music Entertainment,5435532,5486772,51240
2037,"Alemayehu Tesfaye - Delashign | ደላሽኝ - New Ethiopian Music 2017 (Official Video) by Hope Music Ethiopia 4 years ago 5 minutes, 47 seconds 207,089 views",Hope Music Entertainment,207089,207251,162
2038,"Sami Go - Setitu | ሴቲቱ - New Ethiopian Music 2017 (Official Audio) by Hope Music Ethiopia 4 years ago 4 minutes 415,710 views",Hope Music Entertainment,415710,416134,424
2039,"Rahel Fiyorina - Fetweka | ፈትወካ - New Ethiopian Music 2017 (Official Video) by Hope Music Ethiopia 4 years ago 4 minutes, 43 seconds 114,781 views",Hope Music Entertainment,114781,114823,42
2040,"Jacky Gosee - Balambaras | ባላምባራስ - New Album Teaser 2017 (Official Video) by Hope Music Ethiopia 4 years ago 1 minute, 48 seconds 2,244,311 views",Hope Music Entertainment,2244311,2244422,111
2041,"Kidist | Yidnekachew | Zemedkun - AWDAMET | አውዳመት - New Ethiopian Music 2017 (Official Video) by Hope Music Ethiopia 4 years ago 4 minutes, 14 seconds 311,021 views",Hope Music Entertainment,311021,311110,89
2042,"Ashenafi Legesse & Etenesh Demeke - Ende Lijinet - New Ethiopian Music 2017 (Official Video) by Hope Music Ethiopia 4 years ago 4 minutes, 50 seconds 1,142,151 views",Hope Music Entertainment,1142151,1145142,2991
2043,"Demere Legesse - Feka Feta | ፈካ ፈታ - New Ethiopian Music 2017 (Official Video) by Hope Music Ethiopia 4 years ago 7 minutes, 55 seconds 2,164,928 views",Hope Music Entertainment,2164928,2167182,2254
2044,"Deme Lula - Wub Abeba | ውብ አበባ  - New Ethiopian Music 2017 (Official Video) by Hope Music Ethiopia 4 years ago 5 minutes 81,863 views",Hope Music Entertainment,81863,81913,50
2045,"Yared Negu - Yayne Marefia | ያይኔ ማረፊያ - New Ethiopian Music 2017 (Official Video) by Hope Music Ethiopia 4 years ago 5 minutes, 17 seconds 2,885,325 views",Hope Music Entertainment,2885325,2888674,3349
2046,"Meaza Yohannes - Siye Bereka | ስየ በረካ - New Ethiopian Music 2017 (Official Video) by Hope Music Ethiopia 4 years ago 6 minutes, 28 seconds 1,328,750 views",Hope Music Entertainment,1328750,1334422,5672
2047,"Mesay Tefera - Birke Nesh | ብርቄ ነሽ - New Ethiopian Music 2017 (Official Video) by Hope Music Ethiopia 4 years ago 4 minutes, 54 seconds 1,924,088 views",Hope Music Entertainment,1924088,1926746,2658
2048,"Yidnekachew Tsegaye - Enki Selamta | እንኪ ሰላምታ - New Ethiopian Music (Official Video) by Hope Music Ethiopia 4 years ago 5 minutes, 7 seconds 134,710 views",Hope Music Entertainment,134710,134748,38
2049,"Biruk ft. Yetmwork - Yene Engida | የኔ እንግዳ - New Ethiopian Music 2017 (Official Video) by Hope Music Ethiopia 4 years ago 4 minutes, 38 seconds 68,455 views",Hope Music Entertainment,68455,68468,13
2050,"Mebratu Birkneh - Maleda | ማለዳ - New Ethiopian Music 2017 (Official Video) by Hope Music Ethiopia 4 years ago 4 minutes, 54 seconds 335,414 views",Hope Music Entertainment,335414,335819,405
2051,"Werkye Zerihun - Moresh | ሞረሽ - New Ethiopian Music 2017 (Official Video) by Hope Music Ethiopia 4 years ago 6 minutes, 18 seconds 235,686 views",Hope Music Entertainment,235686,235784,98
2052,"D Abe - Girma Mogese | ግርማ ሞገሴ - New Ethiopian Music 2017 (Official Video) by Hope Music Ethiopia 4 years ago 5 minutes, 40 seconds 330,834 views",Hope Music Entertainment,330834,330996,162
2053,"Tarik Biyadig - Edlegna Negn | እድለኛ ነኝ - New Ethiopian Music 2017 (Official Video) by Hope Music Ethiopia 4 years ago 5 minutes, 46 seconds 928,175 views",Hope Music Entertainment,928175,928597,422
2054,"Dawit Alemayehu - Ethiopiaye | ኢትዮዽያዬ - New Ethiopian Music 2017 (Official Video) by Hope Music Ethiopia 4 years ago 5 minutes, 45 seconds 4,551,172 views",Hope Music Entertainment,4551172,4566708,15536
2055,"Dula Adeba ft. Tesfu Delta - Sumaaf | ሱማፍ - New Ethiopian Music 2017 (Official Video) by Hope Music Ethiopia 4 years ago 6 minutes 44,034 views",Hope Music Entertainment,44034,44049,15
2056,"Endish Endish - Dinget | ድንገት - New Ethiopian Music 2017 (Official Video) by Hope Music Ethiopia 4 years ago 5 minutes, 58 seconds 128,513 views",Hope Music Entertainment,128513,128598,85
2057,"Genenew Assefa - Jegna Ale | ጀግና አለ - New Ethiopian Music (Official Video) by Hope Music Ethiopia 4 years ago 6 minutes, 17 seconds 182,064 views",Hope Music Entertainment,182064,182228,164
2058,"Mulualem Takele - Ene Eshalshalehu | እኔ እሻልሻለሁ - New Ethiopian Music 2017 (Official Video) by Hope Music Ethiopia 4 years ago 5 minutes, 27 seconds 978,752 views",Hope Music Entertainment,978752,984747,5995
2059,"Abush Zeleke - Semira | ሰሚራ - New Ethiopian Music 2017 (Official Audio) by Hope Music Ethiopia 4 years ago 4 minutes, 53 seconds 664,778 views",Hope Music Entertainment,664778,666239,1461
2060,"Dubale Melaku - Gudu Gena | ጉዱ ገና - New Ethiopian Music 2017 (Official Video) by Hope Music Ethiopia 4 years ago 5 minutes, 56 seconds 3,307,962 views",Hope Music Entertainment,3307962,3338447,30485
2061,"Elias Gizachew - Konkolata | ኮንኮላታ - New Ethiopian Music 2017 (Official Video) by Hope Music Ethiopia 4 years ago 5 minutes, 14 seconds 407,699 views",Hope Music Entertainment,407699,407970,271
2062,"Samuel Seneshaw - Erget | እርገጥ - New Ethiopian Music 2017 (Official Video) by Hope Music Ethiopia 4 years ago 5 minutes, 6 seconds 342,319 views",Hope Music Entertainment,342319,342398,79
2063,"Tigist Addisu - Ney Belegn | ነይ በለኝ - New Ethiopian Music 2017 (Official Video) by Hope Music Ethiopia 4 years ago 5 minutes, 55 seconds 806,872 views",Hope Music Entertainment,806872,808221,1349
2064,"Zelalem Yonas - Meshe Atbey | መሸ አትበይ - New Ethiopian Music 2017 (Official Video) by Hope Music Ethiopia 4 years ago 5 minutes, 18 seconds 420,388 views",Hope Music Entertainment,420388,420897,509
2065,"Bitik Emlaelu - Yeruk Fikir | የሩቅ ፍቅር - New Ethiopian Music 2017 (Official Video) by Hope Music Ethiopia 4 years ago 4 minutes, 21 seconds 57,412 views",Hope Music Entertainment,57412,57447,35
2066,"Tsilat Gezmu - Yileyilgn | ይለይልኝ - New Ethiopian Music 2017 (Official Video) by Hope Music Ethiopia 4 years ago 5 minutes, 47 seconds 2,698,185 views",Hope Music Entertainment,2698185,2709368,11183
2067,"Sisay Feyisa - Enate | እናቴ - New Ethiopian Music 2017 (Official Video) by Hope Music Ethiopia 4 years ago 6 minutes, 53 seconds 682,624 views",Hope Music Entertainment,682624,684095,1471
2068,"Etenesh Demeke - Yabajalew | ያባጃሌው - New Ethiopian Music 2017 (Official Video) by Hope Music Ethiopia 4 years ago 5 minutes, 14 seconds 734,651 views",Hope Music Entertainment,734651,735101,450
2069,"Addis Adela - Zale Zale | ዛለ ዛለ - New Ethiopian Music 2017 (Official Video) by Hope Music Ethiopia 4 years ago 4 minutes, 39 seconds 148,099 views",Hope Music Entertainment,148099,148118,19
2070,"Kebebush Negash - Ney Ney Belegnina | ነይ ነይ በለኝና - New Ethiopian Music 2017 (Official Video) by Hope Music Ethiopia 4 years ago 6 minutes, 2 seconds 210,797 views",Hope Music Entertainment,210797,211171,374
2071,"Getish Mesfin - Shir Bitin | ሽር ብትን - New Ethiopian Music 2017 (Official Video) by Hope Music Ethiopia 4 years ago 4 minutes, 23 seconds 505,154 views",Hope Music Entertainment,505154,505510,356
2072,"Dj Yo - Yayne Abeba | ያይኔ አበባ - New Ethiopian Music 2017 (Official Video) by Hope Music Ethiopia 4 years ago 4 minutes, 3 seconds 286,058 views",Hope Music Entertainment,286058,286183,125
2073,"Tizazu Betru - Yesemen Shewa Lij | ትዛዙ በትሩ ዘተጉለት - New Ethiopian Music 2017 (Official Video) by Hope Music Ethiopia 4 years ago 5 minutes, 50 seconds 184,423 views",Hope Music Entertainment,184423,184977,554
2074,"Robel Tadesse - Konjo Lij | ቆንጆ ልጅ - New Ethiopian Music 2017 (Official Video) by Hope Music Ethiopia 4 years ago 4 minutes, 11 seconds 91,469 views",Hope Music Entertainment,91469,91490,21
2075,"Yigrem Assefa - Neger Abrji | ነገር አብርጂ - New Ethiopian Music 2017 (Official Video) by Hope Music Ethiopia 4 years ago 5 minutes, 18 seconds 8,256,188 views",Hope Music Entertainment,8256188,8272308,16120
2076,"Makbel Afomia - Bar Bar | ባር ባር - New Ethiopian Music 2017 (Official Video) by Hope Music Ethiopia 4 years ago 4 minutes, 54 seconds 147,831 views",Hope Music Entertainment,147831,147846,15
2077,"Dani Dance - Wuste Nesh | ውስጤ ነሽ - New Ethiopian Music 2017 (Official Video) by Hope Music Ethiopia 4 years ago 5 minutes, 9 seconds 110,932 views",Hope Music Entertainment,110932,110962,30
2078,"Yohannes Birhane - Muna | ሙና - New Ethiopian Music 2017 (Official Video) by Hope Music Ethiopia 4 years ago 5 minutes, 46 seconds 102,482 views",Hope Music Entertainment,102482,102517,35
2079,"Job 27 - Kuratshin Kenes | ኩራትሽን ቀነስ - New Ethiopian Music 2017 (Official Video) by Hope Music Ethiopia 4 years ago 5 minutes, 15 seconds 156,539 views",Hope Music Entertainment,156539,156696,157
2080,"Tensae Gubena - Emye Addis Ababa | እምዬ አዲስ አበባ - New Ethiopian Music 2017 (Official Video) by Hope Music Ethiopia 5 years ago 4 minutes, 34 seconds 43,752 views",Hope Music Entertainment,43752,43797,45
2081,"Yonas Gizaw - Keswa Gar | ከሷ ጋር - New Ethiopian Music 2017 (Official Video) by Hope Music Ethiopia 5 years ago 6 minutes, 8 seconds 280,812 views",Hope Music Entertainment,280812,281165,353
2082,"Emebet Firew - Embualele | እምቧለሌ - New Ethiopian Music 2017 (Official Video) by Hope Music Ethiopia 5 years ago 5 minutes, 40 seconds 968,555 views",Hope Music Entertainment,968555,969140,585
2083,"Endeshaw Shume - Asmat Alat | አስማት አላት - New Ethiopian Music 2017 (Official Video) by Hope Music Ethiopia 5 years ago 4 minutes, 33 seconds 176,871 views",Hope Music Entertainment,176871,177040,169
2084,"Yirdaw Tenaw - Serachilign | ሰራችልኝ - New Ethiopian Music 2017 (Official Video) by Hope Music Ethiopia 5 years ago 5 minutes, 25 seconds 2,039,379 views",Hope Music Entertainment,2039379,2039563,184
2085,"Yeabsira Alemu - Kezih Bota | ከዚህ ቦታ - New Ethiopian Music 2017 (Official Video) by Hope Music Ethiopia 5 years ago 4 minutes, 45 seconds 104,672 views",Hope Music Entertainment,104672,104707,35
2086,"Shumet Tegen - Ney Ney Zema | ነይ ነይ ዜማ - New Ethiopian Music 2017 (Official Video) by Hope Music Ethiopia 5 years ago 5 minutes, 14 seconds 56,211 views",Hope Music Entertainment,56211,56240,29
2087,"Solomon Fuji - Bella | ቤላ - New Ethiopian Music 2017 (Official Video) by Hope Music Ethiopia 5 years ago 5 minutes, 9 seconds 363,572 views",Hope Music Entertainment,363572,363616,44
2088,"Genet Abate - Man Lilekih | ማን ሊለቅህ - New Ethiopian Music 2017 (Official Video) by Hope Music Ethiopia 5 years ago 5 minutes, 47 seconds 7,149,413 views",Hope Music Entertainment,7149413,7176348,26935
2089,"Haymi Lenger - Wanaye | ዋናዬ - New Ethiopian Music 2017 (Official Video) by Hope Music Ethiopia 5 years ago 5 minutes, 24 seconds 145,240 views",Hope Music Entertainment,145240,145262,22
2090,"Binu Solomon - Abejehu | አበጀሁ - New Ethiopian Music 2017 (Official Video) by Hope Music Ethiopia 5 years ago 4 minutes, 36 seconds 1,182,460 views",Hope Music Entertainment,1182460,1183333,873
2091,"Alex Kiros - Alehu  አለሁ - New Ethiopian Music 2017 (Official Video) by Hope Music Ethiopia 5 years ago 4 minutes, 42 seconds 43,047 views",Hope Music Entertainment,43047,43057,10
2092,"Hasset Concert @ The Mosaic Hotel Saturday Feb 18, 2017 by Hope Music Ethiopia 5 years ago 1 minute, 4 seconds 7,354 views",Hope Music Entertainment,7354,7355,1
2093,"Henok Ambaye - Bemin Lamesginat | በምን ላመስግናት - New Ethiopian Music 2017 (Official Video) by Hope Music Ethiopia 5 years ago 5 minutes, 53 seconds 137,526 views",Hope Music Entertainment,137526,137542,16
2094,"Solomon Berihun - Selewlawa | ሰለውላዋ - New Ethiopian Music 2017 (Official Video) by Hope Music Ethiopia 5 years ago 6 minutes, 13 seconds 247,891 views",Hope Music Entertainment,247891,247976,85
2095,"Endalkachew Yenehun - Tenes Gojam | ተነስ ጎጃም - New Ethiopian Music 2017 (Official Video) by Hope Music Ethiopia 5 years ago 4 minutes, 23 seconds 587,480 views",Hope Music Entertainment,587480,587888,408
2096,"Addis Alem Eshete - Yaleselse | ያለሰለሴ - New Ethiopian Music 2017 (Official Video) by Hope Music Ethiopia 5 years ago 5 minutes, 5 seconds 172,352 views",Hope Music Entertainment,172352,172394,42
2097,"Workye Getachew - Jegnaw Wegene | ጀግናው ወገኔ - New Ethiopian Music 2017 (Official Video) by Hope Music Ethiopia 5 years ago 6 minutes, 15 seconds 144,564 views",Hope Music Entertainment,144564,144615,51
2098,"Kako Getachew - Gude | ጉዴ - New Ethiopian Music 2017 (Official Video) by Hope Music Ethiopia 5 years ago 5 minutes, 7 seconds 697,444 views",Hope Music Entertainment,697444,698959,1515
2099,"Netsanet Melkamu - Mondel Mondel | ሞንደል ሞንደል - New Ethiopian Music 2017 (Official Video) by Hope Music Ethiopia 5 years ago 5 minutes, 32 seconds 304,734 views",Hope Music Entertainment,304734,304863,129
2100,"Lula Mandefro - Zelalem Yakoyew | ዘላለም ያቆየው - New Ethiopian Music 2017 (Official Video) by Hope Music Ethiopia 5 years ago 4 minutes, 45 seconds 62,312 views",Hope Music Entertainment,62312,62323,11
2101,"Dag Daniel - Sew Alay | ሰው አላይ - New Ethiopian Music 2017 (Official Video) by Hope Music Ethiopia 5 years ago 4 minutes, 8 seconds 655,515 views",Hope Music Entertainment,655515,657119,1604
2102,"Yeshi Tadesse - Dera | ደራ - New Ethiopian Music 2017 (Official Video) by Hope Music Ethiopia 5 years ago 4 minutes, 57 seconds 75,883 views",Hope Music Entertainment,75883,75903,20
2103,"Merry Wuded - Che Che | ቼቼ - New Ethiopian Music 2017 (Official Video) by Hope Music Ethiopia 5 years ago 6 minutes, 30 seconds 284,776 views",Hope Music Entertainment,284776,284853,77
2104,"Yonas Abate - Melse Aregatina | መልስ አረጋትና - New Ethiopian Music 2017 (Official Video) by Hope Music Ethiopia 5 years ago 4 minutes, 4 seconds 1,041,974 views",Hope Music Entertainment,1041974,1043045,1071
2105,"Dawit Zerihun - Sitalif Besefere | ስታልፍ በሰፈሬ - New Ethiopian Music 2017 (Official Video) by Hope Music Ethiopia 5 years ago 5 minutes, 27 seconds 320,507 views",Hope Music Entertainment,320507,320691,184
2106,"Addis Gurmesa - Fikir Bezebezegn | ፍቅር በዘበዘኝ - New Ethiopian Music 2017 (Official Video) by Hope Music Ethiopia 5 years ago 4 minutes, 5 seconds 427,158 views",Hope Music Entertainment,427158,427846,688
2107,"Abraham Eyob -  Degua Enate | ደጓ እናቴ - New Ethiopian Music 2017 (Official Video) by Hope Music Ethiopia 5 years ago 4 minutes, 29 seconds 221,610 views",Hope Music Entertainment,221610,221969,359
2108,"Mc Siyamregn - Gebahu Hagere | ገባሁ ሀገሬ - New Ethiopian Music 2017 (Official Video) by Hope Music Ethiopia 5 years ago 3 minutes, 28 seconds 141,560 views",Hope Music Entertainment,141560,141603,43
2109,"Tigist Addisu - Tewugn | ተውኝ - New Ethiopian Music 2017 (Official Video) by Hope Music Ethiopia 5 years ago 5 minutes, 16 seconds 878,195 views",Hope Music Entertainment,878195,878650,455
2110,"Dawit Tsige - Tamriyalesh | ታምሪያለሽ - New Ethiopian Music 2017 (Official Video) by Hope Music Ethiopia 5 years ago 8 minutes, 5 seconds 210,980 views",Hope Music Entertainment,210980,211197,217
2111,"Bisrat Teklu -  Dege | ደጌ - New Ethiopian Music 2017 (Official Video) by Hope Music Ethiopia 5 years ago 4 minutes, 11 seconds 135,669 views",Hope Music Entertainment,135669,135678,9
2112,"Eleni Wudneh - Yazulgn | ያዙልኝ - New Ethiopian Music 2017 (Official Video) by Hope Music Ethiopia 5 years ago 4 minutes, 46 seconds 130,198 views",Hope Music Entertainment,130198,130226,28
2113,"Ermias Tesfaye - Atakabji Baksh | አታካብጂ ባክሽ - New Ethiopian Music 2017 (Official Video) by Hope Music Ethiopia 5 years ago 7 minutes, 56 seconds 200,430 views",Hope Music Entertainment,200430,200483,53
2114,"Simachew Kassa - Baso Mit | ባሶ ምት - New Ethiopian Music 2016 (Official Video) by Hope Music Ethiopia 5 years ago 6 minutes, 19 seconds 609,155 views",Hope Music Entertainment,609155,609935,780
2115,"Yibeltal Ayele - Semira | ሰሚራ - New Ethiopian Music 2017 (Official Video) by Hope Music Ethiopia 5 years ago 6 minutes, 23 seconds 264,546 views",Hope Music Entertainment,264546,264887,341
2116,"Yohannes Gebregziabher - Ati Weyzero | ኣቲ ወይዘሮ - New Ethiopian Tigrigna Music 2017 (Official Video) by Hope Music Ethiopia 5 years ago 4 minutes, 27 seconds 192,405 views",Hope Music Entertainment,192405,192473,68
2117,"Kepaso - Lemayhon Neger | ለማይሆን ነገር - New Ethiopian Music 2017 (Official Video) by Hope Music Ethiopia 5 years ago 3 minutes, 44 seconds 159,203 views",Hope Music Entertainment,159203,159436,233
2118,"Mamila Lukas - Kere Netela | ቀረ ነጠላ - New Ethiopian Music 2017 (Official Video) by Hope Music Ethiopia 5 years ago 5 minutes 590,424 views",Hope Music Entertainment,590424,590954,530
2119,"Yosef Mersha - Wey Libe | ወይ ልቤ - New Ethiopian Music 2017 (Official Video) by Hope Music Ethiopia 5 years ago 5 minutes, 5 seconds 2,054,326 views",Hope Music Entertainment,2054326,2056528,2202
2120,"Hiwot H/Mariam - Ketizita Gara | ከትዝታ ጋራ - New Ethiopian Music 2017 (Official Video) by Hope Music Ethiopia 5 years ago 5 minutes, 43 seconds 543,357 views",Hope Music Entertainment,543357,543468,111
2121,"Meron Mekonen - Fikir Yene | ፍቅር የኔ - New Ethiopian Music 2017 (Official Video) by Hope Music Ethiopia 5 years ago 4 minutes, 47 seconds 971,576 views",Hope Music Entertainment,971576,971932,356
2122,"Kako Getachew - Man Ale | ማን አለ - New Ethiopian Music 2017 (Official Video) by Hope Music Ethiopia 5 years ago 4 minutes, 41 seconds 149,610 views",Hope Music Entertainment,149610,149665,55
2123,"Dagmawit Tsehaye - Zoro Zoro | ዞሮ ዞሮ - New Ethiopian Music 2017 (Official Video) by Hope Music Ethiopia 5 years ago 4 minutes, 44 seconds 853,916 views",Hope Music Entertainment,853916,854331,415
2124,"Bewketu Sewmehon - Wey Mamarua | ወይ ማማሯ - New Ethiopian Music 2017 (Official Video) by Hope Music Ethiopia 5 years ago 6 minutes, 11 seconds 388,423 views",Hope Music Entertainment,388423,388931,508
2125,"Meseret Getu - Yegonder Lij | የጎንደር ልጅ - New Ethiopian Music 2017 (Official Video) by Hope Music Ethiopia 5 years ago 5 minutes, 40 seconds 132,097 views",Hope Music Entertainment,132097,132148,51
2126,"Sintayehu Enyew - Anchiye | አንችዬ - New Ethiopian Music 2017 (Official Video) by Hope Music Ethiopia 5 years ago 4 minutes, 52 seconds 39,310 views",Hope Music Entertainment,39310,39327,17
2127,"Moges Ababu - Konjiye | ቆንጅዬ - New Ethiopian Music 2017 (Official Video) by Hope Music Ethiopia 5 years ago 6 minutes, 22 seconds 1,740,979 views",Hope Music Entertainment,1740979,1743059,2080
2128,"Abel Almaz - Cheb Cheb | ቸብ ቸብ - New Ethiopian Music 2017 (Official Video) by Hope Music Ethiopia 5 years ago 4 minutes, 45 seconds 754,640 views",Hope Music Entertainment,754640,756887,2247
2129,"Micky Gonderegna ft. Comedian Thomas - Enmechach | እንመቻች - New Ethiopian Music 2017 (Official Video) by Hope Music Ethiopia 5 years ago 5 minutes, 6 seconds 2,305,135 views",Hope Music Entertainment,2305135,2313495,8360
2130,"Tadesse Bekele - Kelay | ከላይ - New Ethiopian Music 2017 (Official Video) by Hope Music Ethiopia 5 years ago 6 minutes, 36 seconds 517,242 views",Hope Music Entertainment,517242,517369,127
2131,"Maereg Molla - Bemela New | በመላ ነው - New Ethiopian Music 2017 (Official Video) by Hope Music Ethiopia 5 years ago 3 minutes, 50 seconds 98,122 views",Hope Music Entertainment,98122,98127,5
2132,"Yirdaw Tenaw - Serachilign | ሰራችልኝ - New Ethiopian Music 2017 (Official Audio) by Hope Music Ethiopia 5 years ago 5 minutes, 21 seconds 808,069 views",Hope Music Entertainment,808069,809470,1401
2133,"Mesfin Ulma - Enjalign | እንጃልኝ - New Ethiopian Music 2017 (Official Video) by Hope Music Ethiopia 5 years ago 5 minutes, 6 seconds 193,136 views",Hope Music Entertainment,193136,193773,637
2134,"Ethiopiawi Concert @Lafto Mall Jan.06.2017 (Official Video) by Hope Music Ethiopia 5 years ago 1 minute, 54 seconds 41,406 views",Hope Music Entertainment,41406,41411,5
2135,"Abeselom Bihonegn - Neka Neka |  ነካ ነካ - New Ethiopian Music 2017 (Official Video) by Hope Music Ethiopia 5 years ago 5 minutes, 22 seconds 227,131 views",Hope Music Entertainment,227131,227366,235
2136,"Selamawit Yohannes - Senay | ሰናይ - New Ethiopian Music (Official Video) by Hope Music Ethiopia 5 years ago 3 minutes, 55 seconds 19,048,860 views",Hope Music Entertainment,19048860,19081608,32748
2137,"Asegid Eshetu - Nefse | ነፍሴ - New Ethiopian Music (Official Video) by Hope Music Ethiopia 5 years ago 4 minutes, 10 seconds 130,535 views",Hope Music Entertainment,130535,130739,204
2138,"Dawit Tsige - HaHu | ሀሁ - New Ethiopian Music (Official Video) by Hope Music Ethiopia 5 years ago 4 minutes, 3 seconds 44,701 views",Hope Music Entertainment,44701,44729,28
2139,"Kb Man - Endenyhe | እንዴኔሂ - New Ethiopian Music (Official Video) by Hope Music Ethiopia 5 years ago 6 minutes, 20 seconds 401,068 views",Hope Music Entertainment,401068,401409,341
2140,"Buzayehu Kifle (Buze Man) - Komee Dame - New Ethiopian Music (Official Video) by Hope Music Ethiopia 5 years ago 4 minutes, 33 seconds 671,155 views",Hope Music Entertainment,671155,672648,1493
2141,"Fikadu Girma - Aynen | አይኔን - New Ethiopian Music (Official Video) by Hope Music Ethiopia 5 years ago 5 minutes, 58 seconds 642,483 views",Hope Music Entertainment,642483,642796,313
2142,"Seble Tadesse - Shege | ሸጌ - New Ethiopian Music (Official Video) by Hope Music Ethiopia 5 years ago 4 minutes, 26 seconds 191,651 views",Hope Music Entertainment,191651,191808,157
2143,"Dawit Alemayehu - Atse Begulbetu | አጼ በጉልበቱ - New Ethiopian Music (Official Video) by Hope Music Ethiopia 5 years ago 5 minutes, 52 seconds 1,428,211 views",Hope Music Entertainment,1428211,1430074,1863
2144,"Alemayehu Erecha - Sakilign | ሳቂልኝ - New Ethiopian Music (Official Video) by Hope Music Ethiopia 5 years ago 4 minutes, 58 seconds 41,512 views",Hope Music Entertainment,41512,41529,17
2145,"Muluken Dawit - Sera | ሴራ - New Ethiopian Music (Official Video) by Hope Music Ethiopia 5 years ago 4 minutes, 12 seconds 174,880 views",Hope Music Entertainment,174880,174957,77
2146,"Millena Biniam - Sile Nege | ስለ ነገ - New Ethiopian Music (Official Video) by Hope Music Ethiopia 5 years ago 5 minutes, 29 seconds 500,061 views",Hope Music Entertainment,500061,500197,136
2147,"Eyerusalem Amde - Yamegnal | ያመኛል - New Ethiopian Music (Official Video) by Hope Music Ethiopia 5 years ago 4 minutes, 27 seconds 524,650 views",Hope Music Entertainment,524650,525671,1021
2148,"Abe Werku - Melkuama | መልኳማ - New Ethiopian Music (Official Video) by Hope Music Ethiopia 5 years ago 4 minutes, 17 seconds 1,448,909 views",Hope Music Entertainment,1448909,1449224,315
2149,"Tiqo & Dani - AHADU | አሀዱ - New Ethiopian Music (Official Video) by Hope Music Ethiopia 5 years ago 3 minutes, 51 seconds 61,217 views",Hope Music Entertainment,61217,61371,154
2150,"Tigist Gari - Wedike | ወድቄ - New Ethiopian Music (Official Video) by Hope Music Ethiopia 5 years ago 6 minutes, 14 seconds 122,973 views",Hope Music Entertainment,122973,123020,47
2151,"Etenesh Demeke - Yiteyek | ይጠየቅ - New Ethiopian Music (Official Video) by Hope Music Ethiopia 5 years ago 4 minutes, 24 seconds 295,004 views",Hope Music Entertainment,295004,295188,184
2152,"Tsegish (ጃ ማይክ) - Bayne | ባይኔ - New Ethiopian Music (Official Video) by Hope Music Ethiopia 5 years ago 4 minutes, 26 seconds 47,701 views",Hope Music Entertainment,47701,47704,3
2153,"Alex Sheger - Tiz Yibelish | ትዝ ይበልሽ - New Ethiopian Music (Official Video) by Hope Music Ethiopia 5 years ago 5 minutes, 51 seconds 66,842 views",Hope Music Entertainment,66842,66859,17
2154,"Dj Sami - Hewan Addis | ሄዋን አዲስ - New Ethiopian Music (Official Video) by Hope Music Ethiopia 5 years ago 3 minutes, 52 seconds 29,157 views",Hope Music Entertainment,29157,29182,25
2155,"Bisrat Teklu - Anteye  | አንተዬ - New Ethiopian Music (Official Video) by Hope Music Ethiopia 5 years ago 4 minutes, 14 seconds 32,617 views",Hope Music Entertainment,32617,32628,11
2156,"Yigrem Assefa - Habame |  ሀባሜ - New Ethiopian Music (Official Video) by Hope Music Ethiopia 5 years ago 4 minutes, 28 seconds 109,385 views",Hope Music Entertainment,109385,109585,200
2157,"Semir Muler Girma - Sintun Yayehubsh | ስንቱን ያየሁብሽ - New Ethiopian Music (Official video) by Hope Music Ethiopia 5 years ago 5 minutes, 24 seconds 105,867 views",Hope Music Entertainment,105867,105872,5
2158,"Etenesh Demeke - Shir Shir | ሽርሽር - New Ethiopian Music (Official Video) by Hope Music Ethiopia 5 years ago 4 minutes, 33 seconds 1,746,761 views",Hope Music Entertainment,1746761,1747746,985
2159,"Dereje Belay - Mertogn Egre | መርቶኝ እግሬ - New Ethiopian Music (Official Video) by Hope Music Ethiopia 5 years ago 5 minutes, 24 seconds 288,978 views",Hope Music Entertainment,288978,289819,841
2160,"Eskindir Baye - Ethiopiawi | ኢትዮዽያዊ - New Ethiopian Music (Official Video) by Hope Music Ethiopia 5 years ago 5 minutes, 30 seconds 71,279 views",Hope Music Entertainment,71279,71372,93
2161,"Nahom Mekuria - Wuste Nesh | ውስጤ ነሽ - New Ethiopian Music (Official Video) by Hope Music Ethiopia 5 years ago 4 minutes, 30 seconds 156,734 views",Hope Music Entertainment,156734,156932,198
2162,"Niway Damtie - Kuru | ኩሩ - New Ethiopian Music (Official Video) by Hope Music Ethiopia 5 years ago 3 minutes, 53 seconds 33,586 views",Hope Music Entertainment,33586,33633,47
2163,"Esubalew Liyih - Tafach Neger | ጣፋጭ ነገር - New Ethiopian Music (Official Video) by Hope Music Ethiopia 5 years ago 5 minutes, 25 seconds 94,953 views",Hope Music Entertainment,94953,94973,20
2164,"Habtamu Zinabe - Ney Neyilgn | ነይ ነይልኝ - New Ethiopian Music (Official Video) by Hope Music Ethiopia 5 years ago 5 minutes, 37 seconds 140,120 views",Hope Music Entertainment,140120,140181,61
2165,"Deme Lula - Hod Basegn | ሆድ ባሰኝ - New Ethiopian Music (Official Video) by Hope Music Ethiopia 5 years ago 5 minutes, 52 seconds 82,857 views",Hope Music Entertainment,82857,82872,15
2166,"Kassahun Degefaw - Wubetish | ውበትሽ - New Ethiopian Music (Official Video) by Hope Music Ethiopia 5 years ago 5 minutes, 6 seconds 369,610 views",Hope Music Entertainment,369610,369675,65
2167,"Yidnekachew Tsegaye (Yidu) -  Fikote | ፊቆቴ - New Ethiopian Music (Official Video) by Hope Music Ethiopia 5 years ago 5 minutes, 11 seconds 102,422 views",Hope Music Entertainment,102422,102437,15
2168,"Zemach - Eskista | እስክስታ - New Ethiopian Music (Official Video) by Hope Music Ethiopia 5 years ago 3 minutes, 54 seconds 440,729 views",Hope Music Entertainment,440729,441039,310
2169,"Anteneh Minalu - Anley | አንለይ  - New Ethiopian Music (Official Video) by Hope Music Ethiopia 5 years ago 4 minutes, 23 seconds 209,766 views",Hope Music Entertainment,209766,212043,2277
2170,"Filimon Mengesha - Merkachihu | መርቃችሁ - New Ethiopian Music (Official Video) by Hope Music Ethiopia 5 years ago 3 minutes, 34 seconds 30,959 views",Hope Music Entertainment,30959,30976,17
2171,"Sami Go - Ethio Shake | ኢትዮ ሼክ - New Ethiopian Music (Official Video) by Hope Music Ethiopia 5 years ago 4 minutes, 17 seconds 8,048,942 views",Hope Music Entertainment,8048942,8058123,9181
2172,"Yosef Tewolde - Gefteshign | ገፍተሽኝ - New Ethiopian Music (Official Video) by Hope Music Ethiopia 5 years ago 6 minutes, 44 seconds 201,049 views",Hope Music Entertainment,201049,201068,19
2173,"Trhas Tareke - Wesen Eloyo | ወሰን ኢሎዮ - New Ethiopian Tigrigna Music (Official Video) by Hope Music Ethiopia 5 years ago 6 minutes, 48 seconds 6,599,281 views",Hope Music Entertainment,6599281,6616132,16851
2174,"Tadele Kifelew - Atehiji | አትሂጂ - New Ethiopian Music 2016 (Official Video) by Hope Music Ethiopia 5 years ago 5 minutes, 10 seconds 47,481 views",Hope Music Entertainment,47481,47497,16
2175,"Wendwesen Selfago -  Sitebikish | ስጠብቅሽ - New Ethiopian Music 2016  (Official Video) by Hope Music Ethiopia 5 years ago 5 minutes, 25 seconds 193,145 views",Hope Music Entertainment,193145,193160,15
2176,"Hamelmal Abate - Harar | ሀረር  - New Ethiopian Music 2016 (Official Video) by Hope Music Ethiopia 5 years ago 5 minutes, 53 seconds 198,914 views",Hope Music Entertainment,198914,201160,2246
2177,"Fikiru Arage| ቦቼ  - Temeleshi | ተመለሺ - New Ethiopian Music 2016 (Official Video) by Hope Music Ethiopia 5 years ago 4 minutes, 13 seconds 758,617 views",Hope Music Entertainment,758617,759429,812
2178,"Misikir Tamirat - Yematimechi Endew | የማትመጪ እንደው  - New Ethiopian Music 2016 (Official Video) by Hope Music Ethiopia 5 years ago 5 minutes, 12 seconds 73,343 views",Hope Music Entertainment,73343,73385,42
2179,"Jony Ze Arkey | ጆኒ ዘ ዓርከይ -  Enka | እንካ - New Ethiopian Music 2016 (Official Video) by Hope Music Ethiopia 5 years ago 5 minutes, 5 seconds 31,900 views",Hope Music Entertainment,31900,31914,14
2180,"Kako Getachew - Mengedegna | መንገደኛ - New Ethiopian Music 2016 (Official Video) by Hope Music Ethiopia 5 years ago 4 minutes, 28 seconds 60,458 views",Hope Music Entertainment,60458,60599,141
2181,"Melaku Belay - Yilegnal Des Des | ይለኛል ደስ ደስ - New Ethiopian Music 2016 (Official Video) by Hope Music Ethiopia 5 years ago 7 minutes, 9 seconds 1,087,236 views",Hope Music Entertainment,1087236,1089474,2238
2182,"Ashenafi Legesse - Enja | እንጃ - New Ethiopian Music 2016 (Official Video) by Hope Music Ethiopia 5 years ago 5 minutes, 52 seconds 640,916 views",Hope Music Entertainment,640916,642810,1894
2183,"Muas Baba -  Weyne Weyne | ወይኔ ወይኔ - New Ethiopian Music 2016 (Official Video) by Hope Music Ethiopia 5 years ago 5 minutes, 40 seconds 1,920,803 views",Hope Music Entertainment,1920803,1921969,1166
2184,"Dj Chagi ft Lij Michael & Kalkidane - Fikirin Angisew - New Ethiopian Music 2016 (Official Video) by Hope Music Ethiopia 5 years ago 4 minutes, 44 seconds 88,520 views",Hope Music Entertainment,88520,88548,28
2185,"Getish Mamo - Ewedishalehu | እወድሻለሁ - New Ethiopian Music 2016 (Official Video) by Hope Music Ethiopia 5 years ago 5 minutes, 57 seconds 346,048 views",Hope Music Entertainment,346048,346374,326
2186,"Bethelhem  Ayehu - Munane | ሙናኔ - New Ethiopian Music 2016 (Official Video) by Hope Music Ethiopia 5 years ago 5 minutes, 24 seconds 44,030 views",Hope Music Entertainment,44030,44071,41
2187,"Joorji Abbuu - Amma'utuu Deemanii - New Ethiopian Music 2016 (Official Video) by Hope Music Ethiopia 5 years ago 4 minutes, 19 seconds 20,004 views",Hope Music Entertainment,20004,20151,147
2188,"Endalkachew Yenehun - Abay Mado | አባይ ማዶ - New Ethiopian Music 2016 (Official Audio) by Hope Music Ethiopia 5 years ago 5 minutes, 16 seconds 1,145,647 views",Hope Music Entertainment,1145647,1153928,8281
2189,"Genet Bekele - Alsetim | አልሰጥም - New Ethiopian Music 2016 (Official Video) by Hope Music Ethiopia 5 years ago 6 minutes, 10 seconds 175,022 views",Hope Music Entertainment,175022,175105,83
2190,"Sami Dan -  Fikir Selam | ፍቅር ሰላም - New Ethiopian Music 2016 (Official Video) by Hope Music Ethiopia 5 years ago 4 minutes, 45 seconds 285,386 views",Hope Music Entertainment,285386,286200,814
2191,"Andinet Birhanu -  Anchin Atito Menor | አንችን አጥቶ መኖር - New Ethiopian Music 2016 (Official Video) by Hope Music Ethiopia 5 years ago 4 minutes, 22 seconds 16,524 views",Hope Music Entertainment,16524,16528,4
2192,"Dagmawi Yirga Belay - Wedo Zemach | ወዶ ዘማች - New Ethiopian Music 2016 (Official Video) by Hope Music Ethiopia 5 years ago 5 minutes, 1 second 42,148 views",Hope Music Entertainment,42148,42159,11
2193,"Anteneh Asrat - Yiteyek Tizita | ይጠየቅ ትዝታ - New Ethiopian Music 2016 (Official Video) by Hope Music Ethiopia 5 years ago 5 minutes, 21 seconds 63,400 views",Hope Music Entertainment,63400,63418,18
2194,"Dawit Alemayehu - Endengat Semay | እንደንጋት ሰማይ - New Ethiopian Music 2016 (Official Video) by Hope Music Ethiopia 5 years ago 5 minutes, 7 seconds 819,093 views",Hope Music Entertainment,819093,819597,504
2195,"Mykey Shewa & Mieraf Assefa - Shima | ሺማ - New Ethiopian Music 2016 (Official Video) by Hope Music Ethiopia 5 years ago 4 minutes, 2 seconds 463,022 views",Hope Music Entertainment,463022,463986,964
2196,"Tewodros Assefa - Badebabay | ባደባባይ - New Ethiopian Music 2016 (Official Video) by Hope Music Ethiopia 5 years ago 5 minutes, 19 seconds 121,173 views",Hope Music Entertainment,121173,121209,36
2197,"Selamawit Getachew - Eyenafekegn | እየናፈቀኝ - New Ethiopian Music 2016 (Official Video) by Hope Music Ethiopia 5 years ago 4 minutes, 31 seconds 66,670 views",Hope Music Entertainment,66670,66687,17
2198,"Girmaw Admasu - Yene Liyu | የኔ ልዩ - New Ethiopian Music 2016 (Official Video) by Hope Music Ethiopia 5 years ago 4 minutes, 58 seconds 56,178 views",Hope Music Entertainment,56178,56194,16
2199,"Daniel Sintayehu -  ሞናሊዛ - New Ethiopian Music 2016 (Official Video) by Hope Music Ethiopia 5 years ago 4 minutes, 19 seconds 259,457 views",Hope Music Entertainment,259457,259657,200
2200,"Mahlet Demere - Yene Desta | የኔ ደስታ - New Ethiopian Music 2016 (Official Video) by Hope Music Ethiopia 5 years ago 6 minutes, 3 seconds 3,595,794 views",Hope Music Entertainment,3595794,3599884,4090
2201,"Serawitu Lema Tesema - Bushe Dimbule | ቡሼ ድምቡሌ - New Ethiopian Music 2016 (Official Video) by Hope Music Ethiopia 5 years ago 4 minutes, 55 seconds 138,505 views",Hope Music Entertainment,138505,138713,208
2202,"Deme Lula - Enat Hagere | እናት ሀገሬ - New Ethiopian Music 2016 (Official Audio) by Hope Music Ethiopia 5 years ago 4 minutes, 13 seconds 117,147 views",Hope Music Entertainment,117147,117170,23
2203,"Dawit Alemayehu - Mizanish Tezaba | ሚዛንሽ ተዛባ - New Ethiopian Music 2016 (Official Audio) by Hope Music Ethiopia 5 years ago 4 minutes, 26 seconds 21,542 views",Hope Music Entertainment,21542,21580,38
2204,"Dawit Alemayehu - Atse Begulbetu | አፄ በጉልበቱ - New Ethiopian Music 2016 (Official Audio) by Hope Music Ethiopia 5 years ago 5 minutes, 54 seconds 38,914 views",Hope Music Entertainment,38914,38939,25
2205,"Dawit Alemayehu - Yeyikrta Kal | የይቅርታ ቃል - New Ethiopian Music 2016 (Official Audio) by Hope Music Ethiopia 5 years ago 5 minutes, 10 seconds 45,753 views",Hope Music Entertainment,45753,45806,53
2206,"Dawit Alemayehu - Helen Gualu | ሄለን ጏሉ - New Ethiopian Music 2016 (Official Audio) by Hope Music Ethiopia 5 years ago 5 minutes, 20 seconds 120,407 views",Hope Music Entertainment,120407,120473,66
2207,"Dawit Alemayehu - Hon Biye | ሆን ብዬ - New Ethiopian Music 2016 (Official Audio) by Hope Music Ethiopia 5 years ago 5 minutes 98,031 views",Hope Music Entertainment,98031,98107,76
2208,"Dawit  Alemayehu - Endayhon | እንዳይሆን  - New Ethiopian Music 2016 (Official Audio) by Hope Music Ethiopia 5 years ago 3 minutes, 48 seconds 93,026 views",Hope Music Entertainment,93026,93113,87
2209,"Dawit Alemayehu - Nigat Semay | ንጋት ሰማይ  - New Ethiopian Music (Official Audio) by Hope Music Ethiopia 5 years ago 4 minutes, 52 seconds 94,028 views",Hope Music Entertainment,94028,94090,62
2210,"Dawit Alemayehu - Abye Zergaw | አብየ ዘርጋው - New Ethiopian Music 2016 (Official Audio) by Hope Music Ethiopia 5 years ago 6 minutes, 20 seconds 168,591 views",Hope Music Entertainment,168591,168759,168
2211,"Dawit Alemayehu - Kanchi Belay | ካንች በላይ - New Ethiopian Music 2016 (Official Audio) by Hope Music Ethiopia 5 years ago 5 minutes, 26 seconds 307,915 views",Hope Music Entertainment,307915,308049,134
2212,"Dawit Alemayehu - Likeyirat | ልቀይራት - New Ethiopian Music 2016 (Official Audio) by Hope Music Ethiopia 5 years ago 4 minutes, 36 seconds 128,249 views",Hope Music Entertainment,128249,128340,91
2213,"Dawit Alemayehu - Sene Selasa | ሰኔ ሰላሳ - New Ethiopian Music 2016 (Official Audio) by Hope Music Ethiopia 5 years ago 5 minutes, 15 seconds 251,398 views",Hope Music Entertainment,251398,251554,156
2214,"Habtamu kassaye - Ande Nen | አንድ ነን - New Ethiopian Music 2016 (Official Video) by Hope Music Ethiopia 5 years ago 4 minutes, 19 seconds 131,798 views",Hope Music Entertainment,131798,131830,32
2215,"Worku Andualem - Shillela | ሽለላ - New Ethiopian Music 2016 (Official Video) by Hope Music Ethiopia 5 years ago 6 minutes, 6 seconds 1,522,024 views",Hope Music Entertainment,1522024,1526002,3978
2216,"Mulubrehan Abeje - Yena Yena | የና የና - New Ethiopian Music 2016 (Official Video) by Hope Music Ethiopia 5 years ago 5 minutes, 2 seconds 34,938 views",Hope Music Entertainment,34938,34955,17
2217,"Tina Anagaw - Dehna Hun | ደህና ሁን - New Ethiopian Music 2016 (Official Video) by Hope Music Ethiopia 5 years ago 6 minutes, 28 seconds 145,657 views",Hope Music Entertainment,145657,145747,90
2218,"Ephrem Zelalem | Papi - Aleme | ዓለሜ - New Ethiopian Music 2016 (Official Video) by Hope Music Ethiopia 5 years ago 4 minutes, 26 seconds 64,159 views",Hope Music Entertainment,64159,64182,23
2219,"Workye Getachew - Beredu (በሬዱ) - New Ethiopian Music 2016 (Official Video) by Hope Music Ethiopia 5 years ago 5 minutes, 56 seconds 119,053 views",Hope Music Entertainment,119053,119104,51
2220,"Ethio Man - Acham Yelat (አቻም የላት) - New Ethiopian Music 2016 (Official Video) by Hope Music Ethiopia 5 years ago 5 minutes, 55 seconds 1,930,763 views",Hope Music Entertainment,1930763,1932564,1801
2221,"Ashenafi Zeberga - Segele (ሰገሌ) - New Ethiopian Music 2016 (Official Video) by Hope Music Ethiopia 5 years ago 4 minutes, 57 seconds 146,537 views",Hope Music Entertainment,146537,146686,149
2222,"Jacky Gosee - WANKO - New Ethiopian Music 2016 (Official Video) by Hope Music Ethiopia 5 years ago 4 minutes, 17 seconds 177,778 views",Hope Music Entertainment,177778,177814,36
2223,"Abood Fahad - Weyne - New Ethiopian Music 2016 (Official Video) by Hope Music Ethiopia 5 years ago 4 minutes, 7 seconds 40,359 views",Hope Music Entertainment,40359,40366,7
2224,"Yitagesu Nibretu -  Bugi Bugi Cha Cha - New Ethiopian Music 2016 (Official Video) by Hope Music Ethiopia 5 years ago 4 minutes, 26 seconds 426,100 views",Hope Music Entertainment,426100,426516,416
2225,"Mihretab Desta - Yibka Belew (ይብቃ በለው) - New Ethiopian Music 2016 (Official Video) by Hope Music Ethiopia 5 years ago 4 minutes, 50 seconds 42,838 views",Hope Music Entertainment,42838,42854,16
2226,"Davo ft. JukeBox - Setarochign Metahu - New Ethiopian Music 2016 (Official video) by Hope Music Ethiopia 5 years ago 5 minutes, 44 seconds 35,850 views",Hope Music Entertainment,35850,35869,19
2227,"Ashenafi Zeberga - 3Way (ስሪዌ) - New Ethiopian Music 2016 (Official Video) by Hope Music Ethiopia 5 years ago 5 minutes, 56 seconds 114,979 views",Hope Music Entertainment,114979,115088,109
2228,"Menbere T/Selassie - Yene Selam - New Ethiopian Music 2016 (Official Video) by Hope Music Ethiopia 5 years ago 5 minutes, 11 seconds 290,830 views",Hope Music Entertainment,290830,290861,31
2229,"Yared Negu - Chemere - New Ethiopian Music 2016 (Official Video) by Hope Music Ethiopia 5 years ago 4 minutes, 52 seconds 2,549,748 views",Hope Music Entertainment,2549748,2554776,5028
2230,"Aschenaki Bekele - Aylalam (አይላላም) - New Ethiopian Music 2016 (Official Video) by Hope Music Ethiopia 5 years ago 5 minutes, 45 seconds 90,762 views",Hope Music Entertainment,90762,90815,53
2231,"Dawit Alemayehu - Betizitash - New Ethiopian Music 2016 (Official Video) by Hope Music Ethiopia 5 years ago 4 minutes, 47 seconds 1,847,402 views",Hope Music Entertainment,1847402,1849925,2523
2232,"Ras Jany & Don Deltafa - Feeling Irie - New Ethiopian Music 2016 (Official Video) by Hope Music Ethiopia 5 years ago 3 minutes, 35 seconds 198,331 views",Hope Music Entertainment,198331,199033,702
2233,"Daniel Mislework - Yesew Yesew New | የሰው የሰው ነው - New Ethiopian Music 2016 (Official Video) by Hope Music Ethiopia 5 years ago 5 minutes, 6 seconds 77,203 views",Hope Music Entertainment,77203,77227,24
2234,"Frezer Taye ft. Day Go, Kepaso & Netsanet - AWDAMET - New Ethiopian Music 2016 (Official Video) by Hope Music Ethiopia 5 years ago 4 minutes, 6 seconds 50,362 views",Hope Music Entertainment,50362,50379,17
2235,"Simeon AG - Endih Eyetebela - New Ethiopian Music 2016 (Official Video) by Hope Music Ethiopia 5 years ago 4 minutes, 2 seconds 76,024 views",Hope Music Entertainment,76024,76027,3
2236,"Yosef Bekele - Enkutatash (እንቁጣጣሽ) - New Ethiopian Music 2016 (Official Video) by Hope Music Ethiopia 5 years ago 5 minutes, 16 seconds 477,146 views",Hope Music Entertainment,477146,477216,70
2237,"Emebet Negasi - Man Ende Hager - New Ethiopian Music 2016 (Official Video) by Hope Music Ethiopia 5 years ago 6 minutes, 3 seconds 651,445 views",Hope Music Entertainment,651445,652465,1020
2238,"Jote Deresu ft. Netsi - SHINEW MEWEDAT (ሺ ነዉ ሚወዳት) - New Ethiopian Music 2016 (Official Video) by Hope Music Ethiopia 5 years ago 5 minutes, 9 seconds 533,179 views",Hope Music Entertainment,533179,535444,2265
2239,"Million Abebe - Meneya - New Ethiopian Music 2016 (Official Video) by Hope Music Ethiopia 5 years ago 4 minutes, 6 seconds 185,378 views",Hope Music Entertainment,185378,185471,93
2240,"Biruk Getachew - Cher Awlegn (ቸር አውለኝ) - New Ethiopian Music 2016 (Official Video) by Hope Music Ethiopia 5 years ago 4 minutes, 55 seconds 102,858 views",Hope Music Entertainment,102858,102886,28
2241,"Kassahun Eshetu & Konjit Shanko - AWDAMET (አውዳመት) - New Ethiopian Music 2016 (Official Video) by Hope Music Ethiopia 5 years ago 6 minutes, 38 seconds 1,500,151 views",Hope Music Entertainment,1500151,1501060,909
2242,"Betty G | Dawit Tsige | Esubalew Yitayew & Sami Dan - ENE NEGN DERASH (እኔ ነኝ ደራሽ) (Official Video) by Hope Music Ethiopia 5 years ago 6 minutes, 14 seconds 3,670,419 views",Hope Music Entertainment,3670419,3676850,6431
2243,"Emebet Yeshibelay - Yemisrach (የምስራች) - New Ethiopian Music 2016 (Official Video) by Hope Music Ethiopia 5 years ago 6 minutes 603,012 views",Hope Music Entertainment,603012,603274,262
2244,"Mule Rootz - Zema - New Ethiopian Music 2016 (Official Video) by Hope Music Ethiopia 5 years ago 5 minutes, 21 seconds 809,422 views",Hope Music Entertainment,809422,810935,1513
2245,"Wave Slassian - Gual Temben - New Ethiopian Tigrigna Music 2016 (Official Video) by Hope Music Ethiopia 5 years ago 4 minutes, 39 seconds 262,564 views",Hope Music Entertainment,262564,262777,213
2246,"Dawit Alemayehu - Mizanish Tezaba - New Ethiopian Music 2016 (Official Video) by Hope Music Ethiopia 5 years ago 4 minutes, 29 seconds 3,126,105 views",Hope Music Entertainment,3126105,3130334,4229
2247,"Biruk Esundale - Aman Aman - New Ethiopian Music 2016 (Official Video) by Hope Music Ethiopia 5 years ago 4 minutes, 16 seconds 1,237,564 views",Hope Music Entertainment,1237564,1238785,1221
2248,"Girum Shimelis - Kurat - New Ethiopian Music 2016 (Official Video) by Hope Music Ethiopia 5 years ago 3 minutes, 10 seconds 38,866 views",Hope Music Entertainment,38866,38877,11
2249,"Dawit Tsige - Yagere Lij - New Ethiopian Music 2016 (Official Video) by Hope Music Ethiopia 5 years ago 6 minutes, 43 seconds 288,493 views",Hope Music Entertainment,288493,289445,952
2250,"Dagne Walle - Lefo Lefo (ለፎ ለፎ) - New Ethiopian Music 2016 (Official Video) by Hope Music Ethiopia 5 years ago 6 minutes, 30 seconds 876,533 views",Hope Music Entertainment,876533,879032,2499
2251,"Tewodros Demisse - Yene Hugni - New Ethiopian Music 2016 (Official Video) by Hope Music Ethiopia 5 years ago 4 minutes, 50 seconds 28,092 views",Hope Music Entertainment,28092,28101,9
2252,"Abraham Nigussie - Yanurlign - New Ethiopian Music 2016 (Official Video) by Hope Music Ethiopia 5 years ago 5 minutes, 17 seconds 188,944 views",Hope Music Entertainment,188944,189181,237
2253,"Dawit Wordofa - Yaz Lekek - New Ethiopian Music 2016 (Official Video) by Hope Music Ethiopia 5 years ago 4 minutes, 57 seconds 152,430 views",Hope Music Entertainment,152430,152477,47
2254,"Getish Mamo - Tekebel | ተቀበል - New Ethiopian Music 2016 (Official Video) by Hope Music Ethiopia 5 years ago 5 minutes, 15 seconds 28,645,334 views",Hope Music Entertainment,28645334,28745013,99679
2255,"Tom Amdu & Solomon Teresa - Yebuhelet Mata - New Ethiopian Music 2016 (Official Video) by Hope Music Ethiopia 5 years ago 3 minutes, 56 seconds 18,177 views",Hope Music Entertainment,18177,18181,4
2256,"Biruk Shewa - Felege Fikirshin - New Ethiopian Music 2016 (Official Video) by Hope Music Ethiopia 5 years ago 5 minutes, 28 seconds 120,026 views",Hope Music Entertainment,120026,120075,49
2257,"Miky Yo - Weregnan Wa (ወሬኛን ዋ !) - New Ethiopian Music 2016 (Official Video) by Hope Music Ethiopia 5 years ago 4 minutes, 39 seconds 152,132 views",Hope Music Entertainment,152132,152306,174
2258,"Solomon Demle - Fetenegn (ፈተነኝ) - New Ethiopian Music 2016 (Official Video) by Hope Music Ethiopia 5 years ago 6 minutes, 28 seconds 450,841 views",Hope Music Entertainment,450841,451265,424
2259,"Tsehay Amare - Meshe Na (መሸ ና) - New Ethiopian Music 2016 (Official Video) by Hope Music Ethiopia 5 years ago 5 minutes, 48 seconds 236,620 views",Hope Music Entertainment,236620,236746,126
2260,"G Mesay Kebede - Agegnehuat (አገኘሗት) - New Ethiopian Music 2016 (Official Video) by Hope Music Ethiopia 5 years ago 4 minutes, 52 seconds 2,664,777 views",Hope Music Entertainment,2664777,2667071,2294
2261,"Daniel Shawel - Kifu Ayinkash - New Ethiopian Music 2016 (Official Video) by Hope Music Ethiopia 5 years ago 4 minutes, 53 seconds 26,136 views",Hope Music Entertainment,26136,26142,6
2262,"Asne Abate - Mango - New Ethiopian Music (Official Video) by Hope Music Ethiopia 5 years ago 5 minutes, 56 seconds 32,091 views",Hope Music Entertainment,32091,32126,35
2263,"Wassi & Woah! - Kena Beyi (ቀና በይ)- New Ethiopian Music 2016 (Official Video) by Hope Music Ethiopia 5 years ago 5 minutes, 52 seconds 21,248 views",Hope Music Entertainment,21248,21254,6
2264,"Yemane Birhane - HOJERITA -  New Ethiopian Music 2016 (Official Video) by Hope Music Ethiopia 5 years ago 4 minutes, 31 seconds 54,615 views",Hope Music Entertainment,54615,54625,10
2265,"Habtamu Mengistu - Min Yishalal - New Ethiopian Music 2016 (Official Video) by Hope Music Ethiopia 5 years ago 5 minutes, 55 seconds 55,213 views",Hope Music Entertainment,55213,55226,13
2266,"Workye Getachew - Zebenay - New Ethiopian Music 2016 (Official Video) by Hope Music Ethiopia 5 years ago 5 minutes, 36 seconds 373,012 views",Hope Music Entertainment,373012,373384,372
2267,"Getahun Ketema - Beday Yiresal - New Ethiopian Music 2016 (Official Video) by Hope Music Ethiopia 5 years ago 5 minutes, 31 seconds 148,696 views",Hope Music Entertainment,148696,148986,290
2268,"Endale Admike ft Ras Biruk - Candy - New Ethiopian Music 2016 (Official Video) by Hope Music Ethiopia 5 years ago 4 minutes, 35 seconds 490,190 views",Hope Music Entertainment,490190,490382,192
2269,"AHADU & Syco x Skat x Yabu Jc  - Wey Gude - New Ethiopian Music 2016 (Official Video) by Hope Music Ethiopia 5 years ago 3 minutes, 23 seconds 2,145,470 views",Hope Music Entertainment,2145470,2151922,6452
2270,"Sam Seyoum - Tey Atiferi - New Ethiopian Music 2016 (Official Video) by Hope Music Ethiopia 5 years ago 3 minutes, 48 seconds 63,652 views",Hope Music Entertainment,63652,63666,14
2271,"Genet Kiros (GK) ft Sami Go - Ketesmamagn - New Ethiopian Music 2016 (Official Video) by Hope Music Ethiopia 5 years ago 4 minutes, 9 seconds 180,479 views",Hope Music Entertainment,180479,180509,30
2272,"Mesay Tefera - Asebkut - New Ethiopian Music 2016 (Official Video) by Hope Music Ethiopia 5 years ago 5 minutes, 16 seconds 1,903,335 views",Hope Music Entertainment,1903335,1906660,3325
2273,"Lidj Abebaw - Ayteshign Endalayesh - New Ethiopian Music 2016 (Official Video) by Hope Music Ethiopia 5 years ago 5 minutes, 17 seconds 37,446 views",Hope Music Entertainment,37446,37461,15
2274,"Genet Mulugeta - Kora Bel (ኮራ በል) - New Ethiopian Music 2016 (Official Video) by Hope Music Ethiopia 5 years ago 4 minutes, 38 seconds 1,415,681 views",Hope Music Entertainment,1415681,1417055,1374
2275,"Fikremariam Gebru - Wuded (ውድድድ) - New Ethiopian Music 2016 (Official Video) by Hope Music Ethiopia 5 years ago 5 minutes, 29 seconds 3,005,927 views",Hope Music Entertainment,3005927,3010819,4892
2276,"kaleab Mulugeta - Tenadame - New Ethiopian Music 2016 (Official Video) by Hope Music Ethiopia 5 years ago 4 minutes, 57 seconds 5,731,568 views",Hope Music Entertainment,5731568,5764692,33124
2277,"Blen Hailu - Anten Sasib - New Ethiopian Music 2016 (Official Video) by Hope Music Ethiopia 5 years ago 3 minutes, 45 seconds 22,832 views",Hope Music Entertainment,22832,22836,4
2278,"Selamawit G/Hiwot & Tadilo Boled - Digu Manja - New Ethiopian Music (Official Video) by Hope Music Ethiopia 5 years ago 4 minutes, 59 seconds 19,560 views",Hope Music Entertainment,19560,19569,9
2279,"Asne Abate - Goda Zoko - New Ethiopian Music 2016 (Official Video) by Hope Music Ethiopia 5 years ago 4 minutes, 37 seconds 33,066 views",Hope Music Entertainment,33066,33083,17
2280,"Binyam Negatu - Jenen - New Ethiopian Music 2016 (Official Video) by Hope Music Ethiopia 5 years ago 4 minutes, 37 seconds 37,134 views",Hope Music Entertainment,37134,37146,12
2281,"Mulugeta Lema - Yene Bicha - New Ethiopian Music 2016 (Official Video) by Hope Music Ethiopia 5 years ago 5 minutes, 33 seconds 87,334 views",Hope Music Entertainment,87334,87359,25
2282,"Michael Melaku (Mike) - Dera - New Ethiopian Music 2016 (Official Video) by Hope Music Ethiopia 5 years ago 4 minutes, 41 seconds 49,998 views",Hope Music Entertainment,49998,50022,24
2283,"Smachew Kassa - Munana - New Ethiopian Music 2016 (Official Video) by Hope Music Ethiopia 5 years ago 5 minutes, 6 seconds 61,348 views",Hope Music Entertainment,61348,61384,36
2284,"Rekik Amare - Yesew Sew - New Ethiopian Music 2016 (Official Video) by Hope Music Ethiopia 5 years ago 4 minutes, 52 seconds 60,900 views",Hope Music Entertainment,60900,60912,12
2285,"Shewandagne Hailu - Semta Yihon Ende - New Ethiopian Music 2016 (Official Video) by Hope Music Ethiopia 5 years ago 4 minutes, 46 seconds 880,921 views",Hope Music Entertainment,880921,884362,3441
2286,"Mikiyas Nigussie (Miki Lala) - Wede Hagere - New Ethiopian Music (Official Video) by Hope Music Ethiopia 5 years ago 4 minutes, 54 seconds 762,625 views",Hope Music Entertainment,762625,762927,302
2287,"Blen Hailu (ሚጣ) - Yihuna - New Ethiopian Music (Official Video) by Hope Music Ethiopia 5 years ago 5 minutes, 1 second 46,328 views",Hope Music Entertainment,46328,46338,10
2288,"Immuu Girmaa (Boranaa) -  Hellee - New Ethiopian Music 2016 (Official Video) by Hope Music Ethiopia 5 years ago 3 minutes, 52 seconds 51,507 views",Hope Music Entertainment,51507,51517,10
2289,"Hassen Argaw - Yiderkal - New Ethiopian Music 2016 (Official Video) by Hope Music Ethiopia 5 years ago 4 minutes, 42 seconds 1,009,847 views",Hope Music Entertainment,1009847,1010132,285
2290,"Mamila Lukas ft Sara T - Jerusalem - New Ethiopian Music 2016 (Official Video) by Hope Music Ethiopia 5 years ago 5 minutes, 40 seconds 185,699 views",Hope Music Entertainment,185699,185788,89
2291,"Endale Admeke - Kal Selegebahu - New Ethiopian Music 2016 (Official Video) by Hope Music Ethiopia 5 years ago 5 minutes, 22 seconds 122,114 views",Hope Music Entertainment,122114,122288,174
2292,"Sam Habesha ft Jiregna Shiferaw - Sekeren - New Ethiopian Music 2016 (Official Video) by Hope Music Ethiopia 5 years ago 5 minutes, 11 seconds 186,042 views",Hope Music Entertainment,186042,186091,49
2293,"Bereket Hailu (Beki) - Terachign Demo - New Ethiopian Music 2016 (Official video) by Hope Music Ethiopia 5 years ago 3 minutes, 29 seconds 15,615 views",Hope Music Entertainment,15615,15629,14
2294,"Fikiru Arage (የአሜሪካው) - Kizhet (ቅዠት) - New Ethiopian  Musical Comedy 2016 (Official Video) by Hope Music Ethiopia 5 years ago 5 minutes, 24 seconds 360,440 views",Hope Music Entertainment,360440,360724,284
2295,"Betelhem Dagnachew - Demo Bayne Metah - New Ethiopian Music 2016 (Official Video) by Hope Music Ethiopia 5 years ago 6 minutes, 34 seconds 997,461 views",Hope Music Entertainment,997461,1000544,3083
2296,"Biruk Tsegaye - Wub Aleme - New Ethiopia Music 2016 (Official Video) by Hope Music Ethiopia 5 years ago 5 minutes, 42 seconds 26,325 views",Hope Music Entertainment,26325,26330,5
2297,"Workneh Asrat - Agegnehu - New Ethiopian Music 2016 (Official Video) by Hope Music Ethiopia 5 years ago 5 minutes, 8 seconds 80,125 views",Hope Music Entertainment,80125,80139,14
2298,"Tunke (DJ 2K) ft Gildo kassa - Dance - New Ethiopian Music 2016 (Official Video) by Hope Music Ethiopia 5 years ago 5 minutes, 3 seconds 1,153,645 views",Hope Music Entertainment,1153645,1157064,3419
2299,"Daniel Mislework (Dani Dance) - Aynen - New Ethiopian Music 2016 (Official Video) by Hope Music Ethiopia 5 years ago 5 minutes, 21 seconds 247,838 views",Hope Music Entertainment,247838,248148,310
2300,"Defaru Getnet - Ershrshu (እርሽርሹ) - New Ethiopian Music 2016 (Official Video) by Hope Music Ethiopia 5 years ago 5 minutes, 37 seconds 574,545 views",Hope Music Entertainment,574545,575466,921
2301,"Tsion Assefa (NINI) - Wedih New Bete - New Ethiopian Music 2016 (Official Video) by Hope Music Ethiopia 5 years ago 4 minutes, 56 seconds 49,788 views",Hope Music Entertainment,49788,49861,73
2302,"Ha Ge'ez - Yefikir Damakase - New Ethiopian Music 2016 (Official Video) by Hope Music Ethiopia 5 years ago 5 minutes, 15 seconds 81,420 views",Hope Music Entertainment,81420,81471,51
2303,"Meselu Fantahun - Gojam Lay - New Ethiopian Music 2016 (Official Video) by Hope Music Ethiopia 5 years ago 5 minutes, 9 seconds 1,665,563 views",Hope Music Entertainment,1665563,1673630,8067
2304,"Dawit Wordofa - Yebchaye - New Ethiopiann Music 2016 (Official Video) by Hope Music Ethiopia 5 years ago 3 minutes, 42 seconds 240,159 views",Hope Music Entertainment,240159,240837,678
2305,"Gizachew Teshome - Liyu Nesh - New Ethiopian Music (Official Video) by Hope Music Ethiopia 5 years ago 5 minutes, 13 seconds 2,898,049 views",Hope Music Entertainment,2898049,2916015,17966
2306,"Abebe Kefeni - Megaal werre Quaalu - New Ethiopian Music 2016 (Official Video) by Hope Music Ethiopia 5 years ago 5 minutes, 49 seconds 432,090 views",Hope Music Entertainment,432090,433028,938
2307,"Geremew Gualu - Alemeyaz New - New Ethiopian Music 2016 (Official Video) by Hope Music Ethiopia 5 years ago 6 minutes, 8 seconds 622,288 views",Hope Music Entertainment,622288,623119,831
2308,"Lidya Teklu - Lante Adela - New Ethiopian Music 2016 (Official Video) by Hope Music Ethiopia 5 years ago 5 minutes, 21 seconds 16,172 views",Hope Music Entertainment,16172,16177,5
2309,"Teferi Tesfaye - Mar Huna - New Ethiopian Music 2016 (Official Video) by Hope Music Ethiopia 5 years ago 7 minutes, 21 seconds 216,574 views",Hope Music Entertainment,216574,216626,52
2310,"Tigist Kassahun (TT) -  Alaznem - New Ethiopian Music 2016 (Official Video) by Hope Music Ethiopia 5 years ago 4 minutes, 6 seconds 103,698 views",Hope Music Entertainment,103698,103721,23
2311,"Fabulous Addis @ Bole Fana Park June 4/ 2016 by Hope Music Ethiopia 5 years ago 2 minutes, 30 seconds 17,470 views",Hope Music Entertainment,17470,17473,3
2312,"Yared Negu - Hulum Hagere - New Ethiopian Music 2016 (Official Video) by Hope Music Ethiopia 5 years ago 5 minutes, 4 seconds 7,436,207 views",Hope Music Entertainment,7436207,7449158,12951
2313,"Sintayehu Enyew -  Bey Neyina - New Ethiopian Music 2016 (Official Video) by Hope Music Ethiopia 5 years ago 4 minutes, 22 seconds 395,653 views",Hope Music Entertainment,395653,395721,68
2314,"Alex Olompia - Dagim Endegena - New Ethiopian Music 2016 (Official Video) by Hope Music Ethiopia 5 years ago 5 minutes, 31 seconds 367,328 views",Hope Music Entertainment,367328,367678,350
2315,"Dawit Almaz - Teketelkush - New Ethiopian Music 2016 (Official Video) by Hope Music Ethiopia 5 years ago 5 minutes, 28 seconds 670,253 views",Hope Music Entertainment,670253,670593,340
2316,"Selamawit Nega - Kuru New - New Ethiopian Music 2016 (Official Video) by Hope Music Ethiopia 5 years ago 4 minutes, 1 second 75,323 views",Hope Music Entertainment,75323,75346,23
2317,"Wansisa Wana (Siso Man) - Ansi Male Dama - New Ethiopian Music 2016 (Official Video) by Hope Music Ethiopia 5 years ago 3 minutes, 55 seconds 147,777 views",Hope Music Entertainment,147777,147835,58
2318,"Alemayehu Edmealem - Endalew Libe - New Ethiopian Music 2016 (Official Video) by Hope Music Ethiopia 5 years ago 4 minutes, 25 seconds 1,229,501 views",Hope Music Entertainment,1229501,1230047,546
2319,"Efrem G/Michael - Salayat - New Ethiopian Music 2016 (Official Video) by Hope Music Ethiopia 5 years ago 6 minutes, 14 seconds 198,302 views",Hope Music Entertainment,198302,198365,63
2320,"Demeke Bitew - Emu Telemegni - New Ethiopian Music 2016 (Official Video) by Hope Music Ethiopia 5 years ago 6 minutes 120,116 views",Hope Music Entertainment,120116,120288,172
2321,"Fasil Dagne - Gonder - New Ethiopian Music 2016 (Official Video) by Hope Music Ethiopia 5 years ago 5 minutes, 58 seconds 445,133 views",Hope Music Entertainment,445133,445270,137
2322,"Binu Solomon - Ney Melaye - New Ethiopian Music 2016 (Official Video) by Hope Music Ethiopia 5 years ago 4 minutes, 30 seconds 1,913,315 views",Hope Music Entertainment,1913315,1914025,710
2323,"Hailye Tadesse - Yesergachew Elet - New Ethiopian Music (Official Audio/Video) by Hope Music Ethiopia 5 years ago 5 minutes, 11 seconds 107,053 views",Hope Music Entertainment,107053,107147,94
2324,"Tigist G/Meskel - Lalsemah - New Ethiopian Music 2016 (Official Video) by Hope Music Ethiopia 5 years ago 6 minutes, 15 seconds 66,899 views",Hope Music Entertainment,66899,66912,13
2325,"Ashenafi Legesse - Babur Ena Dire - New Ethiopian Music 2016 (Official Video) by Hope Music Ethiopia 5 years ago 5 minutes, 27 seconds 43,822 views",Hope Music Entertainment,43822,44056,234
2326,"Yirga Hunachew - Salayish - New Ethiopian Music 2016 (Official Video) by Hope Music Ethiopia 5 years ago 5 minutes, 9 seconds 123,184 views",Hope Music Entertainment,123184,123201,17
2327,"Tsehay Alem  -  Raya - New Ethiopian Music 2016 (Official Video) by Hope Music Ethiopia 5 years ago 5 minutes, 22 seconds 362,608 views",Hope Music Entertainment,362608,363008,400
2328,"Dawd Sultan (Dawa) - Yarada Lij -  New Ethiopian Music 2016 (Official Video) by Hope Music Ethiopia 5 years ago 4 minutes, 13 seconds 69,118 views",Hope Music Entertainment,69118,69130,12
2329,"Ehtnesh Fenta -  Kuru Gondere - New Ethiopian Music 2016 (Official Video) by Hope Music Ethiopia 5 years ago 5 minutes, 25 seconds 235,955 views",Hope Music Entertainment,235955,236585,630
2330,"Mykey Shewa  - Aegba (ኤግባ) - New Ethiopian Music 2016 (Official Video) by Hope Music Ethiopia 5 years ago 4 minutes, 36 seconds 1,380,003 views",Hope Music Entertainment,1380003,1383570,3567
2331,"Tadele Roba ft Ewolo Mazembo Serge - Tosishe - New Ethiopian Music 2016 (Official Video) by Hope Music Ethiopia 5 years ago 5 minutes, 37 seconds 5,091,977 views",Hope Music Entertainment,5091977,5099561,7584
2332,"Berhanu Tezera - Yemanesh - New Ethiopian Music 2016 (Official Video) by Hope Music Ethiopia 5 years ago 4 minutes, 27 seconds 1,358,601 views",Hope Music Entertainment,1358601,1360302,1701
2333,"Ras Biruk - Rello - New Ethiopian Music 2016 (Official Video) by Hope Music Ethiopia 5 years ago 5 minutes, 41 seconds 130,521 views",Hope Music Entertainment,130521,130623,102
2334,"Abdu Kiar -  Zhwa Zhwe - New Ethiopian Music 2016 (Official Video) by Hope Music Ethiopia 5 years ago 5 minutes, 52 seconds 6,327,701 views",Hope Music Entertainment,6327701,6332500,4799
2335,"Ermiyas Tulu - Tey Beluat - New Ethiopian Music 2016 (Official Video) by Hope Music Ethiopia 5 years ago 4 minutes, 56 seconds 165,515 views",Hope Music Entertainment,165515,165620,105
2336,"Dawd Sultan - Awdamet - New Ethiopian Music 2016 (Official Video) by Hope Music Ethiopia 5 years ago 6 minutes, 11 seconds 218,072 views",Hope Music Entertainment,218072,218223,151
2337,"Buzayehu Kifle (Buze Man) - Eshururu - New Ethiopian Music 2016 (Official Video) by Hope Music Ethiopia 5 years ago 5 minutes 1,483,872 views",Hope Music Entertainment,1483872,1489966,6094
2338,"Hanna Alemayehu - Awdamet - New Ethiopian Music 2016 (Official Video) by Hope Music Ethiopia 5 years ago 5 minutes, 12 seconds 278,074 views",Hope Music Entertainment,278074,278319,245
2339,"Abdu kiar - Yene Mar - New Ethiopian Music 2016 (Official Video) by Hope Music Ethiopia 5 years ago 5 minutes, 30 seconds 1,433,124 views",Hope Music Entertainment,1433124,1457562,24438
2340,"Mulugeta Shite - Yaskuala Temari - New Ethiopian Music 2016 (Official Video) by Hope Music Ethiopia 5 years ago 5 minutes, 1 second 57,180 views",Hope Music Entertainment,57180,57217,37
2341,"Ras Biruk (Barky) - Zemen - New Ethiopian Music 2016 (Official Video) by Hope Music Ethiopia 5 years ago 5 minutes, 53 seconds 48,926 views",Hope Music Entertainment,48926,48965,39
2342,"Ashenafi Legesse - Goh Sayked - New Ethiopian Music 2016 (Official Video) by Hope Music Ethiopia 5 years ago 4 minutes, 53 seconds 320,920 views",Hope Music Entertainment,320920,321428,508
2343,"Fitawrary Kibromma ft Lexi Sol - Agul Siltane - New Ethiopian Music 2016 (Official Video) by Hope Music Ethiopia 5 years ago 5 minutes, 37 seconds 15,896 views",Hope Music Entertainment,15896,15909,13
2344,"Mekuanent  Melesse & Aster Wolde - Almazu - New Ethiopian Music 2016 (Official Video) by Hope Music Ethiopia 5 years ago 6 minutes, 10 seconds 7,414,624 views",Hope Music Entertainment,7414624,7455757,41133
2345,"Mulugeta Alemu - Yefikir Tselote - New Ethiopian Music 2016 (Official Video) by Hope Music Ethiopia 5 years ago 4 minutes, 12 seconds 47,433 views",Hope Music Entertainment,47433,47476,43
2346,"Haimanot Awoke - Kekal Belay - New Ethiopian Music 2016 (Official Video) by Hope Music Ethiopia 5 years ago 4 minutes, 17 seconds 242,906 views",Hope Music Entertainment,242906,243260,354
2347,"Sancho Gebre ft Gildo Kassa -  Ande - New Ethiopian Music 2016 (Official Video) by Hope Music Ethiopia 5 years ago 4 minutes, 21 seconds 1,059,961 views",Hope Music Entertainment,1059961,1063529,3568
2348,"Mamila Lukas - Ethiopia Lay - New Ethiopian Music 2016 (Official Video) by Hope Music Ethiopia 5 years ago 5 minutes, 4 seconds 579,366 views",Hope Music Entertainment,579366,580007,641
2349,"Solome Yosef (Soli) - Zendirosa - New Ethiopian Music 2016 (Official Video) by Hope Music Ethiopia 5 years ago 4 minutes, 54 seconds 213,698 views",Hope Music Entertainment,213698,214253,555
2350,"Dawit Tsige - Tamriyalesh - Ethiopian Wedding Song 2016 (Official Video) by Hope Music Ethiopia 5 years ago 8 minutes, 6 seconds 358,647 views",Hope Music Entertainment,358647,359770,1123
2351,"Meselu Tesema - Gojamew Na - New Ethiopian Music 2016 (Official Video) by Hope Music Ethiopia 5 years ago 5 minutes, 45 seconds 86,522 views",Hope Music Entertainment,86522,86543,21
2352,"Anteneh Asrat - Banchi Alferdim - New Ethiopian Music 2016 (Official Video) by Hope Music Ethiopia 5 years ago 5 minutes, 22 seconds 254,479 views",Hope Music Entertainment,254479,254562,83
2353,"Dagmawi Yirga Belay -  woyne woyne - New Ethiopian Music 2016 (Official Video) by Hope Music Ethiopia 5 years ago 5 minutes, 59 seconds 115,939 views",Hope Music Entertainment,115939,116003,64
2354,"Ashenafi Legesse - Weyneye - New Ethiopian Music 2016 (Official Video) by Hope Music Ethiopia 5 years ago 4 minutes, 53 seconds 613,549 views",Hope Music Entertainment,613549,615174,1625
2355,"Yidnekachew Tsegaye (Yidu) -  Bedimtsish - New Ethiopian Music 2016 (Official Video) by Hope Music Ethiopia 5 years ago 4 minutes, 8 seconds 255,573 views",Hope Music Entertainment,255573,255588,15
2356,"Kit Amenu - Neylign - New Ethiopian Music 2016 (Official Video) by Hope Music Ethiopia 5 years ago 5 minutes, 8 seconds 134,576 views",Hope Music Entertainment,134576,134700,124
2357,"Genet Mulugeta - Nana - New Ethiopian Music 2016 (Official Video) by Hope Music Ethiopia 5 years ago 4 minutes, 47 seconds 600,259 views",Hope Music Entertainment,600259,600769,510
2358,"Selamawit Yohannes & Fikremariam Gebru - Nafkot - New Ethiopian Music 2016 (Official Video) by Hope Music Ethiopia 5 years ago 5 minutes, 48 seconds 9,422,749 views",Hope Music Entertainment,9422749,9452553,29804
2359,"Elias Gizachew - Tera Tera - New Ethiopian Music 2016 (Official Video) by Hope Music Ethiopia 5 years ago 6 minutes, 1 second 2,033,283 views",Hope Music Entertainment,2033283,2035359,2076
2360,"Alem Kebede - Dae Bushu - New Ethiopian Music 2016 (Official Video) by Hope Music Ethiopia 5 years ago 3 minutes, 58 seconds 33,790 views",Hope Music Entertainment,33790,33820,30
2361,"Zeni Tizazu - Aman Awlegn - New Ethiopian Music 2016 (Official Video) by Hope Music Ethiopia 5 years ago 6 minutes, 20 seconds 575,302 views",Hope Music Entertainment,575302,576772,1470
2362,"Banchiamlak Getnet - Zarenew - New Ethiopian Music 2016 (Official Video) by Hope Music Ethiopia 5 years ago 5 minutes, 30 seconds 639,390 views",Hope Music Entertainment,639390,641888,2498
2363,"Nahom Haile - Bey Sechign Mela - New Ethiopian Music 2016 (Official Video) by Hope Music Ethiopia 5 years ago 3 minutes, 50 seconds 52,171 views",Hope Music Entertainment,52171,52178,7
2364,"Dawit Tsige - Betam New Yemewedish - New Ethiopian Music 2016 (Official Video) by Hope Music Ethiopia 5 years ago 5 minutes, 45 seconds 1,455,967 views",Hope Music Entertainment,1455967,1466916,10949
2365,"Kichini Goa - Enane Bay - New Ethiopian Music 2016 (Official Video) by Hope Music Ethiopia 5 years ago 6 minutes, 20 seconds 99,562 views",Hope Music Entertainment,99562,99703,141
2366,"DC Zerfinesh - Tikura - New Ethiopian Music 2016 (Official Video) by Hope Music Ethiopia 5 years ago 5 minutes, 27 seconds 216,503 views",Hope Music Entertainment,216503,216603,100
2367,"Kidist Hailu - Yene Adam - Ethiopian Music 2016 (Official Video) by Hope Music Ethiopia 5 years ago 4 minutes, 24 seconds 135,371 views",Hope Music Entertainment,135371,135403,32
2368,"Andy Amare - Hugni Balebete - Ethiopian Music 2016 (Official Video) by Hope Music Ethiopia 5 years ago 5 minutes, 5 seconds 1,313,364 views",Hope Music Entertainment,1313364,1313546,182
2369,"Wendi Mar (Wendesen Maru) - Ney Shromeda - Ethiopian Music 2016 (Official Video) by Hope Music Ethiopia 5 years ago 4 minutes, 45 seconds 86,790 views",Hope Music Entertainment,86790,86972,182
2370,"Tensae Gubena - SEMAY - New Ethiopian Music 2016 (Official Video) by Hope Music Ethiopia 5 years ago 4 minutes, 59 seconds 96,064 views",Hope Music Entertainment,96064,96327,263
2371,"Mulualem Takele ft Gildo Kasa - Hamelmalo - New Ethiopian Music 2016 (Official Video) by Hope Music Ethiopia 5 years ago 5 minutes, 7 seconds 6,951,558 views",Hope Music Entertainment,6951558,6986170,34612
2372,"Asegid Eshetu - Emwedish - New Ethiopian Music 2016 (Official Video) by Hope Music Ethiopia 5 years ago 5 minutes, 11 seconds 2,408,251 views",Hope Music Entertainment,2408251,2411113,2862
2373,"Mieraf Assefa - Enchi Enka - New Ethiopian Music 2016 (Official Video) by Hope Music Ethiopia 6 years ago 4 minutes, 58 seconds 3,040,885 views",Hope Music Entertainment,3040885,3048376,7491
2374,"Alem kebede - Solomon - New Ethiopian Music 2016 (Official Video) by Hope Music Ethiopia 6 years ago 6 minutes, 15 seconds 96,315 views",Hope Music Entertainment,96315,96375,60
2375,"Anteneh Worku - WEYE - New Ethiopian Music 2016 (Official Video) by Hope Music Ethiopia 6 years ago 4 minutes, 37 seconds 107,977 views",Hope Music Entertainment,107977,108082,105
2376,"Semon Hayle ft Haimanot Asrat - Balechin Gize - New Ethiopian Music 2016 (Official Video) by Hope Music Ethiopia 6 years ago 3 minutes, 41 seconds 102,536 views",Hope Music Entertainment,102536,102560,24
2377,"Henok Berhanu - Keredash - New Ethiopian Music 2016 (Official Video) by Hope Music Ethiopia 6 years ago 4 minutes, 53 seconds 299,678 views",Hope Music Entertainment,299678,299819,141
2378,"Mastewal Admasu - Gonder - New Ethiopian Music 2016 (Official Video) by Hope Music Ethiopia 6 years ago 5 minutes, 35 seconds 599,508 views",Hope Music Entertainment,599508,601140,1632
2379,"Hamelmal Abate ft Melat Mengesha - Hasset - New Ethiopian Music 2016 (Official Video) by Hope Music Ethiopia 6 years ago 4 minutes, 41 seconds 38,214 views",Hope Music Entertainment,38214,38238,24
2380,"Temesgen Gebregziabher (Temu) - Tibel Zena - New Ethiopian Music 2016 (Official Video) by Hope Music Ethiopia 6 years ago 4 minutes, 53 seconds 3,957,335 views",Hope Music Entertainment,3957335,3963645,6310
2381,"Belete Mesele - Tinkebarerbet - New Ethiopian Music 2016 (Official Video) by Hope Music Ethiopia 6 years ago 4 minutes, 46 seconds 61,992 views",Hope Music Entertainment,61992,62021,29
2382,"Tewodros Demisse - Demkesh - New Ethiopian Music 2016 (Official Video) by Hope Music Ethiopia 6 years ago 4 minutes, 18 seconds 26,512 views",Hope Music Entertainment,26512,26528,16
2383,"Abraham Nigussie - Meshe Meshe - New Ethiopian Music 2016 (Official Video) by Hope Music Ethiopia 6 years ago 4 minutes, 5 seconds 49,793 views",Hope Music Entertainment,49793,49844,51
2384,"Wondimu Jira - Tafach Kal (ጣፋጭ ቃል) - New Ethiopian Music 2016 (Official Audio) by Hope Music Ethiopia 6 years ago 5 minutes, 40 seconds 75,466 views",Hope Music Entertainment,75466,75532,66
2385,"Wondimu Jira - DJew (ዲጄው) - New Ethiopian Music 2016 (Official Audio) by Hope Music Ethiopia 6 years ago 5 minutes, 41 seconds 75,427 views",Hope Music Entertainment,75427,75619,192
2386,"Merkeb Bonitua - Shewruba - New Ethiopian Music (Official Video) by Hope Music Ethiopia 6 years ago 4 minutes, 53 seconds 63,926 views",Hope Music Entertainment,63926,63966,40
2387,"Awoke Abebe - Ay Gize Ay Zemen - New Ethiopian Music (Official Video) by Hope Music Ethiopia 6 years ago 4 minutes, 55 seconds 111,398 views",Hope Music Entertainment,111398,111519,121
2388,"Zola - Anchima Lene - New Ethiopian Music (Official Video) by Hope Music Ethiopia 6 years ago 5 minutes, 57 seconds 18,190 views",Hope Music Entertainment,18190,18206,16
2389,"Meron Teklay -  Neylign - New Ethiopian Music 2016 (Official Video) by Hope Music Ethiopia 6 years ago 4 minutes, 30 seconds 9,063 views",Hope Music Entertainment,9063,9073,10
2390,"Babby Ragga - Sewlesew Enihun - New Ethiopian Music 2016 (Official Video) by Hope Music Ethiopia 6 years ago 4 minutes, 45 seconds 22,599 views",Hope Music Entertainment,22599,22611,12
2391,"Asgegnew Ashko (Asge) - Yadisse - New Ethiopian Music 2016 (Official Video) by Hope Music Ethiopia 6 years ago 4 minutes, 57 seconds 7,063,748 views",Hope Music Entertainment,7063748,7092839,29091
2392,"Yohannes Mulugeta (ጆኒ) - Neyilgn - New Ethiopian Music (Official Video) by Hope Music Ethiopia 6 years ago 5 minutes, 5 seconds 166,799 views",Hope Music Entertainment,166799,166936,137
2393,"Moges Mebratu -  WOLEBA - New Ethiopian Music (Official Video) by Hope Music Ethiopia 6 years ago 4 minutes, 38 seconds 406,338 views",Hope Music Entertainment,406338,406504,166
2394,"Hilina Manyazewal - Bematebu Lidagn - New Ethiopian Music 2016 (Official Video) by Hope Music Ethiopia 6 years ago 5 minutes, 8 seconds 110,159 views",Hope Music Entertainment,110159,110173,14
2395,"Yiftusera Zerihun -  Bos Bos - New Ethiopian Music 2016 (Official Video) by Hope Music Ethiopia 6 years ago 5 minutes, 12 seconds 14,226 views",Hope Music Entertainment,14226,14243,17
2396,"Siyumekal Gebre -  Abereregn - New Ethiopian Music 2016 (Official Video) by Hope Music Ethiopia 6 years ago 5 minutes, 6 seconds 184,839 views",Hope Music Entertainment,184839,185119,280
2397,"Tariku Berta - Embi Bila - New Ethiopian Music 2016 (Official Video) by Hope Music Ethiopia 6 years ago 4 minutes, 33 seconds 37,839 views",Hope Music Entertainment,37839,37852,13
2398,"Amsal Mitike - Ende Bethelhem - New Ethiopian Music 2016 (Official Video) by Hope Music Ethiopia 6 years ago 6 minutes, 15 seconds 1,003,852 views",Hope Music Entertainment,1003852,1007061,3209
2399,"Amsal Mitike - Mela Bel - New Ethiopian Music (Official Video) by Hope Music Ethiopia 6 years ago 5 minutes, 22 seconds 444,211 views",Hope Music Entertainment,444211,446303,2092
2400,"Michael Melaku - Yene Nesh - New Ethiopian Music 2016 (Official Video) by Hope Music Ethiopia 6 years ago 3 minutes, 53 seconds 1,026,224 views",Hope Music Entertainment,1026224,1026684,460
2401,"KB MAN - Konjo - New Ethiopian Music 2016 (Official Video) by Hope Music Ethiopia 6 years ago 5 minutes, 1 second 1,824,566 views",Hope Music Entertainment,1824566,1824838,272
2402,"Ethio Man - And ken - New Ethiopian Music 2016 (Official Video) by Hope Music Ethiopia 6 years ago 6 minutes, 54 seconds 94,391 views",Hope Music Entertainment,94391,94441,50
2403,"Wendimu Jira - Sime Nesh - New Ethiopian Music 2016 (Official Video) by Hope Music Ethiopia 6 years ago 5 minutes, 2 seconds 1,345,449 views",Hope Music Entertainment,1345449,1355074,9625
2404,"Melaku Bireda - Ziyoze - New Ethiopian Music 2016 (Official Video) by Hope Music Ethiopia 6 years ago 4 minutes, 13 seconds 69,592 views",Hope Music Entertainment,69592,69640,48
2405,"Fasika Niguse - Alebish Gura - New Ethiopian Music 2016 (Official Video) by Hope Music Ethiopia 6 years ago 5 minutes, 5 seconds 494,246 views",Hope Music Entertainment,494246,494954,708
2406,"Bini Goytom - Dej Adere - New Ethiopian Music 2016 (Official Video) by Hope Music Ethiopia 6 years ago 6 minutes 918,544 views",Hope Music Entertainment,918544,919000,456
2407,"Helena Gebregziabher - Des Des - New Ethiopian Music 2016 (Official Video) by Hope Music Ethiopia 6 years ago 4 minutes, 51 seconds 13,963 views",Hope Music Entertainment,13963,13982,19
2408,"Sasahulish Berga - Alaminishim - New Ethiopian Music (Official Video) by Hope Music Ethiopia 6 years ago 4 minutes, 32 seconds 3,330,483 views",Hope Music Entertainment,3330483,3337223,6740
2409,"King Teddy - LEBO LEBO - New Ethiopian Music 2016 (Official Video) by Hope Music Ethiopia 6 years ago 4 minutes, 16 seconds 75,746 views",Hope Music Entertainment,75746,75778,32
2410,"Emebet Negasi - Yeregnaw Fikir - New Ethiopian Music 2016 (Official Video) by Hope Music Ethiopia 6 years ago 6 minutes, 5 seconds 680,002 views",Hope Music Entertainment,680002,681561,1559
2411,"Netsanet Melese - Nigeregn - New Ethiopian Music 2016(Official Video) by Hope Music Ethiopia 6 years ago 5 minutes, 21 seconds 875,544 views",Hope Music Entertainment,875544,876991,1447
2412,"Leulseged Niguse - Birer Alegn - New Ethiopian Music 2016 (Official Video) by Hope Music Ethiopia 6 years ago 5 minutes, 35 seconds 190,961 views",Hope Music Entertainment,190961,191100,139
2413,"Niway Damtie - Suke Dance - New Ethiopian Music 2016 (Official Video) by Hope Music Ethiopia 6 years ago 4 minutes, 6 seconds 3,662,555 views",Hope Music Entertainment,3662555,3665759,3204
2414,"Brouk Rack ft Melaku Bireda - Gere(ገረ) - New Ethiopian Music 2016 (Official Video) by Hope Music Ethiopia 6 years ago 5 minutes, 17 seconds 3,604,997 views",Hope Music Entertainment,3604997,3608175,3178
2415,"Belete Mesele - YeGojam Namuna - New Ethiopian Music 2016 (Official Video) by Hope Music Ethiopia 6 years ago 6 minutes, 52 seconds 302,446 views",Hope Music Entertainment,302446,302759,313
2416,"Fikadu Girma - Wub Aynama - New Ethiopian Music 2016 (official Video) by Hope Music Ethiopia 6 years ago 5 minutes, 49 seconds 323,602 views",Hope Music Entertainment,323602,323797,195
2417,"Solomon Kebede - Mela (መላ) - New Ethiopian Traditional Music 2016 (Official Video) by Hope Music Ethiopia 6 years ago 6 minutes, 13 seconds 437,611 views",Hope Music Entertainment,437611,438002,391
2418,"Etsegenet Hailemariam - Gubil Kezeba - New Ethiopian Music 2016 (Official Video) by Hope Music Ethiopia 6 years ago 5 minutes, 22 seconds 65,102 views",Hope Music Entertainment,65102,65194,92
2419,"Daniel Tadesse -  Yene Desta - New Ethiopian Music 2016 (Official Video) by Hope Music Ethiopia 6 years ago 5 minutes, 6 seconds 43,293 views",Hope Music Entertainment,43293,43305,12
2420,"Ethiopia : Sami Ahmed - Gomejush Ende - New Ethiopian Music 2016 (Official Video) by Hope Music Ethiopia 6 years ago 4 minutes, 57 seconds 93,484 views",Hope Music Entertainment,93484,93536,52
2421,"Ethiopia -  Etsegenet H/ Mariam - Ende Seblewongel - New Ethiopian Traditional Music 2015 by Hope Music Ethiopia 6 years ago 6 minutes, 38 seconds 203,956 views",Hope Music Entertainment,203956,204215,259
2422,"Elias Asefa - Gize (ጊዜ) - New Ethiopian Music 2015 by Hope Music Ethiopia 6 years ago 4 minutes, 44 seconds 16,419 views",Hope Music Entertainment,16419,16445,26
2423,"Elias Asefa -  Kelay (ከላይ) - New Ethiopian Music 2015 by Hope Music Ethiopia 6 years ago 5 minutes, 57 seconds 40,178 views",Hope Music Entertainment,40178,40247,69
2424,"Enyachew Fancho ft Mesay Goa - Reggae Hawassa - New Ethiopian Music 2015 by Hope Music Ethiopia 6 years ago 5 minutes, 49 seconds 106,202 views",Hope Music Entertainment,106202,106334,132
2425,"Solomon kinde - Sitayign (ስታይኝ) - New Ethiopian Music 2015 (Official Video) by Hope Music Ethiopia 6 years ago 4 minutes, 35 seconds 14,921 views",Hope Music Entertainment,14921,14928,7
2426,"Frehiwot Tafesse - Yesema (ይሠማ) - New Ethiopian Music 2015 (Official Video) by Hope Music Ethiopia 6 years ago 8 minutes 9,788 views",Hope Music Entertainment,9788,9794,6
2427,"Daniel Abebaw  - Biyesh Adera (ብየሽ አደራ) - New Ethiopian Music (Official Video) by Hope Music Ethiopia 6 years ago 6 minutes, 4 seconds 75,463 views",Hope Music Entertainment,75463,75483,20
2428,"Esayas Tamrat - Wuletaw (ውለታው) - New Ethiopian Music 2015 (Official Audio) by Hope Music Ethiopia 6 years ago 6 minutes, 58 seconds 114,814 views",Hope Music Entertainment,114814,114851,37
2429,"Falmata ft Sam Dawg - Accelerate - New Ethiopian Oromigna Music 2015 (Official Video) by Hope Music Ethiopia 6 years ago 4 minutes, 50 seconds 65,231 views",Hope Music Entertainment,65231,65253,22
2430,"Mule Rootz ft Mykey Shewa - Ayne - New Ethiopian Music 2015 (Official Music Video) by Hope Music Ethiopia 6 years ago 5 minutes, 23 seconds 94,164 views",Hope Music Entertainment,94164,94214,50
2431,"Michael Amde (JJ Miko) - Atagay - New Ethiopian Music 2015 (Official Video) by Hope Music Ethiopia 6 years ago 4 minutes, 39 seconds 13,386 views",Hope Music Entertainment,13386,13414,28
2432,"Helen Iticha - Alchalkumina - New Ethiopian Music 2015 (Official Video) by Hope Music Ethiopia 6 years ago 6 minutes, 6 seconds 20,910 views",Hope Music Entertainment,20910,20926,16
2433,"Mieraf Assefa ft Henok Seid -  Hoselema - New Ethiopian Music 2015 (Official Video) by Hope Music Ethiopia 6 years ago 5 minutes, 20 seconds 98,174 views",Hope Music Entertainment,98174,98395,221
2434,"New Ethiopian Music 2015 - Ujulu Fera ft Mister Getachew - maale Lemo Geto by Hope Music Ethiopia 6 years ago 4 minutes, 57 seconds 25,498 views",Hope Music Entertainment,25498,25506,8
2435,"Sami Ahmed  - Baned Eyita - (Official Music Video) - New Ethiopian Music 2015 by Hope Music Ethiopia 6 years ago 4 minutes, 8 seconds 30,371 views",Hope Music Entertainment,30371,30404,33
2436,"New Ethiopia Music 2015 (Official Video) -  Mamila Lukas - Ethiopia Lay by Hope Music Ethiopia 6 years ago 4 minutes, 51 seconds 27,151 views",Hope Music Entertainment,27151,27172,21
2437,"TEDDY X - TSELIY - New Ethiopian Music 2015 (Official Music Video) by Hope Music Ethiopia 6 years ago 4 minutes, 36 seconds 4,854 views",Hope Music Entertainment,4854,4860,6
2438,"Melaku Bireda - Ambareni - New Ethiopian Music 2015 (Official Music Video) by Hope Music Ethiopia 6 years ago 5 minutes, 4 seconds 30,600 views",Hope Music Entertainment,30600,30633,33
2439,"Melaku bireda - Alem New Ethiopian Music 2015 (Official Music Video) by Hope Music Ethiopia 6 years ago 5 minutes, 53 seconds 50,004 views",Hope Music Entertainment,50004,50049,45
2440,"Tekalign Gudeta - Libe Adera - New Ethiopian Music 2015 (Official Video) by Hope Music Ethiopia 6 years ago 4 minutes, 26 seconds 166,194 views",Hope Music Entertainment,166194,166232,38
2441,"Fasika Niguse - Liyu Milikitua (ልዩ ምልክቷ) - New Ethiopian Traditional Music 2015 (Official Video) by Hope Music Ethiopia 6 years ago 4 minutes, 45 seconds 66,058 views",Hope Music Entertainment,66058,66130,72
2442,"Andupa Teshome - Mahamud Ga Tebkign - New Ethiopian music 2015 (Official Video) by Hope Music Ethiopia 6 years ago 5 minutes, 31 seconds 1,719,951 views",Hope Music Entertainment,1719951,1734695,14744
2443,"Mykey Shewa - Sew Fitun #2 - New Ethiopian Music 2015 (Official Music Video) by Hope Music Ethiopia 6 years ago 4 minutes, 28 seconds 62,613 views",Hope Music Entertainment,62613,62698,85
2444,"Nati Turner ft Nahom - Negen Lemayet - New Ethiopian Music 2015 (Official Music Video) by Hope Music Ethiopia 6 years ago 3 minutes, 59 seconds 6,016 views",Hope Music Entertainment,6016,6027,11
2445,"Aklilu Mulat ft Abel Andualem - Mame - New Ethiopian Music 2015 (Official Music Video) by Hope Music Ethiopia 6 years ago 5 minutes, 6 seconds 10,364 views",Hope Music Entertainment,10364,10372,8
2446,"Tarekegn Lencha ft Nigatu Kebede - Haremo - New Ethiopian Music 2015 (Official Music Video) by Hope Music Ethiopia 6 years ago 3 minutes, 52 seconds 6,190 views",Hope Music Entertainment,6190,6203,13
2447,"Alemtsehay Asrat - Tesekayehu - New Ethiopian Music (Official Music Video) by Hope Music Ethiopia 6 years ago 5 minutes, 52 seconds 21,310 views",Hope Music Entertainment,21310,21329,19
2448,"Esayas Senbeto ft Tigabu Cherinet - Esuan Eyale - New Ethiopian Music 2015 (Official Video) by Hope Music Ethiopia 6 years ago 4 minutes, 49 seconds 38,749 views",Hope Music Entertainment,38749,38768,19
2449,"Bini Dana and Tariku 80 Funny Concert Promo by Hope Music Ethiopia 6 years ago 55 seconds 83,233 views",Hope Music Entertainment,83233,83306,73
2450,"Tariku 80 and Bini Dana funniest Moments in the US by Hope Music Ethiopia 6 years ago 3 minutes, 16 seconds 32,055 views",Hope Music Entertainment,32055,32265,210
2451,"Ras Malula - Raggae Musikaye - New Ethiopian Reggae Music 2015 (Official Video) by Hope Music Ethiopia 6 years ago 3 minutes, 49 seconds 13,823 views",Hope Music Entertainment,13823,13847,24
2452,"Asgegnew Ashko - SomuaMori (ሶምኡዋ ሞሪ) - New Ethiopian Music 2015 (Official Video) by Hope Music Ethiopia 6 years ago 4 minutes, 40 seconds 173,205 views",Hope Music Entertainment,173205,173550,345
2453,"Aklilu Mekonen (Aki Man) - Sitakibet - New Ethiopian Music 2015 (Official Video) by Hope Music Ethiopia 6 years ago 6 minutes, 47 seconds 21,701 views",Hope Music Entertainment,21701,21720,19
2454,"Wansisa Wana ( Siso Man ) -  Immo Laa Immo - New Ethioopian Music 2015 (Official Video) by Hope Music Ethiopia 6 years ago 5 minutes, 56 seconds 11,946 views",Hope Music Entertainment,11946,11968,22
2455,"Selamawit Nega - Sele Enate Teaser Collection - Ethiopian Music (Official Teaser Music) by Hope Music Ethiopia 6 years ago 10 minutes, 2 seconds 6,560 views",Hope Music Entertainment,6560,6561,1
2456,"Sami Dan - Anchi Yene - New  Ethiopian music 2015 (Official Video) by Hope Music Ethiopia 6 years ago 4 minutes, 2 seconds 12,541 views",Hope Music Entertainment,12541,12581,40
2457,"Zenawi H/ Mariam -  Denshilgn -  New Ethiopian Traditional Music 2015 (Official Video) by Hope Music Ethiopia 6 years ago 5 minutes, 16 seconds 70,258 views",Hope Music Entertainment,70258,70306,48
2458,"Eyob Belay -  Yamral - New Ethiopian Music 2015 (Official Video) by Hope Music Ethiopia 6 years ago 5 minutes, 14 seconds 25,351 views",Hope Music Entertainment,25351,25383,32
2459,"kichini - Yomu - New Ethiopian Music 2015 (Official Video) by Hope Music Ethiopia 6 years ago 4 minutes, 21 seconds 45,602 views",Hope Music Entertainment,45602,45942,340
2460,"Falmataa Ashebir - Feetu Of Ajeesi - New Ethiopian Oromigna Music 2015 (Official Video) by Hope Music Ethiopia 6 years ago 4 minutes, 30 seconds 23,478 views",Hope Music Entertainment,23478,23630,152
2461,"Selamawit Nega - Manenetachin (ማንነታችን) - New Ethiopian Music 2015 (Official Video) by Hope Music Ethiopia 6 years ago 5 minutes, 18 seconds 163,943 views",Hope Music Entertainment,163943,164006,63
2462,"Beki (Massawa) ft King, Merkeb Bonitua - Bey Ney - New Ethiopian Music 2015 (Official Video) by Hope Music Ethiopia 6 years ago 4 minutes, 53 seconds 82,813 views",Hope Music Entertainment,82813,82846,33
2463,"Wondesen Tesfaye -  Ney Yene Konjo - New Ethiopian Music 2015 (Official Video) by Hope Music Ethiopia 6 years ago 3 minutes, 27 seconds 8,363 views",Hope Music Entertainment,8363,8379,16
2464,"Abdu Kiar - Endet new Miresaw (እንዴት ነው ሚረሳው)- New Ethiopian Music 2015 (Official Audio) by Hope Music Ethiopia 6 years ago 5 minutes, 59 seconds 332,530 views",Hope Music Entertainment,332530,333614,1084
2465,"Abdu Kiar - Des Yilal (ደስ ይላል)  - New Ethiopian Music 2015 (Official Audio) by Hope Music Ethiopia 6 years ago 5 minutes, 6 seconds 375,047 views",Hope Music Entertainment,375047,376131,1084
2466,"Abdu Kiar - Yene Mar (የኔ ማር)  - New Ethiopian Music 2015 (Official Audio) by Hope Music Ethiopia 6 years ago 4 minutes, 56 seconds 1,936,429 views",Hope Music Entertainment,1936429,1938339,1910
2467,"Abdu Kiar - Melkam Ametbal (መልካም አመት በአል) - New Ethiopian Music 2015 (Official Audio) by Hope Music Ethiopia 6 years ago 6 minutes, 20 seconds 359,781 views",Hope Music Entertainment,359781,360356,575
2468,"Abdu Kiar - Dagnaw (ዳኛው) - New Ethiopian Music 2015 (Official Audio) by Hope Music Ethiopia 6 years ago 6 minutes, 16 seconds 455,578 views",Hope Music Entertainment,455578,456833,1255
2469,"Abdu Kiar - Wey Gude (ወይ ጉዴ) - New Ethiopian Music 2015 (Official Audio) by Hope Music Ethiopia 6 years ago 5 minutes, 30 seconds 1,958,335 views",Hope Music Entertainment,1958335,1965542,7207
2470,"Abdu Kiar - Zhwa Zhwe (ዥዋዥዌ) - New Ethiopian Music (Official Audio) by Hope Music Ethiopia 6 years ago 5 minutes, 50 seconds 855,479 views",Hope Music Entertainment,855479,856334,855
2471,"Abdu Kiar - Zemen (ዘመን) - New Ethiopian Music 2015 (Official Audio) by Hope Music Ethiopia 6 years ago 5 minutes, 2 seconds 318,620 views",Hope Music Entertainment,318620,319118,498
2472,"Abdu Kiar - Altenetatelnem (አልተነጣጠልነም) - New Ethiopian Music 2015 (Official Audio) by Hope Music Ethiopia 6 years ago 6 minutes, 30 seconds 371,742 views",Hope Music Entertainment,371742,372174,432
2473,"Abdu kiar - Tikur Anbesa (ጥቁር አንበሳ) - New Ethiopian Music 2015 (Official Audio) by Hope Music Ethiopia 6 years ago 7 minutes, 19 seconds 275,769 views",Hope Music Entertainment,275769,276301,532
2474,"Abdu Kiar - Altelashim (አልጠላሽም) - New Ethiopan Music 2015 (Official Audio) by Hope Music Ethiopia 6 years ago 5 minutes, 9 seconds 924,964 views",Hope Music Entertainment,924964,926828,1864
2475,"Abeba Habtu - Endeminew Wolo - Ethiopian Music 2015 (Official Video) by Hope Music Ethiopia 6 years ago 4 minutes, 18 seconds 2,509,949 views",Hope Music Entertainment,2509949,2510833,884
2476,"Afework G/ Medihin (Besho) - Gudumale Ethiopian Music 2015 (Official Video) by Hope Music Ethiopia 6 years ago 5 minutes 283,684 views",Hope Music Entertainment,283684,283919,235
2477,"Merkeb baryagabr - Waniney - New Ethiopian Music 2015 (Official Video) by Hope Music Ethiopia 6 years ago 7 minutes, 31 seconds 97,864 views",Hope Music Entertainment,97864,97902,38
2478,"Elio251 -  Selam - New Ethiopian Music 2015 (Official Video) by Hope Music Ethiopia 6 years ago 3 minutes, 58 seconds 22,127 views",Hope Music Entertainment,22127,22141,14
2479,"Teddy X - Menetsir Ena  Mestawet - New Ethiopian music (Official Music) by Hope Music Ethiopia 6 years ago 4 minutes, 17 seconds 2,376 views",Hope Music Entertainment,2376,2376,0
2480,"Tg ft Beki, Bu-K & Pro kid - Habesha Swag - New Ethiopian Music 2015 (Official Video) by Hope Music Ethiopia 6 years ago 3 minutes, 59 seconds 26,053 views",Hope Music Entertainment,26053,26080,27
2481,"Miki Yo - Hgere - New Ethiopian Music 2015 (Official Video) by Hope Music Ethiopia 6 years ago 3 minutes, 53 seconds 134,579 views",Hope Music Entertainment,134579,134737,158
2482,"Kalkidan H/Selassie - Mejemeriya New Ethiopian Music 2015 (Official Video) by Hope Music Ethiopia 6 years ago 4 minutes, 15 seconds 8,743 views",Hope Music Entertainment,8743,8751,8
2483,"Tewodros Alem - Brimo New Ethiopian Tigrigna Music 2015 (Official Video) by Hope Music Ethiopia 6 years ago 5 minutes, 50 seconds 10,172 views",Hope Music Entertainment,10172,10178,6
2484,"Saliha Sami - Tabadhuu Gammdi New Ethiopian Oromigna Music 2015 (Official Video) by Hope Music Ethiopia 6 years ago 4 minutes, 48 seconds 820,942 views",Hope Music Entertainment,820942,821831,889
2485,"Daggyshash -  Ancheee!!! - New Ethiopian Music 2015 (Official Video) by Hope Music Ethiopia 6 years ago 3 minutes, 25 seconds 114,087 views",Hope Music Entertainment,114087,114573,486
2486,"Tiruedel Zenebe - Guitar - New Ethiopian Music 2015 (Official Video) by Hope Music Ethiopia 6 years ago 5 minutes, 6 seconds 48,823 views",Hope Music Entertainment,48823,48857,34
2487,"Mulugeta Lema - Yaya (ያያ) - New Ethiopian Music 2015 (Official Video) by Hope Music Ethiopia 6 years ago 5 minutes, 59 seconds 319,484 views",Hope Music Entertainment,319484,319934,450
2488,"Esubalew Adugna - Emye - New Ethiopian Music 2015 (Official Video) by Hope Music Ethiopia 6 years ago 5 minutes, 7 seconds 165,030 views",Hope Music Entertainment,165030,165062,32
2489,"Abdy Jemal - Wore Alebet - New Ethiopian Music 2015 (Official Video) by Hope Music Ethiopia 6 years ago 5 minutes, 26 seconds 12,381 views",Hope Music Entertainment,12381,12394,13
2490,"Elsabet Guangul - Shegawa New Ethiopian Music 2015 (Official Video) by Hope Music Ethiopia 6 years ago 5 minutes, 53 seconds 490,095 views",Hope Music Entertainment,490095,490345,250
2491,"Abdi Jemal - Habiboye New Ethiopian Music 2015 (Official Video) by Hope Music Ethiopia 6 years ago 5 minutes, 23 seconds 19,441 views",Hope Music Entertainment,19441,19490,49
2492,"Wave Slassian (ማዕበል ኣብራሃ)  ft Sami Go -  Kalayew New Ethiopian Music 2015 (Official Audio Video) by Hope Music Ethiopia 6 years ago 5 minutes, 6 seconds 21,311 views",Hope Music Entertainment,21311,21324,13
2493,"Biruk Tesfaye ft Hiwot Assefa - Wesego - New Ethiopian music 2015 (Official Video) by Hope Music Ethiopia 6 years ago 5 minutes, 33 seconds 220,556 views",Hope Music Entertainment,220556,220615,59
2494,"Minyahil Tadele - Hiwote Manesh  New Ethiopian Music 2015 (Official Video) by Hope Music Ethiopia 6 years ago 4 minutes, 57 seconds 13,375 views",Hope Music Entertainment,13375,13389,14
2495,"Amir Ak - Bezmta New Ethiopisn Music 2015 (Official Video) by Hope Music Ethiopia 6 years ago 4 minutes, 32 seconds 32,257 views",Hope Music Entertainment,32257,32610,353
2496,"Sam Seyoum ft Daggy Shash - Alehu  New Ethiopian Music 2015 (Official Video) by Hope Music Ethiopia 6 years ago 3 minutes, 50 seconds 46,197 views",Hope Music Entertainment,46197,46238,41
2497,"Ujulu Fera - Mahe Lando  New Ethiopian Music 2015 (Official Video) by Hope Music Ethiopia 6 years ago 4 minutes, 36 seconds 20,515 views",Hope Music Entertainment,20515,20546,31
2498,"Ujulu ft Yodit  -  Wololo  New Ethiopian Music 2015 (Official Video) by Hope Music Ethiopia 6 years ago 5 minutes, 44 seconds 16,978 views",Hope Music Entertainment,16978,17000,22
2499,"Eyob Mekonnen  & Mieraf Assefa -  Kal Alwetam New Ethiopian Music 2015 (Official Video) by Hope Music Ethiopia 6 years ago 4 minutes, 36 seconds 94,608 views",Hope Music Entertainment,94608,94759,151
2500,"Bethelhem Dagnachew - Fikir Yilegnal New Ethiopian Music 2015 (Official Video) by Hope Music Ethiopia 6 years ago 6 minutes, 24 seconds 245,597 views",Hope Music Entertainment,245597,245711,114
2501,"Bethelhem Dagnachew - Kere Ketrogn New Ethiopian Music 2015 (Official Video) by Hope Music Ethiopia 6 years ago 6 minutes, 35 seconds 65,902 views",Hope Music Entertainment,65902,65943,41
2502,"Brouk Rack - Buhe New Ethiopian Music 2015 by Hope Music Ethiopia 6 years ago 4 minutes, 12 seconds 50,854 views",Hope Music Entertainment,50854,50866,12
2503,"Biniam Tesema -  Yemawayish New Ethiopian Music 2015 (Official Video) by Hope Music Ethiopia 6 years ago 6 minutes, 9 seconds 1,941,690 views",Hope Music Entertainment,1941690,1944308,2618
2504,"Tariku 80 Shele - Enkutataye (እንቁጣጣዬ) New Ethiopian Music 2015 (Official Video) by Hope Music Ethiopia 6 years ago 5 minutes, 11 seconds 856,927 views",Hope Music Entertainment,856927,857394,467
2505,"Beza Mekuannent - Yesewneh New Ethiopian Music 2015 (Official Video) by Hope Music Ethiopia 6 years ago 4 minutes, 46 seconds 141,388 views",Hope Music Entertainment,141388,141489,101
2506,"Tsedenia G/ markos - Yefikir Girma New Ethiopian Music 2015 (Official Video) by Hope Music Ethiopia 6 years ago 6 minutes, 23 seconds 472,109 views",Hope Music Entertainment,472109,475902,3793
2507,"Meseret Nuna (Shiqo) - Lemiso New Ethiopian Music 2015 (Official Video) by Hope Music Ethiopia 6 years ago 4 minutes, 47 seconds 15,185 views",Hope Music Entertainment,15185,15202,17
2508,"Eyob Mekonnen ft Mieraf Assefa - Kal Alwetam New Ethiopian Music 2015 by Hope Music Ethiopia 6 years ago 3 minutes, 48 seconds 24,603 views",Hope Music Entertainment,24603,24623,20
2509,"Bini Dana - menore New Ethiopian Music 2015 (Official Audio) by Hope Music Ethiopia 6 years ago 3 minutes, 34 seconds 24,787 views",Hope Music Entertainment,24787,24799,12
2510,"Getnet Demissie - Bihon New Ethiopian Music 2015 (Official Video) by Hope Music Ethiopia 6 years ago 3 minutes, 45 seconds 52,249 views",Hope Music Entertainment,52249,52291,42
2511,"Bini Dana -  Selamizm New Ethiopian Music 2015 (Official Video) by Hope Music Ethiopia 6 years ago 5 minutes, 20 seconds 1,879,169 views",Hope Music Entertainment,1879169,1881289,2120
2512,"Fantish Bekele -  Ante Lij Cover by ADI New Ethiopian Music 2015 by Hope Music Ethiopia 6 years ago 5 minutes, 22 seconds 98,029 views",Hope Music Entertainment,98029,98124,95
2513,"Adi Belete - Kesimme New Ethiopian Music 2015 by Hope Music Ethiopia 6 years ago 5 minutes, 7 seconds 170,489 views",Hope Music Entertainment,170489,170511,22
2514,"Mekides G/ Mariam - Yute New Ethiopia Music 2015 (Official Video) by Hope Music Ethiopia 6 years ago 5 minutes, 11 seconds 417,441 views",Hope Music Entertainment,417441,419172,1731
2515,"Mike Solo -  Habesha New Ethiopian Music 2015 by Hope Music Ethiopia 6 years ago 4 minutes, 31 seconds 138,916 views",Hope Music Entertainment,138916,138994,78
2516,"Wondimagegn Chane - Gelaye New Ethiopian Music 2015 by Hope Music Ethiopia 6 years ago 4 minutes, 56 seconds 460,343 views",Hope Music Entertainment,460343,460497,154
2517,"Fekaduel - Eskemeche New Ethiopian Music 2015 (Official Video) by Hope Music Ethiopia 6 years ago 5 minutes, 7 seconds 55,877 views",Hope Music Entertainment,55877,55892,15
2518,"Beki ft Bu-k Boss - Amele Bizu New Ethiopian Music 2015 (Official Video) by Hope Music Ethiopia 6 years ago 4 minutes, 46 seconds 18,824 views",Hope Music Entertainment,18824,18828,4
2519,"Elio ft Feven  - Mengedegna New Ethiopian Music 2015 (Official Video) by Hope Music Ethiopia 6 years ago 3 minutes, 44 seconds 68,922 views",Hope Music Entertainment,68922,68929,7
2520,"Tariku 80 Shele - Wechi Albaw Suse New Ethiopian Music 2015 (Official Video) by Hope Music Ethiopia 6 years ago 5 minutes, 23 seconds 216,285 views",Hope Music Entertainment,216285,216336,51
2521,"Nebiyu Solomon - Bagere New Ethiopian Music 2015 (Official Audio Video) by Hope Music Ethiopia 7 years ago 6 minutes, 30 seconds 266,024 views",Hope Music Entertainment,266024,266074,50
2522,"Bethelhem Dagnachew - Techawetu New Ethiopian Music 2015 (Official Video) by Hope Music Ethiopia 7 years ago 5 minutes, 51 seconds 286,830 views",Hope Music Entertainment,286830,286953,123
2523,"Wasihun Hunegnaw - Eski Wede Gojam New Ethiopian Music 2015 (Official Video) by Hope Music Ethiopia 7 years ago 5 minutes, 24 seconds 228,280 views",Hope Music Entertainment,228280,228348,68
2524,"Haftom Gidey - Tsebukye Zelehu New Ethiopian Music 2015 (Official Video) by Hope Music Ethiopia 7 years ago 5 minutes, 4 seconds 57,733 views",Hope Music Entertainment,57733,57750,17
2525,"Efrem Ayzohbelew - Tilk New Best New Ethiopian Music 2014 (Official Video) by Hope Music Ethiopia 7 years ago 6 minutes, 39 seconds 184,167 views",Hope Music Entertainment,184167,184243,76
2526,"Estifanos Getahun - Shalamala New Ethiopian Music 2014 (Official Audio Video by Hope Music Ethiopia 7 years ago 5 minutes, 22 seconds 38,034 views",Hope Music Entertainment,38034,38055,21
2527,"Bini Lali (Bineyam Assefa) - Zaleyewa New Ethiopian Music Video (Official Video) by Hope Music Ethiopia 7 years ago 4 minutes, 24 seconds 170,875 views",Hope Music Entertainment,170875,170942,67
2528,"Michael Amde (JJ miko) - Yiberdal New Ethiopian Music 2014 (Official Video) by Hope Music Ethiopia 7 years ago 4 minutes, 51 seconds 58,936 views",Hope Music Entertainment,58936,58961,25
2529,"Seble Tadese - Minew New Ethiopian Music 2014 (Official Video) by Hope Music Ethiopia 7 years ago 3 minutes, 40 seconds 190,119 views",Hope Music Entertainment,190119,190216,97
2530,"Frezer Aregahegne Worash - Yene Nesh Woy New Ethiopian Music 2014 (Official Video) by Hope Music Ethiopia 7 years ago 3 minutes, 41 seconds 54,877 views",Hope Music Entertainment,54877,54926,49
2531,"Tewodage Yeneneh - Run Away New Ethiopian Music 2014 (Official Video # 2) by Hope Music Ethiopia 7 years ago 3 minutes, 37 seconds 95,062 views",Hope Music Entertainment,95062,95083,21
2532,"Hemen Girma - Gela Hode Best Ethiopian Classic Music (Official Video) by Hope Music Ethiopia 7 years ago 3 minutes, 39 seconds 51,091 views",Hope Music Entertainment,51091,51130,39
2533,"Estifanos Getahun - Sew Le Sew New Ethiopian Reggae Music (Official Video) by Hope Music Ethiopia 7 years ago 4 minutes, 58 seconds 48,095 views",Hope Music Entertainment,48095,48147,52
2534,"Selam Bogale (Selina) - Balekene Best New Ethiopian Music 2014 (Official Video) by Hope Music Ethiopia 7 years ago 5 minutes, 33 seconds 30,431 views",Hope Music Entertainment,30431,30451,20
2535,"Hot New Ethiopian Music 2014 Senait Tadesse - Na Na (Official Video) by Hope Music Ethiopia 7 years ago 4 minutes, 41 seconds 196,116 views",Hope Music Entertainment,196116,196181,65
2536,"Best New Ethiopian Music 2014 Seyoum Moges - Mekurechit (Official Video With Lyrics) by Hope Music Ethiopia 7 years ago 7 minutes, 40 seconds 145,395 views",Hope Music Entertainment,145395,145552,157
2537,"Best New Ethiopian Music 2014 DJ Jote ft Akiya & Mykey - Anchi Konjo (Official Video) by Hope Music Ethiopia 7 years ago 3 minutes, 30 seconds 76,001 views",Hope Music Entertainment,76001,76039,38
2538,"Hot New Ethiopian Music 2014 Tariku 80 Shele ft Bini Dana - Ney BeAman (Official Video) by Hope Music Ethiopia 7 years ago 5 minutes 2,601,244 views",Hope Music Entertainment,2601244,2602942,1698
2539,"New Ethiopian Remix Music 2014 Mimi Addisu - Endew Kenbel (Official Audio Video) by Hope Music Ethiopia 7 years ago 4 minutes, 20 seconds 237,641 views",Hope Music Entertainment,237641,237796,155
2540,"Hot New Ethiopian Music 2014 Mieraf Assefa - Sew Alesh (Official Video) by Hope Music Ethiopia 7 years ago 4 minutes, 36 seconds 73,071 views",Hope Music Entertainment,73071,73131,60
2541,"Hot New Ethiopian Music 2014 Tewodage Yeneneh - Run Away (Official Video) by Hope Music Ethiopia 7 years ago 4 minutes, 5 seconds 45,987 views",Hope Music Entertainment,45987,45995,8
2542,"Hot New Ethiopian Music 2014 Tariku 80 Shele - Baba Geda (Official Video) by Hope Music Ethiopia 7 years ago 5 minutes, 8 seconds 397,279 views",Hope Music Entertainment,397279,397384,105
2543,"Hot New Ethiopian Music 2014 Feysal Haji - Bareeddu Arsii (Official Audio) by Hope Music Ethiopia 7 years ago 5 minutes, 22 seconds 17,436 views",Hope Music Entertainment,17436,17464,28
2544,"Hot New Ethiopian Music 2014 kidest Mengesha - Lafkirih Besisit by Hope Music Ethiopia 7 years ago 4 minutes, 40 seconds 388,884 views",Hope Music Entertainment,388884,388939,55
2545,"Hot New Ethiopian Music 2014 Birhanu Tezera - Man Alegn by Hope Music Ethiopia 7 years ago 4 minutes, 46 seconds 248,522 views",Hope Music Entertainment,248522,248774,252
2546,"Hot New Ethiopian Music 2014 Destaw Belay - Kakm Belay (Official Video) by Hope Music Ethiopia 7 years ago 5 minutes, 22 seconds 167,406 views",Hope Music Entertainment,167406,167486,80
2547,"Hot New Ethiopian Music 2014 Feysal Haji - Wol Yadanna (Official Video) by Hope Music Ethiopia 7 years ago 4 minutes, 3 seconds 33,182 views",Hope Music Entertainment,33182,33244,62
2548,"Hot New Ethiopian Music 2014 Selamawit Abebayehu - Bel Awragn by Hope Music Ethiopia 7 years ago 6 minutes, 51 seconds 206,860 views",Hope Music Entertainment,206860,206988,128
2549,"Hot New Ethiopian Music 2014 Fitawrary Kibromma - Zemenu (Official Audio) by Hope Music Ethiopia 7 years ago 4 minutes, 32 seconds 20,686 views",Hope Music Entertainment,20686,20696,10
2550,"Hot New Ethiopian Music 2014 Fitawrary kibromma - Halewlew (Official Video) by Hope Music Ethiopia 7 years ago 4 minutes, 31 seconds 22,104 views",Hope Music Entertainment,22104,22136,32
2551,"Hot New Ethiopian Music 2014 Sisay Aklilu - Shegye by Hope Music Ethiopia 7 years ago 5 minutes, 1 second 292,008 views",Hope Music Entertainment,292008,292204,196
2552,"Hot New Ethiopian Music 2014  Muluken Tsegaye (Chuli) - Nesh Welela by Hope Music Ethiopia 7 years ago 5 minutes, 19 seconds 106,487 views",Hope Music Entertainment,106487,106538,51
2553,"Best New Ethiopian Music 2014 Bini Lali - Degmo Andande by Hope Music Ethiopia 7 years ago 4 minutes, 43 seconds 448,306 views",Hope Music Entertainment,448306,448573,267
2554,"Hot New Ethiopian Music 2014 Samuel Seneshaw - Ande Lebe by Hope Music Ethiopia 7 years ago 5 minutes, 33 seconds 337,505 views",Hope Music Entertainment,337505,337606,101
2555,"Best New Ethiopian Music 2014 Tefe Lali & Mimi Adisu - Fikir Yademkenal (Official Music Video) by Hope Music Ethiopia 7 years ago 3 minutes, 39 seconds 275,265 views",Hope Music Entertainment,275265,275486,221
2556,"Hot New Ethiopian Music 2014 Seble Tadesse - Fikre by Hope Music Ethiopia 7 years ago 3 minutes, 47 seconds 307,213 views",Hope Music Entertainment,307213,307378,165
2557,"Hot New Ethiopian Music 2014 Elio - Sibet (Official Video) by Hope Music Ethiopia 7 years ago 4 minutes, 2 seconds 29,845 views",Hope Music Entertainment,29845,29864,19
2558,"Hot New Ethiopian Music 2014 Efrem Ayzohbelew (efi ayz) - Ahun (Official Video) by Hope Music Ethiopia 7 years ago 5 minutes, 9 seconds 745,920 views",Hope Music Entertainment,745920,747512,1592
2559,"Hot New Ethopian Music 2014 Raju Star Ft G Mesay - Akunamatata (Official Music Video) by Hope Music Ethiopia 7 years ago 5 minutes, 8 seconds 149,369 views",Hope Music Entertainment,149369,149532,163
2560,"Hot New Ethiopian Music 2014 Teddy Afro - Beseba Dereja by Hope Music Ethiopia 7 years ago 8 minutes, 11 seconds 14,667,213 views",Hope Music Entertainment,14667213,14670132,2919
2561,"Best New Ethiopian Music 2014 Michael Lemma Demissew - Des Bilagnalech (Official Music Video) by Hope Music Ethiopia 7 years ago 3 minutes, 37 seconds 312,470 views",Hope Music Entertainment,312470,312694,224
2562,"Hot New Ethiopian Music 2014 Mieraf Assefa - Guadegnaye (Official Music Video) by Hope Music Ethiopia 7 years ago 4 minutes, 51 seconds 913,954 views",Hope Music Entertainment,913954,914261,307
2563,"Mike Solo - Golden Gal (Official Music Video) by Hope Music Ethiopia 7 years ago 4 minutes, 30 seconds 36,780 views",Hope Music Entertainment,36780,36977,197
2564,"Best New Ethiopian Music 2014  Hayleyesus Feyssa - Semay by Hope Music Ethiopia 7 years ago 6 minutes, 19 seconds 271,675 views",Hope Music Entertainment,271675,272628,953
2565,"Hot New Ethiopian music 2014 Tadele Roba - Semteshal by Hope Music Ethiopia 7 years ago 4 minutes, 26 seconds 378,505 views",Hope Music Entertainment,378505,378741,236
2566,"Hot New Ethiopian Music 2014  Hayleyesus Feyssa - Sew Alebet by Hope Music Ethiopia 7 years ago 4 minutes, 32 seconds 637,068 views",Hope Music Entertainment,637068,638093,1025
2567,"Best New Ethiopian Music 2014 Adi Belete ft Surafel - Ene Ena Ante by Hope Music Ethiopia 7 years ago 4 minutes, 31 seconds 29,434 views",Hope Music Entertainment,29434,29436,2
2568,"Hot New Ethiopian Music 2014 Ziggy Tafesse (Zigi Zaga) - Lela Lela by Hope Music Ethiopia 7 years ago 5 minutes, 28 seconds 657,221 views",Hope Music Entertainment,657221,657469,248
2569,"Best New Ethiopian Tigrigna Music 2014 Berhe Gerekidan - Bselam by Hope Music Ethiopia 8 years ago 5 minutes 470,429 views",Hope Music Entertainment,470429,470495,66
2570,"Hot New Ethiopian Music 2014 Girum Asfaw - Afro Endegena by Hope Music Ethiopia 8 years ago 5 minutes, 7 seconds 37,250 views",Hope Music Entertainment,37250,37260,10
2571,"Best New Ethiopian Music 2014 Girum Asfaw - Alsemat by Hope Music Ethiopia 8 years ago 6 minutes, 19 seconds 34,697 views",Hope Music Entertainment,34697,34703,6
2572,"Best New Ethiopian music 2014 Tadele Roba - Fikir Tefa by Hope Music Ethiopia 8 years ago 5 minutes, 5 seconds 73,084 views",Hope Music Entertainment,73084,73121,37
2573,"Hot New Ethiopian Music 2014 Mikias Chernet - Abebish Abeba by Hope Music Ethiopia 8 years ago 5 minutes, 1 second 393,005 views",Hope Music Entertainment,393005,393099,94
2574,"Best Ethiopian Music 2014 Hanna Girma - Lehilmih Atinur by Hope Music Ethiopia 8 years ago 4 minutes, 34 seconds 223,288 views",Hope Music Entertainment,223288,223310,22
2575,"Best New Ethiopian Music 2014 Martha Ashagari - Abebesh Abeba by Hope Music Ethiopia 8 years ago 4 minutes, 59 seconds 119,808 views",Hope Music Entertainment,119808,119852,44
2576,"Hot New Ethiopian music 2014 Merkeb Baryagabr Kassa - Party by Hope Music Ethiopia 8 years ago 3 minutes, 49 seconds 58,551 views",Hope Music Entertainment,58551,58580,29
2577,"Hot New Ethiopian Music 2014 Shimeles Yismaw - Yetarik Abew by Hope Music Ethiopia 8 years ago 5 minutes, 56 seconds 49,057 views",Hope Music Entertainment,49057,49063,6
2578,"Best Ethiopian Music 2014 Fasil Shimeles - Eski Beyign by Hope Music Ethiopia 8 years ago 3 minutes, 56 seconds 15,144 views",Hope Music Entertainment,15144,15154,10
2579,"Hot New Ethiopian Music 2014 Valentine's Day By The Red Fox by Hope Music Ethiopia 8 years ago 4 minutes, 18 seconds 35,029 views",Hope Music Entertainment,35029,35050,21
2580,"Best New Ethiopian Music 2014 Dawit Haileselassie - Bana by Hope Music Ethiopia 8 years ago 5 minutes, 48 seconds 1,339,506 views",Hope Music Entertainment,1339506,1344682,5176
2581,"Best Ethiopian Traditional Music 2014 Solomon Demle - Mech Ayeshiwuna by Hope Music Ethiopia 8 years ago 6 minutes, 18 seconds 3,395,518 views",Hope Music Entertainment,3395518,3405171,9653
2582,"Hot Ethiopian Traditional Music 2014 Dagne Walle - Wub Abeba by Hope Music Ethiopia 8 years ago 6 minutes, 39 seconds 2,530,423 views",Hope Music Entertainment,2530423,2543913,13490
2583,"NEW Ethiopian Music 2014 Kaleab ft Surafel - Saba by Hope Music Ethiopia 8 years ago 4 minutes 15,827 views",Hope Music Entertainment,15827,15829,2
2584,"Hot New Ethiopian Music 2014 Sami Omar(Geletta) - Lebe Wedoshal by Hope Music Ethiopia 8 years ago 5 minutes, 11 seconds 41,802 views",Hope Music Entertainment,41802,41835,33
2585,"Best New Ethiopian Music 2014 Adi Belete - Kessimme by Hope Music Ethiopia 8 years ago 4 minutes, 59 seconds 24,636 views",Hope Music Entertainment,24636,24649,13
2586,"Hot New Ethiopian music 2014  Fikremariam Gebru Ft  Habtom Abraha - Alkefam by Hope Music Ethiopia 8 years ago 5 minutes, 16 seconds 74,513 views",Hope Music Entertainment,74513,74546,33
2587,"Hot New Ethiopian Traditional Music 2014 Habtamu Abraham - Mulu Gojam by Hope Music Ethiopia 8 years ago 4 minutes, 50 seconds 78,948 views",Hope Music Entertainment,78948,78986,38
2588,"Hot New Ethiopian Music 2014 - Leul Alemu - Besew Medina by Hope Music Ethiopia 8 years ago 5 minutes, 26 seconds 221,442 views",Hope Music Entertainment,221442,221474,32
2589,"Best New Ethiopian Music 2014 Tadele Roba -  Eswan Tewat Lene by Hope Music Ethiopia 8 years ago 5 minutes, 38 seconds 32,373 views",Hope Music Entertainment,32373,32394,21
2590,"Hot New Ethiopian Traditional Music 2014 Hana Alemayehu - Difer Lebe by Hope Music Ethiopia 8 years ago 5 minutes, 18 seconds 98,036 views",Hope Music Entertainment,98036,98120,84
2591,"Best New Ethiopian Traditional Music 2014 Woyinshet Adino - Tolo Na (Wollo Raya) by Hope Music Ethiopia 8 years ago 4 minutes, 48 seconds 643,723 views",Hope Music Entertainment,643723,644258,535
2592,"Best New Ethiopian Music 2014  Amesyas Solomon (DJ Amy) - Alchelema by Hope Music Ethiopia 8 years ago 5 minutes, 7 seconds 65,890 views",Hope Music Entertainment,65890,65903,13
2593,"Hot New Ethiopian Music Arbin Ervin (Ben) 2014 - Magna by Hope Music Ethiopia 8 years ago 3 minutes, 50 seconds 110,456 views",Hope Music Entertainment,110456,110473,17
2594,"Hot New Ethiopian Music 2014 Dagmawi Getaneh - Zim Alilim by Hope Music Ethiopia 8 years ago 4 minutes, 44 seconds 157,027 views",Hope Music Entertainment,157027,157060,33
2595,"New Hot Ethiopian Music 2014  Mahlet Demere - Habesh by Hope Music Ethiopia 8 years ago 4 minutes, 18 seconds 184,913 views",Hope Music Entertainment,184913,185032,119
2596,"Hot New Ethiopian Music 2014 Selamawit Nega - Silenate by Hope Music Ethiopia 8 years ago 6 minutes, 4 seconds 503,014 views",Hope Music Entertainment,503014,503296,282
2597,"Best Ethiopian Music 2014 Tesfaye Mamo - Nitsuh Fikir by Hope Music Ethiopia 8 years ago 4 minutes, 30 seconds 34,030 views",Hope Music Entertainment,34030,34043,13
2598,"Best New Ethiopian music 2014 Tefe Lali - Kakaten by Hope Music Ethiopia 8 years ago 4 minutes, 55 seconds 929,688 views",Hope Music Entertainment,929688,930195,507
2599,"Best New Ethiopian Music 2014 Abenet Girma - Yansbshal Lanchi Meweded by Hope Music Ethiopia 8 years ago 4 minutes, 16 seconds 278,053 views",Hope Music Entertainment,278053,278351,298
2600,"New Ethiopian Music 2014 Addis Mulat - Tewbelew by Hope Music Ethiopia 8 years ago 4 minutes, 48 seconds 60,283 views",Hope Music Entertainment,60283,60306,23
2601,"Hot New Ethiopian Music 2014 Miki Niguse & Efrem ft Dagi Shasha - Shir Bebaburu by Hope Music Ethiopia 8 years ago 4 minutes, 52 seconds 654,480 views",Hope Music Entertainment,654480,654776,296
2602,"Best Ethiopian Traditional Music 2014  Danny Dance - Wa Stel by Hope Music Ethiopia 8 years ago 5 minutes, 54 seconds 206,784 views",Hope Music Entertainment,206784,206902,118
2603,"Hot New Ethiopian Music 2014 Daniel Mislework (Dani Dance) -  Mamaye by Hope Music Ethiopia 8 years ago 5 minutes, 28 seconds 373,878 views",Hope Music Entertainment,373878,373993,115
2604,"Hot New Ethiopian Traditional Music 2014 Emebet Negasi - Senda Bel by Hope Music Ethiopia 8 years ago 5 minutes, 17 seconds 1,176,146 views",Hope Music Entertainment,1176146,1177798,1652
2605,"Hot New Ethiopian Music 2014  Emebet Negasi - Min Yishalal by Hope Music Ethiopia 8 years ago 6 minutes, 13 seconds 18,876,433 views",Hope Music Entertainment,18876433,18929912,53479
2606,"Hot New Ethiopian music 2014 Henok Amare - stota nesh by Hope Music Ethiopia 8 years ago 5 minutes, 8 seconds 33,284 views",Hope Music Entertainment,33284,33284,0
2607,"Hot New Ethiopian Music 2014 MyKey Shewa - Sew Fitun [OFFICIAL MUSIC VIDEO] by Hope Music Ethiopia 8 years ago 4 minutes, 39 seconds 83,768 views",Hope Music Entertainment,83768,83788,20
2608,"[ HAPPY NEW YEAR!! ] New Hot Ethiopian Traditional Music 2014 Elias Abiyu - Tarik Alegn by Hope Music Ethiopia 8 years ago 4 minutes, 59 seconds 165,985 views",Hope Music Entertainment,165985,166048,63
2609,"New Best Ethiopian Tizita music Muluberhan Abeje - Astawesewalehu by Hope Music Ethiopia 8 years ago 6 minutes, 3 seconds 22,752 views",Hope Music Entertainment,22752,22790,38
2610,"New Ethiopian Reggae Music 2014 Messuwani - Ylal Yagere Sew by Hope Music Ethiopia 8 years ago 6 minutes 110,095 views",Hope Music Entertainment,110095,110225,130
2611,"New Hot Ethiopian Music 2014 Bilusa - Achawichign by Hope Music Ethiopia 8 years ago 4 minutes, 34 seconds 78,252 views",Hope Music Entertainment,78252,78264,12
2612,"New Ethiopian music 2014 Seble Tadesse - Demamaye (Official Video) by Hope Music Ethiopia 8 years ago 4 minutes, 22 seconds 574,030 views",Hope Music Entertainment,574030,575122,1092
2613,"New Ethiopian Hip Hop Music 2014 Fitawrary Kibromma - Zanigaba by Hope Music Ethiopia 8 years ago 3 minutes, 49 seconds 25,362 views",Hope Music Entertainment,25362,25377,15
2614,"Best New Ethiopian Music 2014 Samuel Sinshaw (Sami) - Ayne by Hope Music Ethiopia 8 years ago 5 minutes, 6 seconds 148,688 views",Hope Music Entertainment,148688,148720,32
2615,"New Hot Ethiopian Music 2014 Siyoum Moges - Yezinaye [Gonderigna] by Hope Music Ethiopia 8 years ago 7 minutes, 9 seconds 177,476 views",Hope Music Entertainment,177476,177551,75
2616,"Best Ethiopian Guragegna Music 2014 Teka Asefa Ft Yetagesu Melesse - Yangut by Hope Music Ethiopia 8 years ago 4 minutes, 49 seconds 381,178 views",Hope Music Entertainment,381178,383962,2784
2617,"Best New Ethiopian Music 2014 Jerry Asfaw - Jenenew by Hope Music Ethiopia 8 years ago 5 minutes, 51 seconds 86,748 views",Hope Music Entertainment,86748,86788,40
2618,"New Hot Ethiopian Music 2014 Asne Abate - Gamo by Hope Music Ethiopia 8 years ago 5 minutes, 19 seconds 134,529 views",Hope Music Entertainment,134529,134673,144
2619,"BEST Ethiopian Music 2014 Fasil Demoz, Betty G & Other Singers - Beka Terign by Hope Music Ethiopia 8 years ago 5 minutes, 51 seconds 447,601 views",Hope Music Entertainment,447601,447821,220
2620,"Best New Ethiopian Traditional Music 2014 Workye Getachew - Wollo by Hope Music Ethiopia 8 years ago 5 minutes, 29 seconds 684,478 views",Hope Music Entertainment,684478,685442,964
2621,"Yared Tadesse - Gerhi Libu New Hot Ethiopian Tigrigna Music 2014 by Hope Music Ethiopia 8 years ago 6 minutes, 57 seconds 491,865 views",Hope Music Entertainment,491865,492207,342
2622,"Mimi Adissu - Melsat Merkebu  New Ethiopian music 2014 by Hope Music Ethiopia 8 years ago 6 minutes, 18 seconds 676,405 views",Hope Music Entertainment,676405,676470,65
2623,"Hanan Berihun ft Edidiya Ayele - Feta Feta ፈታ ፈታ New Hot Ethiopian Music 2014 by Hope Music Ethiopia 8 years ago 4 minutes, 16 seconds 508,041 views",Hope Music Entertainment,508041,508131,90
2624,"Hanna Girma ሀና ግርማ - Delala ደላላ New Ethiopian Music 2014 by Hope Music Ethiopia 8 years ago 5 minutes, 33 seconds 174,016 views",Hope Music Entertainment,174016,174083,67
2625,"Michael Negasa - Baman በአማን New Hot Ethiopian Music 2014 by Hope Music Ethiopia 8 years ago 5 minutes, 54 seconds 115,174 views",Hope Music Entertainment,115174,115186,12
2626,"MyKey Shewa - Sew Fitun Hot Ethiopian Music Dedicated To all Ethiopias all around the World by Hope Music Ethiopia 8 years ago 4 minutes, 47 seconds 17,959 views",Hope Music Entertainment,17959,17966,7
2627,"Sintayehu Zenebe ስንታየሁ ዘነበ - Abo Jebagn አቦ ጀባኝ New Hot Ethiopian Traditional Music by Hope Music Ethiopia 8 years ago 6 minutes, 35 seconds 471,622 views",Hope Music Entertainment,471622,473162,1540
2628,"Samrawit Alemu - Akolamtegna Hot New Ethiopian Music 2014 by Hope Music Ethiopia 8 years ago 4 minutes, 58 seconds 77,938 views",Hope Music Entertainment,77938,77947,9
2629,"Sami ሳሚ - Tezemite ተዘሚተ New Hot Tigrigna Song 2014 by Hope Music Ethiopia 8 years ago 5 minutes, 24 seconds 155,643 views",Hope Music Entertainment,155643,155671,28
2630,"Jacky Gosee - Hememen Bezema New Song Dedicated To Ethiopians In Saudi Arabia by Hope Music Ethiopia 8 years ago 5 minutes, 10 seconds 636,685 views",Hope Music Entertainment,636685,637026,341
2631,"Mebre Mengste መብሬ መንግስቴ - Serg ሠርግ New Hot Ethiopian Wedding Song 2014 by Hope Music Ethiopia 8 years ago 7 minutes, 53 seconds 641,081 views",Hope Music Entertainment,641081,642566,1485
2632,"Muluberhan Abeje(Mulucha) ሙሉብርሀን አበጀ - Fekerehema ፍቅርህማ Best New Ethiopian Song 2014 by Hope Music Ethiopia 8 years ago 5 minutes, 41 seconds 11,701 views",Hope Music Entertainment,11701,11711,10
2633,"kidest Mengesha  ቅድስት መንገሻ - Endeteyekegn  እንደጠየከኝ New Ethiopian music 2013 by Hope Music Ethiopia 8 years ago 5 minutes, 44 seconds 479,111 views",Hope Music Entertainment,479111,479772,661
2634,"Tsige Tesfaye (ሎሚ) ፅጌ ተስፋየ - Yene Adam የኔ አዳም  HOT New Ethiopian Music by Hope Music Ethiopia 8 years ago 4 minutes, 57 seconds 624,456 views",Hope Music Entertainment,624456,624645,189
2635,"Befkadu Yadete በፈቃዱ ያዴታ  -  Zemeta ዝምታ Hot New Ethiopian Music 2013 by Hope Music Ethiopia 8 years ago 4 minutes, 38 seconds 348,549 views",Hope Music Entertainment,348549,348711,162
2636,"Biniam Assefa ቢንያም አሰፋ (ቢኒ ላሊ) -  Betesema ብትሰማ New Single 2013 by Hope Music Ethiopia 8 years ago 3 minutes, 56 seconds 64,647 views",Hope Music Entertainment,64647,64681,34
2637,"Daniel Kebede (Dani Jegol) ዳኒ ጀግል - Quchit ቁጭት Ethiopian Traditional Song 2013 by Hope Music Ethiopia 8 years ago 5 minutes, 7 seconds 414,294 views",Hope Music Entertainment,414294,414745,451
2638,"MyKey ft Ela man - Ketat ቅጣት Best Ethiopian Animation Music Video 2013 by Hope Music Ethiopia 8 years ago 4 minutes, 56 seconds 32,374 views",Hope Music Entertainment,32374,32407,33
2639,"Gashaw Molla ጋሻዉ ሞላ - Eshitash እሽታሽ Best Ethiopian Traditional Song 2013 by Hope Music Ethiopia 8 years ago 5 minutes, 22 seconds 272,244 views",Hope Music Entertainment,272244,272483,239
2640,"Workye Getachew ወርቅየ ጌታቸዉ - Chawata ጨዋታ New Hot Ethiopian Song 2013 by Hope Music Ethiopia 8 years ago 5 minutes, 30 seconds 529,650 views",Hope Music Entertainment,529650,530645,995
2641,"Abnet Demissie አብነት ደምሴ - Min Filega ምን ፍለጋ New Single 2013 by Hope Music Ethiopia 8 years ago 4 minutes, 17 seconds 528,927 views",Hope Music Entertainment,528927,529498,571
2642,"Bilusa ft Surafel & Addi - mitta ምታ New Hot Music by Hope Music Ethiopia 8 years ago 3 minutes, 55 seconds 51,353 views",Hope Music Entertainment,51353,51380,27
2643,"Shewandagne Hailu  ሸዋንዳኝ ሀይሉ : Selene ስለኔ NEW 2013 by Hope Music Ethiopia 8 years ago 5 minutes 349,892 views",Hope Music Entertainment,349892,350269,377
2644,"Shewandagne Hailu ሸዋንዳኝ ሀይሉ : Seberber ስብርብር NEW 2013 by Hope Music Ethiopia 8 years ago 5 minutes, 21 seconds 316,886 views",Hope Music Entertainment,316886,317524,638
2645,"Shewandagn Hailu ሸዋንዳኝ ሀይሉ - And Leben አንድ ልቤን NEW 2013 by Hope Music Ethiopia 8 years ago 4 minutes, 35 seconds 379,818 views",Hope Music Entertainment,379818,380279,461
2646,"Ziggy Zaga ዚጊ ዛጋ : Zema  ዜማ NEW Hot Ethiopian Music by Hope Music Ethiopia 8 years ago 5 minutes, 50 seconds 691,261 views",Hope Music Entertainment,691261,691380,119
2647,"Dawit Mideksa ft Lij Michael(faf) : Adrashash Tefabegn አድራሻሽ ጠፋብኝ New Ethiopian Music 2013 by Hope Music Ethiopia 8 years ago 3 minutes, 38 seconds 155,466 views",Hope Music Entertainment,155466,155804,338
2648,"Addis mulat አዲስ ሙላት : Band Kal በአንድ ቃል New Ethiopian Music 2013 by Hope Music Ethiopia 8 years ago 5 minutes, 31 seconds 153,524 views",Hope Music Entertainment,153524,153684,160
2649,"Shewandagne Hailu ሸዋንዳኝ ሀይሉ :  Sitotash ስጦታሽ NEW 2013 by Hope Music Ethiopia 8 years ago 4 minutes, 49 seconds 152,701 views",Hope Music Entertainment,152701,152834,133
2650,"Shewandagne Hailu ሸዋንዳኝ ሀይሉ : Sitski Say ስትስቂ ሳይ NEW  2013 by Hope Music Ethiopia 8 years ago 4 minutes, 27 seconds 144,742 views",Hope Music Entertainment,144742,144857,115
2651,"Jossy ft Ziggy Zagga : Ethiopia ኢትዮዽያ New Music Video 2013 by Hope Music Ethiopia 8 years ago 6 minutes, 1 second 60,494 views",Hope Music Entertainment,60494,60521,27
2652,"Dina Anteneh ዲና አንተነህ : Alchilim አልችልም New Hot Ethiopian music by Hope Music Ethiopia 8 years ago 5 minutes, 11 seconds 2,635,601 views",Hope Music Entertainment,2635601,2643026,7425
2653,"Biniam Dana ቢንያም ዳና : Begna Style  በኛ ስታይል New Ethiopian Music Video 2013 by Hope Music Ethiopia 8 years ago 5 minutes, 5 seconds 1,585,713 views",Hope Music Entertainment,1585713,1586636,923
2654,"Lij Michael ልጅ ሚካኤል (ፋፍ) : Zenach ዘናጭ New Ethiopian Hip Hop Music 2013 by Hope Music Ethiopia 8 years ago 4 minutes, 30 seconds 931,979 views",Hope Music Entertainment,931979,933776,1797
2655,"Abeba Desalegn : Teret Teret / ተረት ተረት New Ethiopian Music 2013 by Hope Music Ethiopia 8 years ago 6 minutes, 1 second 1,130,496 views",Hope Music Entertainment,1130496,1134598,4102
2656,"Abeba desalegn : Bate Asaklugn /  ባጥ አሳቅሉኝ New Ethiopian Music 2013 by Hope Music Ethiopia 8 years ago 5 minutes, 27 seconds 1,982,952 views",Hope Music Entertainment,1982952,1985908,2956
2657,"Getu Omahire : KeBet Wede EsirBet  New Ethiopian Music Video by Hope Music Ethiopia 8 years ago 7 minutes, 57 seconds 671,183 views",Hope Music Entertainment,671183,673408,2225
2658,"Dj Sami NEW Remix Song For Baby Michael 2013 by Hope Music Ethiopia 8 years ago 4 minutes, 38 seconds 833,838 views",Hope Music Entertainment,833838,833891,53
2659,"New Ethiopian Music Video Mulugeta Alemu - Fikir beFormula by Hope Music Ethiopia 8 years ago 4 minutes, 46 seconds 224,734 views",Hope Music Entertainment,224734,224786,52
2660,"New Ethiopian Music Mimi Addisu (Hamood) 2013 - Konjo / ቆንጆ by Hope Music Ethiopia 8 years ago 4 minutes 90,692 views",Hope Music Entertainment,90692,90723,31
2661,"New Hot Ethiopian Wedding Song Elias Solomon ft. Micky (Gonderegna) - Firew Yamare Zer by Hope Music Ethiopia 8 years ago 9 minutes, 5 seconds 3,337,827 views",Hope Music Entertainment,3337827,3344432,6605
2662,"Mikyas Nigussie ft Martha Getachew 2013 - Akalie (Official Video) by Hope Music Ethiopia 8 years ago 5 minutes, 15 seconds 125,511 views",Hope Music Entertainment,125511,125569,58
2663,"Arada Boyz - Shisha (Hookah)  Ethiopian Hip Hop Music 2013 by Hope Music Ethiopia 9 years ago 4 minutes, 34 seconds 67,800 views",Hope Music Entertainment,67800,67838,38
2664,"Teddy Afro - Ewnet / እውነት Cover by Hanna Girma by Hope Music Ethiopia 9 years ago 4 minutes, 50 seconds 841,732 views",Hope Music Entertainment,841732,842030,298
2665,"Jacky Gosee - Sela Bey by Hope Music Ethiopia 9 years ago 5 minutes, 20 seconds 10,393,123 views",Hope Music Entertainment,10393123,10415421,22298
2666,"Mamila & Kichin ft Teddy Afro SONG 2013 - ESSO esso by Hope Music Ethiopia 9 years ago 4 minutes, 33 seconds 192,134 views",Hope Music Entertainment,192134,192401,267
2667,"The Funniest Ethiopian Athlete  Interview Ever [Must See] by Hope Music Ethiopia 9 years ago 1 minute, 52 seconds 526,123 views",Hope Music Entertainment,526123,527089,966
2668,"New Music Video Addis and Haymanot  ft Jah Lude - Yenafkot Chewata by Hope Music Ethiopia 9 years ago 5 minutes, 4 seconds 4,123,090 views",Hope Music Entertainment,4123090,4130121,7031
2669,"Amazing poetry by Hiwot Adilow at Brave New Voices 2012 by Hope Music Ethiopia 9 years ago 3 minutes, 47 seconds 360,445 views",Hope Music Entertainment,360445,360788,343
2670,"Teddy Afro Song for His Girlfriend[Amleset] _Tsebaye Senay 2012 by Hope Music Ethiopia 9 years ago 4 minutes, 53 seconds 5,230,293 views",Hope Music Entertainment,5230293,5232865,2572
2671,"Tasanbannu | Megersa Bekele ft. Rahel T. by Ilaamee Records 1 month ago 6 minutes, 23 seconds 281,339 views",Ilaamee Records,281339,319984,38645
2672,"Tasanbannu | Megersa Bekele ft. Rahel  T. Trailer by Ilaamee Records 1 month ago 52 seconds 14,758 views",Ilaamee Records,14758,15217,459
2673,"Uumaa Uumamaa| Elias Gebula by Ilaamee Records 2 months ago 5 minutes, 27 seconds 92,456 views",Ilaamee Records,92456,95369,2913
2674,"Lafti Unkuramtee| Magarsaa Baqalaa by Ilaamee Records 3 months ago 8 minutes, 16 seconds 281,367 views",Ilaamee Records,281367,292803,11436
2675,"Far. Megersa Bekele ""Lafti Unkuramtee"" Trailer by Ilaamee Records 3 months ago 47 seconds 26,682 views",Ilaamee Records,26682,26966,284
2676,"Ogeti Paulos - Gooftaa Bira by Ilaamee Records 7 months ago 5 minutes, 17 seconds 14,454 views",Ilaamee Records,14454,15118,664
2677,"Ogeti Paulos - Gooftaa Bira (Official Lyric Video) by Ilaamee Records 7 months ago 4 minutes, 5 seconds 2,327 views",Ilaamee Records,2327,2421,94
2678,"Megersa Bekele - Rooba maa Shakkine (ft. Rahel Tefera) Official Lyric Video by Ilaamee Records 1 year ago 8 minutes, 8 seconds 8,245 views",Ilaamee Records,8245,8327,82
2679,"Rahel Tefera - Weedduu Babbareedaa  (Official Music Video) ft. Megersa Bekele by Ilaamee Records 1 year ago 6 minutes, 35 seconds 292,303 views",Ilaamee Records,292303,296834,4531
2680,"ATI WAAQAYYOO DHA Lyric video Rahel Tefera FT. Megersa Bekele by Ilaamee Records 2 years ago 6 minutes, 3 seconds 10,720 views",Ilaamee Records,10720,10876,156
2681,"Ethiopia: Jossy In Z House Show - Interview with EAF President Haile Gebresilassie | JTV Ethiopia by Jossy in Z House 5 years ago 1 hour, 16 minutes 127,462 views",Jossy in Z House,127462,127547,85
2682,"JTV Ethiopia - Spending New Year with Amha Tewedaj by Jossy in Z House 5 years ago 43 minutes 120,356 views",Jossy in Z House,120356,120380,24
2683,"JTV Ethiopia - Jossy in Z House Visit The Families of Colonel Abdissa Aga by Jossy in Z House 5 years ago 35 minutes 117,194 views",Jossy in Z House,117194,117271,77
2684,"Jtv - Jossy in Z House - New Year Special with Manalemosh Dibo Family by Jossy in Z House 5 years ago 46 minutes 1,924,593 views",Jossy in Z House,1924593,1925533,940
2685,"Jossy - Alelem Bechirash (አልልም በጭራሽ) [NEW! Ethiopian Music Video 2015] by Jossy in Z House 6 years ago 6 minutes, 22 seconds 5,219,716 views",Jossy in Z House,5219716,5223064,3348
2686,"Jossy in Z House - Interview with Super Model Anna Getaneh by Jossy in Z House 6 years ago 56 minutes 100,405 views",Jossy in Z House,100405,100459,54
2687,"Jossy In Z House - Artist Beata G-Hiwot and Ayele Mamo with Jossy by Jossy in Z House 6 years ago 57 minutes 26,586 views",Jossy in Z House,26586,26599,13
2688,"Jossy In Z House - Interview with Artist Helen Bedelu by Jossy in Z House 6 years ago 53 minutes 569,380 views",Jossy in Z House,569380,569473,93
2689,"Jossy in Z House Show - Artist Fikadu T-Mariam with Jossy Show - Part 2 by Jossy in Z House 6 years ago 56 minutes 42,145 views",Jossy in Z House,42145,42152,7
2690,"Jossy in Z House Show - Interview with Artist Fikadu T- Mariam - Part 1 by Jossy in Z House 6 years ago 56 minutes 58,205 views",Jossy in Z House,58205,58217,12
2691,"Jossy - Shik Belesh Ft. Jah Lude [NEW! Music Video 2015] by Jossy in Z House 6 years ago 4 minutes, 56 seconds 805,144 views",Jossy in Z House,805144,806906,1762
2692,"Jossy in Z House Show - Gezahegn Assefa and Animator Semere Fikadu by Jossy in Z House 6 years ago 49 minutes 24,937 views",Jossy in Z House,24937,24948,11
2693,"Jossy in Z House - Interview with Assistant Inspector Assefa Mezgebu by Jossy in Z House 6 years ago 53 minutes 18,883 views",Jossy in Z House,18883,18901,18
2694,"Jossy in Z House Show - Film Producer Artist Roman Befikadu by Jossy in Z House 6 years ago 55 minutes 334,964 views",Jossy in Z House,334964,335394,430
2695,"Jossy in Z House Show - Interview with The Legendary Alemayehu Fenta by Jossy in Z House 6 years ago 1 hour 45,806 views",Jossy in Z House,45806,45820,14
2696,"Jossy in Z House - The Season 3 Review by Jossy in Z House 7 years ago 59 minutes 25,328 views",Jossy in Z House,25328,25337,9
2697,"Jossy in Z House Show - Arba Minch and The Story of The First Photo Studio by Jossy in Z House 7 years ago 56 minutes 60,891 views",Jossy in Z House,60891,60896,5
2698,"Jossy in Z House Show - Travels to Arba Minch {አርባ ምንጭ} by Jossy in Z House 7 years ago 55 minutes 43,888 views",Jossy in Z House,43888,43895,7
2699,"Jossy in Z House Show - Holiday Special Part 2 by Jossy in Z House 7 years ago 1 hour, 3 minutes 78,123 views",Jossy in Z House,78123,78132,9
2700,"Jossy in Z House Show - Ethiopian Christmas Special 2007 Part 1 by Jossy in Z House 7 years ago 1 hour, 2 minutes 85,698 views",Jossy in Z House,85698,85704,6
2701,"Jossy in Z House Show - Ethiopian Christmas Special 2007 by Jossy in Z House 7 years ago 2 hours, 6 minutes 239,043 views",Jossy in Z House,239043,239057,14
2702,"Jossy in Z House Show - Ethiopian Christmas Special Program by Jossy in Z House 7 years ago 1 minute, 48 seconds 81,368 views",Jossy in Z House,81368,81382,14
2703,"Jossy in Z House - Interview with Gash Ayele Mamo by Jossy in Z House 7 years ago 1 hour, 2 minutes 20,837 views",Jossy in Z House,20837,20906,69
2704,"Jossy in Z House Show - Interview With Traditional ‪‎Singers Fenta Bele & Alemayehu Tesfaye by Jossy in Z House 7 years ago 57 minutes 528,760 views",Jossy in Z House,528760,528881,121
2705,"Jossy in Z House Show Interview with Bini Dana & Tariku by Jossy in Z House 7 years ago 1 hour, 3 minutes 182,356 views",Jossy in Z House,182356,182499,143
2706,"Jossy in Z House Show Interview with Amleset Muchie by Jossy in Z House 7 years ago 50 minutes 331,496 views",Jossy in Z House,331496,331806,310
2707,"Jossy in Z House Show Interview with Designer Mahlet Afework aka Mafi by Jossy in Z House 7 years ago 54 minutes 29,383 views",Jossy in Z House,29383,29411,28
2708,"Jossy in Z House Show Interview with Saudi Returnees by Jossy in Z House 7 years ago 52 minutes 117,137 views",Jossy in Z House,117137,117149,12
2709,"Jossy in Z House Show Interview with Artist Abel Mulugeta by Jossy in Z House 7 years ago 56 minutes 101,581 views",Jossy in Z House,101581,101597,16
2710,"Jossy in Z House Show Interview with Artist Abebe Melese in Israel by Jossy in Z House 7 years ago 1 hour, 1 minute 33,527 views",Jossy in Z House,33527,33563,36
2711,"Jossy in Z House Show - Special Program on Artist Abreham Asmelash by Jossy in Z House 7 years ago 1 hour, 1 minute 17,132 views",Jossy in Z House,17132,17152,20
2712,"Jossy in Z House Show - Interview with Artist Girum Ermiyas by Jossy in Z House 7 years ago 1 hour, 4 minutes 96,576 views",Jossy in Z House,96576,96654,78
2713,"Jossy in Z House Show - Interview with Hamelmal Abate by Jossy in Z House 7 years ago 1 hour, 2 minutes 33,799 views",Jossy in Z House,33799,33811,12
2714,"Jossy in Z House Show - Visiting Manalemosh Dibo Family by Jossy in Z House 7 years ago 1 hour, 48 minutes 1,025,051 views",Jossy in Z House,1025051,1025359,308
2715,"Yosef Gebre Aka Jossy ""Meche New"" [New! Ethiopian Music 2014] by Jossy in Z House 7 years ago 6 minutes, 12 seconds 781,666 views",Jossy in Z House,781666,782043,377
2716,"Jossy In Z House Interview with DireTube Founder Biniam Negessu and Two other Guests by Jossy in Z House 7 years ago 1 hour, 1 minute 12,331 views",Jossy in Z House,12331,12335,4
2717,"Jossy - YeFikir Leba [NEW! HOT! Ethiopian Music Video 2015] by Jossy in Z House 7 years ago 4 minutes, 11 seconds 305,798 views",Jossy in Z House,305798,306033,235
2718,"Interview with Athlete Meseret Defar with Jossy in Z House Show - Part 2 by Jossy in Z House 7 years ago 54 minutes 129,561 views",Jossy in Z House,129561,129571,10
2719,"Jossy ft Nhatty Man Kibechilegn Ziggy Zagga by Jossy in Z House 7 years ago 5 minutes, 18 seconds 268,446 views",Jossy in Z House,268446,268578,132
2720,"Jossy - Abet Zemen [NEW! Music Video 2015] by Jossy in Z House 7 years ago 5 minutes, 39 seconds 296,572 views",Jossy in Z House,296572,296670,98
2721,"Jossy in Z House Show Interview with Top Comedians Dokile and Temesgen by Jossy in Z House 7 years ago 1 hour 26,179 views",Jossy in Z House,26179,26182,3
2722,"Jossy in Z House Show Interview with Interior Designer Gigi Sebsibe by Jossy in Z House 7 years ago 1 hour, 2 minutes 7,009 views",Jossy in Z House,7009,7018,9
2723,"Jossy in Z House Show Interview with Top Model Maya Haile by Jossy in Z House 7 years ago 1 hour, 5 minutes 20,418 views",Jossy in Z House,20418,20423,5
2724,"Jossy in Z House Show A Memorial Service Program to Singer Eyob Mekonnen by Jossy in Z House 7 years ago 1 hour 26,706 views",Jossy in Z House,26706,26786,80
2725,"Jossy in Z House Show Interview with Artist Dagmawit Tsehaye & Samson Tadesse by Jossy in Z House 7 years ago 1 hour 46,782 views",Jossy in Z House,46782,46795,13
2726,"Jossy in Z House Show Interview with Artist Shewandgn Hailu by Jossy in Z House 7 years ago 1 hour, 1 minute 42,901 views",Jossy in Z House,42901,42986,85
2727,"Jossy in Z House Show Interview with Artist Zenahbezu Tsegaye by Jossy in Z House 7 years ago 1 hour, 1 minute 24,451 views",Jossy in Z House,24451,24458,7
2728,"Jossy In Z House Show Interview with  Artist Birtukan Befekadu by Jossy in Z House 7 years ago 1 hour, 1 minute 39,095 views",Jossy in Z House,39095,39105,10
2729,"Jossy In Z House Show Interview with Lyrics Writer Yilma GebreAb by Jossy in Z House 7 years ago 1 hour, 6 minutes 29,839 views",Jossy in Z House,29839,29889,50
2730,"Jossy In Z House Show Jossy Talks about the TV Show & Answers Fans Questions by Jossy in Z House 7 years ago 59 minutes 21,548 views",Jossy in Z House,21548,21553,5
2731,"Jossy In Z House Show Wrap-Up Season1 Episode 10 by Jossy in Z House 7 years ago 54 minutes 6,393 views",Jossy in Z House,6393,6398,5
2732,"Jossy In Z House Show Wrap-Up Season1Episode 1 by Jossy in Z House 7 years ago 1 hour, 5 minutes 6,194 views",Jossy in Z House,6194,6197,3
2733,"Jossy In Z House Show Interview with  Artist Tsegaye Esetu by Jossy in Z House 7 years ago 1 hour, 2 minutes 29,930 views",Jossy in Z House,29930,29940,10
2734,"Jossy in Z House Show Interview with Artist Sileshe Demessie by Jossy in Z House 7 years ago 1 hour 15,553 views",Jossy in Z House,15553,15563,10
2735,"Jossy in Z House Show Interview with Artist Netsanet Melese by Jossy in Z House 7 years ago 1 hour, 2 minutes 149,821 views",Jossy in Z House,149821,149989,168
2736,"Jossy in Z House Show Interview with Singer Aster Kebede by Jossy in Z House 7 years ago 1 hour, 1 minute 45,314 views",Jossy in Z House,45314,45326,12
2737,"Jossy in Z House Show Interview with Musician Samuel Yerga by Jossy in Z House 7 years ago 1 hour, 3 minutes 7,774 views",Jossy in Z House,7774,7788,14
2738,"Jossy In Z House Interview with Singer Jacky Gosee by Jossy in Z House 7 years ago 57 minutes 283,734 views",Jossy in Z House,283734,283807,73
2739,"Jossy In Z House Interview with the Actress & Model Etsehiwot Abebe by Jossy in Z House 7 years ago 1 hour, 1 minute 442,043 views",Jossy in Z House,442043,442255,212
2740,"Interview with Athlete Meseret Defar with Jossy in Z House Show by Jossy in Z House 7 years ago 54 minutes 80,529 views",Jossy in Z House,80529,80547,18
2741,"Jossy in Z House Show Interview with Artist Minyishu Kifle by Jossy in Z House 7 years ago 46 minutes 15,183 views",Jossy in Z House,15183,15184,1
2742,"Jossy In Z House Interview with Choreographer Temesgen Melese by Jossy in Z House 7 years ago 55 minutes 11,051 views",Jossy in Z House,11051,11054,3
2743,"Jossy in Z House Show  Interview with Music Writer Abebe Melese by Jossy in Z House 7 years ago 51 minutes 12,866 views",Jossy in Z House,12866,12869,3
2744,ጆሲ ቴዎድሮስ ሞሲሳን ከልቡ ያመሰገነበት ምክንያት.... by JTV Ethiopia 8 days ago 17 minutes 944 views,JTV Ethiopia,944,1327,383
2745,"Ethiopian Music Jossy   Kager Lij Ga Chewata NEW! Video Clip by JTV Ethiopia 3 weeks ago 4 minutes, 32 seconds 2,027 views",JTV Ethiopia,2027,2196,169
2746,"''ሌባ ቀድሞህ ሌባ ካለህ ምንታደርጋለህ?'' by JTV Ethiopia 1 month ago 23 minutes 2,633 views",JTV Ethiopia,2633,2699,66
2747,"መረዋ ኳየር ""ብዙ ክፉ ነገሮችን አሳልፈናል"" l Merewa Choir by JTV Ethiopia 1 month ago 22 minutes 1,125 views",JTV Ethiopia,1125,1181,56
2748,"ማኪ ኬቢ ፡ በደነገጠ  የሙዚቃ ክሊፕ ምን ያህል እንደተከፈላት l Maki Kb - Denegete by JTV Ethiopia 1 month ago 9 minutes, 38 seconds 4,559 views",JTV Ethiopia,4559,4745,186
2749,"የ ዲያሰፖራዎች ገጠመኝ በአዲስ አበባ ከጆሲ ጋር by JTV Ethiopia 1 month ago 14 minutes, 9 seconds 6,900 views",JTV Ethiopia,6900,7032,132
2750,"ለካ ይሄን ያህል ደርሰዋል   ""የገና ዛፍ የሰይጣን ምልክት ነው!!"" by JTV Ethiopia 1 month ago 37 minutes 3,325 views",JTV Ethiopia,3325,3382,57
2751,"የገና በአል ቆይታ ጆሲ ከ ብስራት ሱራፌል ጋር by JTV Ethiopia 1 month ago 8 minutes, 36 seconds 2,625 views",JTV Ethiopia,2625,2704,79
2752,"ጆሲ ስለ ሃገሩ ኢትዮጲያ ሲያወራ እምባው መቆጣጠር አቃተው by JTV Ethiopia 1 month ago 11 minutes, 1 second 4,306 views",JTV Ethiopia,4306,4434,128
2753,"JTV Ethiopia Live Stream by JTV Ethiopia Streamed 1 month ago 17 minutes 1,900 views",JTV Ethiopia,1900,2006,106
2754,"ልብ የሚነካ ቆይታከ ሙናዬ መንበሩ ልጆች ጋር by JTV Ethiopia 1 month ago 22 minutes 5,037 views",JTV Ethiopia,5037,5074,37
2755,"የግሩም ጫላ የልጅነት አስተዳደግ ...l ከ ጆሲ ጋር ያደረጉት ቆይታ by JTV Ethiopia 2 months ago 10 minutes, 58 seconds 1,789 views",JTV Ethiopia,1789,1813,24
2756,"የወንዶች ጉዳይ ላይ የተከፈለኝ  2000 ብር ብቻ ነው by JTV Ethiopia 2 months ago 8 minutes, 43 seconds 2,487 views",JTV Ethiopia,2487,2495,8
2757,"ተዋናይት ሸዊት ከበደ""ኢለመንተሪ ላይ በጣም ቀልቃላ ልጅ ነበርኩኝ"" l artist shewit kebede by JTV Ethiopia 2 months ago 11 minutes, 4 seconds 4,745 views",JTV Ethiopia,4745,4860,115
2758,"ከባለቤቴ ጋር ለመጀመሪያ ጊዜ የተያየነው ስርየትን ስንሰራ ነው by JTV Ethiopia 2 months ago 15 minutes 14,155 views",JTV Ethiopia,14155,14266,111
2759,"ብርቱካን በፍቃዱ ""ወጣ ወጣ ማለት አልወድም የቤት ልጅ ነኝ "" l የልጅነት እድገቴ በደብረ ብርሃን ነው  l  Birtukan Befikadu by JTV Ethiopia 2 months ago 11 minutes, 14 seconds 5,551 views",JTV Ethiopia,5551,5609,58
2760,"በእኔና በቴዲ ጋብቻ ብዙ ሴቶች ተከፍተው ነበር by JTV Ethiopia 2 months ago 9 minutes, 39 seconds 13,377 views",JTV Ethiopia,13377,13431,54
2761,"ቴዲ አፍሮ በሚገርም ሁኔታ ሰፕራይዝ አርጎኛል l Tedy Afro | Amleset muchie by JTV Ethiopia 2 months ago 11 minutes, 47 seconds 7,470 views",JTV Ethiopia,7470,7511,41
2762,"ሀመልማል አባተ l የውሻ ስጋ ስለበላችበት አጋጣሚ የተናገረችው by JTV Ethiopia 2 months ago 16 minutes 1,647 views",JTV Ethiopia,1647,1658,11
2763,"ሀመልማል አባተ ከጆሲጋ ""ከሞት ሁለት ጊዜ ተርፌያለሁ l ፀሀየ ዮሀንስ ጉድ አድርጎኛል "" by JTV Ethiopia 2 months ago 19 minutes 7,719 views",JTV Ethiopia,7719,7762,43
2764,"ግሩም ኤርሚያስ"" ከሞት ስለተረፈበት አጋጣሚ ይናገራል "" by JTV Ethiopia 2 months ago 20 minutes 2,810 views",JTV Ethiopia,2810,2823,13
2765,"ግሩም ኤርሚያስ  ""ሰለ አምስት አመት የእስር ቤት ቆይታው"" by JTV Ethiopia 2 months ago 22 minutes 35,244 views",JTV Ethiopia,35244,35281,37
2766,"ሙሉአለም ታደሰ ""የዘንድሮ አርቲስቶች ባቋራጭ ለመክበር አትሞክሩ "" by JTV Ethiopia 2 months ago 16 minutes 13,827 views",JTV Ethiopia,13827,13892,65
2767,"""የብሔራዊ ቴአትር ጥበቃዎች ያስቸግሩኝ ነበር "" l ጆሲ ከሙሉአለም ታደሰ ጋር by JTV Ethiopia 2 months ago 10 minutes, 48 seconds 11,207 views",JTV Ethiopia,11207,11257,50
2768,"ጆሲ ከሙሉአለም ታደሰ ጋር l ዘጠነኛ ክፍል እያለው ነው ልጄን የወለድኩት by JTV Ethiopia 2 months ago 10 minutes, 44 seconds 160,100 views",JTV Ethiopia,160100,160345,245
2769,"ጆሲ ከሙሉአለም ታደሰ ጋር አዝናኝ ቆይታ ""አዳሪ ትምህርት ቤት ነው የተማርኩት""  ወርቃማው ጊዜ ነበር by JTV Ethiopia 2 months ago 12 minutes, 10 seconds 30,096 views",JTV Ethiopia,30096,30284,188
2770,"አዝናኝ ቆይታ ከአትሌት ሃይሌ ገብረስላሴ ጋር by JTV Ethiopia 2 months ago 14 minutes, 53 seconds 6,215 views",JTV Ethiopia,6215,6232,17
2771,"ጆሲ ከአትሌት ሃይሌ ገብረስላሴ ጋር ያደረገው ቆይታ by JTV Ethiopia 2 months ago 16 minutes 8,914 views",JTV Ethiopia,8914,8925,11
2772,"ጃሉድ የጥላሁን ዘፈን ሲዘፍን ቢሰሙ ምን ይላሉ?? by JTV Ethiopia 2 months ago 4 minutes, 52 seconds 5,504 views",JTV Ethiopia,5504,5524,20
2773,"የጆሲ  የመድረክ ስራ by JTV Ethiopia 3 months ago 9 minutes, 16 seconds 4,283 views",JTV Ethiopia,4283,4288,5
2774,"የአለባቸው ተካ እና የወንድሙ አሟሟት ከእህታቸው አንደበት by JTV Ethiopia 3 months ago 4 minutes, 34 seconds 3,843 views",JTV Ethiopia,3843,3849,6
2775,"""በ አስናቀ ምክንያት መንገድ ላይ ጫጩት ነበር ምባለው"" ሄለን በድሉ ከ ጆሲ ጋር by JTV Ethiopia 3 months ago 16 minutes 3,923 views",JTV Ethiopia,3923,3946,23
2776,"""ምርጥ የ አሰላ ልጅ ነኝ "" ሄለን በድሉ ከ ጆሲ ጋር አዝናኝ ቆየታ by JTV Ethiopia 3 months ago 11 minutes, 3 seconds 18,476 views",JTV Ethiopia,18476,18484,8
2777,"ሮማን በፍቃዱ  ከጆሲ ጋር ""ጆሲን ከባድ ጥያቄ ጠየቀችው"" by JTV Ethiopia 3 months ago 17 minutes 43,184 views",JTV Ethiopia,43184,43195,11
2778,"ያልተሰማው የሮማን በፍቃዱ የፍቅር ህይወት ""ባለ ታክሲውን ስሰራ በዛው በፍቅር ያዘኝ "" by JTV Ethiopia 3 months ago 12 minutes, 37 seconds 155,854 views",JTV Ethiopia,155854,155880,26
2779,"በጣም አስቸጋሪ ልጅ ነበርኩኝ  l አርቲስት ሮማን በፍቃዱ by JTV Ethiopia 3 months ago 13 minutes, 10 seconds 13,688 views",JTV Ethiopia,13688,13704,16
2780,"ፍቃዱ ስለ ልጅንት ግዜው የነበረው ቆይታ by JTV Ethiopia 3 months ago 11 minutes, 45 seconds 1,203 views",JTV Ethiopia,1203,1205,2
2781,"ጆሲ ከፍቃዱ ጋር አርጎት የነበረው ቆይታ l fekadu teklemariam by JTV Ethiopia 3 months ago 14 minutes, 29 seconds 1,616 views",JTV Ethiopia,1616,1618,2
2782,JTV Ethiopia Live Stream by JTV Ethiopia Streamed 4 months ago 37 seconds 962 views,JTV Ethiopia,962,971,9
2783,"ጆሲ ከ አትሌት ሃይሌ ገ/ስላሴ ጋር አዝናኝ ቆይታ l Jossy In Z House Show   Interview with Haile Gebresilassie by JTV Ethiopia 4 months ago 1 hour, 16 minutes 4,408 views",JTV Ethiopia,4408,4411,3
2784,"የመስቀል ልዩ ሰፕራይዝ በጄቲቪ አፋላጊ-ክፍል 3 by JTV Ethiopia 5 months ago 20 minutes 6,604 views",JTV Ethiopia,6604,6615,11
2785,"የመስቀል ልዩ ሰፕራይዝ በጄቲቪ አፋላጊ-ክፍል 2 by JTV Ethiopia 5 months ago 17 minutes 12,227 views",JTV Ethiopia,12227,12341,114
2786,"የመስቀል ልዩ ሰፕራይዝ በጄቲቪ አፋላጊ-ክፍል 1 by JTV Ethiopia 5 months ago 12 minutes, 12 seconds 5,904 views",JTV Ethiopia,5904,5916,12
2787,"ደስ የሚል ቆይታ ከጆሲ ጋር by JTV Ethiopia 5 months ago 12 minutes, 41 seconds 3,997 views",JTV Ethiopia,3997,4154,157
2788,"ሚገርም ቆይታ ከጆሲ ጋር by JTV Ethiopia 5 months ago 19 minutes 5,914 views",JTV Ethiopia,5914,5918,4
2789,"ሚኪ ሀሴት ከ ጆሲ ጋር አዝናኝ ቆይታ by JTV Ethiopia 5 months ago 17 minutes 7,180 views",JTV Ethiopia,7180,7200,20
2790,"መለስ ዜናዊን ባገኛቸው ኖሮ ደስ ይለኝ ነበር። ክፍል 2  |አሰልጣኝ ሰላም ዘራዓይ by JTV Ethiopia 1 year ago 19 minutes 7,967 views",JTV Ethiopia,7967,7970,3
2791,"ዶ/ር አብይን ባገኛቸው ኖሮ ደስ ይለኝ ነበር።  ክፍል 2 |ሰላዲን በርጌቾ by JTV Ethiopia 1 year ago 20 minutes 7,075 views",JTV Ethiopia,7075,7083,8
2792,"ኮሮና ቢገባም የአኗኗር ዘይቤዬ ያው ነው። ክፍል 1   |አሰልጣኝ ሰላም ዘራዓይ by JTV Ethiopia 1 year ago 32 minutes 3,346 views",JTV Ethiopia,3346,3346,0
2793,"ለትውስታ| አምለሰት ሙጬ ስለግል ህይወቷ ታጫውተናለች | ክፍል 1 by JTV Ethiopia 1 year ago 10 minutes, 38 seconds 45,207 views",JTV Ethiopia,45207,45316,109
2794,"እግር ኳሱ ባይቀጥል ይሻላል ክፍል 2| ኮሎኔል አወል by JTV Ethiopia 1 year ago 43 minutes 1,851 views",JTV Ethiopia,1851,1851,0
2795,"የቴዲ አፍሮ አድናቂ ነኝ   ክፍል 1|ሳላዲን በርጌቾ by JTV Ethiopia 1 year ago 15 minutes 4,742 views",JTV Ethiopia,4742,4751,9
2796,"ከልጄ በላይ ዋጋ የከፈልኩለት ክለብ ነው ደደቢት by JTV Ethiopia 1 year ago 41 minutes 2,842 views",JTV Ethiopia,2842,2842,0
2797,"ዙሪክ ላይ ጥሩ ብር ነበር |አትሌት ኃይሌ ገ/ስላሴ by JTV Ethiopia 1 year ago 37 minutes 15,748 views",JTV Ethiopia,15748,15749,1
2798,"ሲዲኒን የሚያክል የስፖርት ታሪክ የለም |አትሌት ኃይሌ ገ/ስላሴ by JTV Ethiopia 1 year ago 35 minutes 10,330 views",JTV Ethiopia,10330,10333,3
2799,"የጠፋነው በምክንያት ነው     አዝናኝ ቆይታ       ፍቅርተ አበበ (አለብሲሴ) by JTV Ethiopia 1 year ago 20 minutes 24,976 views",JTV Ethiopia,24976,24982,6
2800,"ጋዜጠኛ ገነነ መኩሪያ (ሊብሮ) ከሜዳ ውጪ ያለውን ህይወቱን ያስቃኘናል by JTV Ethiopia 1 year ago 25 minutes 6,155 views",JTV Ethiopia,6155,6165,10
2801,"ለትውስታ ከ አትሌት መሰረት ደፋር ጋር አዝናኝ ቆይታ by JTV Ethiopia 1 year ago 42 minutes 22,929 views",JTV Ethiopia,22929,22932,3
2802,"ስለሺ ዳባ (ትርጉም በስለሺ) | ታደለ ሮባ፣ አብዱ ኪያር፣ጎሳዬ ተስፋዬ የቪዲዮ ቤቴ ደንበኞች ነበሩ by JTV Ethiopia 1 year ago 21 minutes 24,359 views",JTV Ethiopia,24359,24368,9
2803,"አርቲስት የትናየት ይልማ | ኮ/ል መንግስቱ እጄን ሲጨብጥ መቆም አቃተኝ by JTV Ethiopia 1 year ago 28 minutes 70,566 views",JTV Ethiopia,70566,70574,8
2804,"ጋሽ ይጥና ደምሴ|  ሀገር ፍቅር ቴአትር ከረጅም ዓመታት በኃላ ካርታ እንዲኖረው አድርጌአለሁ፡፡ by JTV Ethiopia 1 year ago 30 minutes 8,513 views",JTV Ethiopia,8513,8515,2
2805,"የቴክንኩ ዋናው ቦታ ውጥንቅጡ ጠፍቷል |አቶ ግርማ መስፍን የኢ.እ.ኳ ተጫዋቾችና ባለሙያዎች ማ. ም/ፕሬዝደንት by JTV Ethiopia 1 year ago 1 hour 4,045 views",JTV Ethiopia,4045,4045,0
2806,"ጤና ይስጥልን| ሀኪሞቹ በግጥም አልተቻሉም ክፍል 4 by JTV Ethiopia 1 year ago 27 minutes 4,315 views",JTV Ethiopia,4315,4316,1
2807,"ጤና ይስጥልን| የበዓል ሰርፕራይዝ ለሀኪሞች ክፍል 3 by JTV Ethiopia 1 year ago 46 minutes 8,870 views",JTV Ethiopia,8870,8872,2
2808,"የማይረሱ ስራዎችን ያበረከተው ድምፃዊ ተስፋዬ ገብዬ ማነው by JTV Ethiopia 1 year ago 26 minutes 18,803 views",JTV Ethiopia,18803,18803,0
2809,"ጤና ይስጥልን| ወቅታዊ ጭውውት ለ ሀኪሞች የማነቃቂያ ዝግጅት ክፍል 2 by JTV Ethiopia 1 year ago 24 minutes 6,335 views",JTV Ethiopia,6335,6336,1
2810,"ጤና ይስጥልን| አርቲስቶች ለህክምና ባለሙያዎች ያዘጋጁት የማነቃቂያ ዝግጅት ክፍል 1 by JTV Ethiopia 1 year ago 26 minutes 14,473 views",JTV Ethiopia,14473,14473,0
2811,"አቶ ተሾመ አሊ| አዲስ አበባ ስታዲየም ፕሮቶኮል  ቦታ ለማስያዝ የፈራሁት ኮ/ል መንግስቱን ብቻ ነው by JTV Ethiopia 1 year ago 23 minutes 66,955 views",JTV Ethiopia,66955,66963,8
2812,"አባቴን ካየሁት 13 ዓመታት ተቆጠሩ by JTV Ethiopia 1 year ago 11 minutes, 13 seconds 133,481 views",JTV Ethiopia,133481,133533,52
2813,"ለሁሉም ጊዜ አለው  የኔ እህት ዛሬ እንደተወለድኩ ነው ምቆጥረው by JTV Ethiopia 1 year ago 24 minutes 184,653 views",JTV Ethiopia,184653,184745,92
2814,"በጣም አሳዛኝ  l በጆሲ ዘመድ ጥየቃ ዕለት ያረፉት አርቲስት መስፍን አስፋው by JTV Ethiopia 1 year ago 24 minutes 117,931 views",JTV Ethiopia,117931,117989,58
2815,"ከዘመናት በኃላ የተጠፋፉት ቤተሰቦች የበዓል ዕለት ይገናኛሉ by JTV Ethiopia 1 year ago 2 minutes, 49 seconds 95,803 views",JTV Ethiopia,95803,95816,13
2816,"ጤና ይስጥልኝ በዓልን በየካ ኮተቤ አጠቃላይ ሆስፒታል by JTV Ethiopia 1 year ago 2 minutes, 37 seconds 9,843 views",JTV Ethiopia,9843,9844,1
2817,"ልዩ የዘመድ ጥየቃ ፕሮግራም የፋሲካ ዕለት by JTV Ethiopia 1 year ago 5 minutes, 32 seconds 22,827 views",JTV Ethiopia,22827,22830,3
2818,"ኢቲ 7-24 ልዩ የፋሲካ በዓል ዝግጅት by JTV Ethiopia 1 year ago 2 minutes, 36 seconds 11,159 views",JTV Ethiopia,11159,11163,4
2819,"ልዩ ትውስታዎች በፋሲካ በዓል  ሙሉውን ለመከታተል ሊንኩን ይጫኑ by JTV Ethiopia 1 year ago 29 minutes 25,281 views",JTV Ethiopia,25281,25296,15
2820,"ራስ ጃኒ እና ባለቤቱ ጄጄ “ራሳይን” ስለተባለው አዲሱ ፕሮጀክታቸው ይነግሩናል  |ጄውድ ከ ሳሚ ጋር by JTV Ethiopia 1 year ago 28 minutes 3,964 views",JTV Ethiopia,3964,3965,1
2821,"ልጅ በሆስፒታሉ በህክምና ሙያ ላይ ለምትገኘው እናቷ ያስተላለፈችው አሳዛኝ መልዕክት by JTV Ethiopia 1 year ago 50 minutes 7,622 views",JTV Ethiopia,7622,7622,0
2822,"የኮሮና ቫይረስ መልዕክት በቀጥታ ስርጭት | ትዝብት ከእንዳልክ ጋር by JTV Ethiopia 1 year ago 36 minutes 12,245 views",JTV Ethiopia,12245,12246,1
2823,"ያለምንም የዋጋ ጭማሪ እየሰራ የሚገኘው ኢስት አፍሪካ ሆልዲንግስ by JTV Ethiopia 1 year ago 52 minutes 1,891 views",JTV Ethiopia,1891,1891,0
2824,"ብዙ ማውራት ስለማልወድ አንዳንድ ቀጠሮዎችን ሁሉ እሰርዛለሁ  ክፍል 2 | የስፖርት ጋዜጠኛ መኳንንት በርሄ by JTV Ethiopia 1 year ago 36 minutes 2,076 views",JTV Ethiopia,2076,2077,1
2825,"ጤና ይስጥልኝ | አንድ ሰው ከኮሮና ቫይረስ አገገመ ሲባል ምን ማለት ነው by JTV Ethiopia 1 year ago 1 hour, 2 minutes 3,783 views",JTV Ethiopia,3783,3783,0
2826,"በመኪና አደጋ ከሞት ተርፌአለሁ ክፍል 2 | የስፖርት ጋዜጠኛ መንሱር አብዱልቀኒ by JTV Ethiopia 1 year ago 1 hour, 3 minutes 3,276 views",JTV Ethiopia,3276,3284,8
2827,"እግዚአብሔር ለኔ ሁለተኛ ዕድል ሰቶኛል ክፍል 1 | የስፖርት ጋዜጠኛ መኳንንት በርሄ by JTV Ethiopia 1 year ago 52 minutes 3,103 views",JTV Ethiopia,3103,3103,0
2828,"ይሄን ምስኪን ህዝብ አትበክሉ |ትዝብት ከእንዳልክ ጋር by JTV Ethiopia 1 year ago 33 minutes 14,791 views",JTV Ethiopia,14791,14795,4
2829,"በቅርቡ ልጅ ጠብቁ | አርቲስት ዳንኤል ተገኝ  ክፍል 5 by JTV Ethiopia 1 year ago 15 minutes 10,916 views",JTV Ethiopia,10916,10917,1
2830,"ከሲኒማ ቤት ገንዘቤን ማግኘት ስላልቻልኩ መኪናዬን ሸጫለሁ  | አርቲስት ዳንኤል ተገኝ  ክፍል 4 by JTV Ethiopia 1 year ago 36 minutes 17,784 views",JTV Ethiopia,17784,17784,0
2831,"ኢትዮፒካሊንክና ዛሚን እስከማሳገድ ያደረሰው ጉዳይ | አርቲስት ዳንኤል ተገኝ   ክፍል 3 by JTV Ethiopia 1 year ago 40 minutes 28,257 views",JTV Ethiopia,28257,28260,3
2832,"አንድ መንገድ ስንሰራ አንድ ገብርኤል አለ |የክብር ዶክተር ሳሙኤል ታፈሰ by JTV Ethiopia 1 year ago 49 minutes 33,003 views",JTV Ethiopia,33003,33094,91
2833,"ከምትመኩበት ዘር ይሻላል ሳኒታይዘር |ትዝብት ከእንዳልክ ጋር by JTV Ethiopia 1 year ago 39 minutes 32,012 views",JTV Ethiopia,32012,32013,1
2834,"ስታዲየም ኳስ ሲያልቅ እኔ የተቀመጡበትን ጋዜጣ እሰበስብ ነበር | ክቡር ዶ/ር ሳሙኤል ተስፋዬ  ክፍል 1 by JTV Ethiopia 1 year ago 46 minutes 38,114 views",JTV Ethiopia,38114,38220,106
2835,"ይህ መልዕክት ለሁሉም ነው |ኮሮና ቫይረስን በጋራ እንከላከል by JTV Ethiopia 1 year ago 2 minutes, 10 seconds 2,466 views",JTV Ethiopia,2466,2466,0
2836,"የ ዮሴፍ ገብሬ (ጆሲ) መልዕክት |ሁሉም ወደየ አምላኩ ያንጋጥ!! by JTV Ethiopia 1 year ago 1 minute, 36 seconds 20,057 views",JTV Ethiopia,20057,20059,2
2837,"ጤና መረጃ| ኮሮና ቫይረስን ለመግታት በየቤታችን ምን እናድርግ | ጤና ይስጥልን by JTV Ethiopia 1 year ago 14 minutes, 48 seconds 6,801 views",JTV Ethiopia,6801,6801,0
2838,"ከባለሙያዎች አንደበት| የ ኮሮና ቫይረስን ለመግታት በ የካ ኮተቤ ሆስፒታል ያለው እንቅስቃሴ ምን ይመስላል | ጤና ይስጥልን by JTV Ethiopia 1 year ago 37 minutes 3,361 views",JTV Ethiopia,3361,3361,0
2839,"ሀገሪቷ ላይ እያንዣበበ ያለው ሌላኛው ቫይረስ | ትዝብት ከእንዳልክ ጋር by JTV Ethiopia 1 year ago 42 minutes 22,383 views",JTV Ethiopia,22383,22389,6
2840,"“የሴም ወርቅ” ማስተርሴን እንድይዝ ያደረገኝ ፊልም ነው | አርቲስት ዳንኤል ተገኝ    ክፍል 2 by JTV Ethiopia 1 year ago 28 minutes 21,659 views",JTV Ethiopia,21659,21671,12
2841,"5 ማስቲካ እየበላሁ ነው ባቢሎን በሳሎንን የምጫወተው | አርቲስት ዳንኤል ተገኝ  ክፍል 1 by JTV Ethiopia 1 year ago 50 minutes 79,424 views",JTV Ethiopia,79424,79450,26
2842,"ጤና ይስጥልን | ድንገተኛ የእሳት ቃጠሎ የደረሰበት ሰው ብናገኝ ወይም ቢደርስብን ምን ማድረግ አለብን |ህይወት አድን by JTV Ethiopia 1 year ago 28 minutes 2,325 views",JTV Ethiopia,2325,2345,20
2843,"ጤና ይስጥልን| ድንገተኛ ስብራት ያጋጠመው ሰው ብናገኝ ምን ማድረግ አለብን |ህይወት አድን by JTV Ethiopia 1 year ago 25 minutes 3,061 views",JTV Ethiopia,3061,3064,3
2844,"ሰማኸኝ በለው (ሰሜ ባላገር)|  ፖለቲከኞቻችን የቴዲ ዘፈን ለእናንተ በቂ ነው፡፡ እስኪ ተዋደዱ…… by JTV Ethiopia 1 year ago 21 minutes 32,703 views",JTV Ethiopia,32703,32703,0
2845,"ጤና ይስጥልን| በኮሮና ቫይረስ ላለመያዝ ምን ማድረግ አለብን |ከባለሙያ አንደበት by JTV Ethiopia 1 year ago 32 minutes 48,030 views",JTV Ethiopia,48030,48030,0
2846,"ትዝብት ከእንዳልክ ጋር| አሳሳቢ ደረጃ የደረሰው የመኪና ስርቆት by JTV Ethiopia 1 year ago 33 minutes 11,039 views",JTV Ethiopia,11039,11039,0
2847,"ሰማኸኝ በለው (ሰሜ ባላገር)|  4 ዓመት የተፈረደብኝ ሰው ገድዬ ሳይሆን በፖለቲካ ምክንያት ነው by JTV Ethiopia 1 year ago 33 minutes 32,452 views",JTV Ethiopia,32452,32462,10
2848,"ጤና ይስጥልኝ| መርዝ የጠጣ ሰው ብናገኝ ምን ማድረግ አለብን | ህይወት አድን by JTV Ethiopia 1 year ago 14 minutes, 53 seconds 2,777 views",JTV Ethiopia,2777,2791,14
2849,"ሰማኸኝ በለው (ሰሜ ባላገር)| ደርግ ለኪነጥበቡ ትልቅ አስተዋፅኦ ያደገረ መንግስት ነው፡፡ ክፍል 1 by JTV Ethiopia 1 year ago 44 minutes 31,999 views",JTV Ethiopia,31999,32002,3
2850,"ትዝብት ከእንዳልክ ጋር| የህክምና ባለሙያዎችን ማባረር ወይስ መቅጠር by JTV Ethiopia 1 year ago 34 minutes 24,229 views",JTV Ethiopia,24229,24234,5
2851,"ጤና ይስጥልኝ| የአንጀት ቱቦ መዘጋት ዋና ዋና ምክንያቶችን ከባለሙያ አንደበት by JTV Ethiopia 1 year ago 18 minutes 3,307 views",JTV Ethiopia,3307,3334,27
2852,"አለቤ እና ኤሊያስ መልካ የሙዚቃዬ ባለውለታዎች ናቸው |ድምፃዊ ሀብ እንግዳው by JTV Ethiopia 1 year ago 28 minutes 5,302 views",JTV Ethiopia,5302,5307,5
2853,"ከአድማስ ኢንተርቴመንት ጋር ስለነበረው ክስ የተናገረው l ዳዊት አለማየው by JTV Ethiopia 2 years ago 7 minutes, 58 seconds 6,834 views",JTV Ethiopia,6834,6837,3
2854,"ጆሲ አዲስ ስለሚያወጣው አልበም ለዳዊት አለማየው የተናገረው  ምንድን ነው?? by JTV Ethiopia 2 years ago 12 minutes, 56 seconds 10,306 views",JTV Ethiopia,10306,10314,8
2855,"ባላገሩን ካልተወዳድርክ አልበምህ አይወጣም አለኝ ""አብርሃም ወልዴ"" lካሳሁን እሸቱ by JTV Ethiopia 2 years ago 13 minutes, 34 seconds 16,699 views",JTV Ethiopia,16699,16722,23
2856,"የነዋይ ደበበ ዘፈን ካልተከፈተ ምግብ አልበላም l ካሳሁን እሸቱ by JTV Ethiopia 2 years ago 19 minutes 15,199 views",JTV Ethiopia,15199,15233,34
2857,"MIN ADDIS EP 11 michael belaynh by JTV Ethiopia 2 years ago 31 minutes 4,243 views",JTV Ethiopia,4243,4243,0
2858,"Tadese Bekele Yezenbaba Mar Nesh mpeg MPEG by JTV Ethiopia 2 years ago 5 minutes, 11 seconds 652 views",JTV Ethiopia,652,655,3
2859,J I Z H With Fikre Tolossa E by JTV Ethiopia 2 years ago 26 minutes 884 views,JTV Ethiopia,884,884,0
2860,"Ydnekacwe Geleta Webetsh mpeg MPEG by JTV Ethiopia 2 years ago 5 minutes, 45 seconds 22,698 views",JTV Ethiopia,22698,22832,134
2861,"Anteneh Ene Bebekule mpeg MPEG by JTV Ethiopia 2 years ago 4 minutes, 34 seconds 15,419 views",JTV Ethiopia,15419,15541,122
2862,"J I Z H With Fikre Tolossa part 2 E by JTV Ethiopia 2 years ago 14 minutes, 23 seconds 1,037 views",JTV Ethiopia,1037,1037,0
2863,Et-724 JTV Entertainment News by JTV Ethiopia 2 years ago 33 minutes 616 views,JTV Ethiopia,616,619,3
2864,"My Edited Video by JTV Ethiopia 2 years ago 1 minute, 51 seconds 690 views",JTV Ethiopia,690,693,3
2865,sport 5 hd A by JTV Ethiopia 2 years ago 50 minutes 335 views,JTV Ethiopia,335,335,0
2866,"J I Z H With Fikre Tolossa Part 2 F by JTV Ethiopia 2 years ago 26 minutes 1,352 views",JTV Ethiopia,1352,1352,0
2867,"Selomon Kebede  Chakka mpeg MPEG by JTV Ethiopia 2 years ago 3 minutes, 18 seconds 310 views",JTV Ethiopia,310,311,1
2868,"melat all 1 by JTV Ethiopia 2 years ago 31 minutes 2,483 views",JTV Ethiopia,2483,2485,2
2869,"Afalagi EP 46 B by JTV Ethiopia 2 years ago 20 minutes 6,015 views",JTV Ethiopia,6015,6021,6
2870,"ገናን በዱባይ ከአርቲስቶች ጋር  ክፍል 2 by JTV Ethiopia 2 years ago 59 minutes 8,286 views",JTV Ethiopia,8286,8290,4
2871,"ከጀግንነቴ የተነሳ ሻብያ ድል ያደረኩበትን ቦታ ተስፋዬ በር ብለው ሰይመውታል |ብ/ጄ ተስፋዬ ሀ/ማርያም by JTV Ethiopia 2 years ago 25 minutes 27,187 views",JTV Ethiopia,27187,27207,20
2872,"የሚያገኙትን ገንዘብ የማያሳውቁ የተጫዋች ደላሎች ሌቦች ናቸው ክፍል 2 | አሰልጣኝ ውበቱ አባተ by JTV Ethiopia 2 years ago 42 minutes 1,627 views",JTV Ethiopia,1627,1627,0
2873,"3 ኦሎምፒክ ላይ ተሳትፌአለሁ |የቀድሞ የኢ.ብ.ቡድን ቦክሰኛ አየለ መሐመድ by JTV Ethiopia 2 years ago 21 minutes 7,818 views",JTV Ethiopia,7818,7818,0
2874,"የግድያ ማስፈራሪያ በብዛት ደርሶኛል    ክፍል 1 | መንሱር አብዱልቀኒ by JTV Ethiopia 2 years ago 33 minutes 17,779 views",JTV Ethiopia,17779,17879,100
2875,"ከ 3ኛው እስከ 7ኛው የአፍሪካ ዋንጫ ሀገሬን ወክዬ ተጫውቻለሁ |የቀድሞ የኢ.ብ.ቡድን እግር ኳስ ተጫዋችች ባሻ ሀይሉ አበበ by JTV Ethiopia 2 years ago 21 minutes 12,634 views",JTV Ethiopia,12634,12636,2
2876,"ብዙ መብቶቼ ተነፍገውኛል  | ጋዜጠኛ፣መምህር፣ደራሲ እና ተርጓሚ ግርማይ ተ/ፃዲቅ by JTV Ethiopia 2 years ago 25 minutes 14,848 views",JTV Ethiopia,14848,14848,0
2877,"አዝናኝ የበዓል ዝግጅት አርቲስቶቻችን እንዴት እያከበሩ ነው ክፍል 2 by JTV Ethiopia 2 years ago 36 minutes 6,972 views",JTV Ethiopia,6972,6973,1
2878,"የገና በዓል ሰርፕራይዝ ለ አቶ ዳንኤል መንገሻ  ክፍል 2 | ጤና ይስጥልኝ by JTV Ethiopia 2 years ago 37 minutes 2,157 views",JTV Ethiopia,2157,2160,3
2879,"ፖሊስ ቤት ጡረታ ስወጣ ሻይ እንኳን አልጋበዘኝም  |ድምፃዊ ታደለ በቀለ by JTV Ethiopia 2 years ago 29 minutes 38,901 views",JTV Ethiopia,38901,38927,26
2880,"ጆሲ አንተም ጥፋተኛ ነህ | ድምፃዊት ቤተልሔም መኮንን by JTV Ethiopia 2 years ago 31 minutes 423,307 views",JTV Ethiopia,423307,423469,162
2881,"የገና በዓል ሰርፕራይዝ ጎዳና ላይ ላሉ ወጣቶች ክፍል 1 | ጤና ይስጥልኝ by JTV Ethiopia 2 years ago 1 hour, 9 minutes 35,008 views",JTV Ethiopia,35008,35019,11
2882,"ከአርቲስቶች ጋር አዝናኝ የገና በዓል ዝግጅት ክፍል 1 by JTV Ethiopia 2 years ago 25 minutes 23,610 views",JTV Ethiopia,23610,23613,3
2883,"የእናት እና ልጅ ፍቅር ከ 54 ዓመታት በኃላ ክፍል 2 | ጄ ቴቪ አፋላጊ by JTV Ethiopia 2 years ago 27 minutes 131,631 views",JTV Ethiopia,131631,131752,121
2884,"ከ 54 ዓመታት በኃላ እናት እና ልጅ በ በዓል ተገናኙ ክፍል 1 by JTV Ethiopia 2 years ago 20 minutes 58,261 views",JTV Ethiopia,58261,58318,57
2885,"በገና በዓል ከ 35 ዓመት በኃላ የተገናኙት እህት እና ወንድም አሳዛኝ ታሪክ ክፍል 2 | ጄ ቴቪ አፋላጊ by JTV Ethiopia 2 years ago 21 minutes 143,181 views",JTV Ethiopia,143181,143235,54
2886,"ቦሌ መንገድ ላይ ነው የተዋወቅነው | ሀዲንቆ እና ዘ አርአያ by JTV Ethiopia 2 years ago 8 minutes, 56 seconds 8,299 views",JTV Ethiopia,8299,8299,0
2887,"የቴዲ ኮንሰርት ከህዝብ ጋር በደንብ አስተዋውቆኛል | ሀዲስ አለማየሁ (ሀዲንቆ) by JTV Ethiopia 2 years ago 28 minutes 25,428 views",JTV Ethiopia,25428,25429,1
2888,"ያሬድ ሙዚቃ ቤት ለ ባህላዊ የሙዚቃ መሳሪያዎች ብዙም አይደለም | ሀዲስ አለማየሁ (ሀዲንቆ) by JTV Ethiopia 2 years ago 17 minutes 11,383 views",JTV Ethiopia,11383,11396,13
2889,"እናቴ ለማሲንቆዬ ቅኝት ማሳመሪያ እጣን ትሰጠኝ ነበር | ሀዲስ አለማየሁ (ሀዲንቆ) by JTV Ethiopia 2 years ago 19 minutes 47,007 views",JTV Ethiopia,47007,47028,21
2890,"የሀበሻን ልብስ በፈረንጅ ስታይል መስራት ይቻላል |ዳዊት አደናግር by JTV Ethiopia 2 years ago 44 minutes 4,875 views",JTV Ethiopia,4875,4875,0
2891,"የገና እለት ከውድ ተመልካቾቻችን ጋር ዘመድ እንጠይቃለን by JTV Ethiopia 2 years ago 3 minutes, 42 seconds 29,421 views",JTV Ethiopia,29421,29423,2
2892,"አንድ ክር የሆነው በምክንያት ነው | ሀዲስ አለማየሁ (ሀዲንቆ) by JTV Ethiopia 2 years ago 2 minutes, 27 seconds 4,724 views",JTV Ethiopia,4724,4724,0
2893,"እንደ ሊያ ከበደ እና አና ጌታነህ አይነት ቁመት የለም | ማህሌት ተ/ማርያም by JTV Ethiopia 2 years ago 16 minutes 11,697 views",JTV Ethiopia,11697,11699,2
2894,"ቻይናዎቹ ጥበቡን ፕሪንት እያረጉ እያመጡ ነው | ማህሌት ተ/ማርያም by JTV Ethiopia 2 years ago 23 minutes 3,975 views",JTV Ethiopia,3975,3976,1
2895,"ፌዴሬሽናችን የቪዲዮ መረጃ እንኳን አይቀበልም |አሰልጣኝ ውበቱ አባተ by JTV Ethiopia 2 years ago 54 minutes 1,314 views",JTV Ethiopia,1314,1314,0
2896,"ፋሽን ኢትዮጵያ ውስጥ ገና አልተለመደም | ማህሌት ተ/ማርያም by JTV Ethiopia 2 years ago 20 minutes 7,865 views",JTV Ethiopia,7865,7866,1
2897,"ለፈረንጆቹ ከኢትዮጵያ ነው የመጣሁት ስላቸው ያፌዙብኝ ነበር   | ማህሌት ተ/ማርያም by JTV Ethiopia 2 years ago 18 minutes 19,058 views",JTV Ethiopia,19058,19058,0
2898,"ሰው መስራት እፈልጋለሁ   | አትሌት ገ/እግዚአብሔር ገ/ማርያም  ከሜዳ ውጪ ቆይታ by JTV Ethiopia 2 years ago 49 minutes 1,835 views",JTV Ethiopia,1835,1835,0
2899,"የጥፍር ስራ እና ዲዛይን | ፋሽን 365 by JTV Ethiopia 2 years ago 1 hour, 13 minutes 3,112 views",JTV Ethiopia,3112,3121,9
2900,"የ HUB of AFRICA መስራች ጋር የተደረገ ልዩ ቆይታ by JTV Ethiopia 2 years ago 2 minutes, 15 seconds 3,560 views",JTV Ethiopia,3560,3560,0
2901,"የኢትዮጵያ ታሪክ እንዲጠፋ የሚፈልጉ አሉ ንፁህ ልብ ያስፈልገናል |ሰዓሊ ደስታ ሀጎስ by JTV Ethiopia 2 years ago 21 minutes 7,361 views",JTV Ethiopia,7361,7361,0
2902,"የአንድ ት/ቤት የተማሪዎች የክርስትና እናት ተብዬ ተሸልሜአለሁ |ሰዓሊ ደስታ ሀጎስ by JTV Ethiopia 2 years ago 22 minutes 10,924 views",JTV Ethiopia,10924,10924,0
2903,"ድሬድ ወይም በተለምዶ ራስታ የምንለው ነገር ምንድነው? |ፋሽን 365 by JTV Ethiopia 2 years ago 54 minutes 2,998 views",JTV Ethiopia,2998,3035,37
2904,"እኔ እና እቴጌ መነን ከህንድ ሀገር እኩል ሽልማት ወስደናል |ሰዓሊ ደስታ ሀጎስ by JTV Ethiopia 2 years ago 23 minutes 21,039 views",JTV Ethiopia,21039,21048,9
2905,"ቅጠል ከምትቀጥፊ እነሱን ሳያቸው ይለኛል አባቴ  |ሰዓሊ ደስታ ሀጎስ by JTV Ethiopia 2 years ago 28 minutes 13,678 views",JTV Ethiopia,13678,13678,0
2906,"በዘር መደራጀት የትም አያደርስም  |መቶ አለቃ ፈቃደ ማሞ (ቼንቶ) by JTV Ethiopia 2 years ago 37 minutes 2,109 views",JTV Ethiopia,2109,2109,0
2907,"ቴዲን ሌላ ሰው ሲወድብኝ ራሱ እቀናለሁ |ሚኪያስ ቸርነት by JTV Ethiopia 2 years ago 17 minutes 46,610 views",JTV Ethiopia,46610,46642,32
2908,"የሚኪያስ ቸርነት ምርቃት ለጆሲ by JTV Ethiopia 2 years ago 18 minutes 12,068 views",JTV Ethiopia,12068,12069,1
2909,"ከዘር በላይ ኢትዮጵያን የሚያስቀድም ሰው ለኔ ኢትዮጵያዊ ነው   |ዶ/ር አሸብር ወ/ጊዮርጊስ by JTV Ethiopia 2 years ago 52 minutes 1,437 views",JTV Ethiopia,1437,1437,0
2910,"ለእናቴ ምንም ሳላዳርግ ማለፏ እስካሁን ይቆጨኛል  |ድምፃዊ ሚኪያስ by JTV Ethiopia 2 years ago 13 minutes, 19 seconds 40,684 views",JTV Ethiopia,40684,40723,39
2911,"MP3 ነው ምባለው ብዙ ዘፈን ስለምችል |ድምፃዊ ሚኪያስ ቸርነት by JTV Ethiopia 2 years ago 18 minutes 23,703 views",JTV Ethiopia,23703,23709,6
2912,"ሲንግል ላለመልቀቅ ምዬ ነው አልበም ያወጣሁት |ሚኪያስ ቸርነት by JTV Ethiopia 2 years ago 19 minutes 31,027 views",JTV Ethiopia,31027,31033,6
2913,"የኢትዮጵያ እግር ኳስ ለደላሎች ኪስ መሙያ ሆኗል |አሰልጣኝ መሳይ በየነ by JTV Ethiopia 2 years ago 44 minutes 1,385 views",JTV Ethiopia,1385,1385,0
2914,"ዳኝነትን ከነችግሩ ደስታ አገኝበታለሁ |ኢንስትራክተር ግዛቴ አለሙ by JTV Ethiopia 2 years ago 1 hour, 8 minutes 1,256 views",JTV Ethiopia,1256,1256,0
2915,"ተሾመ ወልዴ | ለጆሲ ቃል የገባለት ምንድን ነው? by JTV Ethiopia 2 years ago 25 minutes 8,128 views",JTV Ethiopia,8128,8131,3
2916,"“አበባዬ” በኢትዮጵያ ቴሌቭዥን ክሊፕ ታሪክ የመጀመሪያው የታየው የኔ ነው |ድምፃዊ ተሾመ ወልዴ by JTV Ethiopia 2 years ago 26 minutes 10,004 views",JTV Ethiopia,10004,10018,14
2917,"የሴቶች የፀጉር አቆራረጥ |በፋሽን 365 by JTV Ethiopia 2 years ago 45 minutes 10,109 views",JTV Ethiopia,10109,10175,66
2918,"“ጀማዬን” ኤፍሬም ከኔ ወስዶ ነው የዘፈነው |ተሾመ ወልዴ by JTV Ethiopia 2 years ago 23 minutes 27,288 views",JTV Ethiopia,27288,27291,3
2919,"እናቴን ለመርዳት ስል የመንገድ ላይ ንግድ ሰርቻለሁ|ተሾመ ወልዴ by JTV Ethiopia 2 years ago 23 minutes 20,990 views",JTV Ethiopia,20990,20993,3
2920,"ጃፓን እና አሜሪካ ያለው መሬት የኔ ይመስለኛል |አሰልጣኝ ሰውነት ቢሻው by JTV Ethiopia 2 years ago 52 minutes 9,423 views",JTV Ethiopia,9423,9425,2
2921,"ኢንጅነር አይደለሁም ግን ደሞ ይሄን ባቡር መስራት አያቅተኝም |ኤሊያስ ተባበል by JTV Ethiopia 2 years ago 22 minutes 25,589 views",JTV Ethiopia,25589,25614,25
2922,"የቀድሞ የብ/ቡድን አሰልጣኝ ሰውነት ቢሻው  እሁድ ከምሽቱ 1፡00 ከሜዳ ውጭ በጄ ቴቪ ኢትዮጵያ ላይ ይጠብቁን by JTV Ethiopia 2 years ago 58 seconds 2,117 views",JTV Ethiopia,2117,2119,2
2923,"ኤሊያስ የነዋይና የፀሃዬን ተንኮሎች ይፋ አደረገ |ኤሊያስ ተባበል by JTV Ethiopia 2 years ago 14 minutes, 4 seconds 130,582 views",JTV Ethiopia,130582,130706,124
2924,"ጆሲ ኤሊያስን ለምን ይቅርታ ጠየቀው by JTV Ethiopia 2 years ago 16 minutes 37,801 views",JTV Ethiopia,37801,37809,8
2925,"ሮሃ ባንዶች ስለሚሰድቡኝ  እከሳቸው ነበር  |ኤሊያስ ተባባል by JTV Ethiopia 2 years ago 24 minutes 94,907 views",JTV Ethiopia,94907,94936,29
2926,"ካገሬ ስወጣ ነዋይ ደበበ በ 3 ብር ይበልጠኝ ነበር |ኤሊያስ ተባባል by JTV Ethiopia 2 years ago 19 minutes 64,597 views",JTV Ethiopia,64597,64626,29
2927,"አመራር ላይ ብሆን ስታዲየሙን እዘጋው ነበር |አቶ አብነት ገ/መስቀል by JTV Ethiopia 2 years ago 33 minutes 15,826 views",JTV Ethiopia,15826,15838,12
2928,"“በልምምድ ብዛት ራሴን ስቼ ወድቄ ለጠንካራ ልምምድ እንዴት ምሳሌ አደርጋለሁ? በዚያው ብሞትስ?” | ኤልመዲን መሐመድ by JTV Ethiopia 2 years ago 1 hour 2,491 views",JTV Ethiopia,2491,2491,0
2929,"የኤሊያስ ተባባል ያልተነገረው ህይወቱ by JTV Ethiopia 2 years ago 2 minutes, 25 seconds 5,908 views",JTV Ethiopia,5908,5916,8
2930,"አብነት እና ቅዱስ ጊዮርጊስ ስፖርት ክለብ by JTV Ethiopia 2 years ago 1 minute, 1 second 1,868 views",JTV Ethiopia,1868,1869,1
2931,"ኢትዮጵያዊነት መልካምነት by JTV Ethiopia 2 years ago 52 seconds 6,664 views",JTV Ethiopia,6664,6666,2
2932,"አርቲስት እንመርጣለን |አቢሲኒያ ቫይን by JTV Ethiopia 2 years ago 11 minutes, 20 seconds 30,323 views",JTV Ethiopia,30323,30327,4
2933,"ህዳር መጨረሻ ለ 30 ሺ  ዜጎች የነፃ ህክምና ምርመራ እና ምክር አገልግሎት ይሰጣል |ጤና ይስጥልኝ by JTV Ethiopia 2 years ago 44 minutes 1,934 views",JTV Ethiopia,1934,1934,0
2934,"ኑ ህይወት እናድን! ህዳር መጨረሻ ድረስ የኩላሊት እጥበትን ነፃ ለማድረግ ታስቧል | አቶ ሰለሞን አሰፋ by JTV Ethiopia 2 years ago 21 minutes 3,533 views",JTV Ethiopia,3533,3533,0
2935,"እያየን ያደግነው ደረጄና ሀብቴን ነው |አቢሲኒያ ቫይን by JTV Ethiopia 2 years ago 21 minutes 182,357 views",JTV Ethiopia,182357,182399,42
2936,"እባካችሁ መጠባበቂያ ሌላ ሀገር ያላችሁ ሰዎች! እኛ ወዴት እንሰደድ እሺ?     |አትሌት ኃይሌ ገ/ስላሴ by JTV Ethiopia 2 years ago 39 minutes 27,772 views",JTV Ethiopia,27772,27773,1
2937,"“በአደባባይ የምቃወመው ነገር ቢኖር ታማኝ ምንጮቻችን ገለፁ የሚለውን ዘገባ ነው” | አቶ ባህሩ ጥላሁን by JTV Ethiopia 2 years ago 1 hour, 1 minute 3,500 views",JTV Ethiopia,3500,3500,0
2938,"“በእኛ ሀገር እግር ኳስ አስተሳሰብ ፊዚካል አፒራንስ እና ፊትነስን የሚለይ ሰው ብዙ አይደለም” | ፍፁም (ትሬኳርቲስታ) by JTV Ethiopia 2 years ago 57 minutes 2,765 views",JTV Ethiopia,2765,2766,1
2939,"10 ሚስት አግብቼ ብፈታም  በኔ ህይወት ውስጥ ማንም መግባት አይችልም | ሽመልስ አበራ (ጆሮ) by JTV Ethiopia 2 years ago 32 minutes 81,132 views",JTV Ethiopia,81132,81150,18
2940,"ሰኔ 30ን ስሰራ አይኔ ጠፍቶ ነበር by JTV Ethiopia 2 years ago 26 minutes 25,626 views",JTV Ethiopia,25626,25629,3
2941,"በገንዘብ የሚደለል ስብዕና የለኝም | ሽመልስ አበራ (ጆሮ) by JTV Ethiopia 2 years ago 26 minutes 16,626 views",JTV Ethiopia,16626,16638,12
2942,"ዘመናዊ እና ባህላዊ ህክምና በሙያተኞች አንደበት |ጤና ይስጥልኝ by JTV Ethiopia 2 years ago 49 minutes 1,363 views",JTV Ethiopia,1363,1365,2
2943,"ሀዋሳ ቴያትር እያሳየን ቦንብ ተወርውሮብናል | ሽመልስ አበራ (ጆሮ) by JTV Ethiopia 2 years ago 24 minutes 18,696 views",JTV Ethiopia,18696,18697,1
2944,"ከ 30 ዓመት በኃላ የተገናኙት ቤተሰቦች ክፍል 2 by JTV Ethiopia 2 years ago 33 minutes 143,242 views",JTV Ethiopia,143242,143343,101
2945,"ከ 30 ዓመት በኃላ የተለያዩት ቤተሰቦች ተገናኙ ክፍል 1 by JTV Ethiopia 2 years ago 21 minutes 158,246 views",JTV Ethiopia,158246,158331,85
2946,"ወ/ሮ ዘሚ የኑስ እና ስራዎቻቸው | ጤና ይስጥልኝ by JTV Ethiopia 2 years ago 50 minutes 4,848 views",JTV Ethiopia,4848,4850,2
2947,"ቲያትረኞች በትያትረኛ ተበልጠናል |ሽመልስ አበራ (ጆሮ) by JTV Ethiopia 2 years ago 25 minutes 73,681 views",JTV Ethiopia,73681,73686,5
2948,"አንድ የሀገራችን ሚንስትር በግልፅ እንደማልፈራቸው ተናግሬአቸዋለሁ by JTV Ethiopia 2 years ago 20 minutes 41,879 views",JTV Ethiopia,41879,41881,2
2949,"“ማሪኝ”  የሚለውን ቲያትር ኃየሎም አርአያ እንዳናሳይ አርጎናል |ሽመልስ አበራ (ጆሮ) by JTV Ethiopia 2 years ago 22 minutes 77,298 views",JTV Ethiopia,77298,77301,3
2950,"በእኛ ቤተሰብ ውስጥ 5ኛ ልጆች ተዋናዮች ናቸው |ሽመልስ አበራ (ጆሮ) by JTV Ethiopia 2 years ago 17 minutes 81,027 views",JTV Ethiopia,81027,81035,8
2951,"ጅግጅግጋ ሁለት ቀን አልጋ ስር ተደብቄአለሁ by JTV Ethiopia 2 years ago 13 minutes, 15 seconds 82,932 views",JTV Ethiopia,82932,82952,20
2952,"ከቴዲ አፍሮ ጋር በተያያዘ ጉዳይ ከድንጋይ አምልጫለሁ by JTV Ethiopia 2 years ago 12 minutes, 44 seconds 192,806 views",JTV Ethiopia,192806,192889,83
2953,"የአርቲስቱን ድካም ከንቱ የሚያደርጉ ፕሮዲውሰሮች አሉ by JTV Ethiopia 2 years ago 12 minutes, 42 seconds 51,805 views",JTV Ethiopia,51805,51838,33
2954,"ግጥምና ዜማ በመሸጥ ላይ እገኛለሁ by JTV Ethiopia 2 years ago 11 minutes, 1 second 20,657 views",JTV Ethiopia,20657,20659,2
2955,"ለነዋይ ብር ለመክፈል ስል ቤቴን ሸጫለሁ by JTV Ethiopia 2 years ago 15 minutes 125,120 views",JTV Ethiopia,125120,125135,15
2956,"በማላውቀው ሁኔታ ናይት ክለብ እየሰራሁ ደህንነቶች ይዘውኝ ወጣሁ by JTV Ethiopia 2 years ago 19 minutes 57,850 views",JTV Ethiopia,57850,57858,8
2957,"ስልጣን ላይ ያሉ ሰዎች ያሳዝኑኛል ጉልበት ያላቸው አይመስለኝም by JTV Ethiopia 2 years ago 24 minutes 76,839 views",JTV Ethiopia,76839,76868,29
2958,"50% የአይሁድ ዘር አለብኝ by JTV Ethiopia 2 years ago 19 minutes 87,100 views",JTV Ethiopia,87100,87128,28
2959,"ኢሕአዴጎች ደርግን ጥለው መንግስት እንደሚሆኑ ተነግሯቸው ነበር by JTV Ethiopia 2 years ago 20 minutes 89,536 views",JTV Ethiopia,89536,89570,34
2960,"በትንቢት ከተጋባህ በትንቢት ይፈርሳል by JTV Ethiopia 2 years ago 26 minutes 277,831 views",JTV Ethiopia,277831,278032,201
2961,"በጣምም አልተደመርኩም በጣምም አልተቀነስኩም by JTV Ethiopia 2 years ago 1 minute, 48 seconds 15,439 views",JTV Ethiopia,15439,15440,1
2962,"ገስት ሀውስ ተከራይተው ህዝቡን ይዘርፉታል by JTV Ethiopia 2 years ago 16 minutes 121,423 views",JTV Ethiopia,121423,121462,39
2963,"ቁልቢ ገብርኤል ነው የተጠመኩት እና ክርስትና የተነሳሁት by JTV Ethiopia 2 years ago 20 minutes 118,063 views",JTV Ethiopia,118063,118099,36
2964,"የፕሮፌሰር አስራት ወልደየስ ተማሪ ነኝ ዶ/ር ወዳጄነህ መሃረነ by JTV Ethiopia 2 years ago 22 minutes 163,827 views",JTV Ethiopia,163827,163945,118
2965,"በቂ ዕውቀት የሌላቸው ሰዎች በሠራተኞቼ ላይ ሽብር እየነዙ ነው አለ ኢትዮ-ቴሌኮም by JTV Ethiopia 2 years ago 3 minutes, 20 seconds 8,382 views",JTV Ethiopia,8382,8384,2
2966,"ከዶ/ር ወዳጄነህ መሃረነ ጋር የተደረገ ልዩ ቆይታ በ ጆሲ ኢን ዘ ሀውስ ሾው እሁድ ምሽት 2፡00 ሰዓት ይጠብቁን by JTV Ethiopia 2 years ago 1 minute, 54 seconds 19,848 views",JTV Ethiopia,19848,19858,10
2967,"መስቀልን በነቀምቴ ከተማ ኒው ጄኔሬሽን ዩንቨርሲቲ ኮሌጅ ከ ጄ ቴቪ ኢትዮጵያ ጋር በመተባበር የቀረበ by JTV Ethiopia 2 years ago 1 hour, 29 minutes 6,136 views",JTV Ethiopia,6136,6139,3
2968,"የኤሊያስ መልካ ያልተነገሩ ታሪኮች እና ስራዎች by JTV Ethiopia 2 years ago 1 minute, 48 seconds 4,416 views",JTV Ethiopia,4416,4419,3
2969,"ጠ/ሚ ዶ/ር አብይ አህመድ  የ 2019 የሰላም ኖቤል ሽልማትን ያሸነፉበት ዋና ዋና ምክንያቶች by JTV Ethiopia 2 years ago 7 minutes, 36 seconds 5,974 views",JTV Ethiopia,5974,5974,0
2970,"ልጄ ከጠፋብኝ 37 ዓመት ሆኖታል by JTV Ethiopia 2 years ago 4 minutes, 55 seconds 18,565 views",JTV Ethiopia,18565,18571,6
2971,"የእናቴን ቤተሰቦችን አፋልጉኝ by JTV Ethiopia 2 years ago 4 minutes, 4 seconds 11,791 views",JTV Ethiopia,11791,11797,6
2972,"13 ዓመት ሆነኝ ልጄን ካየኋት ጠፍታብኛለች by JTV Ethiopia 2 years ago 4 minutes, 30 seconds 9,446 views",JTV Ethiopia,9446,9449,3
2973,"ሁለት መንታ ልጆቼ ከጠፉ 15 ዓመት ሆነው ካላችሁበት ድምፃችሁን አሰሙኝ by JTV Ethiopia 2 years ago 8 minutes, 41 seconds 34,926 views",JTV Ethiopia,34926,34930,4
2974,"የኔ ቆንጆ ኑሪ እና የኔ ቢጫ ወባ ካስቂኝ ገጠመኞቻቸው ጋር by JTV Ethiopia 2 years ago 42 minutes 49,622 views",JTV Ethiopia,49622,49670,48
2975,"ፖለቲከኞቹ የርሃብ አድማ ልናደርግ ነው አሉ! by JTV Ethiopia 2 years ago 4 minutes, 13 seconds 2,620 views",JTV Ethiopia,2620,2620,0
2976,"ለድማፃዊ ሙላለም ታከለ የተደረገ ልዩ ሰርፕራይዝ ክፍል 2 by JTV Ethiopia 2 years ago 28 minutes 50,467 views",JTV Ethiopia,50467,50474,7
2977,"ለድማፃዊ ሙላለም ታከለ የተደረገ ልዩ ሰርፕራይዝ ከ ጤናይስጥልኝ ጋር ክፍል 1 by JTV Ethiopia 2 years ago 1 hour 40,166 views",JTV Ethiopia,40166,40170,4
2978,"ጄ ቴቪ አፋላጊ ሰርፕራይዝ  ከ 38 ዓመታት በኃላ አባት እና ልጅ ተገናኙ ክፍል 2 by JTV Ethiopia 2 years ago 35 minutes 209,882 views",JTV Ethiopia,209882,210053,171
2979,"ከ 38 ዓመታት በኃላ አባት እና ልጅ ተገናኙ ጄ ቴቪ አፋላጊ ሰርፕራይዝ ክፍል 1 by JTV Ethiopia 2 years ago 29 minutes 328,902 views",JTV Ethiopia,328902,329130,228
2980,"በሳቅ ፍርስ የሚያደርግ የአዲስ ዓመት ልዩ ቆይታ ከኮሜዲያን ካያሞ ጋር by JTV Ethiopia 2 years ago 20 minutes 9,812 views",JTV Ethiopia,9812,9817,5
2981,"የአዲስ ዓመት ልዩ ቆይታ ከመስፍን በቀለ፣ ቅድስት፣ እና አቤሴሎም ጋር by JTV Ethiopia 2 years ago 31 minutes 17,924 views",JTV Ethiopia,17924,17929,5
2982,"በጋራ ጥሩ መልዕክት ያለው ዘፈን ለመስራት ዝግጅት ላይ ነን ድምፃዊ አሸብር በላይ እና ድምፃዊት ምናሉሽ ረታ by JTV Ethiopia 2 years ago 39 minutes 23,009 views",JTV Ethiopia,23009,23014,5
2983,"እኔ በጣም ጎበዝ ከሚባሉ ድምፃውያን መካከል አንዱ ነኝ ድምፃዊ ኤሊያስ ተባባል by JTV Ethiopia 2 years ago 56 minutes 49,794 views",JTV Ethiopia,49794,49806,12
2984,"የጤናይስጥልኝ ልዩ የበዓል ሰርፕራይዝ ፕሮግራም ክፍል 3 by JTV Ethiopia 2 years ago 27 minutes 2,264 views",JTV Ethiopia,2264,2268,4
2985,"የዘመድ ጥየቃ ልዩ የአውዳመት ቆይታ ጆሲ ከፀሃፊትዕዛዝ አክሊሉ ሀ/ወልድ ቤተሰቦች ጋር ክፍል 3 by JTV Ethiopia 2 years ago 19 minutes 12,905 views",JTV Ethiopia,12905,12924,19
2986,"የዘመድ ጥየቃ ልዩ የአውዳመት ቆይታ ጆሲ ከፀሃፊትዕዛዝ አክሊሉ ሀ/ወልድ ቤተሰቦች ጋር ክፍል 2 by JTV Ethiopia 2 years ago 32 minutes 10,277 views",JTV Ethiopia,10277,10280,3
2987,"የጤናይስጥልኝ ልዩ የበዓል ሰርፕራይዝ ፕሮግራም ክፍል 2 by JTV Ethiopia 2 years ago 13 minutes, 37 seconds 6,180 views",JTV Ethiopia,6180,6181,1
2988,"የዘመድ ጥየቃ ልዩ የአውዳመት ቆይታ ጆሲ ከፀሃፊትዕዛዝ አክሊሉ ሀ/ወልድ ቤተሰቦች ጋር ክፍል 1 by JTV Ethiopia 2 years ago 32 minutes 45,085 views",JTV Ethiopia,45085,45086,1
2989,"ህዝብ በተሰበሰበበት አስለቃሽ ጭስ እየተኮሱ ህዝብ በተሰበሰበበት ሲጋራ አታጭሱ ይሉናል ትዝብት ከእንዳልክ ጋር by JTV Ethiopia 2 years ago 1 hour, 29 minutes 46,647 views",JTV Ethiopia,46647,46657,10
2990,"የዘመድ ጥየቃ ልዩ የአውዳመት ቆይታ ጆሲ ከድምፃዊ በኃይሉ እሸቴ ቤተሰቦች ጋር by JTV Ethiopia 2 years ago 37 minutes 44,829 views",JTV Ethiopia,44829,44835,6
2991,"ጆሲ ከአስፋው እና  ሊቀ-ትጉሃን ደረጄ ጋር አስደሳች የበዓል ቆይታ ክፍል 3 by JTV Ethiopia 2 years ago 45 minutes 27,549 views",JTV Ethiopia,27549,27549,0
2992,"የጤናይስጥልኝ ልዩ የበዓል ሰርፕራይዝ ፕሮግራም ክፍል 1 by JTV Ethiopia 2 years ago 37 minutes 8,541 views",JTV Ethiopia,8541,8541,0
2993,"አስደናቂ የዋዜማ ዝግጅት ጆሲ ከዘቢባ እና ፍቅሩ ጋር ክፍል 2 by JTV Ethiopia 2 years ago 37 minutes 67,265 views",JTV Ethiopia,67265,67267,2
2994,"አስደናቂ የዋዜማ ዝግጅት ጆሲ ከነ ዘቢባ፣ ፍቅሩ፣አስፋው፣ እንዲሁም ሊቀ-ትጉሃን ደረጄ ጋር ክፍል 1 by JTV Ethiopia 2 years ago 35 minutes 59,923 views",JTV Ethiopia,59923,59950,27
2995,"ልዩ የዓውዳመት ዝግጅት በተከበሩ ሐኪም አበበች መኖሪያ ቤት - አንድሮሜዳ በጄ ቴቪ by JTV Ethiopia 2 years ago 43 minutes 18,317 views",JTV Ethiopia,18317,18360,43
2996,"የዘመድ ጥየቃ ልዩ የአውዳመት ቆይታ ጆሲ ከጋዜጠኛ፣ደራሲ እና ሀያሲ አቶ አክበር ፈሪድ ቤተሰቦች ጋር  ክፍል 2 by JTV Ethiopia 2 years ago 17 minutes 28,396 views",JTV Ethiopia,28396,28398,2
2997,"የዘመድ ጥየቃ ልዩ የአውዳመት ቆይታ ጆሲ ከጋዜጠኛ፣ደራሲ እና ሀያሲ አቶ አክበር ፈሪድ ቤተሰቦች ጋር  ክፍል 1 by JTV Ethiopia 2 years ago 27 minutes 31,150 views",JTV Ethiopia,31150,31151,1
2998,"የዘመድ ጥየቃ ልዩ የአውዳመት ቆይታ ጆሲ ከመራኢጥበብ እዩኤል ዮሐንስ ቤተሰቦች by JTV Ethiopia 2 years ago 24 minutes 30,834 views",JTV Ethiopia,30834,30839,5
2999,"የዘመድ ጥየቃ ልዩ የአውዳመት ቆይታ ጆሲ ከኮሜዲያን አለባቸው ተካ ልጅ እስራኤል አለባቸው ጋር by JTV Ethiopia 2 years ago 25 minutes 133,879 views",JTV Ethiopia,133879,133965,86
3000,"የእናት እና ልጅ ፍቅር ከ24 ዓመት በኃላ በጄቴቪ አፋላጊ የአውዳመት ሰርፕራይዝ  ላይ ክፍል 2 by JTV Ethiopia 2 years ago 22 minutes 245,318 views",JTV Ethiopia,245318,245488,170
3001,"የእናት እና ልጅ ፍቅር ከ24 ዓመት በኃላ በጄቴቪ አፋላጊ የአውዳመት ሰርፕራይዝ  ላይ ክፍል 1 by JTV Ethiopia 2 years ago 22 minutes 289,528 views",JTV Ethiopia,289528,289678,150
3002,"Jossy in z house lአስደሳች የዋዜማ ፕሮግራም  በጆሲ ኢን ዘ ሐውስ ሾው ክፍል 1 by JTV Ethiopia 2 years ago 29 minutes 93,823 views",JTV Ethiopia,93823,93826,3
3003,"Jossy in z house lአስደሳች የዋዜማ ፕሮግራም  ጆሲ ከተስፋዬ እና በላይ በቀለ ወያ ጋር  ክፍል 2 by JTV Ethiopia 2 years ago 34 minutes 58,138 views",JTV Ethiopia,58138,58153,15
3004,"Jossy in z house lአስደሳች የዋዜማ ፕሮግራም  ጆሲ ከ ቱ ፓክ እና ናርዶስ ጋር ክፍል 3 by JTV Ethiopia 2 years ago 31 minutes 177,376 views",JTV Ethiopia,177376,177645,269
3005,"ጆሲ ኢንዘሃውስ ሾው የ2012 ዓ.ም አዲስ አመት ልዩ ''የዘመድ ጥየቃ'' ፕሮግራም መስከረም አንድ ቀን ይጠብቁን by JTV Ethiopia 2 years ago 4 minutes, 40 seconds 67,338 views",JTV Ethiopia,67338,67342,4
3006,"''ስዕል እና እንቁጣጣሽ'' የአዲስ አመት ልዩ ፕሮግራም በጄቲቪ ኢትዮጵያ by JTV Ethiopia 2 years ago 2 minutes, 1 second 10,773 views",JTV Ethiopia,10773,10776,3
3007,"ጆሲ ኢንዘሃውስ ሾው የ2012 ዓ.ም አዲስ አመት ልዩ የዋዜማ ፕሮግራም by JTV Ethiopia 2 years ago 2 minutes, 49 seconds 31,556 views",JTV Ethiopia,31556,31561,5
3008,"ጆሲ ኢንዘሃውስ ሾው የ2012 ዓ.ም አዲስ አመት ልዩ የዘመድ ጥየቃ ፕሮግራም መስከረም አንድ ቀን ይጠብቁን by JTV Ethiopia 2 years ago 5 minutes, 54 seconds 138,902 views",JTV Ethiopia,138902,138908,6
3009,"ጄቲቪ አፋላጊ 2012ዓ.ም የአዲስ አመት ልዩ ፕሮግራም መስከረም 1 እንዳያመልጣችሁ by JTV Ethiopia 2 years ago 2 minutes, 48 seconds 120,386 views",JTV Ethiopia,120386,120412,26
3010,"''ኢየሱስ ክርስቶስ ኢትዮጵያ ውስጥ ሶስት አመት ኖሯል፡፡'' ፕሮፌሰር ፍቅሬ ቶሎሳ by JTV Ethiopia 2 years ago 24 minutes 8,070 views",JTV Ethiopia,8070,8091,21
3011,"አማራና ኦሮሞ አንድ አይነት ሳይሆን አንድ ቤተሰብ ናቸው፡፡ ፕሮፌሰር ፍቅሬ ቶሎሳ by JTV Ethiopia 2 years ago 17 minutes 3,135 views",JTV Ethiopia,3135,3141,6
3012,"እኔ የምታገለው ለኢትዮጵያዊያን መብት እና ደህንነት ሰላም ነው:: ፕሮፌሰር ፍቅሬ ቶሎሳ by JTV Ethiopia 2 years ago 13 minutes, 23 seconds 2,308 views",JTV Ethiopia,2308,2308,0
3013,"በአሜሪካ ከ28 ዓመት በፊት የመጀመሪያውን የአማረኛ የቴሌቪዥን ፕሮግራም  የጀመርኩት እኔ ነኝ:: ፕሮፌሰር ፍቅሬ ቶሎሳ by JTV Ethiopia 2 years ago 14 minutes, 1 second 1,961 views",JTV Ethiopia,1961,1962,1
3014,"ትዝብት ከእንዳልክ ጋር የአዲስ አመት ዘመን መለወጫ ልዩ ፕሮግራም by JTV Ethiopia 2 years ago 2 minutes, 43 seconds 35,612 views",JTV Ethiopia,35612,35617,5
3015,"ልጄ ኤርትራ አሰብ እንደታሰረ ነው ጥየው የመጣሁት by JTV Ethiopia 2 years ago 17 minutes 7,800 views",JTV Ethiopia,7800,7805,5
3016,"ጤና ይስጥልኝ በጄቲቪ ኢትዮጵያ ልዩ የአዲስ አመት/ዘመን መለወጫ/ ፕሮግራም by JTV Ethiopia 2 years ago 2 minutes, 53 seconds 20,792 views",JTV Ethiopia,20792,20794,2
3017,"አባቴ በህይዎት ካለህ እባክህ አይንህን እንየው ልጆችህ by JTV Ethiopia 2 years ago 21 minutes 24,950 views",JTV Ethiopia,24950,24962,12
3018,"''የብሄራዊ ቡድን ምርጫ ሲካሄድ ኢትዮጲያዊ ነኝ ወይስ አይደለሁም ብዬ ፓስፖርቴን አያለሁ'' ዳዊት እስጢፋኖስ by JTV Ethiopia 2 years ago 48 minutes 4,164 views",JTV Ethiopia,4164,4164,0
3019,"Jossy in The House Show Interview with Fikre Tolossa part E by JTV Ethiopia 2 years ago 26 minutes 4,488 views",JTV Ethiopia,4488,4504,16
3020,"ሰካራሙ ታዬ የድሬዳዋው ገጸባህሪ by JTV Ethiopia 2 years ago 20 minutes 4,091 views",JTV Ethiopia,4091,4091,0
3021,"ወንድሜ ከአመታት በፊት ጅግጅጋ አካባቢ አለ ስባል ነበር by JTV Ethiopia 2 years ago 16 minutes 11,044 views",JTV Ethiopia,11044,11046,2
3022,"Jtv Afalagi ወንድሜን ከ1960ዓ.ም በኋላ አይቼው አላውቅም ተስፋም አልቆረጥኩም by JTV Ethiopia 2 years ago 17 minutes 22,865 views",JTV Ethiopia,22865,22874,9
3023,"የሻደይ ፤ አሸንድዬ እና ሶለል በዓል አከባበር በሚሊየም አዳራሽ by JTV Ethiopia 2 years ago 14 minutes, 59 seconds 50,244 views",JTV Ethiopia,50244,50282,38
3024,"''አሜሪካኖች ኢትዮጵያን እንድሰልልላቸው ጠይቀውኝ ነበር'' Jossy in The House Show Interview with Fikre Tolossa part C by JTV Ethiopia 2 years ago 13 minutes, 34 seconds 30,800 views",JTV Ethiopia,30800,30800,0
3025,"Jossy in The House Show Interview with Fikre Tolossa part B by JTV Ethiopia 2 years ago 14 minutes, 38 seconds 11,438 views",JTV Ethiopia,11438,11442,4
3026,"Jossy in The House Show Interview with /professor/ Fikre Tolossa part A by JTV Ethiopia 2 years ago 18 minutes 16,439 views",JTV Ethiopia,16439,16448,9
3027,"''ከአራት ወንዶች አንዱ በትዳሩ ላይ ይማግጣል'' አበስኩ ገበርኩ ትዝብት ከእንዳልክ ጋር by JTV Ethiopia 2 years ago 54 minutes 41,742 views",JTV Ethiopia,41742,41785,43
3028,"Jossy In Z House Show Interview with Artist Tsegaye Esetu  [archive] by JTV Ethiopia 2 years ago 1 hour, 1 minute 13,302 views",JTV Ethiopia,13302,13305,3
3029,"Jtv Music Yedenekachew Geleta ''የገጠር ሎሚ'' - BURNT FACES  (Cover Song ) by JTV Ethiopia 2 years ago 4 minutes, 34 seconds 35,909 views",JTV Ethiopia,35909,36037,128
3030,"Jtv Music የማርያም ቸርነት ''ተሳሳተኝኮ'' Tessassategn eko - BURNT FACES ft. YEMI (Cover Song ) by JTV Ethiopia 2 years ago 4 minutes, 8 seconds 10,710 views",JTV Ethiopia,10710,10846,136
3031,"Jtv Music Yedenekachew Geleta ''የገጠር ሎሚ'' - BURNT FACES  (Cover Song ) by JTV Ethiopia 2 years ago 4 minutes, 34 seconds 3,095 views",JTV Ethiopia,3095,3103,8
3032,"Jtv Music የማርያም ቸርነት ''ተሳሳተኝኮ'' Tessassategn eko - BURNT FACES ft. YEMI (Cover Song ) by JTV Ethiopia 2 years ago 4 minutes, 8 seconds 5,272 views",JTV Ethiopia,5272,5273,1
3033,"አንድሮሜዳ የጀመረበት የአንደኛ አመት አከባበር መርሃግብርና የአንድሮሜዳ መጽሃፍ ምረቃ ዝግጅት በግራንድ ኤሊያና ሆቴል by JTV Ethiopia 2 years ago 57 minutes 9,483 views",JTV Ethiopia,9483,9483,0
3034,"የማያልቅ የህዝብ ጥያቄ እና ህዝባዊነት የተጠናዎተው መንግስት ትዝብት ከእንዳልክ ጋር by JTV Ethiopia 2 years ago 1 hour, 1 minute 14,102 views",JTV Ethiopia,14102,14102,0
3035,"የአጼ ሃይለስላሴ የዱባይ ጉብኝት ''አረብ ውጣ ነገር ሳታመጣ '' by JTV Ethiopia 2 years ago 20 minutes 24,636 views",JTV Ethiopia,24636,24640,4
3036,"የኢትዮጵያዊያን የአረብ ሃገራት ትርፍ አልባ ስደትና አስከፊ ታሪክ by JTV Ethiopia 2 years ago 17 minutes 12,617 views",JTV Ethiopia,12617,12621,4
3037,"የሃበሾች ክብርና ሞገስ በእስልምና ፕሮፌሰር አደም ካሚል by JTV Ethiopia 2 years ago 16 minutes 11,823 views",JTV Ethiopia,11823,11842,19
3038,"የኢትዮጵያው Gangnam style Jacky Gosee by JTV Ethiopia 2 years ago 51 minutes 109,647 views",JTV Ethiopia,109647,109652,5
3039,"አሰቃቂ የመኪና አደጋዎች በኢትዮጵያ Jossy in Z House Interview with Assistant Inspector Assefa Mezgebu 1 by JTV Ethiopia 2 years ago 50 minutes 7,673 views",JTV Ethiopia,7673,7675,2
3040,"''የተወለድኩት በአንበጣው ዘመን ነው'' ፕሮፌሰር አደም ካሚል by JTV Ethiopia 2 years ago 20 minutes 37,044 views",JTV Ethiopia,37044,37049,5
3041,"''እስልምናን የሚያስገድዱ የቅዱስ ቁርዓንን ህግ የጣሱ ናቸው የፈለገ ብቻ ይመን አታስገድደው'' ፕሮፌሰር አደም ካሚል by JTV Ethiopia 2 years ago 15 minutes 35,551 views",JTV Ethiopia,35551,35553,2
3042,"ይህንን ያውቁ ኑሯል? ''የነብዩ መሃመድ አሳዳጊ  እናት ኢትዮጵያዊ ናቸው '' ፕሮፌሰር አደም ካሚል by JTV Ethiopia 2 years ago 20 minutes 61,424 views",JTV Ethiopia,61424,61437,13
3043,"''የታሪክ ጸኃፊ ሰዎች እንደሚሉት ቢላል ጥቁር አይደለም ጠይም እንጂ'' ፕሮፌሰር አደም ካሚል by JTV Ethiopia 2 years ago 19 minutes 58,226 views",JTV Ethiopia,58226,58232,6
3044,"''ሙስሊም እንዳይማር ገደብ ተጥሎበት ነበር'' ፕሮፌሰር አደም ካሚል by JTV Ethiopia 2 years ago 11 minutes, 53 seconds 20,568 views",JTV Ethiopia,20568,20576,8
3045,"እህቴ አዲስ አበባ መጥታ ከጠፋች ሃያ አመት ሆኗታል እህቴ እናትሽን በህይዎት እያለች እያት by JTV Ethiopia 2 years ago 19 minutes 39,616 views",JTV Ethiopia,39616,39650,34
3046,"''ወንድሜ ያሲን ከማል እናቴ በጣም እየናፈቀችህ ነው እባክህ በህይዎት ካለህ ያለህበትን አሳውቀን'' by JTV Ethiopia 2 years ago 17 minutes 17,124 views",JTV Ethiopia,17124,17129,5
3047,"ጄቲቪ አፋላጊ ልዩ የአረፋ በዓል ሰርፕራይዝ by JTV Ethiopia 2 years ago 14 minutes, 14 seconds 102,509 views",JTV Ethiopia,102509,102546,37
3048,"''ልጄን ያየ አደራ እዚህ ነው ይበለኝ'' ልጃቸውን ፈላጊ እናት ለተሚካኤል ነጋሽ by JTV Ethiopia 2 years ago 15 minutes 19,699 views",JTV Ethiopia,19699,19719,20
3049,"ከልጄ ጋር ጊዜ ነው ያለያን ጊዜ ያገናኘን by JTV Ethiopia 2 years ago 17 minutes 9,209 views",JTV Ethiopia,9209,9212,3
3050,"ታናሽ ወንድሜ አብዱል ናስር በአጋጣሚ ከቤት እንደወጣ አልተመለሰም by JTV Ethiopia 2 years ago 15 minutes 49,194 views",JTV Ethiopia,49194,49205,11
3051,"ጤና ይስጥልን በጄቲቪ ኢትዮጵያ የምግብ አምራቶች ፈቃድ አሰጣጥ እና አመራረት ጥንቃቄ by JTV Ethiopia 2 years ago 52 minutes 3,020 views",JTV Ethiopia,3020,3020,0
3052,"አራት ህጻናትን የደፈረው የ81 ዓመቱ አዛውንት እና ኢትዮጵያን አስገድደው የደፈሩ ትዝብት ከእንዳልክ ጋር by JTV Ethiopia 2 years ago 48 minutes 18,078 views",JTV Ethiopia,18078,18084,6
3053,"ንግስት ኢተያ ክፍል ሁለት by JTV Ethiopia 2 years ago 8 minutes, 25 seconds 26,788 views",JTV Ethiopia,26788,26806,18
3054,"የማትቆረጥበት ደምህ የማስፍልግበት የህክምና ጥበብ ያለባት ሃገር ናት ኢትዮጵያ by JTV Ethiopia 2 years ago 13 minutes, 42 seconds 107,858 views",JTV Ethiopia,107858,107919,61
3055,"ብዙ ኢትዮጵያዊያን የማውቋት አስገራሚዋ የኢትዮጵያ ንግስት ፤ ንግስት ኢተያ by JTV Ethiopia 2 years ago 13 minutes, 58 seconds 41,777 views",JTV Ethiopia,41777,41804,27
3056,"የልጄን አባት ያያችሁ ልጁህ ይፈልግሃል በሉልኝ by JTV Ethiopia 2 years ago 18 minutes 85,618 views",JTV Ethiopia,85618,85663,45
3057,"ልጄ አለማየሁ በ1985 ዓ.ም ድንገት ጥዋት ቁርሱን በልቶ ከቤት እንደወጣ የውሃሽታ ሆነ by JTV Ethiopia 2 years ago 20 minutes 20,204 views",JTV Ethiopia,20204,20214,10
3058,"ኢትኤል ኢትዮጵያዊው ንጉስ እና አስገራሚ የጥንታዊያን ነገስታት የ6 ሺህ አመታት ታሪክ by JTV Ethiopia 2 years ago 24 minutes 31,681 views",JTV Ethiopia,31681,31781,100
3059,"ኢትኤል ኢትዮጵያዊው ንጉስ እና አስገራሚ የጥንታዊያን ነገስታት የ6 ሺህ አመታት ታሪክ by JTV Ethiopia 2 years ago 19 minutes 26,902 views",JTV Ethiopia,26902,26983,81
3060,"አቦ ሰላም ስጡን ትዝብት ከእንዳልክ ጋር by JTV Ethiopia 2 years ago 45 minutes 28,505 views",JTV Ethiopia,28505,28509,4
3061,"የሃገር ፍቅር 84ኛ አመት ምስረታ በአክራሞት ፕሮግራም by JTV Ethiopia 2 years ago 59 minutes 7,962 views",JTV Ethiopia,7962,7964,2
3062,"መደናነቅ ፤ መተዋወቅ ፤ፍቅር እስከ ትዳር ሁለቱ ዝነኞች ብጽአት ስዩምና ተስፋዬ ገ/ሃና by JTV Ethiopia 2 years ago 14 minutes, 9 seconds 119,221 views",JTV Ethiopia,119221,119226,5
3063,"ድንገተኛው የአውስትራሊያ ኑሮ ሚስጥር አርቲስት ተስፋዬ ገ/ሃና by JTV Ethiopia 2 years ago 14 minutes, 38 seconds 45,612 views",JTV Ethiopia,45612,45615,3
3064,"ማንም ስለተማረ የቲያትር ሰው አይሆንም አርቲስት ተስፋዬ ገ/ሃና by JTV Ethiopia 2 years ago 14 minutes, 15 seconds 19,491 views",JTV Ethiopia,19491,19491,0
3065,"ቲያትር እንደ እግር ኳስ ጭዋታ ነው አርቲስት ተስፋዬ ገ/ሃና by JTV Ethiopia 2 years ago 15 minutes 19,105 views",JTV Ethiopia,19105,19106,1
3066,"መላኩ አሻግሬ እና አዝናኝ ስራዎቹ ተጓዥ ቲያትር by JTV Ethiopia 2 years ago 15 minutes 21,293 views",JTV Ethiopia,21293,21293,0
3067,"Jossy in the House interview with Artist Tesfaye Gebrehana by JTV Ethiopia 2 years ago 16 minutes 35,770 views",JTV Ethiopia,35770,35776,6
3068,"ድንጋይ የሚያቀልጥ አስደናቂ ማዕድን በኢትዮጵያ ውስጥ ብቻ-ሀኪም አበበች ሽፈራው -አንድሮሜዳ by JTV Ethiopia 2 years ago 41 minutes 383,685 views",JTV Ethiopia,383685,384239,554
3069,"እናቴ ሰባት ወልዳ ሁለት ነን የቀረነው by JTV Ethiopia 2 years ago 17 minutes 15,779 views",JTV Ethiopia,15779,15783,4
3070,"ታህሳስ 26/1983 ዓ.ም የወንድሜ ልጅ ከቤት እንደወጣች አልተመለሰችም by JTV Ethiopia 2 years ago 22 minutes 13,084 views",JTV Ethiopia,13084,13086,2
3071,"ኮንዶሚኒየም እና ጽዳት ትዝብት ከእንዳልክ ጋር በጄቲቪ ኢትዮጵያ by JTV Ethiopia 2 years ago 39 minutes 18,676 views",JTV Ethiopia,18676,18691,15
3072,"ኢትዮጵያ አትፈርስም by JTV Ethiopia 2 years ago 9 minutes, 16 seconds 8,462 views",JTV Ethiopia,8462,8466,4
3073,"ጉዞ ወደ ሀገር ቤት Jossy in Z House Show interview with Artist Berhanu Tezera part 2 /E by JTV Ethiopia 2 years ago 9 minutes, 46 seconds 15,044 views",JTV Ethiopia,15044,15049,5
3074,"Ethiopian : በኢትዮ-ኤርትራ ጦርነት የተማረኩ የኢትዮጵያ ታዳጊ ወጣቶች በኤርትራ፡፡ by KanaTunes 3 years ago 10 minutes, 27 seconds 9,461 views",KanaTunes,9461,9548,87
3075,"Ethiopian: ኢትዮጵያ በክብር ለዘላለም ትኑር፡፡ by KanaTunes 4 years ago 5 minutes, 51 seconds 720 views",KanaTunes,720,728,8
3076,"Ethiopian : Ejigayehu Shibabaw- Eyedalew Felega | ጂጂ - እሄዳለው ፍለጋ - New Ethiopian Music 2018 by KanaTunes 4 years ago 3 minutes, 41 seconds 26,797 views",KanaTunes,26797,26860,63
3077,"Ethiopian  : Gedion Daniel - Libeluat Asebew | ጌድዮን ዳንኤል  - ሊበሉዋት አስበው - New Ethiopian Music 2018 by KanaTunes 4 years ago 6 minutes, 50 seconds 35,492 views",KanaTunes,35492,35574,82
3078,"Ethiopian : Jano Band - Keteraraw Mado | ጃኖ ባንድ - ከተራራው ማዶ  - New Ethiopian Music 2018 by KanaTunes 4 years ago 6 minutes, 37 seconds 40,750 views",KanaTunes,40750,40954,204
3079,"Ethiopian : Jano Band - Shegye | ጃኖ ባንድ - ሸግዬ - New Ethiopian Music 2018 by KanaTunes 4 years ago 4 minutes, 25 seconds 168,636 views",KanaTunes,168636,168722,86
3080,StayTuned With US! by KanaTunes 4 years ago 13 seconds 126 views,KanaTunes,126,128,2
3081,"Ethiopian : Jano Band - Zew Zew | ጃኖ ባንድ - ዘው ዘው - New Ethiopian Music 2018 by KanaTunes 4 years ago 4 minutes, 4 seconds 30,097 views",KanaTunes,30097,30102,5
3082,"Ethiopian : አሳ በፆም ይበላል ወይስ አይበላም? ከዲያቆን ዳንኤል ክብረት የተሰጠ መልስ by KanaTunes 4 years ago 5 minutes, 9 seconds 2,920 views",KanaTunes,2920,3255,335
3083,"Ethiopian - Lij Michael Faf |  ልጅ ሚካኤል  - Workezebo | ወርቀዘቦ - New Single Ethiopian Music 2017 by KanaTunes 4 years ago 4 minutes, 10 seconds 4,303 views",KanaTunes,4303,4332,29
3084,Kanatunes Into - Stay Tuned! for coming new videos by KanaTunes 4 years ago 9 seconds 194 views,KanaTunes,194,195,1
3085,"Ethiopian Abebe Teka : Meche new | አበበ ተካ ፡ መቼ ነው  | መታሰቢያነቱ ቆሼ በሚባለው አካባቢ ሕይወታቸውን ላጡ 2017 by KanaTunes 4 years ago 6 minutes, 39 seconds 7,575 views",KanaTunes,7575,7587,12
3086,"Ethiopian Zeritu Kebede : Weshetam | ዘሪቱ ከበደ : ውሸታም Ethiopian Music Video 2017 by KanaTunes 4 years ago 5 minutes, 31 seconds 17,329 views",KanaTunes,17329,17353,24
3087,"Ethiopian የአድዋ ድል በማስመልከት ሚኒሊክ አደባባይ ወጣቶች ያቀረቡት ሽለላ 2017 by KanaTunes 4 years ago 5 minutes, 44 seconds 6,641 views",KanaTunes,6641,6643,2
3088,"Ethiopian Ejigayehu Shibabaw: Sew Argegne | እጅጋየው ሽባባው : ሰው አርገኝ  Ethiopian Music Video 2017 by KanaTunes 5 years ago 5 minutes, 31 seconds 186,665 views",KanaTunes,186665,187013,348
3089,"Ethiopian Nonstop Music Mix KanaTunes Presents New Ethiopian Music 2017 by KanaTunes 5 years ago 54 minutes 118,784 views",KanaTunes,118784,118850,66
3090,"Ethiopian Teddy Afro New : Fiker Eske Mekabir  | ቴዲ አፍሮ ፡ ፍቅር እስከ መቃብር   New Ethiopian Music  2017 by KanaTunes 5 years ago 4 minutes, 59 seconds 372,921 views",KanaTunes,372921,373017,96
3091,"Ethiopian Zeritu Kebede : Eza Alkerehum  | ዘሪቱ ከበደ : እዛ አልቀረሁም Ethiopian Music Video 2017 by KanaTunes 5 years ago 6 minutes, 14 seconds 11,856 views",KanaTunes,11856,11857,1
3092,"Ethiopian Tilahun Gessesse's : Yetelash Yetela  |  ጥላሁን ገሰሰ ፡ የጠላሽ ይጠላ  Ethiopian Music  2017 by KanaTunes 5 years ago 11 minutes, 11 seconds 8,108 views",KanaTunes,8108,8122,14
3093,"Ethiopian Abinet Girma : alqitar dawr hadidu  |  አብነት ግርማ  Ethiopian Music Video 2017 by KanaTunes 5 years ago 4 minutes, 56 seconds 6,698 views",KanaTunes,6698,6713,15
3094,"Ethiopian  Sami Dan | ሳሚ ዳን  - Kaleshe Anchi | ካለሽ አንቺ -  Ethiopian Music Lyric Video 2017 by KanaTunes 5 years ago 5 minutes, 3 seconds 218,894 views",KanaTunes,218894,224745,5851
3095,"Ethiopian Teddy Afro | ቴዲ አፍሮ  - በቴዲ አፍሮ የአልበም ከቨር ላይ የተሰጠ አስገራሚ ውይይት - በቴዎድሮስ ፀጋዬ - 2017 by KanaTunes 5 years ago 16 minutes 47,674 views",KanaTunes,47674,47693,19
3096,"Ethiopian Dan Admasu | ዳን አድማሱ  - Tadeye | ታድዬ  Lyric Video Ethiopian Music 2017 by KanaTunes 5 years ago 5 minutes, 32 seconds 14,353 views",KanaTunes,14353,14383,30
3097,"Ethiopian Eyob Mekonnen | እዮብ መኮንን - Man Yawkal | ማን ያውቃል - Lyric Video New Ethiopian Music 2017 by KanaTunes 5 years ago 5 minutes, 54 seconds 538,084 views",KanaTunes,538084,540018,1934
3098,"Ethiopian Eyob Mekonnen | እዮብ መኮንን - Libe Tenestual | ልቤ ተነስቷል - New Ethiopian Music 2017 by KanaTunes 5 years ago 4 minutes, 59 seconds 383,042 views",KanaTunes,383042,383578,536
3099,"Ethiopian Helen Berhe Feat: Lij Michael አስቀየምኩህ Official Audio by KanaTunes 5 years ago 4 minutes, 16 seconds 51,753 views",KanaTunes,51753,51763,10
3100,"Best Ethiopian HOT Music MIx 2016 KanaTunes Presents by KanaTunes 5 years ago 1 hour, 6 minutes 29,114 views",KanaTunes,29114,29179,65
3101,"Best Ethiopian HOT Music MIx Cultural and Modern  2016 KanaTunes Presents by KanaTunes 5 years ago 52 minutes 54,987 views",KanaTunes,54987,55065,78
3102,"Best Ethiopian HOT Music Collection Mix 2016 Kanatunes Presents by KanaTunes 5 years ago 1 hour, 22 minutes 219,177 views",KanaTunes,219177,219964,787
3103,"Endalkachew Yenehun - Abay Mado | አባይ ማዶ - New Ethiopian Music 2016 (Official Audio) by KanaTunes 5 years ago 5 minutes, 22 seconds 4,412 views",KanaTunes,4412,4431,19
3104,"Best Ethiopian Holiday Music Collection Mix 2016 Kanatunes Presents by KanaTunes 5 years ago 55 minutes 16,121 views",KanaTunes,16121,16127,6
3105,"Ethiopian Lij Micheal (faf) admired by DjPhat Su - Hagerem Endeh Ethiopian Music Video 2017 by KanaTunes 5 years ago 7 minutes, 38 seconds 422 views",KanaTunes,422,422,0
3106,"Best Ethiopian Music Collection Mix 2016 Kanatunes Presents by KanaTunes 5 years ago 1 hour, 12 minutes 135,962 views",KanaTunes,135962,136045,83
3107,"Sami Dan - Hoyahoye  - New Ethiopian Music 2016 (Official Audio) by KanaTunes 5 years ago 6 minutes, 37 seconds 27,986 views",KanaTunes,27986,27989,3
3108,"Eyayu Fungus (Girum Zenebe) _ Ethiopian Theater Comedy by KanaTunes 5 years ago 27 minutes 52,448 views",KanaTunes,52448,52491,43
3109,"LAZAR ALECO Medina መዲና Official video clip Tigrigna 2016 by KanaTunes 5 years ago 6 minutes, 41 seconds 144 views",KanaTunes,144,147,3
3110,"Heenok Kidaane - Uumamaa Simboo   Official Music Video   New Ethiopian Music 2016 by KanaTunes 5 years ago 4 minutes, 57 seconds 106 views",KanaTunes,106,108,2
3111,"Alemeye Getachew Weyene Alemeye   New Ethiopian Music 2016 Official Music Audio by KanaTunes 5 years ago 4 minutes, 56 seconds 2,366 views",KanaTunes,2366,2371,5
3112,"Bre Bright  Geday  Official Music Video -   New Ethiopian Music 2015 by KanaTunes 5 years ago 4 minutes, 18 seconds 219 views",KanaTunes,219,222,3
3113,PM Netanyahu Meets Ethiopian President Teshome Mulatu at the National palace by KanaTunes 5 years ago 47 seconds 120 views,KanaTunes,120,121,1
3114,"Brouk Rack ft Melaku Bireda   Gereገረ   New Ethiopian Music 2016 Official Video by KanaTunes 5 years ago 5 minutes, 17 seconds 655 views",KanaTunes,655,662,7
3115,"Ethiopian Music Fikir Yitagesu - Malina |  Official Music Video  New Music 2016 by KanaTunes 5 years ago 4 minutes, 50 seconds 33,062 views",KanaTunes,33062,33235,173
3116,"The funniest video ever by KanaTunes 5 years ago 8 minutes, 20 seconds 115 views",KanaTunes,115,115,0
3117,"Tita Begashaw Laughter Coach @ America's Got Talent 2016 by KanaTunes 5 years ago 3 minutes, 29 seconds 57 views",KanaTunes,57,57,0
3118,"ethiopian music Shewandagne Hailu Semta Yihon Ende  New  Music 2016 Official Video by KanaTunes 5 years ago 4 minutes, 46 seconds 264 views",KanaTunes,264,265,1
3119,"Ethiopian Music Mikiyas Nigussie Miki Lala  Wede Hagere  Official Video 2016 by KanaTunes 5 years ago 4 minutes, 54 seconds 347 views",KanaTunes,347,353,6
3120,"Ethiopian Music Nati Haile  Yetayshalwey -  Official Music Video   New Ethiopian Music 2016 by KanaTunes 5 years ago 6 minutes, 43 seconds 6,106 views",KanaTunes,6106,6131,25
3121,"Ethiopian Music Bezuayhu Demesse DEREBABA - ደርባባ  New Ethiopian Music 2016 by KanaTunes 5 years ago 5 minutes, 17 seconds 127 views",KanaTunes,127,128,1
3122,"Ethiopia music Berhanu Tezera -Yemanesh  New Ethiopian Music 2016 Official Video by KanaTunes 5 years ago 4 minutes, 27 seconds 284 views",KanaTunes,284,289,5
3123,"Ethiopian Music Bini Dana - Selamizm New Ethiopian Music 2015 Official Video by KanaTunes 5 years ago 5 minutes, 20 seconds 352 views",KanaTunes,352,352,0
3124,"Ethiopia Rahel Haile Welelay  ወለላይ  Official Music Video New Ethiopian Music 2015 by KanaTunes 5 years ago 6 minutes, 44 seconds 6,839 views",KanaTunes,6839,6921,82
3125,"Ethiopian Music   Best KanaTunes Nonstop modern Music collection by KanaTunes 5 years ago 1 hour, 29 minutes 9,823 views",KanaTunes,9823,9856,33
3126,"Ethiopia Tadele Roba ft Ewolo Mazembo Serge  Tosishe   New Ethiopian Music 2016 Official Video by KanaTunes 5 years ago 5 minutes, 37 seconds 651 views",KanaTunes,651,652,1
3127,"Ethiopia  Rahel Haile   ሆ በላኒ ሆ Ho Belani   Best New Tigrigna Music 2014 by KanaTunes 5 years ago 6 minutes, 38 seconds 133,760 views",KanaTunes,133760,137849,4089
3128,"Tigist Belachew   ቆንጆ, Konjo   Best New Ethiopian Music 2014 by KanaTunes 5 years ago 6 minutes, 3 seconds 504,621 views",KanaTunes,504621,539313,34692
3129,"Ethiopian Music   Frehiwot Sleshi  -  Ezam Ezam  Official Music Video   New Ethiopian Music 2015 by KanaTunes 5 years ago 4 minutes, 52 seconds 1,083 views",KanaTunes,1083,1093,10
3130,"Ahmed Teshome Denbi   Betezetaw Feress   Official Music Video   NEW ETHIOPIAN MUSIC 2015 by KanaTunes 5 years ago 4 minutes, 41 seconds 3,548 views",KanaTunes,3548,3559,11
3131,"New Ethiopian Music 2016 Alemeye Getachew  | Washew Ende   Official Music Video by KanaTunes 5 years ago 6 minutes, 39 seconds 142 views",KanaTunes,142,143,1
3132,"Hot Ethiopian Hip Hop Rasselas ft  Nigstee   Eskista   ራሴላስ እስክስታ by KanaTunes 5 years ago 5 minutes, 7 seconds 3,621 views",KanaTunes,3621,3640,19
3133,"Ethiopian Movie Balager 2016 Full Movie  ባላገር ሙሉ ፊልም by KanaTunes 5 years ago 1 hour, 49 minutes 18,319 views",KanaTunes,18319,18338,19
3134,"The Untold History King ( Negus) of Ethiopia by KanaTunes 5 years ago 25 minutes 2,228 views",KanaTunes,2228,2229,1
3135,"ህጋዊ ጋብቻ  |  Hegawi Gabicha -  የልዑል ሰለሞን አዲስ ፊልም …   Ethiopian Movie Trailer 2016 by KanaTunes 5 years ago 1 minute, 3 seconds 7,119 views",KanaTunes,7119,7159,40
3136,"(ጎብለል) ኣብ መድረክ - ኤደን ገብረስላሴ Eden Gebreselasie Goblel - New Tigrigna Music Video 2022 by kebero Entertainment 10 days ago 5 minutes, 1 second 203 views",kebero Entertainment,203,241,38
3137,"Shmuye Brhane & mamit negash (ሰራሒ ታሪክ) - ሽሙየ ብርሃነ & ማሚት ነጋሽ (Official Audio) New Tigrigna Music 2022 by kebero Entertainment 3 weeks ago 4 minutes, 24 seconds 1,065 views",kebero Entertainment,1065,1150,85
3138,"(ድምፂ ውፁዓት) Ephirem Amare ""Eden Gebreselassie ""Amaniel yemane - New Tigrigna Music 2022 by kebero Entertainment 1 month ago 4 minutes, 8 seconds 509 views",kebero Entertainment,509,543,34
3139,ሽደን ኢካሞ ሽደንየ ከም ኣቦታትካ ሽደንየ ' ዝገርም ጓይላ ባህላዊ ጭራ ዘብራኣብሩክ  ገሬ እሙን ናሳዕስዑ by kebero Entertainment 1 month ago 21 minutes 196 views,kebero Entertainment,196,197,1
3140,"new tigray ፀጋሉኡል ሃይለማርያን - ኣብ ዓድዋ  በሎም | Tsegalu-ul H/Mariam - Belom _New Tigrigna Music by kebero Entertainment 1 month ago 10 minutes, 35 seconds 184 views",kebero Entertainment,184,185,1
3141,"መርከብን ማዕበልን ብሰለሙን ባይረ (Merkeb) solomun bayre new tigray tigrigna music 2022 by kebero Entertainment 1 month ago 7 minutes, 45 seconds 106 views",kebero Entertainment,106,106,0
3142,"ናይ እንኻዕ ኣብፀሐኩም መልእክቲ ከየንቲ ትግራይ""Girmay Haileslassie""Solomun bayre ""huluf alemu ""nuguse abadi wed iale by kebero Entertainment 1 month ago 28 minutes 176 views",kebero Entertainment,176,176,0
3143,"Rezene Teame (መተዓዛዘቢ) - ረዘነ ጠዓመ (Meteazazebi) New tigray Tigrigna Music! by kebero Entertainment 1 month ago 4 minutes, 30 seconds 338 views",kebero Entertainment,338,357,19
3144,"Shmuye Brhane (ታ ጉራዴኻ) ሹምየ ብርሃነ - ኣብ ሸራሮ ዝገርም ምርኢት ሙዚቃ by kebero Entertainment 1 month ago 8 minutes, 51 seconds 494 views",kebero Entertainment,494,661,167
3145,"ኪነትን ገድልን ተገዳላይ ሙቁር ወልዱ - Mukur Weldu Full Interview New Tigray Tigrigna Music by kebero Entertainment 1 month ago 7 minutes, 56 seconds 191 views",kebero Entertainment,191,193,2
3146,"Tiemtu Gebrehiwet (ወይነይ) ጥዕምቱ ገብረሂወት - Weyney - New Tigray Tigrigna music 2021 by kebero Entertainment 2 months ago 7 minutes, 41 seconds 907 views",kebero Entertainment,907,910,3
3147,"Kefey Hagos (ጓል'ወየንቲ) ከፈይ ሓጎስ (Gal weyenti)  - New Tigrigna Music 2021! by kebero Entertainment 2 months ago 5 minutes, 56 seconds 677 views",kebero Entertainment,677,682,5
3148,"Tewelde Yemane (ንፅናዕ) ተወልደ የማነ  (Ntsnae) - New Tigrigna Music 2021! (Official music) by kebero Entertainment 3 months ago 4 minutes, 2 seconds 972 views",kebero Entertainment,972,989,17
3149,"(የብለኒ'ሎ) Selamawit Yohannes - Yebleni'loo - on stage by kebero Entertainment 3 months ago 1 minute, 9 seconds 872 views",kebero Entertainment,872,877,5
3150,"ደርጊ ኢሉ  ግስም ኣብ ማእኸል ኣኽሱም ""ሰላማዊት ዮሃንስ - ኣብ መድረክ by kebero Entertainment 3 months ago 1 minute, 21 seconds 401 views",kebero Entertainment,401,402,1
3151,"ተጋዳላይ (መኳንንት መለሰ) ከ /ትግራይ ቲቪ ባደረገዉ ቆይታ ለ '' ታሪኩ ዲሽታ ጊና  አደነቀ  “ኣገው ፡ ትግራይ” by kebero Entertainment 3 months ago 3 minutes, 38 seconds 556 views",kebero Entertainment,556,579,23
3152,"(እምበር ተጋዳላይ) እፊሬም ኣማረ (ember tegadalay) - Ephrem Amare on stage - new tigray music tigrigna 2021 by kebero Entertainment 3 months ago 12 minutes, 30 seconds 3,044 views",kebero Entertainment,3044,3085,41
3153,"DW: ህጹጽ ዜና ዓወት ግንባር ሚለ - MI 35 ሄሊኮፕተር ነፋሪት ብTDF ተሓምሺሻ- ብመዳፍዕን ነፈርትን ተሰንዩ ናይ ሞትን ሕየትን by kebero Entertainment 3 months ago 1 minute, 44 seconds 250 views",kebero Entertainment,250,250,0
3154,"Nguse Abadi (ዘይሓልፍ የለን) ንጉሰ ኣባዲ (zeyhalef yelen) new tigray music tigrigna by kebero Entertainment 3 months ago 11 minutes, 54 seconds 3,287 views",kebero Entertainment,3287,3749,462
3155,"Winta Berhane (segeli) ዊንታ ብርሃነ (ሰግሊ) new tigray tigrigna music 2021 by kebero Entertainment 3 months ago 7 minutes, 20 seconds 1,407 views",kebero Entertainment,1407,1433,26
3156,"ሰላማዊት ዮዋሃንስ - ኣብ መድረኽ - On Stage Washington D.C by kebero Entertainment 3 months ago 11 minutes, 3 seconds 1,787 views",kebero Entertainment,1787,1787,0
3157,"Selamawit Yohannes (ሰላም ጥራይ) ኣብ መድረኽ  Tigray Tigrigna Music 2021 Washington D.C by kebero Entertainment 3 months ago 5 minutes, 37 seconds 12,855 views",kebero Entertainment,12855,12898,43
3158,"(ከሚሴ) ጅግና ሰራዊት ትግራይ በኣማራ ክልል የኦሮሞ ልዩ ዞን ዋና ከተማ የሆነችዉ የከሚሴ ከተማ ተቆጣጥረዋል by kebero Entertainment 3 months ago 1 minute, 21 seconds 190 views",kebero Entertainment,190,190,0
3159,"(ሒሳቡ ሃቦ) ሰለሞን ይኩኖኣምላክ - Solomon YikunoAmlak  (Hisabu Habo) New Tdf Tigray Tigrgna Music 2021 by kebero Entertainment 3 months ago 4 minutes, 32 seconds 4,541 views",kebero Entertainment,4541,4569,28
3160,"ሰበር መረጃ አስቸኳይ ግዜ አዋጅ ታወጀ | አዲስ አበባ ከነገ ጀምሮ ልትታመስ ነው by kebero Entertainment 3 months ago 8 minutes, 35 seconds 331 views",kebero Entertainment,331,331,0
3161,"ሰራዊት ትግራይ ምስ ነበርቲ ውጫለ  - ሰበይቲ ጅንታ እናበሉ እዮም ዝፀርፉኒ by kebero Entertainment 3 months ago 2 minutes, 46 seconds 131 views",kebero Entertainment,131,131,0
3162,"ሰበር ዜና ኦነግ ከሚሴ ተቆጻጺሮም #ኦነግ OLF  ሓደሽቲ ከተማታት ይቆጻጸር ኣሎ by kebero Entertainment 4 months ago 3 minutes, 31 seconds 130 views",kebero Entertainment,130,130,0
3163,"ሰበር ዜና (ደሴ) new tigray #tdf by kebero Entertainment 4 months ago 3 minutes, 19 seconds 198 views",kebero Entertainment,198,198,0
3164,"(ትግራይ ንኹሉ በዲሃ)  ድምፃዊ ተክለ ሃፍተ tigray nekulu bediha new tigrigna music 2021 by kebero Entertainment 4 months ago 4 minutes, 32 seconds 1,390 views",kebero Entertainment,1390,1448,58
3165,"(ይኾኖ) dawit nega - yekono  new tigray by kebero Entertainment 5 months ago 1 minute, 55 seconds 283 views",kebero Entertainment,283,290,7
3166,"Abrehet Abdu - hezebey ኣብረሀት ዓብድ (ህዝበይ)new tigrigna music 2021 by kebero Entertainment 6 months ago 5 minutes, 41 seconds 1,029 views",kebero Entertainment,1029,1043,14
3167,"(jegena) tekle hafet - ተኽለ ሃፍተ (ጅግና) - new tigrigna  tigray  music 2021 by kebero Entertainment 7 months ago 6 minutes, 46 seconds 451 views",kebero Entertainment,451,457,6
3168,"abraham gebremdehen { ኣምበሳ በረካ } ተጋዳላይ ድምፃዊ - ኣብራሃም ገብረመድህን - ትግርኛ ደርፉ new tigrigna music 2021 by kebero Entertainment 8 months ago 2 minutes, 50 seconds 25,373 views",kebero Entertainment,25373,25390,17
3169,"ephrem amare { ወረ ዝቐለቦም } - እፍሬም ኣማረ new tegrigna  tigray  music 2021 by kebero Entertainment 8 months ago 1 minute, 28 seconds 11,131 views",kebero Entertainment,11131,11152,21
3170,"wedi kokob ( ኣይምሮ) ወዲ ኮኾብ - ayemro (official video) new tigrigna tigray music 2021 by kebero Entertainment 9 months ago 5 minutes, 34 seconds 49,133 views",kebero Entertainment,49133,49240,107
3171,"(tigray) tekle hafte - ተክለ ሃፍተ (ትግራይ) new tegrigna  tigray music 2021 by kebero Entertainment 9 months ago 6 minutes, 1 second 6,817 views",kebero Entertainment,6817,6872,55
3172,"(ፈዳይ ሕነ) gebru fano -ገብሩ ፈኖ - (feday hene) new ትግርኛ tigray ደርፉ music 2021 by kebero Entertainment 10 months ago 6 minutes, 16 seconds 7,245 views",kebero Entertainment,7245,7296,51
3173,"Wedi kokob  (ኩርፂ ዉላድ ዛሃገር)  ወዲ ኮኮብ  (kuretsi wulade  zahager) - new  tigray tigrigna  music 2021 by kebero Entertainment 10 months ago 6 minutes, 18 seconds 33,459 views",kebero Entertainment,33459,33532,73
3174,"ወዲ ኮኮብ - አብ መርዓ ዝተፃዎታ (ኩሒል ሰለል በልየ) wedi kokob by kebero Entertainment 2 years ago 5 minutes, 58 seconds 8,190 views",kebero Entertainment,8190,8304,114
3175,"Timenit welday  (ኣቦል) ትምኒት ወልዳይ -ሓዳሽ ናይ ፍቅሪ ደርፊ - new tigray music by kebero Entertainment 2 years ago 5 minutes, 31 seconds 3,840 views",kebero Entertainment,3840,3901,61
3176,"(ምዘከርካኒ ዶ)  ትምኒት ወልዳይ&ኤፍሬም ኣማረ (mezekerkani do) - new ትግርኛ tigray ደርፉ music 2020 by kebero Entertainment 2 years ago 5 minutes, 48 seconds 10,163 views",kebero Entertainment,10163,10180,17
3177,"Desalegn Bekama(Asu Koo)*Ethiopia* New Ethiopian music (official Video)2022 by Keenyaa Entertainment 19 hours ago 4 minutes, 8 seconds 234 views",Keenyaa Entertainment,234,781,547
3178,"Asefa Teshome *Damma koo* New Ethiopian Music (official video) by Keenyaa Entertainment 9 days ago 5 minutes, 30 seconds 682 views",Keenyaa Entertainment,682,928,246
3179,"Eskiyas Mezemir*Yaa Tan Fagoo Jirtuu*Free style best performance by Keenyaa Entertainment 10 days ago 1 minute, 16 seconds 807 views",Keenyaa Entertainment,807,874,67
3180,"Danabo Gemechu * Mee Ka'een Goota Faarsa* New Ethiopian Music (official Video)2022 by Keenyaa Entertainment 1 month ago 6 minutes, 30 seconds 908 views",Keenyaa Entertainment,908,934,26
3181,"Free style Cultural Music by Keenyaa Entertainment 2 months ago 1 minute, 1 second 129 views",Keenyaa Entertainment,129,135,6
3182,"Sisay Tufa *Raayyaa* New Ethiopian Music (official video )2021 by Keenyaa Entertainment 2 months ago 3 minutes, 22 seconds 3,390 views",Keenyaa Entertainment,3390,3496,106
3183,"Shimelis ,Bruk,Kadir & Samuel *Hoo Jedhe * New Ethiopian Music (official Video)2021 by Keenyaa Entertainment 3 months ago 6 minutes, 17 seconds 4,988 views",Keenyaa Entertainment,4988,5198,210
3184,Best Free style by Keenyaa Entertainment 4 months ago 6 seconds 803 views,Keenyaa Entertainment,803,830,27
3185,"Redi Umer *Lama Buluuf Hin Jiraannu *New Ethiopian Music official video(2021) by Keenyaa Entertainment 4 months ago 4 minutes, 20 seconds 1,980 views",Keenyaa Entertainment,1980,1995,15
3186,"Kacha Kachale Free style by Keenyaa Entertainment 4 months ago 29 seconds 2,269 views",Keenyaa Entertainment,2269,2398,129
3187,"Jorj Abu & Hawwi H.Kanani *Yoom Dhuftaaree* New Ethiopian Music (official Video)2021 by Keenyaa Entertainment 5 months ago 4 minutes, 26 seconds 198,190 views",Keenyaa Entertainment,198190,201975,3785
3188,"Ambase Chala *Oromiyaa Daawwana* New Ethiopian Oromo Music Official Video 2021 by Keenyaa Entertainment 5 months ago 5 minutes, 36 seconds 950 views",Keenyaa Entertainment,950,957,7
3189,"Yonas Wubishet *Yaa Obsaa Koo* New Ethiopian Music Official Video 2021 by Keenyaa Entertainment 5 months ago 5 minutes, 40 seconds 830 views",Keenyaa Entertainment,830,838,8
3190,"Tsegaye Dendena* Birraa Birraa *New Ethiopian Music official video 2021 by Keenyaa Entertainment 5 months ago 5 minutes, 20 seconds 2,921 views",Keenyaa Entertainment,2921,2979,58
3191,"Yosan Getahun *Simbir Kilole* New Ethiopian Music (official Video)2021 by Keenyaa Entertainment 5 months ago 6 minutes, 48 seconds 3,804 views",Keenyaa Entertainment,3804,3868,64
3192,"Mindaye Dame * Kormee Kormitti * New Ethiopian Music (official video)2021 by Keenyaa Entertainment 6 months ago 4 minutes, 4 seconds 4,273 views",Keenyaa Entertainment,4273,4297,24
3193,"Marta Solomon* Ye Selalew* New Ethiopian music (official video)2021 Best stage performances 👌 by Keenyaa Entertainment 6 months ago 5 minutes, 22 seconds 1,538 views",Keenyaa Entertainment,1538,1553,15
3194,"Hiriyyaa Koo Miti Haacaaluun Obboleessa koo Dha by Keenyaa Entertainment 6 months ago 7 minutes, 37 seconds 2,213 views",Keenyaa Entertainment,2213,2218,5
3195,"Getu Alemu New Ethiopian Mash up Music (official video) 2021 by Keenyaa Entertainment 7 months ago 7 minutes, 13 seconds 3,498 views",Keenyaa Entertainment,3498,3517,19
3196,"Sisay Tufa *Barrii Ni Darbaa*New Ethiopian Music (official video)2021 Stage performance by Keenyaa Entertainment 7 months ago 8 minutes, 43 seconds 1,636 views",Keenyaa Entertainment,1636,1651,15
3197,"Ibrahim Roobaa (Kan Karrayyuu) *Doorii * New Ethiopian Music (official Video) 2021 by Keenyaa Entertainment 7 months ago 6 minutes, 1 second 925 views",Keenyaa Entertainment,925,930,5
3198,"Ibrahim Roobaa (Kan Karrayyuu) *Doorii * New Ethiopian Music (official Video) 2021 Intro by Keenyaa Entertainment 7 months ago 1 minute, 49 seconds 771 views",Keenyaa Entertainment,771,773,2
3199,"Caalaa Bultume New Ethiopian music official stage performance video @ Adama 2021 part 3 by Keenyaa Entertainment 8 months ago 4 minutes, 9 seconds 2,536 views",Keenyaa Entertainment,2536,2546,10
3200,"Caalaa Bultume New Ethiopian music official stage performance @ Adama 2021 part 2 by Keenyaa Entertainment 8 months ago 4 minutes, 9 seconds 3,330 views",Keenyaa Entertainment,3330,3355,25
3201,"Emu Girma New Ethiopian music (official stage performance video)2021 by Keenyaa Entertainment 8 months ago 4 minutes, 12 seconds 1,699 views",Keenyaa Entertainment,1699,1715,16
3202,"Eskias Mezemmir Yaa Hunde New Ethiopian Music official stage performance 2021 by Keenyaa Entertainment 8 months ago 4 minutes, 40 seconds 1,433 views",Keenyaa Entertainment,1433,1436,3
3203,"Caalaa Bultume New Ethiopian music official stage performance @ Adama 2021 by Keenyaa Entertainment 8 months ago 7 minutes, 6 seconds 3,335 views",Keenyaa Entertainment,3335,3362,27
3204,"Haaloo Daawwee *Obbooleessii Gaarii*  New Music Video  2021 free style by Keenyaa Entertainment 8 months ago 2 minutes, 39 seconds 1,270 views",Keenyaa Entertainment,1270,1275,5
3205,"Haaloo Daawwee *Wajji Tarkaafanna* New Music Video Amazing performance 2021 by Keenyaa Entertainment 9 months ago 3 minutes, 40 seconds 1,743 views",Keenyaa Entertainment,1743,1753,10
3206,"Kabaja Ayyana Faasikaa 2013 ETV by Keenyaa Entertainment 9 months ago 1 hour, 52 minutes 749 views",Keenyaa Entertainment,749,750,1
3207,"Desalegn Bekama *Adaamaa* New Ethiopian Oromo Music (official video)2021 by Keenyaa Entertainment 9 months ago 4 minutes, 46 seconds 188,140 views",Keenyaa Entertainment,188140,189909,1769
3208,"Umar Gobbe * Wal Nu taatee*New Ethiopian Oromo Music official video 2021 Free style by Keenyaa Entertainment 9 months ago 5 minutes, 32 seconds 22,184 views",Keenyaa Entertainment,22184,24403,2219
3209,"Eid Alfatir Special program Haaloo Daawwee, Shantam Shubbisaa & Umar Gobbee  on FANA Tv by Keenyaa Entertainment 9 months ago 1 hour, 6 minutes 1,551 views",Keenyaa Entertainment,1551,1662,111
3210,"Halima Mekuria *Kiyyaa *New Ethiopian Music official Video  2021 by Keenyaa Entertainment 9 months ago 5 minutes, 8 seconds 1,831 views",Keenyaa Entertainment,1831,1839,8
3211,"Margitu Warqineh *Amma Yeroon* New Ethiopian Music Official Video 2021 by Keenyaa Entertainment 10 months ago 5 minutes, 4 seconds 3,888 views",Keenyaa Entertainment,3888,3926,38
3212,"Halima Mekuria *Callaa Kiyyaa*New Ethiopian  Music (official video)2021 by Keenyaa Entertainment 10 months ago 5 minutes, 8 seconds 1,174 views",Keenyaa Entertainment,1174,1179,5
3213,"Raju star *Hakim * New Ethiopian Music official video 2021 by Keenyaa Entertainment 10 months ago 4 minutes, 24 seconds 1,555 views",Keenyaa Entertainment,1555,1572,17
3214,"Margitu Warqina *Magaallee Kiyya*  New Ethiopian Music 2021(official video) by Keenyaa Entertainment 10 months ago 6 minutes, 27 seconds 253,683 views",Keenyaa Entertainment,253683,255162,1479
3215,"Raju star *Akunamatata* New Ethiopian Music official video 2021 by Keenyaa Entertainment 11 months ago 4 minutes, 1 second 4,184 views",Keenyaa Entertainment,4184,4236,52
3216,"March 8 program On EBC producer Sinqe Malti Media Official video 2021 by Keenyaa Entertainment 11 months ago 1 hour, 38 minutes 796 views",Keenyaa Entertainment,796,802,6
3217,"Olif Mj *Ati Enyu* New Ethiopian Music(official Video) 202 by Keenyaa Entertainment 11 months ago 3 minutes, 31 seconds 1,212 views",Keenyaa Entertainment,1212,1213,1
3218,"Caaltu H/Maariyam*Ulfaataa* New Ethiopian Oromo Music Video Making Behind the scene 2021 part 2 by Keenyaa Entertainment 1 year ago 3 minutes, 54 seconds 3,027 views",Keenyaa Entertainment,3027,3125,98
3219,"Caaltu H/Maariyam*Ulfaataa* New Ethiopian Oromo Music Video Making Behind the scene 2021 part 3 by Keenyaa Entertainment 1 year ago 2 minutes, 36 seconds 3,881 views",Keenyaa Entertainment,3881,3947,66
3220,"Caaltu H/Maariyam*Ulfaataa* New Ethiopian Oromo Music Video Making Behind the scene 2021 part 1 by Keenyaa Entertainment 1 year ago 5 minutes, 10 seconds 2,021 views",Keenyaa Entertainment,2021,2051,30
3221,"Afro Gisho *Boolee* New Ethiopian Oromo Music Video Making Behind the scene 2021 part 2 by Keenyaa Entertainment 1 year ago 1 minute, 46 seconds 1,316 views",Keenyaa Entertainment,1316,1320,4
3222,"Zinnash Lolee *Bariisoo Dukkallee* New Ethiopian Oromo Music(official video)2021 by Keenyaa Entertainment 1 year ago 5 minutes, 44 seconds 5,080 views",Keenyaa Entertainment,5080,5123,43
3223,"Afro Gisho *Boolee* New Ethiopian Oromo Music Video Making Behind the scene 2021 part 1 by Keenyaa Entertainment 1 year ago 4 minutes, 18 seconds 1,588 views",Keenyaa Entertainment,1588,1594,6
3224,"Seenaa Mulugeetaa *Kudhaama Seenaa* New Ethiopian Oromo Music Video Making 2021 Behind The Scene 2 by Keenyaa Entertainment 1 year ago 3 minutes, 41 seconds 4,900 views",Keenyaa Entertainment,4900,4936,36
3225,"Seenaa Mulugeetaa *Kudhaama Seenaa* New Ethiopian Oromo Music Video Making 2021 Behind The Scene 1 by Keenyaa Entertainment 1 year ago 3 minutes, 18 seconds 3,844 views",Keenyaa Entertainment,3844,3889,45
3226,"Kekiyyaa Badhaadhaa *Warri Kuun* Music Video Making Behind the seen 2021 part 2 by Keenyaa Entertainment 1 year ago 1 minute, 47 seconds 3,925 views",Keenyaa Entertainment,3925,3939,14
3227,"Kekiyyaa Badhaadhaa *Warri Kuun* Music Video Making Behind the seen 2021 part 3 by Keenyaa Entertainment 1 year ago 5 minutes, 9 seconds 64,804 views",Keenyaa Entertainment,64804,64924,120
3228,"Kekiyyaa Badhaadhaa *Warri Kuun* Music Video Making Behind the seen 2021 part 1 by Keenyaa Entertainment 1 year ago 3 minutes, 10 seconds 5,976 views",Keenyaa Entertainment,5976,5992,16
3229,"Ibraahim Roobaa *Doorii*New Ethiopian Music(official Video) Behind the scene 2021 part 1 by Keenyaa Entertainment 1 year ago 3 minutes, 1 second 554 views",Keenyaa Entertainment,554,558,4
3230,"Getu Alemu *Shorin Shora*New Ethiopian Music(official Video) Behind the scene 2021 part 2 by Keenyaa Entertainment 1 year ago 6 minutes, 23 seconds 773 views",Keenyaa Entertainment,773,776,3
3231,"Getu Alemu *Shorin Shora*New Ethiopian Music(official Video) Behind the scene 2021 part 1 by Keenyaa Entertainment 1 year ago 1 minute, 47 seconds 622 views",Keenyaa Entertainment,622,625,3
3232,"Getu Alemu *Shorin Shora*New Ethiopian Music(official Video)2021 by Keenyaa Entertainment 1 year ago 5 minutes, 10 seconds 2,668 views",Keenyaa Entertainment,2668,2677,9
3233,"Negash Gelalcha *Maal Si Sirbu*New Ethiopian Music (official video )2021 by Keenyaa Entertainment 1 year ago 6 minutes, 23 seconds 315 views",Keenyaa Entertainment,315,316,1
3234,"Kekiyyaa Badhaadhaa *Ayyaantumaa Moona* Music Video Making Behind the seen 2021 part 2 by Keenyaa Entertainment 1 year ago 2 minutes, 53 seconds 3,112 views",Keenyaa Entertainment,3112,3117,5
3235,"Kekiyyaa Badhaadhaa *Ayyaantumaan Moona* Music Video Making Behind the scene 2021 part 1 by Keenyaa Entertainment 1 year ago 3 minutes, 15 seconds 12,884 views",Keenyaa Entertainment,12884,12897,13
3236,"Addunyaa Galaalchaa *Birrii Bisii* New Ethiopian Music(official video)2021 by Keenyaa Entertainment 1 year ago 5 minutes, 17 seconds 518 views",Keenyaa Entertainment,518,521,3
3237,"Zinnaash Lolee *Obbolee Shaayii *New Ethiopian Oromo Music official Video 2021 by Keenyaa Entertainment 1 year ago 4 minutes, 21 seconds 1,284 views",Keenyaa Entertainment,1284,1291,7
3238,"Urgeessaa Gabbisaa *Abaayyee Tiyyaa *New Ethiopian Music (Official video)2021 by Keenyaa Entertainment 1 year ago 5 minutes, 23 seconds 2,358 views",Keenyaa Entertainment,2358,2377,19
3239,"Haacaaluu Hundeessaa Documentary Based  On True Story seenaa rirmi hin nyaatu 2021 by Keenyaa Entertainment 1 year ago 22 minutes 1,978 views",Keenyaa Entertainment,1978,2026,48
3240,"Taaddasa Fixee *Xaafii Qucuccatte * New Ethiopian Music (official Video)2021 by Keenyaa Entertainment 1 year ago 4 minutes, 56 seconds 531 views",Keenyaa Entertainment,531,531,0
3241,"Eskyas Mezemir *Yaa Tan Fagoo Jirtu* New Ethiopian Music (official video )2021Free style by Keenyaa Entertainment 1 year ago 1 minute, 16 seconds 3,156 views",Keenyaa Entertainment,3156,3170,14
3242,"Kabaja Ayyaana Qillee 2021 EBC Waliin Ta'un kan Qophaa'e by Keenyaa Entertainment 1 year ago 1 hour, 34 minutes 731 views",Keenyaa Entertainment,731,744,13
3243,"Fotoqsaa New Ethiopian Oromo comedy (official video) 2021 by Keenyaa Entertainment 1 year ago 6 minutes, 40 seconds 561 views",Keenyaa Entertainment,561,561,0
3244,Kabaja Ayyaana Qillee bara 2021 Magaalaa Burraayyuuti Qophaa'e EBC Entertainment irratti nu eggadha by Keenyaa Entertainment 1 year ago 43 seconds 462 views,Keenyaa Entertainment,462,462,0
3245,"Kadir Ahmed  New Ethiopian Music Official Video 2020 by Keenyaa Entertainment 1 year ago 2 minutes, 35 seconds 568 views",Keenyaa Entertainment,568,574,6
3246,"Haacaaluu Hundeessaa Documentary Video Seenaa Rirmi Hin Nyaatu  Waan Oromoon Haace Irraa Dhaale Part by Keenyaa Entertainment 1 year ago 19 minutes 41,562 views",Keenyaa Entertainment,41562,41629,67
3247,"Zinash Lolee* Boorii Mallee* New Ethiopian Music (official video) 2020 by Keenyaa Entertainment 1 year ago 4 minutes, 47 seconds 2,923 views",Keenyaa Entertainment,2923,2946,23
3248,"Iskiyas Mezemmir *Akkam Nagumaa* New Ethiopian Oromo Music  official video by Keenyaa Entertainment 1 year ago 8 minutes, 22 seconds 3,500 views",Keenyaa Entertainment,3500,3603,103
3249,"Kadir Ahmed  *Dakikaa*New Ethiopian Music   (official video) 2020 Original Music Kemer Yusuf by Keenyaa Entertainment 1 year ago 5 minutes, 44 seconds 1,336 views",Keenyaa Entertainment,1336,1347,11
3250,"Eskiyas Mezammir *Sin Barbaada* New Ethiopian Oromo  Music (official video)2020 by Keenyaa Entertainment 1 year ago 4 minutes, 38 seconds 6,388 views",Keenyaa Entertainment,6388,6456,68
3251,Seenaa Rirmi Hin Nyaatu  Documentary Video Haacaaluu Hundessaa  - Haamma Dunu Cimne- Part 1-4 by Keenyaa Entertainment 1 year ago 20 minutes 667 views,Keenyaa Entertainment,667,673,6
3252,"Haacaaluu Hundessaa *Seenaa Rirmi Hin Nyaatu *Documentry (official Video) 2020 Intro stay tune by Keenyaa Entertainment 1 year ago 2 minutes, 3 seconds 924 views",Keenyaa Entertainment,924,926,2
3253,"Nasraa Yusuuf ""Midhagseen Mul'isa"" New Ethiopian Oromo Music Official Video 2020 by Keenyaa Entertainment 1 year ago 4 minutes, 20 seconds 680 views",Keenyaa Entertainment,680,683,3
3254,"Nasra Yusuf ""Yaa Jarana"" New Ethiopian Oromo MusicOfficial Video2020 by Keenyaa Entertainment 1 year ago 4 minutes, 31 seconds 2,654 views",Keenyaa Entertainment,2654,2751,97
3255,"Desalegn Bekama ""Barana Immoo Maal Maal Odeessani""New Ethiopian Oromo Music  Stage video by Keenyaa Entertainment 1 year ago 2 minutes, 42 seconds 5,255 views",Keenyaa Entertainment,5255,5319,64
3256,"Jirra Jirraa Eenyutu Barechee Sirbee by Keenyaa Entertainment 1 year ago 3 minutes, 36 seconds 2,639 views",Keenyaa Entertainment,2639,2648,9
3257,Gaazexeessituun  Jalqabaa Maal Jedhuu Waa'ee Afaan Oromoo? by Keenyaa Entertainment 1 year ago 6 minutes 508 views,Keenyaa Entertainment,508,508,0
3258,"Barecha Bekele""Jirra Jirraa"" Amazing Free style Performance by Keenyaa Entertainment 1 year ago 45 seconds 895 views",Keenyaa Entertainment,895,895,0
3259,"Taaddasaa Qalbeessaa ""New Ethiopian Oromo Music (official Video)2020 by Keenyaa Entertainment 1 year ago 3 minutes, 40 seconds 2,368 views",Keenyaa Entertainment,2368,2389,21
3260,"New Year Special Full program Afran Qalloo Team on EBS by Keenyaa Entertainment 1 year ago 1 hour, 41 minutes 942 views",Keenyaa Entertainment,942,942,0
3261,"Abarraa Indaalaa  New Ethiopian Oromo Music 2020 (official video) stage performance by Keenyaa Entertainment 1 year ago 6 minutes, 12 seconds 2,497 views",Keenyaa Entertainment,2497,2511,14
3262,"Kemer Yusuf Garaa Koo Na Raaftaa New Ethiopian Oromo Music free style 2020 by Keenyaa Entertainment 1 year ago 32 seconds 2,727 views",Keenyaa Entertainment,2727,2784,57
3263,"""Emmoo Caammaa Sharaa Dhisaa Aadaa jaraa qe'eetti  si Gala"" ... Kabaja Ayyaana Goobee 2020 by Keenyaa Entertainment 1 year ago 12 minutes, 44 seconds 5,666 views",Keenyaa Entertainment,5666,5773,107
3264,"Maalan Jadhee Gerara Haacee Koon Dhabeen Jira New Afaan Oromoo Music 2020 by Keenyaa Entertainment 1 year ago 2 minutes, 27 seconds 6,407 views",Keenyaa Entertainment,6407,6416,9
3265,"Abbaan Haacaaluu Haasaa Yaadannoo Guyyaa 80ffaa Irraatti Maal Jedhan by Keenyaa Entertainment 1 year ago 1 minute, 47 seconds 1,574 views",Keenyaa Entertainment,1574,1574,0
3266,"Marsi Abboomaa 🎶Soba Hojjanne Hin Bullu🎶 New Ethiopian Oromo Lyrics 2020 (official Video) by Keenyaa Entertainment 1 year ago 3 minutes, 38 seconds 3,083 views",Keenyaa Entertainment,3083,3093,10
3267,"Tesfaye Gutamaa Booraa🎶Mee Kaawoo🎶 New Ethiopian Oromo Music official video 2020 by Keenyaa Entertainment 1 year ago 5 minutes, 7 seconds 957 views",Keenyaa Entertainment,957,959,2
3268,"Mustefa Shehabrar🎶 Shilillaa🎶New Music ( official video) 2020 by Keenyaa Entertainment 1 year ago 17 minutes 2,447 views",Keenyaa Entertainment,2447,2519,72
3269,"Andualem Gosa🎶 Assahayru🎶New  Music (official video)2020 2 years ago by Keenyaa Entertainment 1 year ago 6 minutes, 10 seconds 89,064 views",Keenyaa Entertainment,89064,89891,827
3270,"Funyee,Daadhii and Addisuu New Ethiopian Oromo Comedy (official video )2020 2 Years Ago @Sululta by Keenyaa Entertainment 1 year ago 13 minutes, 43 seconds 3,187 views",Keenyaa Entertainment,3187,3189,2
3271,"Andualem Gosa * Gadaatu Keeti* Music Video Making Behind The scene(official video)2020 by Keenyaa Entertainment 1 year ago 4 minutes, 14 seconds 12,353 views",Keenyaa Entertainment,12353,12429,76
3272,"Yaa Lammacha Koo New Free style Music (official video)2020 by Keenyaa Entertainment 1 year ago 51 seconds 1,919 views",Keenyaa Entertainment,1919,1925,6
3273,"Roorrisaa Shuraa🎶Furtuu Jiru🎶New Ethiopian Oromo Music (official video)2020 by Keenyaa Entertainment 1 year ago 4 minutes, 40 seconds 641 views",Keenyaa Entertainment,641,641,0
3274,"Asagedach Entale *Kalaalaa Birraa* New Ethiopian Oromo Music (official Video)2020 4 Years Ago by Keenyaa Entertainment 1 year ago 5 minutes, 26 seconds 646 views",Keenyaa Entertainment,646,646,0
3275,"Lammecha Korso 🎶Kaasi Nurraa🎶 New Ethiopian Oromo music(official video)2020 by Keenyaa Entertainment 1 year ago 4 minutes, 44 seconds 3,684 views",Keenyaa Entertainment,3684,3712,28
3276,"Urji Adaamaa Band * Nullee Dhaamsa Qabna* New Ethiopian Oromoo Music (official Video)  2020 by Keenyaa Entertainment 1 year ago 3 minutes, 53 seconds 703 views",Keenyaa Entertainment,703,704,1
3277,"Mekonin Beyene -Akki Kalee Hin Taane_New Ethiopian Music about COVID 19 (official Video)2020 by Keenyaa Entertainment 1 year ago 5 minutes, 3 seconds 1,557 views",Keenyaa Entertainment,1557,1567,10
3278,"Jireenyaa Shifarraaw  ft.Bruk Anteneh 🎶NU BARAARI 🎶New Ethiopian Oromo Music Video  2020 by Keenyaa Entertainment 1 year ago 4 minutes, 6 seconds 6,809 views",Keenyaa Entertainment,6809,6816,7
3279,"Gammaachuu Xaafaa* Covid 19 1* New Ethiopian music video 2020 by Keenyaa Entertainment 1 year ago 3 minutes, 45 seconds 1,513 views",Keenyaa Entertainment,1513,1513,0
3280,"Isqiyaas,Nasraa fi Abarraa*Kan Dursu Fayyaa Dha* New Ethiopian Music Video 2020 by Keenyaa Entertainment 1 year ago 3 minutes, 55 seconds 15,702 views",Keenyaa Entertainment,15702,15709,7
3281,"Of eeggachuun keessan lammii keessaniif fayyina!! How To Prevent COVID 19 New Official Video by Keenyaa Entertainment 1 year ago 1 minute, 22 seconds 2,840 views",Keenyaa Entertainment,2840,2840,0
3282,"Kabada Wayyeessaa  New Ethiopian  Oromoo Music 2020 Official Video by Keenyaa Entertainment 1 year ago 6 minutes, 30 seconds 1,234 views",Keenyaa Entertainment,1234,1236,2
3283,"Wal Dorgommii Sirba Aadaa Jaarsoolii fi Qeerroo Gidduu Taasifame New Oromoo Music 2020 by Keenyaa Entertainment 1 year ago 6 minutes, 5 seconds 3,453 views",Keenyaa Entertainment,3453,3459,6
3284,"Urgeeessaa Gabbisaa  *Abaayee Tiyyaa * New Ethiopian Oromoo Music 2020 official Video by Keenyaa Entertainment 2 years ago 5 minutes, 50 seconds 3,352 views",Keenyaa Entertainment,3352,3356,4
3285,"Meetii Haayilee* Leellee Kiyya*Music Video Making Behind The Scene 2020 It was Amazing by Keenyaa Entertainment 2 years ago 2 minutes, 12 seconds 10,543 views",Keenyaa Entertainment,10543,10613,70
3286,"Daangaa  *Qoree Suqqatee*New Music Video Making Behind The Scene 2020 by Keenyaa Entertainment 2 years ago 3 minutes, 7 seconds 9,970 views",Keenyaa Entertainment,9970,9992,22
3287,"Ababech Ajjamaa,Humnechaa & Daadhii *Waliin Tolla*  New Ethiopian Oromo Comedy 2020 official video by Keenyaa Entertainment 2 years ago 10 minutes, 52 seconds 34,889 views",Keenyaa Entertainment,34889,34947,58
3288,"Fikru Tesfaye _Bareeduu_ New Ethiopian Oromo Music Video 2020 by Keenyaa Entertainment 2 years ago 5 minutes, 57 seconds 43,034 views",Keenyaa Entertainment,43034,43090,56
3289,"Jambo Jote * Belba* Music Video Making Behind The Scene 2020 by Keenyaa Entertainment 2 years ago 1 minute, 35 seconds 6,576 views",Keenyaa Entertainment,6576,6592,16
3290,"Reedwaan Qaasoo- Amma Ammaa -New Ethiopian Oromo Music  Official Video 2020 by Keenyaa Entertainment 2 years ago 4 minutes, 44 seconds 1,573 views",Keenyaa Entertainment,1573,1578,5
3291,"Meqdas Adunya -Sin Barbada -New Ethiopian Music Video 2020 by Keenyaa Entertainment 2 years ago 4 minutes, 31 seconds 2,120 views",Keenyaa Entertainment,2120,2122,2
3292,"Ibraahim Roobaa -Oborraa- New Oromo Music 2020 by Keenyaa Entertainment 2 years ago 6 minutes, 50 seconds 1,567 views",Keenyaa Entertainment,1567,1569,2
3293,"Huseen Booruu -Godaannisa- New Afaan Oromo Lyrics 2020 by Keenyaa Entertainment 2 years ago 4 minutes, 26 seconds 724 views",Keenyaa Entertainment,724,726,2
3294,"Caaltu Butoo -Obbeeyyoo _Music video Making Part 1 by Keenyaa Entertainment 2 years ago 3 minutes, 40 seconds 1,407 views",Keenyaa Entertainment,1407,1413,6
3295,Afran Qalloon  Yoom Hundaaye Part 2 by Keenyaa Entertainment 2 years ago 30 minutes 368 views,Keenyaa Entertainment,368,368,0
3296,"Desalegn Bekema *Fano*    Behind the Scene  Music video Making 2020 by Keenyaa Entertainment 2 years ago 3 minutes, 32 seconds 3,214 views",Keenyaa Entertainment,3214,3215,1
3297,"Desalegn Bekema (Asu Ko)_ Iti ti ti...New Afan Oromo Music 2019/2020 by Keenyaa Entertainment 2 years ago 5 minutes, 39 seconds 102,382 views",Keenyaa Entertainment,102382,102650,268
3298,"Dhisaa Adaa Ormaa ...Goobee part 2 Adaamaa Dada Mall stay stay tuned.. by Keenyaa Entertainment 2 years ago 9 minutes, 35 seconds 3,552 views",Keenyaa Entertainment,3552,3563,11
3299,"Leencoo Fikru New stage performance Monologue With OBN 2019 by Keenyaa Entertainment 2 years ago 4 minutes, 12 seconds 1,138 views",Keenyaa Entertainment,1138,1149,11
3300,"Goobee new Afaan Oromo cultural music 2019/2020(Hooteela Kebeki Adaamaa) part 1 Adaamaa by Keenyaa Entertainment 2 years ago 19 minutes 15,917 views",Keenyaa Entertainment,15917,15977,60
3301,"Afran Qalloon Aartiistoota Dhaloota Haaraaf Amaanaa Aartii Guuddisuu Kennan part 1 by Keenyaa Entertainment 2 years ago 6 minutes, 44 seconds 566 views",Keenyaa Entertainment,566,566,0
3302,"Kadir Ahmed *Boontu Jimmaa* New Ethiopian  Oromo music (  official video) by Keenyaa Entertainment 2 years ago 4 minutes, 50 seconds 2,097 views",Keenyaa Entertainment,2097,2099,2
3303,"Kadir Ahmed *Anis Biyyan Qaba *New Ethiopian Music (official Video) by Keenyaa Entertainment 2 years ago 5 minutes, 37 seconds 1,672 views",Keenyaa Entertainment,1672,1673,1
3304,"Ayyaanoo Barisoo -Dhufee Gurraachii Afrikaa..New Ethiopian Oromo Music Video 2020 by Keenyaa Entertainment 2 years ago 5 minutes, 20 seconds 2,206 views",Keenyaa Entertainment,2206,2232,26
3305,"Irreechaa Music 2019 Makaa Hin qabu by Keenyaa Entertainment 2 years ago 6 minutes, 58 seconds 21,504 views",Keenyaa Entertainment,21504,21520,16
3306,"Goobee Oromo Cultural Song 2020 by Keenyaa Entertainment 2 years ago 8 minutes, 32 seconds 140,572 views",Keenyaa Entertainment,140572,141399,827
3307,"Eskyas Mezemir *Gammachuu* New Ethiopian Afaan Oromo Music ( officail video )2020 by Keenyaa Entertainment 2 years ago 5 minutes, 16 seconds 45,016 views",Keenyaa Entertainment,45016,45093,77
3308,"2012 E.C New Year Special Program (kabaja Ayyaana bara Haaraa)coming Soon ETV language by Keenyaa Entertainment 2 years ago 1 minute, 33 seconds 1,310 views",Keenyaa Entertainment,1310,1311,1
3309,"Jiituu Daanye(Karramarraa) *Haabaabilee* New afaan oromo stage performanceofficial video2019 by Keenyaa Entertainment 2 years ago 7 minutes, 53 seconds 3,516 views",Keenyaa Entertainment,3516,3527,11
3310,"Anduu'alam Gosaa *Gadaatu Keeti* New Afaan Oromo  Amazing Stage performance official video 2019 by Keenyaa Entertainment 2 years ago 5 minutes, 47 seconds 10,764 views",Keenyaa Entertainment,10764,10788,24
3311,"Zerihun Tesfaye -Shurruubee Koo- New Afaan Oromo Music stage performance( official Video)2019 by Keenyaa Entertainment 2 years ago 5 minutes, 27 seconds 1,023 views",Keenyaa Entertainment,1023,1024,1
3312,"Fotoksa - New Afaan Oromo Comedy 2019 by Keenyaa Entertainment 2 years ago 5 minutes, 10 seconds 9,268 views",Keenyaa Entertainment,9268,9278,10
3313,"Mogoroo Jifaar -Eemmolee -New Music stage performance at Mugar by Keenyaa Entertainment 2 years ago 4 minutes, 43 seconds 10,628 views",Keenyaa Entertainment,10628,10687,59
3314,"Dasaalany Bekamaa - Asuu Koo -stage performance 2019 (official video) by Keenyaa Entertainment 2 years ago 8 minutes, 1 second 5,318 views",Keenyaa Entertainment,5318,5330,12
3315,"Milion Feyyisa** Warra Tufaati**  New Afaan Oromo Music clip 2019(Official Video) by Keenyaa Entertainment 2 years ago 5 minutes, 49 seconds 103,951 views",Keenyaa Entertainment,103951,104012,61
3316,"Tsegaye Dendena(Sayyoo)** BOOLEE** New Afaan Oromo Music 2019 (official video) by Keenyaa Entertainment 3 years ago 9 minutes, 29 seconds 25,387 views",Keenyaa Entertainment,25387,25476,89
3317,"Jiituu Daanyee (Karramarraa)** Habaabiyyoo** New Afaan Oromoo Music 2019 (official music video) by Keenyaa Entertainment 3 years ago 4 minutes, 56 seconds 538,686 views",Keenyaa Entertainment,538686,542093,3407
3318,"Tsegaye Dendena(Sayyoo)  New Afaan Oromo Music 2019(official video) by Keenyaa Entertainment 3 years ago 5 minutes, 55 seconds 6,301 views",Keenyaa Entertainment,6301,6318,17
3319,"Fuunyee,Daadhii   **Qe'ee Koo Diigee...** New Ethiopoan Afaan Oromo comedy 2019(official video) by Keenyaa Entertainment 3 years ago 15 minutes 567,613 views",Keenyaa Entertainment,567613,568552,939
3320,"Andualem Gosa- Gammachuu-  New Ethiopian Afaan Oromoo Music 2019( Official video) Dr.  Alii Birraa by Keenyaa Entertainment 3 years ago 7 minutes, 6 seconds 23,745 views",Keenyaa Entertainment,23745,24001,256
3321,"Andualem Gosa - Injifannoon Kan Oromooti- New Afaan Oromoo Music 2018 19 Stage performance by Keenyaa Entertainment 3 years ago 6 minutes, 41 seconds 77,088 views",Keenyaa Entertainment,77088,77468,380
3322,"Jiituu Daanyee(Karramarraa)  *Habaabilee *New Ethiopian Afaan Oromo Music (official video)2021 by Keenyaa Entertainment 3 years ago 6 minutes, 23 seconds 383,859 views",Keenyaa Entertainment,383859,385236,1377
3323,"Kabaja Ayyaana Bara Haaraa 2011 Siinqee promotion OBN waliin by Keenyaa Entertainment 3 years ago 1 minute, 47 seconds 11,298 views",Keenyaa Entertainment,11298,11298,0
3324,"Andualem Gosaa- (Haacaaluu Xiqqaa)-Gerrarsa -New Ethiopian  Music Video  2020 by Keenyaa Entertainment 3 years ago 13 minutes, 28 seconds 325,139 views",Keenyaa Entertainment,325139,329488,4349
