,Posts,Channel,Views_03/03,Views_03/12,view_delta
0,"Farhaan Sulee  (Baddeeysa) _ Ashiitaa Nuuree - Nuural eeynii - New Ethiopian Oromo Music 2022 by Laangaano Tube 3 weeks ago 1 minute, 43 seconds 35,999 views",Laangaano Tube,35999,0,-35999
1,"Shukri Jamal - Nan Quuxessin - #Ammuma -New Ethiopian Oromo Music Video 2022 (Audio Spectrum) - by Laangaano Tube 3 weeks ago 4 minutes, 8 seconds 853 views",Laangaano Tube,853,0,-853
2,"Andualem Gosa - Gumgume -Sirboota Andualam Gosaa Hundaa -Nonstop Ethiopian Oromo Music 2022 by Laangaano Tube 3 weeks ago 39 minutes 2,974 views",Laangaano Tube,2974,0,-2974
3,"Galaanaa Gaaromsaa, New Oromo music, Waraana Jaalalaa by Laangaano Tube 3 weeks ago 5 minutes, 1 second 283 views",Laangaano Tube,283,0,-283
4,"Leencoo Gammachu  - Sirboota Lencho Gemechu Hundaa -Nonstop Ethiopian  Music's - Laangaano Tube 2022 by Laangaano Tube 1 month ago 39 minutes 19,448 views",Laangaano Tube,19448,0,-19448
5,"AL BULAA - Fiilmii Gabaabaa 2022 - New Ethiopian Short Movie - Laangaano Tube by Laangaano Tube 1 month ago 12 minutes, 7 seconds 243 views",Laangaano Tube,243,0,-243
6,"sagantaa afaan oromoo haaraa | oduu bunaa | coming soon by Laangaano Tube 2 months ago 1 minute, 12 seconds 212 views",Laangaano Tube,212,0,-212
7,"Walaloo Afaan Oromoo harawa (JAJAL'O) - Firaanol Ahmad - laangaano tube by Laangaano Tube 7 months ago 1 minute, 59 seconds 417 views",Laangaano Tube,417,0,-417
8,"Akkamitti Video Youtube Irratti Report Goona - How To Report Videos On Youtube! by Laangaano Tube 8 months ago 4 minutes, 9 seconds 193 views",Laangaano Tube,193,0,-193
9,"Caalaa Gaaromsaa Yaa Namakoo New Ethiopian Oromo Music  2021 (Audio Spectrum) by Laangaano Tube 9 months ago 5 minutes, 45 seconds 2,468 views",Laangaano Tube,2468,0,-2468
10,"Fiilmii Oromoo Haarawa ""IMALAA"" 2022 - New Ethiopian Short Movie Laangaanoo_Tube by Laangaano Tube 9 months ago 8 minutes, 44 seconds 958 views",Laangaano Tube,958,0,-958
11,"Fayyisaa Furii -Qondaala-New Ethiopian Oromo Music 2021(Audio Spectrum) by Laangaano Tube 9 months ago 5 minutes, 51 seconds 424 views",Laangaano Tube,424,0,-424
12,"Midhagso - Deemi Tole - New Ethiopian Oromo Music 2021 Official Audio Spectrum by Laangaano Tube 9 months ago 3 minutes, 20 seconds 480 views",Laangaano Tube,480,0,-480
13,"Mergitu Workineh - Obomboleettii - ኦቦምቦሌቲ - New Ethiopian Oromo music 2021 (Audio Spectrum) by Laangaano Tube 9 months ago 4 minutes, 48 seconds 5,413 views",Laangaano Tube,5413,0,-5413
14,"Kuul Surre - EEKAA - New Ethiopian Oromo Music 2021 Official Audio Spectrum by Laangaano Tube 9 months ago 3 minutes, 38 seconds 205 views",Laangaano Tube,205,0,-205
15,"Lij Yared - Biyya Koo - New Ethiopia Oromo Music 2021 Official Audio Spectrum by Laangaano Tube 9 months ago 4 minutes, 49 seconds 1,486 views",Laangaano Tube,1486,0,-1486
16,"Midhaso ft Rc-Boys - Habibi - New Ethiopian Oromo Music Video 2021 (Audio Spectrum) by Laangaano Tube 9 months ago 4 minutes, 31 seconds 393 views",Laangaano Tube,393,0,-393
17,"Leencoo Gammachuu - Dibaabee Ko - New Ethiopian Oromo Music Video 2021 (Audio Spectrum) by Laangaano Tube 9 months ago 6 minutes, 36 seconds 65,243 views",Laangaano Tube,65243,0,-65243
18,"Andualem Gosa - Darbee Laalla - New Ethiopian Oromo Music Video 2021 (Audio Spectrum) by Laangaano Tube 10 months ago 4 minutes, 42 seconds 2,554 views",Laangaano Tube,2554,0,-2554
19,"Fiilmii Afaan Oromoo ""DAMBALII""  2021 ❤️😍 by Laangaano Tube 10 months ago 1 hour, 17 minutes 11,461 views",Laangaano Tube,11461,0,-11461
20,"Jaal Marroo Kumsaa Dirribaa Aljazeera Irratti   ጃል መሮ ኩምሳ ዲሪባ በአልጀዚራ ለይ የተናገረው by Laangaano Tube 11 months ago 1 minute, 34 seconds 8,131 views",Laangaano Tube,8131,0,-8131
21,"Ebooko -New Ethiopian Oromo Music 2021 ( Official Video) Laangaano Tube by Laangaano Tube 11 months ago 6 minutes, 21 seconds 364 views",Laangaano Tube,364,0,-364
22,"""IMALAA"" Fiilmii Afaan Oromo Haarawa 2021 Yeroo Dhihootti by Laangaano Tube 1 year ago 1 minute, 43 seconds 323 views",Laangaano Tube,323,0,-323
23,"Rophnan ft Chris Brown "" Turn Up Gamo Dare"" New ሮፍናን - ተስፋ | ROPHNAN - TESFA 2022 by Laangaano Tube 1 year ago 1 minute, 47 seconds 540 views",Laangaano Tube,540,0,-540
24,"Zawuduu Silashii fi Eminem - Siingilii Laqqaqa  ""Qa Qa Qa Qa"" 2022 New Oromo Funny Music Clip by Laangaano Tube 1 year ago 1 minute, 7 seconds 21,667 views",Laangaano Tube,21667,0,-21667
25,"New Ethiopian Music 2022 | በዛብህ ሻወል - ሽሙንሙን | Bezabih Shawel Shmunmun by Legend Entertainment 11 days ago 5 minutes, 52 seconds 827 views",Legend Entertainment,827,1077,250
26,"Yishak Assefa - Lagbashina | ይስሃቅ አሰፋ - ላግባሽና - Ethiopian New Music 2022 by Legend Entertainment 2 weeks ago 4 minutes, 2 seconds 4,034 views",Legend Entertainment,4034,4211,177
27,"Ethiopian New Music 2022 - Asmarew Tegegn - Kiretsegn - አስማረው ተገኝ - ቅረፀኝ @Legend Entertainment by Legend Entertainment 3 weeks ago 4 minutes, 25 seconds 9,352 views",Legend Entertainment,9352,9784,432
28,"Behailu Bayou - Min Tesera Zare  | ምን ተሰራ ዛሬ - New Ethiopian Music 2022 @Legend Entertainment by Legend Entertainment 1 month ago 5 minutes, 12 seconds 6,002 views",Legend Entertainment,6002,6079,77
29,"Ethiopian New Movie:  Layhonlgn - ላይሆንልኝ - New Ethiopian Movie 2022 (Full Movie) by Legend Entertainment 2 months ago 1 hour, 26 minutes 227,502 views",Legend Entertainment,227502,229810,2308
30,"Ethiopian Movie: Layhonlgn - ላይሆንልኝ -Trailer by Legend Entertainment 2 months ago 1 minute, 56 seconds 915 views",Legend Entertainment,915,928,13
31,"Abel Abera - Dimmtuu - New Ethiopian Music 2021 (Oromifa Music Video) Ethio One Love by Legend Entertainment 11 months ago 4 minutes, 15 seconds 10,993 views",Legend Entertainment,10993,11075,82
32,"ካቤል ደሳለኝ Kabel Dessalegn | ሁሉም ተናጋሪ Hulum Tenagari -  (Official Video) Ethio One Love by Legend Entertainment 1 year ago 5 minutes, 2 seconds 13,172 views",Legend Entertainment,13172,13273,101
33,"Ethiopian Music : Joni Z Arkey  - Inka - ጆኒ ዘ ዕርከይ - እንካ New Ethiopian Music 2021 ትግርኛ ሙዚቃ by Legend Entertainment 1 year ago 5 minutes, 6 seconds 3,215 views",Legend Entertainment,3215,3258,43
34,"Ethiopian: Zerihun Demisse - GUM GUM - ዘሪሁን ደምሴ - New Ethiopian Music 2021 (Official Video) by Legend Entertainment 1 year ago 5 minutes, 37 seconds 19,145 views",Legend Entertainment,19145,20386,1241
35,"Elias Getachew - Andafta - ኤልያስ ጌታቸው - አንዳፍታ - (Official Video) | Ethio One Love by Legend Entertainment 1 year ago 3 minutes, 52 seconds 4,227 views",Legend Entertainment,4227,4272,45
36,"Ethiopian Music : ያውቃሉ? የዶሮ ወጥን ለመጀመርያ ጊዜ የሰራችው ሴት ማን እንደሆነች? by Legend Entertainment 1 year ago 16 minutes 1,241 views",Legend Entertainment,1241,1262,21
37,"Ethiopian Music : Advertisement for Tsilat´s new song - Guramayé - New Ethiopian Music 2021 by Legend Entertainment 1 year ago 58 seconds 15,257 views",Legend Entertainment,15257,15457,200
38,"Tsilat Gezmu (Guramaylé) ፅላት ገዝሙ (ጉራማይሌ) | New Ethiopian Music 2022 | Ethio One Love by Legend Entertainment 1 year ago 5 minutes, 8 seconds 18,185 views",Legend Entertainment,18185,18460,275
39,"Ethiopian Music - BIbi Kabtamu - Ababicho by Legend Entertainment 1 year ago 4 minutes, 55 seconds 2,813 views",Legend Entertainment,2813,2849,36
40,"Ethiopian Music - Tesfahun Hailu (እንገናኝ ጎጃም) - Engenagn Gojam by Legend Entertainment 1 year ago 5 minutes, 32 seconds 5,463 views",Legend Entertainment,5463,5530,67
41,"Aregash Alene - Gonder - Ethiopian Music by Legend Entertainment 1 year ago 5 minutes, 23 seconds 8,424 views",Legend Entertainment,8424,8514,90
42,"Ethiopian Music : Yon Addis ft. Tarekegn Mulu | Echilewalew | እችለዋለሁ (Official Music Video) by Legend Entertainment 1 year ago 6 minutes, 35 seconds 2,855 views",Legend Entertainment,2855,2879,24
43,"Dj Lee (እቴጌ) ft. Mc Siyamregn - Ankes Ankes - New Ethiopian Music 2017 by Legend Entertainment 4 years ago 4 minutes, 46 seconds 130,189 views",Legend Entertainment,130189,130302,113
44,"Temesgen Tafesse - Sabiye - New Ethiopian Music 2017 | Ethio One Love by Legend Entertainment 4 years ago 5 minutes, 3 seconds 379,134 views",Legend Entertainment,379134,379839,705
45,"Nati Hoye fet. Meron - Abejesh Yegna Lej - New Ethiopian Music 2017 by Legend Entertainment 4 years ago 5 minutes, 23 seconds 356,352 views",Legend Entertainment,356352,356677,325
46,"Ziggy Zaga - Be Simaa Haya - (Official Music Video) - New Ethiopian Music 2017 | Ethio One Love by Legend Entertainment 4 years ago 4 minutes, 29 seconds 208,839 views",Legend Entertainment,208839,209308,469
47,"Fikremariam Gebru - Loga - New Ethiopian Music 2017 -  (Official Video) by Legend Entertainment 4 years ago 4 minutes, 39 seconds 310,925 views",Legend Entertainment,310925,310996,71
48,"Ethio One Love - Ethiopian Music 2017 by Legend Entertainment 4 years ago 2 minutes, 45 seconds 1,303 views",Legend Entertainment,1303,1314,11
49,"Bisrat Surafel feat. Jah Lude - Yehew Sewyew - Ethiopian New Music 2017 l EthioOneLove by Legend Entertainment 4 years ago 4 minutes, 52 seconds 680,193 views",Legend Entertainment,680193,680391,198
50,"Yosef Josi - Wesewesegn - Official Music Video - New Ethiopian Music 2017 by Legend Entertainment 4 years ago 5 minutes, 8 seconds 166,846 views",Legend Entertainment,166846,166866,20
51,"Babby Ragga - Tefekari - Official Music Video - New Ethiopian Music 2017 by Legend Entertainment 4 years ago 4 minutes, 56 seconds 65,674 views",Legend Entertainment,65674,65709,35
52,"Wendi Mak - Jeba | ጀባ - Official Music Video - New Ethiopian Music 2017 by Legend Entertainment 4 years ago 4 minutes, 21 seconds 999,058 views",Legend Entertainment,999058,1000970,1912
53,"Tommy Zuk - Shire Shire Yame - Official Music Video - l New Ethiopian Music 2017 by Legend Entertainment 4 years ago 5 minutes, 52 seconds 46,839 views",Legend Entertainment,46839,46902,63
54,"Behailu Bayou - Des Bilongnal -  Official Music 2017 - Ethio One Love by Legend Entertainment 4 years ago 5 minutes, 53 seconds 406,641 views",Legend Entertainment,406641,407214,573
55,"Abebe Kefeni - Jininna - (Official Music Video) I EthioOneLove by Legend Entertainment 5 years ago 5 minutes, 9 seconds 86,076 views",Legend Entertainment,86076,86117,41
56,"Fikir Yitagesu - Laselam - (Official Music Video) - New Ethiopian Music 2017 by Legend Entertainment 5 years ago 4 minutes, 56 seconds 667,162 views",Legend Entertainment,667162,668981,1819
57,"Tommy Zuk - Eskinega I እስኪነጋ - New Ethiopian Music 2017 by Legend Entertainment 5 years ago 5 minutes, 29 seconds 64,383 views",Legend Entertainment,64383,64401,18
58,"Fitsum Gebretsadik - Shebelaye | ሸበላዬ - New Ethiopian Music 2017 (Official Video) by Legend Entertainment 5 years ago 4 minutes, 10 seconds 130,005 views",Legend Entertainment,130005,130108,103
59,"Ethiopian Music : Abinet Agonafir - Maal Naa Wayaa -  (Official Music Video) I EthioOneLove by Legend Entertainment 5 years ago 5 minutes, 40 seconds 4,121,500 views",Legend Entertainment,4121500,4124999,3499
60,"Ethiopian Music : Messay Goa - Hana Monaliza - (Official Music Video) I Ethio One Love by Legend Entertainment 5 years ago 5 minutes, 2 seconds 120,373 views",Legend Entertainment,120373,120439,66
61,"Ashenafi Geremew - Lene Balesh - (Official Music Video) I EthioOneLove by Legend Entertainment 5 years ago 5 minutes, 36 seconds 214,666 views",Legend Entertainment,214666,214886,220
62,"Kalkidan Meshesha - Gela - (Official Video) - EthioOneLove by Legend Entertainment 5 years ago 6 minutes, 16 seconds 1,851,107 views",Legend Entertainment,1851107,1853657,2550
63,"Joni Z Arkey - Inka - New Ethiopian Music 2016 by Legend Entertainment 5 years ago 5 minutes, 5 seconds 45,292 views",Legend Entertainment,45292,45320,28
64,"New Ethiopian Music 2016 - Tadele Kifelew - Athiji by Legend Entertainment 5 years ago 5 minutes, 10 seconds 54,550 views",Legend Entertainment,54550,54558,8
65,"New Ethiopian Music 2016 - Zerihun Demise - Gum Gum I EthioOneLove by Legend Entertainment 5 years ago 5 minutes, 56 seconds 51,409 views",Legend Entertainment,51409,51496,87
66,"Bisrat Surafel - Hed meles - (Official Music Video) - New Ethiopian Music 2017 I EthioOneLove by Legend Entertainment 5 years ago 5 minutes, 25 seconds 2,870,771 views",Legend Entertainment,2870771,2873586,2815
67,"Anteneh Adnew - Chaw Chaw - (Official Music Video) - New Ethiopian Music 2017 I EthioOneLove by Legend Entertainment 5 years ago 5 minutes, 33 seconds 444,945 views",Legend Entertainment,444945,445066,121
68,"Rahel Haile - Weriha Hizeya - New Ethiopian Music 2016 by Legend Entertainment 5 years ago 6 minutes, 2 seconds 1,410,285 views",Legend Entertainment,1410285,1410441,156
69,"King Teddy  - Natey Kesanetey - New Ethiopian Music 2016 by Legend Entertainment 5 years ago 4 minutes, 26 seconds 86,688 views",Legend Entertainment,86688,86714,26
70,"Cypher Abyssinia - New Ethiopian Hip Hop Music 2016 by Legend Entertainment 5 years ago 4 minutes 91,870 views",Legend Entertainment,91870,91894,24
71,"New Ethiopian Music 2016 by Demere Legesse - Yimokregna - Official Music Video by Legend Entertainment 5 years ago 5 minutes, 14 seconds 284,069 views",Legend Entertainment,284069,284206,137
72,"Dawit Tsige - Addis Zemen - New Ethiopian Music 2016 (Official Video) by Legend Entertainment 5 years ago 7 minutes, 15 seconds 99,057 views",Legend Entertainment,99057,99080,23
73,"Abrham Belayneh - Malo - New Ethiopian Music 2016 by Legend Entertainment 5 years ago 4 minutes, 57 seconds 85,966 views",Legend Entertainment,85966,85994,28
74,"Demere Legesse - Mokregna - New Ethiopian Music 2016 I Ethio One Love by Legend Entertainment 5 years ago 5 minutes, 13 seconds 145,820 views",Legend Entertainment,145820,145842,22
75,"Ashenafi Aweke - Jeba Alegn - New Ethiopian Music 2016 I Ethio One Love by Legend Entertainment 5 years ago 6 minutes, 5 seconds 39,642 views",Legend Entertainment,39642,39652,10
76,"Mesfin Bekele - Selam Le Ethiopia - New Ethiopian Music 2016 by Legend Entertainment 5 years ago 8 minutes, 10 seconds 39,559 views",Legend Entertainment,39559,39561,2
77,"Netsanet Melkamu - Eski Chalew - New Ethiopian Music by Ethio One Love by Legend Entertainment 5 years ago 4 minutes, 36 seconds 176,726 views",Legend Entertainment,176726,176831,105
78,"Berry - Melkus Libu New - New Ethiopian Music by Ethio One Love by Legend Entertainment 5 years ago 4 minutes, 3 seconds 42,246 views",Legend Entertainment,42246,42255,9
79,"Haftom Molla (Tsegu) - Aytgedesi - New Ethiopian Music 2016 by Ethio One Love by Legend Entertainment 5 years ago 4 minutes, 2 seconds 26,129 views",Legend Entertainment,26129,26140,11
80,"Dawit Tsige - Bete - New Ethiopian Music 2016 by Legend Entertainment 5 years ago 5 minutes, 51 seconds 51,181 views",Legend Entertainment,51181,51200,19
81,"New Ethiopian Music 2016 - Yidne Oslo - Lebe Tenesa - (Official Music Video) by Legend Entertainment 5 years ago 5 minutes, 8 seconds 45,574 views",Legend Entertainment,45574,45590,16
82,"Fish Twista - yene - (Official Music Video) - New Ethiopian Music 2016 I Ethio One Love by Legend Entertainment 5 years ago 5 minutes, 21 seconds 35,194 views",Legend Entertainment,35194,35232,38
83,"Biruk Befkadu - Gerie chancha - (Official music Video) - New Ethiopian Music 2016 by Legend Entertainment 5 years ago 5 minutes, 7 seconds 47,051 views",Legend Entertainment,47051,47062,11
84,"Mahlet Demere - Agera - (Official Music Video) I New Ethiopian Music 2016 by Legend Entertainment 5 years ago 4 minutes, 27 seconds 83,771 views",Legend Entertainment,83771,83911,140
85,"Endriyas Kelifa - Wede Gede - (Official Audio Video) - New Ethiopian Music 2016 by Legend Entertainment 5 years ago 4 minutes, 53 seconds 35,073 views",Legend Entertainment,35073,35076,3
86,"Ethio One Love TOP MUSIc by Legend Entertainment 5 years ago 1 minute, 23 seconds 6,817 views",Legend Entertainment,6817,6821,4
87,"Dereje Geteye  - Yamarew - (Official Music Video) by Legend Entertainment 5 years ago 6 minutes, 36 seconds 52,532 views",Legend Entertainment,52532,52544,12
88,"Tesfahun Hailu - Engenagn Gojam - (Offical Music Video) by Legend Entertainment 5 years ago 5 minutes, 47 seconds 26,372 views",Legend Entertainment,26372,26402,30
89,"Michael Guyassa - Ahun Ahunma - (Official Music Video) by Legend Entertainment 5 years ago 5 minutes, 38 seconds 24,132 views",Legend Entertainment,24132,24149,17
90,"Yamlaksira (Yami Besemish) - Besew Hager - (Official Music Video) by Legend Entertainment 5 years ago 6 minutes, 11 seconds 24,791 views",Legend Entertainment,24791,24794,3
91,"Mahlet Demere - Mata Mata - (Official Music Video) - New Ethiopian Music by Legend Entertainment 5 years ago 4 minutes, 35 seconds 176,150 views",Legend Entertainment,176150,176208,58
92,"Dereje Nasir - Lanfurona - (Official Music Video) by Legend Entertainment 5 years ago 5 minutes, 27 seconds 156,409 views",Legend Entertainment,156409,156632,223
93,"Nhatty Man & Gara - Lemme Go - (Official Music Video) by Legend Entertainment 5 years ago 3 minutes, 49 seconds 26,917 views",Legend Entertainment,26917,26951,34
94,"Habtamu Waqjira - Sekerku - (Official Music Video) by Legend Entertainment 5 years ago 6 minutes, 5 seconds 14,259 views",Legend Entertainment,14259,14263,4
95,"Addis Kibret - Amaregn - (Official Music Video) by Legend Entertainment 5 years ago 5 minutes, 49 seconds 34,346 views",Legend Entertainment,34346,34350,4
96,"Habtamu Tadese - Yene Zebenay - (Official Music Video) by Legend Entertainment 5 years ago 5 minutes, 52 seconds 57,805 views",Legend Entertainment,57805,57814,9
97,"Tommy Zuk - Lene Wedaj - (Official Audio Video) - New Ethiopian Music 2016 by Legend Entertainment 5 years ago 4 minutes, 47 seconds 58,544 views",Legend Entertainment,58544,58554,10
98,"Heenok Kidaane - Uumamaa Simboo - (Official Music Video) - New Ethiopian Music 2016 by Legend Entertainment 5 years ago 4 minutes, 57 seconds 40,130 views",Legend Entertainment,40130,40132,2
99,"Deme Lula - Yisakal Hilme - (Official Audio Video) - New Ethiopian Music 2016 by Legend Entertainment 5 years ago 3 minutes, 54 seconds 28,783 views",Legend Entertainment,28783,28784,1
100,"Tesfaye Kebede - Digemign - (Official Music Video) - New Ethiopian Music 2016 by Legend Entertainment 5 years ago 5 minutes, 30 seconds 66,197 views",Legend Entertainment,66197,66204,7
101,"Wendi Mak - Ethiopia Yeman Nate - (Official Audio Video) - New Ethiopian Music 2016 by Legend Entertainment 5 years ago 4 minutes, 40 seconds 189,855 views",Legend Entertainment,189855,189938,83
102,"Abel Mulugeta - Shiret - (Offical Sound Truck) - New ethiopian music 2016 by Legend Entertainment 5 years ago 3 minutes, 57 seconds 129,454 views",Legend Entertainment,129454,129468,14
103,"Dani - Yikewet - (Official Music Video) - New Ethiopian Music 2016 by Legend Entertainment 5 years ago 4 minutes, 50 seconds 2,160,442 views",Legend Entertainment,2160442,2173871,13429
104,"Dawit Tsige - yehilme guadegna - (Official Music Video) - New Ethiopian Music 2016 by Legend Entertainment 5 years ago 5 minutes, 52 seconds 44,891 views",Legend Entertainment,44891,44904,13
105,"Helen Girma - Salmotibeh - (Official Music Video) - New Ethiopian music 2016 by Legend Entertainment 5 years ago 7 minutes, 8 seconds 226,649 views",Legend Entertainment,226649,226678,29
106,"Nhatty Man & Gara - Selam - (Official Music Video) - New Ethiopian Music 2016 by Legend Entertainment 5 years ago 5 minutes, 15 seconds 57,845 views",Legend Entertainment,57845,57864,19
107,"Fikeru Talarge - Temeleshi -  ( Official Music Video ) - New Ethiopian Music 2016 by Legend Entertainment 5 years ago 5 minutes, 45 seconds 35,076 views",Legend Entertainment,35076,35083,7
108,"Wendimu Jira - And Bota - (Official Music Video) - New Ethiopian Music 2016 by Legend Entertainment 5 years ago 4 minutes, 34 seconds 1,623,386 views",Legend Entertainment,1623386,1626148,2762
109,"Dereje Getiye  - Yamarew - (Official Music Video) - New Ethiopian music 2016 by Legend Entertainment 5 years ago 6 minutes, 36 seconds 37,245 views",Legend Entertainment,37245,37255,10
110,"Dereje Belay - Emagn - (Official Music Video) - New Ethiopian music 2016 by Legend Entertainment 5 years ago 5 minutes, 7 seconds 40,044 views",Legend Entertainment,40044,40057,13
111,"Mahlet  Demere - Akorefegn - (Official Music Video) - New Ethiopian Music 2016 by Legend Entertainment 5 years ago 4 minutes, 50 seconds 1,478,391 views",Legend Entertainment,1478391,1480995,2604
112,"Dagem Abebe - Yinageral aynish - (Official Music Video) - New Ethiopian Music 2016 by Legend Entertainment 5 years ago 4 minutes, 42 seconds 200,573 views",Legend Entertainment,200573,200768,195
113,"Abel Almaz - Hagere - (Official Music Video) - New Ethiopian Music 2016 by Legend Entertainment 5 years ago 5 minutes, 14 seconds 26,126 views",Legend Entertainment,26126,26140,14
114,"Wendi Mak - Yineda - (Official Audio Video) - New Ethiopian Music 2016 by Legend Entertainment 5 years ago 4 minutes, 50 seconds 309,113 views",Legend Entertainment,309113,309293,180
115,"Mokshez - Zemedewa - (Official Music Video) - New Ethiopian Music 2016 by Legend Entertainment 5 years ago 4 minutes, 3 seconds 2,045,748 views",Legend Entertainment,2045748,2046194,446
116,"Demelash Negussa (Dema Lula) -የወንፈሌው ጥጥ - (Official Audio Video) - New Ethiopian Music 2016 by Legend Entertainment 5 years ago 4 minutes, 38 seconds 30,584 views",Legend Entertainment,30584,30591,7
117,"Zerihun Demese - Lebesh yebel sela - (Official Music Video) - New Ethiopian Music 2016 by Legend Entertainment 5 years ago 4 minutes, 46 seconds 450,291 views",Legend Entertainment,450291,450370,79
118,"Fekeru Talarge - Nigringe - (Official Music Video) - New Ethiopian Music 2016 by Legend Entertainment 5 years ago 4 minutes, 33 seconds 36,068 views",Legend Entertainment,36068,36071,3
119,"Kaleb Areya - Awanday Welaytaye - (Official Music Video) - New Ethiopian Music 2016 by Legend Entertainment 5 years ago 3 minutes, 46 seconds 73,479 views",Legend Entertainment,73479,73496,17
120,"Zelalem Yonas (Zola) - Ente aref - (Official Music Video) -  New Ethiopian Music 2016 by Legend Entertainment 5 years ago 4 minutes, 59 seconds 51,010 views",Legend Entertainment,51010,51023,13
121,"Alemu Tafese - Guragena- (Official Music Video) - New Ethiopian Music 2016 by Legend Entertainment 5 years ago 4 minutes, 59 seconds 108,974 views",Legend Entertainment,108974,109160,186
122,"Mikael Negasa - Maringe beye metaw - (Official Music Video) - New Ethiopian Music 20 by Legend Entertainment 5 years ago 4 minutes, 9 seconds 11,628 views",Legend Entertainment,11628,11633,5
123,"Abinet Agonafir - Ayawikunem - (Official Video) - New Ethiopian Music 2016 by Legend Entertainment 5 years ago 6 minutes, 22 seconds 31,408 views",Legend Entertainment,31408,31443,35
124,"Abinet Agonafir - Semegne- (Official Video) - New Ethiopian Music 2016 by Legend Entertainment 5 years ago 3 minutes, 49 seconds 15,060 views",Legend Entertainment,15060,15067,7
125,"Behailu Lemma (Baya) - Shega - (Official Music Video) - New Ethiopian Music 2016 by Legend Entertainment 5 years ago 3 minutes, 35 seconds 23,131 views",Legend Entertainment,23131,23136,5
126,"Mikael Negasa -Samash Metamema - (Official Music Video) - New Ethiopian Music 2016 by Legend Entertainment 5 years ago 4 minutes, 9 seconds 162,498 views",Legend Entertainment,162498,162502,4
127,"Betelihem Lemma - Tilhinge Sethade - (Official Music Video) - New Ethiopian Music 2016 by Legend Entertainment 5 years ago 6 minutes, 27 seconds 13,752 views",Legend Entertainment,13752,13756,4
128,"Alemu Tafese - Meskil Begurage - (Official Music Video) - New Ethiopian Music 2016 by Legend Entertainment 5 years ago 5 minutes, 53 seconds 125,049 views",Legend Entertainment,125049,125374,325
129,"Bahil - Tigabu Chirnet - Chiwewet bebate - (Official Music Video) - New Ethiopian Music 2016 by Legend Entertainment 5 years ago 7 minutes, 43 seconds 133,772 views",Legend Entertainment,133772,133792,20
130,"Bahil - Birhanu Molla - Shegwa - (Official Music Video) - New Ethiopian Music 2016 by Legend Entertainment 5 years ago 5 minutes, 3 seconds 26,335 views",Legend Entertainment,26335,26368,33
131,"Bahil - Habetamu Alemayew - Yilungal - (Official Music Video) - New Ethiopian Music 2016 by Legend Entertainment 5 years ago 6 minutes, 30 seconds 121,767 views",Legend Entertainment,121767,121840,73
132,"Bahil - Solomon Demela - Yegonder lij nat - (Official Music Video) - New Ethiopian Music 2016 by Legend Entertainment 5 years ago 5 minutes, 53 seconds 152,299 views",Legend Entertainment,152299,152368,69
133,"Bahil - Tadila Fente - Shew Bel No.2 - (Official Music Video) - New Ethiopian Music 2016 by Legend Entertainment 5 years ago 6 minutes, 50 seconds 469,227 views",Legend Entertainment,469227,469645,418
134,"Jad Mesay - Mar b Keremela - (Official  Audio Video) - New Ethiopian Music 2016 by Legend Entertainment 5 years ago 4 minutes, 16 seconds 9,423 views",Legend Entertainment,9423,9423,0
135,"Werkineh Zerihun - Zare New (Official Music Video) - New Ethiopian Music 2016 by Legend Entertainment 5 years ago 5 minutes, 7 seconds 139,940 views",Legend Entertainment,139940,139953,13
136,"Mesfin Olma - Enat - (Official Music Video) - New Ethiopian Music 2016 by Legend Entertainment 5 years ago 5 minutes, 6 seconds 38,402 views",Legend Entertainment,38402,38404,2
137,"Mikael Negasa - Manat (Official Music Video) - New Ethiopian Music 2016 by Legend Entertainment 5 years ago 4 minutes, 52 seconds 15,163 views",Legend Entertainment,15163,15166,3
138,"Habtamu Abreham - Hasset - (Official Music Video) - New Ethiopian Music 2016 by Legend Entertainment 5 years ago 4 minutes, 56 seconds 6,282 views",Legend Entertainment,6282,6283,1
139,"Bahil - Aregash Alene - Hya hya gonder - (Official Music Video) - New Ethiopian Music 2016 by Legend Entertainment 5 years ago 5 minutes, 23 seconds 24,993 views",Legend Entertainment,24993,25010,17
140,"Bahil - Solmon Ademassu - Dehna Ney - (Official Music Video) - New Ethiopin Music 2016 by Legend Entertainment 5 years ago 7 minutes, 17 seconds 37,714 views",Legend Entertainment,37714,37797,83
141,"Bedru Kemal -Ashmak - (Official Music Video) - New Ethiopian Music 2016 by Legend Entertainment 5 years ago 5 minutes, 13 seconds 277,083 views",Legend Entertainment,277083,277521,438
142,"Alemu Tafese - Sokem - (Official Music Video) - New Ethiopian Music 2016 by Legend Entertainment 5 years ago 6 minutes, 33 seconds 103,877 views",Legend Entertainment,103877,103999,122
143,"wenda Konta - Kembatecho - (Official Music Video) - New Ethiopian Music 2016 by Legend Entertainment 5 years ago 5 minutes, 10 seconds 88,520 views",Legend Entertainment,88520,88564,44
144,"Alemtsehay Getnet - Yehun Dehina - (Official Music Video) - New Ethiopian Music 2016 by Legend Entertainment 5 years ago 5 minutes, 51 seconds 43,504 views",Legend Entertainment,43504,43511,7
145,"Papi - Aleme - (Official Music Video) - New Ethiopian Music Video 2016 by Legend Entertainment 5 years ago 4 minutes, 26 seconds 27,822 views",Legend Entertainment,27822,27824,2
146,"Dan Ab - Kukilu - (Official Audio Video) - New Ethiopian music 2016 by Legend Entertainment 5 years ago 4 minutes, 50 seconds 13,478 views",Legend Entertainment,13478,13508,30
147,"Eyerusalm Amde - Fikir Tekafelni - (Official Music Video) - New Ethiopian Music 2016 by Legend Entertainment 5 years ago 6 minutes, 10 seconds 193,809 views",Legend Entertainment,193809,194070,261
148,"Bahil - Tadila Fente - Nama - (Official Music Video) - New Ethiopian Music 2016 by Legend Entertainment 5 years ago 7 minutes, 52 seconds 58,684 views",Legend Entertainment,58684,58700,16
149,"Mebtu Aduinga - Lalemaye - (Official Music Video) - New Ethiopian Music 2016 by Legend Entertainment 5 years ago 6 minutes, 7 seconds 88,444 views",Legend Entertainment,88444,88541,97
150,"Bahil - Dange Wale- Wib abeba -(Official Music Video) - New Ethiopian Music 2016 by Legend Entertainment 5 years ago 6 minutes, 41 seconds 20,628 views",Legend Entertainment,20628,20650,22
151,"Bahil - Birhanu Molla - Raya - ( Official Music Video ) - new Ethiopian Music 2016 by Legend Entertainment 5 years ago 5 minutes, 15 seconds 107,930 views",Legend Entertainment,107930,108196,266
152,"Bahil - Kassahun Taye - Embaye Wey - (Official Music Video) - New Ethiopian Music 2016 by Legend Entertainment 5 years ago 6 minutes, 41 seconds 77,270 views",Legend Entertainment,77270,77290,20
153,"Mahari Kiros - Niyatey - ( Official Music Video ) - New Ethiopian Music 2016 by Legend Entertainment 5 years ago 4 minutes, 20 seconds 25,516 views",Legend Entertainment,25516,25519,3
154,"Melaku Bireda - Amadiwe - (Official Music Video) - New Ethiopian Music 2016 by Legend Entertainment 5 years ago 5 minutes, 40 seconds 95,204 views",Legend Entertainment,95204,95311,107
155,"Tigabu Chirnet -  Birr Talu - (Official Music Video) - New Ethiopian Music 2016 by Legend Entertainment 5 years ago 6 minutes, 51 seconds 182,493 views",Legend Entertainment,182493,182521,28
156,"Zelalem Eshetu - Ney Belwat - (Official Music Video) - New Ethiopian Music 2016 by Legend Entertainment 5 years ago 4 minutes, 32 seconds 247,029 views",Legend Entertainment,247029,247070,41
157,"Afeworke Gebrekidan - Demoni - (Official Music Video ) - New Ethiopian Music 2016 by Legend Entertainment 5 years ago 6 minutes, 11 seconds 20,870 views",Legend Entertainment,20870,20878,8
158,"Bahil - Worku Molla - Saneki - (Official Music Video) - New Ethiopian Music 2016 by Legend Entertainment 5 years ago 5 minutes, 5 seconds 112,320 views",Legend Entertainment,112320,112361,41
159,"Daniel Mehrte - Tey ayhonim - (Official Music Video) - New Ethiopian Music 2016 by Legend Entertainment 5 years ago 4 minutes, 9 seconds 23,312 views",Legend Entertainment,23312,23313,1
160,"Bre Bright - Etbkshalew - (Official Music Video) - New Ethiopian Music 2016 by Legend Entertainment 5 years ago 4 minutes, 46 seconds 150,622 views",Legend Entertainment,150622,150833,211
161,"Abel Mulugeta - Wedo Ayskem Tersa - (Official Music Video ) - New Ethiopian Music 2016 by Legend Entertainment 5 years ago 4 minutes, 43 seconds 197,173 views",Legend Entertainment,197173,197322,149
162,"Selam Akilelu - Zeringne - (Official Music Video) - New Ethiopian Music 2016 by Legend Entertainment 5 years ago 4 minutes, 40 seconds 377,487 views",Legend Entertainment,377487,377741,254
163,"Berry -Liben Moqotal - (Official Music Video) - New Ethiopian Music 2016 by Legend Entertainment 5 years ago 3 minutes, 11 seconds 17,058 views",Legend Entertainment,17058,17058,0
164,"Mehari Degefaw - Yakoragnal - (Official Music Video) - New Ethiopian Music 2016 by Legend Entertainment 5 years ago 7 minutes, 53 seconds 1,576,391 views",Legend Entertainment,1576391,1577474,1083
165,"Kinfe Gebregiorgis - Gamahum - (Official Music Video ) - New Ethiopian Music 2016 by Legend Entertainment 5 years ago 5 minutes, 58 seconds 19,164 views",Legend Entertainment,19164,19168,4
166,"Betelihem Lemma - Menoren wededekut - (Official Music Video) - New Ethiopian Music 2016 by Legend Entertainment 5 years ago 6 minutes, 8 seconds 32,351 views",Legend Entertainment,32351,32358,7
167,"Mandfero Kassahun - Meche yatal - (Official Music Video) - New Ethiopian Music 2016 by Legend Entertainment 5 years ago 6 minutes 55,787 views",Legend Entertainment,55787,55804,17
168,"Mekdes Hailu - yamregnal - (Official Music Video) -  New Ethiopian Music 2016 by Legend Entertainment 5 years ago 4 minutes, 39 seconds 1,288,969 views",Legend Entertainment,1288969,1291171,2202
169,"Abdu Kiyar - Yene Mar - (Official Music Video) - New Ethiopian Music 2016 by Legend Entertainment 5 years ago 5 minutes, 30 seconds 2,477,940 views",Legend Entertainment,2477940,2478290,350
170,"Rahel Haile - Hamimelka - (Official Music Video) -  New Ethiopian Music 2016 by Legend Entertainment 5 years ago 5 minutes, 55 seconds 1,268,375 views",Legend Entertainment,1268375,1271680,3305
171,"Demere Legesse - Yewubedar Wibitua - (Official Audio Video) - New Ethiopian Music 2016 by Legend Entertainment 5 years ago 5 minutes, 34 seconds 27,856 views",Legend Entertainment,27856,27860,4
172,"Abeselom Bihonegn - Melkama - (Official Music Video) - New Ethiopian Music 2016 by Legend Entertainment 5 years ago 5 minutes, 43 seconds 130,255 views",Legend Entertainment,130255,130312,57
173,"Tamrat kahsaye- Lbey meaduley-(Official Music Video)-New Ethiopian Music 2016 by Legend Entertainment 5 years ago 4 minutes, 50 seconds 18,085 views",Legend Entertainment,18085,18086,1
174,"Hanna Alemayehu - Difer libe - (Official Music Video) - New Ethiopian Music 2016 by Legend Entertainment 5 years ago 5 minutes, 21 seconds 187,873 views",Legend Entertainment,187873,187910,37
175,"Melaku Bireda - Werdot - (Official Music Video) - New Ethiopian Music 2016 by Legend Entertainment 5 years ago 4 minutes, 48 seconds 39,536 views",Legend Entertainment,39536,39706,170
176,"Tesfaye Tilahun - Lelisie - (Official Music Video) - New Ethiopian Music 2016 by Legend Entertainment 5 years ago 6 minutes, 11 seconds 373,509 views",Legend Entertainment,373509,373733,224
177,"Yitagesu Nibertu - Gudancehall - (Official Music Video) - New Ethiopian Music 2016 by Legend Entertainment 5 years ago 4 minutes, 41 seconds 35,852 views",Legend Entertainment,35852,35860,8
178,"Michael Negasa - Beaman - (Official Music Video) - New Ethiopian Music 2016 by Legend Entertainment 5 years ago 5 minutes, 41 seconds 14,703 views",Legend Entertainment,14703,14706,3
179,"Endrias Sora - Yayesh Yelem - (Official Music Video) - New Ethiopian Music 2016 by Legend Entertainment 5 years ago 5 minutes, 37 seconds 132,132 views",Legend Entertainment,132132,132180,48
180,"Getish Mamo - Segno Mata - (Official Music Video) - New Ethiopian Music 2016 by Legend Entertainment 5 years ago 4 minutes, 51 seconds 94,364 views",Legend Entertainment,94364,94395,31
181,"Alemeye Getachew - Washew Ende - (Official Music Video) - New Ethiopian Music 2016 by Legend Entertainment 5 years ago 6 minutes, 39 seconds 12,357,495 views",Legend Entertainment,12357495,12391192,33697
182,"Mestawet Adegeh - Sela - (Official Audio Video) - New Ethiopian Music 2016 by Legend Entertainment 5 years ago 4 minutes, 10 seconds 47,839 views",Legend Entertainment,47839,47847,8
183,"Dina Anteneh - Bede - (Official Music Video) - New Ethiopian Music 2016 by Legend Entertainment 5 years ago 5 minutes 5,106,949 views",Legend Entertainment,5106949,5115073,8124
184,"Sami Mekebo - Kanchi Gar - (Official Music Video) - New Ethiopian Music 2016 by Legend Entertainment 5 years ago 4 minutes, 31 seconds 85,213 views",Legend Entertainment,85213,85222,9
185,"Dan Ab - Yehedew Fiker - (Official Music Video) - New Ethiopian Music 2016 by Legend Entertainment 5 years ago 5 minutes, 58 seconds 53,176 views",Legend Entertainment,53176,53200,24
186,"Yiftusera Zerihun - Bos Bos - (Official Music Video) - New Ethiopian Music 2016 by Legend Entertainment 5 years ago 5 minutes, 17 seconds 20,740 views",Legend Entertainment,20740,20741,1
187,"Nuru Mudyi - Ayferam Lbe -  ( Official Music Video)  - New Ethiopian Music 2016 by Legend Entertainment 5 years ago 5 minutes, 48 seconds 54,653 views",Legend Entertainment,54653,54662,9
188,"Abrham Belayneh - Selam yadrgat - (Official Music Video) - New Ethiopian Music 2016 by Legend Entertainment 5 years ago 5 minutes, 40 seconds 443,801 views",Legend Entertainment,443801,443962,161
189,"Nebiyu Solomon - Yehager - (Official Music Video) - New Ethiopian Music 2016 by Legend Entertainment 5 years ago 4 minutes, 5 seconds 43,666 views",Legend Entertainment,43666,43673,7
190,"Zenebe Werku - Eskemeche - (Official Music Video) - New Ethiopian Music 2016 by Legend Entertainment 5 years ago 5 minutes, 5 seconds 20,744 views",Legend Entertainment,20744,20744,0
191,"Berry - Hilina - Live performance with Zion Band - New Ethiopian Music 2016 by Legend Entertainment 5 years ago 4 minutes, 7 seconds 122,668 views",Legend Entertainment,122668,122688,20
192,"Yoni Cash - Smile - (Official Music Video) - New Ethiopian Music 2016 by Legend Entertainment 5 years ago 4 minutes, 2 seconds 16,594 views",Legend Entertainment,16594,16595,1
193,"Demisu Belete - Kurfiyash Yinafkal - (Official Music Video) - New Ethiopian Music 2016 by Legend Entertainment 5 years ago 5 minutes, 30 seconds 113,919 views",Legend Entertainment,113919,113925,6
194,"Bahil - Banchiamalk Getinet - Zare New - (Official Music Video) - New Ethiopian Music 2016 by Legend Entertainment 5 years ago 5 minutes, 34 seconds 24,732 views",Legend Entertainment,24732,24740,8
195,"Tigist Yaregal - Fiker Yibeltal - (Official Music Video) - New Ethiopian Music 2016 by Legend Entertainment 5 years ago 5 minutes, 27 seconds 34,426 views",Legend Entertainment,34426,34431,5
196,"Fitsum Tsegaye - Addis Abeba - (Official Music Video) - New Ethiopian Music 2016 by Legend Entertainment 5 years ago 5 minutes, 4 seconds 112,737 views",Legend Entertainment,112737,112750,13
197,"Bahil - Tadila Fente - Kassa Bale Matebu - (Official Music Video) - New Ethiopian Music 2016 by Legend Entertainment 5 years ago 7 minutes 28,802 views",Legend Entertainment,28802,28810,8
198,"Fitsum Tsegaye - Mela Mela - (Official Music Video) - New Ethiopian Music 2016 by Legend Entertainment 5 years ago 4 minutes, 53 seconds 45,534 views",Legend Entertainment,45534,45542,8
199,"H/Mikael Webale ft. Dinber Adane - Erikum Hip Hop - New Ethiopian Music 2016 by Legend Entertainment 5 years ago 4 minutes, 3 seconds 82,336 views",Legend Entertainment,82336,82382,46
200,"Getish Mamo - Ney Ena - (Official Music Video) - New Ethiopian Music 2016 by Legend Entertainment 5 years ago 4 minutes, 12 seconds 43,511 views",Legend Entertainment,43511,43536,25
201,"Mikael Negasa - Behilmem Bewne - (Official Music Video) - New Ethiopian Music 2016 by Legend Entertainment 5 years ago 4 minutes, 33 seconds 43,525 views",Legend Entertainment,43525,43530,5
202,"Mentesnot Tilahun - Eskemeche - (Official Audio Video) - New Ethiopian Music 2016 by Legend Entertainment 5 years ago 5 minutes, 49 seconds 15,201 views",Legend Entertainment,15201,15202,1
203,"Getish Mamo - Sangebaba - (Official Music Video) - New Ethiopian Music 2016 by Legend Entertainment 5 years ago 5 minutes, 26 seconds 87,137 views",Legend Entertainment,87137,87192,55
204,"Kiflom Abrha - Anchin Mesay - (Official Music Video) - Ethiopian New Music 2016 by Legend Entertainment 5 years ago 5 minutes, 17 seconds 37,759 views",Legend Entertainment,37759,37779,20
205,"Shewangizaw Mehret - Feraol - (Official Music Video) - New Ethiopian Music 2016 by Legend Entertainment 5 years ago 4 minutes, 23 seconds 31,778 views",Legend Entertainment,31778,31784,6
206,"Tesfaye Negatu - Esuan Bicha - (Official Music Video) - New Ethiopian Music 2016 by Legend Entertainment 5 years ago 6 minutes, 2 seconds 50,255 views",Legend Entertainment,50255,50271,16
207,"Mikael Negasa - Anawo - (Official Music Video) - New Ethiopian Music 2016 by Legend Entertainment 6 years ago 4 minutes, 36 seconds 14,176 views",Legend Entertainment,14176,14176,0
208,"Bahil - Aschayew Fetene - Ergib Da Bani - (Official Music Video) - Ethiopian Music 2016 by Legend Entertainment 6 years ago 5 minutes, 46 seconds 15,563 views",Legend Entertainment,15563,15571,8
209,"Bahil - Selemon Demle - Mech Ayeshiwna - (Official Music Video) - New Ethiopian Music 2016 by Legend Entertainment 6 years ago 6 minutes, 19 seconds 17,856 views",Legend Entertainment,17856,17862,6
210,"Abinet Agonafir - Yene Wedase - (Official Video) - New Ethiopiann Music 2016 by Legend Entertainment 6 years ago 4 minutes, 37 seconds 17,906 views",Legend Entertainment,17906,17939,33
211,"Anteneh Aynalem - Zenebech Hamealki - (Official Music Video) - Ethiopian New Music 2016 by Legend Entertainment 6 years ago 4 minutes, 58 seconds 20,470 views",Legend Entertainment,20470,20473,3
212,"Hanna Alemayhu - Sasaleh - (Official Music Video) - New Ethiopian Music 2016 by Legend Entertainment 6 years ago 5 minutes, 5 seconds 107,744 views",Legend Entertainment,107744,107748,4
213,"Ethiopia - WINTA : The Show - Interview With Mikias Chernet by Legend Entertainment 6 years ago 52 minutes 91,753 views",Legend Entertainment,91753,91775,22
214,"Abinet Agonafir - live performance - Hid Yazat - Ethiopian New Music 2016 by Legend Entertainment 6 years ago 6 minutes, 21 seconds 19,826 views",Legend Entertainment,19826,19836,10
215,"Daani´le Angeesaa - Naaf Kottu - (Official Music Video) - New Ethiopian Music 2016 by Legend Entertainment 6 years ago 5 minutes, 26 seconds 14,301 views",Legend Entertainment,14301,14306,5
216,"King Teddy - Addis Hiwet - (Official Music Video) - New Ethiopian Music 2016 by Legend Entertainment 6 years ago 4 minutes, 13 seconds 46,511 views",Legend Entertainment,46511,46522,11
217,"Zenebe Werku - Yehagere Lij - (Official Music Video) - New Ethiopian Music 2016 by Legend Entertainment 6 years ago 6 minutes 232,950 views",Legend Entertainment,232950,232968,18
218,"Getnet Demssie - Bihon - (Official Music Video) - New Ethiopian Music 2016 by Legend Entertainment 6 years ago 3 minutes, 45 seconds 18,292 views",Legend Entertainment,18292,18292,0
219,"Mesfin Erstu (Mess) - Weker - (Official Music Video) - New Ethopian Music 2016 by Legend Entertainment 6 years ago 6 minutes, 7 seconds 457,157 views",Legend Entertainment,457157,457228,71
220,"Adamu Wale - Gojam Lay - (Official Music Video) - New Ethiopian Music 2016 by Legend Entertainment 6 years ago 4 minutes, 12 seconds 44,453 views",Legend Entertainment,44453,44461,8
221,"Fikir Yitagesu - Malina - (Official Music Video) - New Ethiopian Music 2016 by Legend Entertainment 6 years ago 4 minutes, 50 seconds 2,866,160 views",Legend Entertainment,2866160,2867437,1277
222,"Mistre Yonas - Bela - (Official Music Video) - New Ethiopian Music 2016 by Legend Entertainment 6 years ago 3 minutes, 57 seconds 28,352 views",Legend Entertainment,28352,28353,1
223,"Bahil - Kassahun Taye - Leleye - (Official Music Video) - New Ethiopian Music 2016 by Legend Entertainment 6 years ago 5 minutes, 5 seconds 70,559 views",Legend Entertainment,70559,70605,46
224,"Bahil - Semahegn Belew - Alesh Neger - (Official Music Video) - New Ethiopian Music 2016 by Legend Entertainment 6 years ago 7 minutes, 28 seconds 116,529 views",Legend Entertainment,116529,116562,33
225,"Danny Dance - Mamaye - (Official Music Video) - New Ethiopian Music by Legend Entertainment 6 years ago 5 minutes, 18 seconds 17,484 views",Legend Entertainment,17484,17488,4
226,"Ashenafi Aweke - Mare - (Official Music Video) - New Ethiopian Music 2016 by Legend Entertainment 6 years ago 4 minutes, 53 seconds 61,400 views",Legend Entertainment,61400,61410,10
227,"Teka Assefa - Tenichen - (Official Music Video) - New Ethiopian Music 2016 by Legend Entertainment 6 years ago 5 minutes, 34 seconds 79,598 views",Legend Entertainment,79598,79652,54
228,"Nati Haile (Roni) - Yemrthe Gonche - (Official Music video) - New Ethiopian Music 2016 by Legend Entertainment 6 years ago 5 minutes, 55 seconds 121,414 views",Legend Entertainment,121414,121427,13
229,"Sami Habesha - Feker New - (Official Music Video) - Ethiopian Music New 2016 by Legend Entertainment 6 years ago 5 minutes, 30 seconds 157,634 views",Legend Entertainment,157634,157668,34
230,"Milion Abebe - Ginbegna - (Official Music Video) - New Ethiopian Music 2016 by Legend Entertainment 6 years ago 3 minutes, 43 seconds 89,696 views",Legend Entertainment,89696,89702,6
231,"Endryas Sora - Yayesh Yelem - (Official Audio Video) - New Ethiopian Music 2016 by Legend Entertainment 6 years ago 5 minutes, 17 seconds 21,337 views",Legend Entertainment,21337,21340,3
232,"Melaku Bireda - Ziyoze - (Official Music Video) - New Ethiopian Music 2016 by Legend Entertainment 6 years ago 4 minutes, 13 seconds 47,780 views",Legend Entertainment,47780,47785,5
233,"Leuel Sisay and Etenesh Demeke - Ayne Bego - (Official Music Video) - New Ethiopian Music 2016 by Legend Entertainment 6 years ago 6 minutes, 11 seconds 2,170,793 views",Legend Entertainment,2170793,2172535,1742
234,"Gashaw Molla - Alamnshim - (Official Music Video) - New Ethiopian Music 2016 by Legend Entertainment 6 years ago 5 minutes, 49 seconds 270,986 views",Legend Entertainment,270986,271039,53
235,"Enanu Demissie and Sintayew Fanta - Enanye - (Official Music Video) - New Ethiopian Music 2016 by Legend Entertainment 6 years ago 6 minutes, 9 seconds 97,276 views",Legend Entertainment,97276,97291,15
236,"Semahegn Asfaw - Beya Neya - (Official Music Video) - New Ethiopian Music 2016 by Legend Entertainment 6 years ago 5 minutes, 41 seconds 30,593 views",Legend Entertainment,30593,30599,6
237,"Demere Legese And Etenesh Girma - Amrobatal - (Official Music Video) - New Ethiopian Music 2016 by Legend Entertainment 6 years ago 6 minutes, 23 seconds 119,260 views",Legend Entertainment,119260,119292,32
238,"Mesfin Yetesha - Mar Yazenbal - (Official Music Video) - New Ethiopian Music 2016 by Legend Entertainment 6 years ago 6 minutes, 17 seconds 99,220 views",Legend Entertainment,99220,99227,7
239,"Fasil Shimeles - Lehib Eshog - (Official Music Video) - New Ethiopian Music 2016 by Legend Entertainment 6 years ago 7 minutes, 13 seconds 78,065 views",Legend Entertainment,78065,78070,5
240,"King Teddy - Lebo - (Official Music Video) - New Ethiopian Music 2016 by Legend Entertainment 6 years ago 4 minutes, 16 seconds 55,231 views",Legend Entertainment,55231,55236,5
241,"Tommy Zuk - Tewedaj - (Official Music Video) - New Ethiopian Music 2016 by Legend Entertainment 6 years ago 6 minutes, 12 seconds 104,894 views",Legend Entertainment,104894,104977,83
242,"Bahil - Bewketu Sewmehon - Salnekaw - (Official Music Video) - New Ethiopian Music 2016 by Legend Entertainment 6 years ago 5 minutes, 45 seconds 327,378 views",Legend Entertainment,327378,327597,219
243,"Getahun Ketema - Kanchi Belay - (Official Music Video) - New Ethiopian Music 2016 by Legend Entertainment 6 years ago 5 minutes, 36 seconds 25,158 views",Legend Entertainment,25158,25163,5
244,"Yidenekachew Mekonen - Nigerign - (Official Music Video) - New Ethiopian Music 2016 by Legend Entertainment 6 years ago 3 minutes, 36 seconds 351,586 views",Legend Entertainment,351586,351611,25
245,"Ashenafi Zeberga - Siriwe - (Official Music Video) - New Ethiopian Music 2016 by Legend Entertainment 6 years ago 6 minutes, 3 seconds 139,980 views",Legend Entertainment,139980,140051,71
246,"Dani Roma - And Ken - (Official Music Video) - New Ethiopian Music 2016 by Legend Entertainment 6 years ago 5 minutes, 8 seconds 11,204 views",Legend Entertainment,11204,11205,1
247,"Girma Tefera Kassa - Libe Libe - (Official Music Video) - New Ethiopian Music 2016 by Legend Entertainment 6 years ago 4 minutes, 54 seconds 179,603 views",Legend Entertainment,179603,179802,199
248,"Bizuayehu Kifle - Kalesh - (Official Music Video) - New Ethiopian Music 2016 by Legend Entertainment 6 years ago 5 minutes, 27 seconds 195,084 views",Legend Entertainment,195084,195121,37
249,"Dawit Zerihun - Mealeme - (Official Music Video) - New Ethiopian Music 2016 by Legend Entertainment 6 years ago 5 minutes, 25 seconds 198,954 views",Legend Entertainment,198954,198986,32
250,"Wendi Mak - Shi80 - (Official Music Video) - New Ethiopian Music 2016 by Legend Entertainment 6 years ago 4 minutes, 35 seconds 6,204,656 views",Legend Entertainment,6204656,6214268,9612
251,"Fisum T - Ke Hewan - (Official Music Video) - New Ethiopian Music 2016 by Legend Entertainment 6 years ago 3 minutes, 48 seconds 32,734 views",Legend Entertainment,32734,32747,13
252,"Jote Deresu ft. Getachew - Ajeba - (Official Music Video) - New Ethiopian Music 2016 by Legend Entertainment 6 years ago 5 minutes, 38 seconds 190,396 views",Legend Entertainment,190396,190858,462
253,"Zufan Tadesse - Awdamet Yastarken (Official Music Video) - New Ethiopian Music 2016 by Legend Entertainment 6 years ago 5 minutes, 34 seconds 290,055 views",Legend Entertainment,290055,290079,24
254,"Geremew Assefa - Ale Wey - (Official Music Video) - New Ethiopian Music 2016 by Legend Entertainment 6 years ago 4 minutes, 55 seconds 427,075 views",Legend Entertainment,427075,427354,279
255,"Milion Abebe - Zeniye Arada - (Official Music Video) - New Ethiopian Music 2016 by Legend Entertainment 6 years ago 5 minutes, 27 seconds 811,560 views",Legend Entertainment,811560,811626,66
256,"Seada Tesfaye - Asayegn Endemtiwedegn - (Official Music Video) - New Ethiopian Music 2016 by Legend Entertainment 6 years ago 4 minutes, 57 seconds 211,406 views",Legend Entertainment,211406,211526,120
257,"Zenebe Werku - Ewedishalew - (Official Music Video) - New Ethiopian Music 2016 by Legend Entertainment 6 years ago 4 minutes, 50 seconds 88,671 views",Legend Entertainment,88671,88679,8
258,"Misker Tilahun - Tadyalew - (Official Music Video) - Ethiopian New Music 2016 by Legend Entertainment 6 years ago 4 minutes, 56 seconds 24,030 views",Legend Entertainment,24030,24035,5
259,"Mentesnot Tilahun - Altewshim - (Official Music Video) - Ethiopian Music New 2016 by Legend Entertainment 6 years ago 5 minutes, 40 seconds 19,294 views",Legend Entertainment,19294,19294,0
260,"Yosef Tewelde - Gefiteshign - (Official Music Video) - New Ethiopian Music 2015 by Legend Entertainment 6 years ago 6 minutes, 46 seconds 41,379 views",Legend Entertainment,41379,41381,2
261,"Zerubabbel Molla - Wegegna Nesh - (Official Audio Video) - Ethiopian Music New 2015 by Legend Entertainment 6 years ago 4 minutes, 45 seconds 12,758 views",Legend Entertainment,12758,12763,5
262,"Elias Getachew - Amrolatal Foto - (Official Audio Video) - Ethiopian Music New 2015 by Legend Entertainment 6 years ago 4 minutes, 51 seconds 29,646 views",Legend Entertainment,29646,29648,2
263,"Sami Habesha - Feker New - (Official Audio Video) - Ethiopian Music New 2015 by Legend Entertainment 6 years ago 5 minutes, 25 seconds 26,025 views",Legend Entertainment,26025,26025,0
264,"Basil - Nuraddis Seyid - Etatu - (Official Music Video) - Ethiopian Music New 2015 by Legend Entertainment 6 years ago 5 minutes, 3 seconds 1,146,291 views",Legend Entertainment,1146291,1149608,3317
265,"Genene Haile - Min Alebet - (Official music Video) - Ethiopian Music New 2015 by Legend Entertainment 6 years ago 3 minutes, 42 seconds 25,249 views",Legend Entertainment,25249,25268,19
266,"Mentesnot Tilahun - Aydebekim - (Official Audio Video) - Ethiopian Music New 2015 by Legend Entertainment 6 years ago 5 minutes, 36 seconds 7,674 views",Legend Entertainment,7674,7674,0
267,"Nebiyu Solomon - Ameseginalehu - (Official Music Video) - New Ethiopian Music 2015 by Legend Entertainment 6 years ago 5 minutes, 28 seconds 307,220 views",Legend Entertainment,307220,307269,49
268,"Mesfin Zeberga -  Yasenbethu - (Official Music Video) - Ethiopian New Music 2015 by Legend Entertainment 6 years ago 5 minutes, 22 seconds 33,335 views",Legend Entertainment,33335,33343,8
269,"Ethiopia - Bre Bright - Geday - (Official Music Video) - New Ethiopian Music 2015 by Legend Entertainment 6 years ago 4 minutes, 18 seconds 129,953 views",Legend Entertainment,129953,130002,49
270,"Mikias Chernet - Atechenanek - (Official Music Video) - New Ethiopian Music 2015 by Legend Entertainment 6 years ago 6 minutes, 31 seconds 2,656,846 views",Legend Entertainment,2656846,2658737,1891
271,"Mentesnot Tilahun - Fiker Min Tekeme - (Official Audio Video) - Ethiopian Music New 2015 by Legend Entertainment 6 years ago 5 minutes, 29 seconds 13,051 views",Legend Entertainment,13051,13053,2
272,"Tsehay Tesfaye - Emaye - (Oficial Music Video) - New Ethiopian Music 2015 by Legend Entertainment 6 years ago 5 minutes, 3 seconds 18,472 views",Legend Entertainment,18472,18480,8
273,"Abe Werku - Zuma - (Official Music Video) - Ethiopian Music New 2015 by Legend Entertainment 6 years ago 5 minutes, 4 seconds 128,180 views",Legend Entertainment,128180,128212,32
274,"Biruk Befikadu - Gerwa Chamcha - (Official Audio Video) - Ethiopian Music New 2015 by Legend Entertainment 6 years ago 4 minutes, 57 seconds 12,729 views",Legend Entertainment,12729,12729,0
275,"Kaleb Areya - Awanday Welaytaye - (Official Audio Video) - New Ethiopian Music 2015 by Legend Entertainment 6 years ago 3 minutes, 30 seconds 124,170 views",Legend Entertainment,124170,124175,5
276,"Selamawit Nega - Manenetachin - (official Music Video) - Ethiopian Music New 2015 by Legend Entertainment 6 years ago 5 minutes, 18 seconds 24,860 views",Legend Entertainment,24860,24865,5
277,"Mesfin Zeberga - Gena Ewodishalehu - (Official Music Video) - Ethiopian New Music 2015 by Legend Entertainment 6 years ago 6 minutes, 58 seconds 74,508 views",Legend Entertainment,74508,74511,3
278,"King Teddy - Natey Kesanetey - (Official Music Video) - New Ethiopian Music 2015 by Legend Entertainment 6 years ago 4 minutes, 49 seconds 108,377 views",Legend Entertainment,108377,108378,1
279,"Liya Mohamed - Tez Tewis Alegn - (Official Music Video) - Ethiopian New Music 2015 by Legend Entertainment 6 years ago 4 minutes, 1 second 16,342 views",Legend Entertainment,16342,16343,1
280,"Tamrat Kahsaye - Sew Basebew Aywelem - (Official Music Video) - New Ethiopian Music 2015 by Legend Entertainment 6 years ago 4 minutes, 25 seconds 15,559 views",Legend Entertainment,15559,15566,7
281,"Behailu Bayou - Liyuye - (Official Music Video) - New Ethiopian Music 2015 | Ethio One Love by Legend Entertainment 6 years ago 4 minutes, 28 seconds 284,272 views",Legend Entertainment,284272,284618,346
282,"Betty Solomon - Bemesil Chelema - (Official Music Video) - New Ethiopian Music 2015 by Legend Entertainment 6 years ago 6 minutes, 5 seconds 79,384 views",Legend Entertainment,79384,79390,6
283,"Genene Haile - Yesuten Melkama - (Official music Video) - New Ethiopian Music 2015 by Legend Entertainment 6 years ago 3 minutes, 54 seconds 30,065 views",Legend Entertainment,30065,30090,25
284,"Mamila Lukas - Ethiopia Lay - (Official Music Video) - New Ethiopian Music 2015 by Legend Entertainment 6 years ago 4 minutes, 51 seconds 63,697 views",Legend Entertainment,63697,63728,31
285,"Dereje Belay - Yekir - (Official Music Video) - New Ethiopian Music 2015 by Legend Entertainment 6 years ago 5 minutes, 46 seconds 281,187 views",Legend Entertainment,281187,282163,976
286,"Yohana Belay - Nalign - (Official Music Video) - New Ethiopian Music 2015 by Legend Entertainment 6 years ago 4 minutes, 52 seconds 113,813 views",Legend Entertainment,113813,113861,48
287,"Melaku Bireda - Alem - (Official Music Video) - New Ethiopian New Music 2015 by Legend Entertainment 6 years ago 5 minutes, 55 seconds 23,127 views",Legend Entertainment,23127,23130,3
288,"Chernet G/Michael - Tew Lebe - (Official Music Video) - New Ethiopian Music 2015 by Legend Entertainment 6 years ago 5 minutes, 38 seconds 205,734 views",Legend Entertainment,205734,205785,51
289,"Gizachew Teshome and Meselu F - Ayifres Betachen - (Official Music Video) - New Ethiopian Music 2015 by Legend Entertainment 6 years ago 6 minutes, 47 seconds 337,911 views",Legend Entertainment,337911,339331,1420
290,"Bahil - Gizachew Teshome - Tangut Nr.2 - (Official Music Video) - New Ethiopian Music 2015 by Legend Entertainment 6 years ago 6 minutes, 3 seconds 125,347 views",Legend Entertainment,125347,125500,153
291,"Mastewal Berihun - Gudea - (Official Music Video) - New Ethiopian Music 2015 by Legend Entertainment 6 years ago 5 minutes, 43 seconds 209,157 views",Legend Entertainment,209157,209184,27
292,"Andupa Teshome - Mahamud Ga - (Official Music Video) - New Ethiopian Music 2015 by Legend Entertainment 6 years ago 5 minutes, 31 seconds 5,685,557 views",Legend Entertainment,5685557,5688496,2939
293,"Ethiopia - Ziggy Zaga - Sawa Sawa stage performance - New Ethiopian Music 2015 by Legend Entertainment 6 years ago 4 minutes, 26 seconds 38,678 views",Legend Entertainment,38678,38687,9
294,"Kebebush Negash - Belele Hilwene - (Official Music Video) - New Ethiopian Music 2015 by Legend Entertainment 6 years ago 3 minutes, 35 seconds 21,062 views",Legend Entertainment,21062,21112,50
295,"Nuraddis Seyid and Yoni Yoye - Beflega - (Official Music Video) - New Ethiopian Music 2015 by Legend Entertainment 6 years ago 5 minutes, 43 seconds 366,151 views",Legend Entertainment,366151,366198,47
296,"Liya Mohamed - Mama Ethiopia - (Official Music Video) - New Ethiopian Music 2015 by Legend Entertainment 6 years ago 3 minutes, 59 seconds 44,739 views",Legend Entertainment,44739,44739,0
297,"Ethiopia - Zekarias Asamrew and Chernet G/michael - (Official Music Video) New Ethiopian Music 2015 by Legend Entertainment 6 years ago 4 minutes, 44 seconds 11,222 views",Legend Entertainment,11222,11222,0
298,"Kenubeshe Abebe - Shalom - (Official Music Video) - New Ethiopian Music 2015 by Legend Entertainment 6 years ago 5 minutes, 42 seconds 46,745 views",Legend Entertainment,46745,46752,7
299,"Ethiopia - Miki Lala - Be3te (በ3ቴ) - (Official Music Video) New Ethiopian Music 2015 by Legend Entertainment 6 years ago 5 minutes, 5 seconds 106,839 views",Legend Entertainment,106839,106868,29
300,"Dan Admasu - Semi Lalagegn - (Official Audio Video) - New Ethiopian Music 2015 by Legend Entertainment 6 years ago 5 minutes, 32 seconds 43,998 views",Legend Entertainment,43998,44086,88
301,"Dan Admasu - Nigeregn Beya Ethiopia - (Official Audio Video) - New Ethiopian Music 2015 by Legend Entertainment 6 years ago 6 minutes, 30 seconds 28,279 views",Legend Entertainment,28279,28339,60
302,"Dan Admasu - Gurra Ayseram - (Official Audio Video) - New Ethiopian Music Video 2015 by Legend Entertainment 6 years ago 5 minutes, 21 seconds 25,801 views",Legend Entertainment,25801,25874,73
303,"Dan Admasu - Petros - (Official Audio Video) - New Ethiopian Music 2015 by Legend Entertainment 6 years ago 5 minutes, 5 seconds 32,045 views",Legend Entertainment,32045,32133,88
304,"Dan Admasu - Liken Ayehut - (Official Audio Video) - New Ethiopian Music 2015 by Legend Entertainment 6 years ago 4 minutes, 57 seconds 25,019 views",Legend Entertainment,25019,25088,69
305,"Dan Admasu - Wedehuala - (Official Audio Video) - New Ethiopian Music 2015 by Legend Entertainment 6 years ago 5 minutes, 2 seconds 73,231 views",Legend Entertainment,73231,73349,118
306,"Dan Admasu - Higgu Annd New - (Official Audio Video) - New Ethiopian Music 2015 by Legend Entertainment 6 years ago 6 minutes, 18 seconds 33,857 views",Legend Entertainment,33857,33934,77
307,"Ethiopia - Yared Negu - Kore Reyasta - (Official Music Video) - New Ethiopian Music 2015 by Legend Entertainment 6 years ago 4 minutes, 27 seconds 1,655,350 views",Legend Entertainment,1655350,1657136,1786
308,"Saba Yenehun - Gondere Negn Yale - (Official Music Video) - New Ethiopian Music 2015 by Legend Entertainment 6 years ago 4 minutes, 53 seconds 67,097 views",Legend Entertainment,67097,67100,3
309,"Kalkidan Meshesha - Ema - (Official Music Video) - New Ethiopian Music 2015 by Legend Entertainment 6 years ago 5 minutes, 55 seconds 2,809,215 views",Legend Entertainment,2809215,2820978,11763
310,"Leul Alemu - Yahayat - (Official Music Video) - New Ethiopian Music 2015 by Legend Entertainment 6 years ago 4 minutes, 42 seconds 20,419 views",Legend Entertainment,20419,20426,7
311,"Nebiyu Solomon - Afu Beyign - (Official Music Video) - New Ethiopian Music 2015 by Legend Entertainment 6 years ago 5 minutes, 56 seconds 55,028 views",Legend Entertainment,55028,55057,29
312,"Mesfin Bekele - Welelawa - (Official Music Video) - New Ethiopian Music by Legend Entertainment 6 years ago 5 minutes, 23 seconds 225,216 views",Legend Entertainment,225216,225349,133
313,"Ethiopia - Mikimos, LiL K, Ahemed Teshome and Fitsum G/Tsadiq - Bul Ebulun by Legend Entertainment 6 years ago 4 minutes, 9 seconds 276,451 views",Legend Entertainment,276451,276478,27
314,"King Teddy Ft Dj Jote - O konjiye - (Official Music Video) - New Ethiopian Music 2015 by Legend Entertainment 6 years ago 4 minutes, 41 seconds 186,807 views",Legend Entertainment,186807,186837,30
315,"Ermiyas Tesfaye - Nafkotesh Metana - (Official Music Video) - New Ethiopian Music 2015 by Legend Entertainment 6 years ago 6 minutes, 18 seconds 115,930 views",Legend Entertainment,115930,115945,15
316,"Ethiopia - Esubalew Yetayew - Mare Mare - (Official Music Video) - New Ethiopian Music 2015 by Legend Entertainment 6 years ago 4 minutes, 8 seconds 167,916 views",Legend Entertainment,167916,167956,40
317,"Ethiopia - Dina Anteneh - Gamme - (Official Music Video) - New Ethiopian Music 2015 by Legend Entertainment 6 years ago 6 minutes, 16 seconds 695,094 views",Legend Entertainment,695094,700703,5609
318,"Ethiopia - Zola - Anchima Lene - (Official Music Video) - New Ethiopian Music 2015 by Legend Entertainment 6 years ago 5 minutes, 57 seconds 17,176 views",Legend Entertainment,17176,17177,1
319,"Dereje Bela and Etenesh Demeke - Eshururu - (Official Music Video) - New Ethiopian Music 2015 by Legend Entertainment 6 years ago 7 minutes, 6 seconds 606,576 views",Legend Entertainment,606576,606896,320
320,"Mentesnot Tilahun - Hodye - (Official Music Video) - New Ethiopian Music 2015 by Legend Entertainment 6 years ago 5 minutes, 40 seconds 24,201 views",Legend Entertainment,24201,24209,8
321,"Bahil - Gizachew Teshome - Asnikalech - (Official Music Video) - New Ethiopian Music 2015 by Legend Entertainment 6 years ago 6 minutes, 24 seconds 1,150,893 views",Legend Entertainment,1150893,1152616,1723
322,"Ethiopia - Michael Lema - Libe Sira Feto - (Official Music Video) - New Ethiopian Music 2015 by Legend Entertainment 6 years ago 4 minutes, 21 seconds 165,335 views",Legend Entertainment,165335,165482,147
323,"Ethiopia - Yidnekachew Tsegaye - Alew Negir - (Official Music Video) - New Ethiopian Music 2015 by Legend Entertainment 6 years ago 5 minutes, 11 seconds 72,076 views",Legend Entertainment,72076,72088,12
324,"Ethiopia - Mikeyas Solomon - Weleyewa - (Official Music Video) - New Ethiopian Music 2015 by Legend Entertainment 6 years ago 6 minutes, 22 seconds 271,955 views",Legend Entertainment,271955,272044,89
325,"Abinet Agonafir - Astaraki - (Official Music Video) - New Ethiopian Music 2015 by Legend Entertainment 6 years ago 6 minutes, 16 seconds 169,269 views",Legend Entertainment,169269,169425,156
326,"Eyerusalem Amdea - Tswet Fekeri - (Official Music Video) - New Ethiopian Music 2015 by Legend Entertainment 6 years ago 4 minutes, 33 seconds 45,212 views",Legend Entertainment,45212,45491,279
327,"Yodit Tariku - Salayih - (Official Music Video) - New Ethiopian Music 2015 by Legend Entertainment 6 years ago 5 minutes, 28 seconds 96,429 views",Legend Entertainment,96429,96447,18
328,"Ethiopia - Andinet Bogale - Welaita Afrika - (Official Music Video) - New Ethiopian music 2015 by Legend Entertainment 6 years ago 5 minutes, 13 seconds 8,136 views",Legend Entertainment,8136,8151,15
329,"Ethiopia - Fikremariam Gebru - Yimechen - (Official Music Video) - New Ethiopian Music 2015 by Legend Entertainment 6 years ago 4 minutes, 20 seconds 15,459 views",Legend Entertainment,15459,15461,2
330,"Miky Yo - Wey Deneshi - (Official Music Video) - New Ethiopian Music 2015 by Legend Entertainment 6 years ago 4 minutes, 15 seconds 14,471 views",Legend Entertainment,14471,14483,12
331,"Ethiopia - Ashu Geremew (Weretegna) - Sew Adrgign - New Ethiopian Music 2015 by Legend Entertainment 6 years ago 4 minutes, 28 seconds 195,691 views",Legend Entertainment,195691,195711,20
332,"Ethiopia - Tamrat Desta - Keza Sefer - (Official Music Video) - New Ethiopian Music 2015 by Legend Entertainment 6 years ago 5 minutes, 10 seconds 2,059,119 views",Legend Entertainment,2059119,2068922,9803
333,"Lij Michael  - Zaray Yehun Neg - (Official Music Video) - New Ethiopian Music 2015 by Legend Entertainment 6 years ago 4 minutes, 31 seconds 72,610 views",Legend Entertainment,72610,72621,11
334,"Weynishet Belew - Awi Kantalay - (Official Music Video) - New Ethiopian Music 2015 Weyneshet by Legend Entertainment 6 years ago 6 minutes, 41 seconds 41,634 views",Legend Entertainment,41634,41683,49
335,"Ethiopia - Yafet Atlaw - Amalele - (Official Music Video) - New Ethiopian music 2015 by Legend Entertainment 6 years ago 6 minutes, 51 seconds 567,130 views",Legend Entertainment,567130,567185,55
336,"Ethiopia - Saba Yenehun - Kegone - (Official Music Video) - New Ethiopian Music 2015 by Legend Entertainment 6 years ago 5 minutes, 31 seconds 172,986 views",Legend Entertainment,172986,173020,34
337,"Ethiopia - Yidnekachew Tsegaye - Girgir - (Official Music Video) - New Ethiopian Music 2015 by Legend Entertainment 6 years ago 4 minutes, 23 seconds 82,961 views",Legend Entertainment,82961,82965,4
338,"Ethiopia - Fitsum Gebretsadik - Lemiwedih Libe -  (official music video) - New Ethiopian Music 2015 by Legend Entertainment 6 years ago 3 minutes, 55 seconds 109,605 views",Legend Entertainment,109605,109611,6
339,"Ethiopia - Deme Lula - Ader Bane - (Official Music Video) - New Ethiopian Music 2015 by Legend Entertainment 6 years ago 4 minutes, 48 seconds 65,217 views",Legend Entertainment,65217,65250,33
340,"Ethiopia - Teddy Yo - Addis Abeba - (Official Video) - New Ethiopian Music 2015 by Legend Entertainment 6 years ago 3 minutes, 22 seconds 228,949 views",Legend Entertainment,228949,229411,462
341,"Mulugeta Lema - Yaya - (Official Music Video) - New Ethiopian Music 2015 by Legend Entertainment 6 years ago 5 minutes, 59 seconds 115,580 views",Legend Entertainment,115580,115632,52
342,"Dawit Alemayehu - Yizenbal - (Official Music Video) - New Ethiopian Music 2015 by Legend Entertainment 6 years ago 5 minutes, 13 seconds 1,868,423 views",Legend Entertainment,1868423,1868892,469
343,"Dani Roma - Konjo Nat - (Official Music Video) - New Ethiopian Music 2015 by Legend Entertainment 6 years ago 4 minutes, 53 seconds 890,199 views",Legend Entertainment,890199,890458,259
344,"Ethiopia - Ziggy Zaga - Jilo - (Official Music Video) - New Ethiopian Music 2015 by Legend Entertainment 6 years ago 4 minutes, 13 seconds 878,533 views",Legend Entertainment,878533,879086,553
345,"Fasil Shimeles - Almaze - (Official Music Video) - New Ethiopian Music 2015 by Legend Entertainment 6 years ago 4 minutes, 15 seconds 168,456 views",Legend Entertainment,168456,168496,40
346,"Wendi Mak - Yenea Mar - (Official Music Video) - New Ethiopian Music 2015 by Legend Entertainment 6 years ago 5 minutes, 27 seconds 3,584,290 views",Legend Entertainment,3584290,3587565,3275
347,"Dan Admasu - Zim Alilim - (Official Audio Video) - New Ethiopian Music 2015 by Legend Entertainment 6 years ago 5 minutes, 10 seconds 30,966 views",Legend Entertainment,30966,31014,48
348,"Dan Admasu - Tadiyea - (Official Audio Video) - New Ethiopian Music 2015 by Legend Entertainment 6 years ago 5 minutes, 28 seconds 23,778 views",Legend Entertainment,23778,23823,45
349,"Dan Admasu - Abay - (Official Audio Video) - New Ethiopian Music 2015 by Legend Entertainment 6 years ago 5 minutes, 26 seconds 23,713 views",Legend Entertainment,23713,23760,47
350,"Haileyesus Girma - Aba Alem Limena - (Official Music Video) - New Ethiopian Music 2015 by Legend Entertainment 6 years ago 7 minutes, 22 seconds 114,848 views",Legend Entertainment,114848,114868,20
351,"G Mesay Kebede - Gelaglegn - (Official Music  Video) - New Ethiopian Music 2015 by Legend Entertainment 6 years ago 5 minutes, 31 seconds 1,979,889 views",Legend Entertainment,1979889,1980247,358
352,"Nhatty Man & The Lalibelas - Andneger አይከፋ ገፅሽ New Ethiopian Music 2015 by Legend Entertainment 6 years ago 4 minutes, 42 seconds 31,909 views",Legend Entertainment,31909,31940,31
353,"Andy Amare - Alekshim - (Official Music Video) - New Ethiopian Music 2015 by Legend Entertainment 6 years ago 5 minutes 905,400 views",Legend Entertainment,905400,906746,1346
354,"Mikias Chernet - Atechenanek - (Official Audio Video) - New Ethiopian Music 2015 by Legend Entertainment 6 years ago 5 minutes, 56 seconds 786,121 views",Legend Entertainment,786121,786343,222
355,"Dina Anteneh - Nama - (Official Music Video) - New Ethiopian Music 2015 by Legend Entertainment 6 years ago 4 minutes, 38 seconds 10,499,495 views",Legend Entertainment,10499495,10508486,8991
356,"Ethiopia - Saba Yenehun - Alemdem - (Official Music Video) - New Ethiopian Music 2015 by Legend Entertainment 6 years ago 5 minutes, 35 seconds 218,677 views",Legend Entertainment,218677,218761,84
357,"Ethiopia - Getish Mamo - Tewedegnalech - (Official Audio Video) - New Ethiopian Music 2015 by Legend Entertainment 6 years ago 4 minutes, 37 seconds 100,511 views",Legend Entertainment,100511,100554,43
358,"Abrham Belayneh - Nafkote - (Official Audio Video) - New Ethiopian music 2015 by Legend Entertainment 6 years ago 5 minutes, 19 seconds 53,901 views",Legend Entertainment,53901,53905,4
359,"Ethiopia - Bewketu Sewmehon - Anchi Yene Abeba Nesh - New Ethiopian Music 2015 by Legend Entertainment 6 years ago 7 minutes, 14 seconds 706,446 views",Legend Entertainment,706446,706588,142
360,"Ethiopia - Frehiwot Sleshi - Awey Ena - (Official Music Video) - New Ethiopian Music 2015 by Legend Entertainment 6 years ago 5 minutes, 57 seconds 141,779 views",Legend Entertainment,141779,141794,15
361,"Ethiopia - Ziggy Zaga - Marign Hagera - (Official Music Video) - New Ethiopian Music 2015 by Legend Entertainment 6 years ago 4 minutes, 57 seconds 581,878 views",Legend Entertainment,581878,582108,230
362,"Fikremariam Gebru - Min alebesh - (Official Music Video) - New Ethiopian Music 2015 by Legend Entertainment 6 years ago 4 minutes, 59 seconds 227,564 views",Legend Entertainment,227564,227645,81
363,"Ethiopia - Getish Mamao - Keftosh Endalay - (Official Music Video) - New Ethiopian music 2015 by Legend Entertainment 6 years ago 4 minutes, 10 seconds 98,562 views",Legend Entertainment,98562,98603,41
364,"Ethiopia - Abeselom Bihonegn ft . Eyerusalem Getu - Sega keharer dire nat - New Ethiopian Music 2015 by Legend Entertainment 6 years ago 7 minutes, 26 seconds 2,381,181 views",Legend Entertainment,2381181,2381982,801
365,"Ethiopia - Addis Gurmessa - Amogn - (Official Music Video) - New Ethiopian music 2015 by Legend Entertainment 6 years ago 5 minutes, 34 seconds 196,330 views",Legend Entertainment,196330,196399,69
366,"Ethiopia - Emebet Negasi - Zoma New - (Official Music Video) - New Ethiopian Music 2015 by Legend Entertainment 6 years ago 6 minutes, 33 seconds 761,619 views",Legend Entertainment,761619,762226,607
367,"Mesfin Bekele - Aseresh Mechiw - New Ethiopian Music 2015 by Legend Entertainment 6 years ago 5 minutes, 23 seconds 14,118,201 views",Legend Entertainment,14118201,14139509,21308
368,"Ethiopia - Nebiyu Solomon - Konjo Nesh - (Official Music Video) - New Ethiopian Music 2015 by Legend Entertainment 6 years ago 4 minutes, 21 seconds 169,822 views",Legend Entertainment,169822,169845,23
369,"Ethiopia - Yamlaksira - Besmish - (Official Music Video) - New Ethiopian Music 2015 by Legend Entertainment 6 years ago 6 minutes, 25 seconds 239,215 views",Legend Entertainment,239215,239225,10
370,"Ethiopia - Miky Lala - Ere Gude - (Official Musci Video) - New Ethiopian Music 2015 by Legend Entertainment 6 years ago 5 minutes, 3 seconds 178,056 views",Legend Entertainment,178056,178065,9
371,"Bahil - Madingo Afework - Tangut - (Official music Video) - New Ethiopian Music 2015 by Legend Entertainment 6 years ago 5 minutes, 32 seconds 1,357,715 views",Legend Entertainment,1357715,1359100,1385
372,"Ethiopia - Tiruedel Zenebe - Guitar - (Official Music Video) - New Ethiopian Music 2015 by Legend Entertainment 6 years ago 5 minutes, 8 seconds 82,161 views",Legend Entertainment,82161,82170,9
373,"Ethiopia - Daniel Zewdu - Yezna - (Official Music Video) - New Ethiopian Music 2015 by Legend Entertainment 6 years ago 5 minutes, 20 seconds 457,565 views",Legend Entertainment,457565,457608,43
374,"Ethiopia - Seblewengel Zmikael - Lakolapapisew - (Official Music Video) - New Ethiopian Music 2015 by Legend Entertainment 6 years ago 4 minutes, 49 seconds 87,091 views",Legend Entertainment,87091,87097,6
375,"Ethiopia - Yon Addis - Shomkush - (Official Music Video) - New Ethiopian Music 2015 by Legend Entertainment 6 years ago 5 minutes, 18 seconds 58,880 views",Legend Entertainment,58880,58898,18
376,"Ethiopia - Yared Negu - Yemerkato Arada - (Official Music Video) - New Ethiopian Music 2015 by Legend Entertainment 6 years ago 5 minutes, 25 seconds 2,441,730 views",Legend Entertainment,2441730,2442676,946
377,"Ethiopia - Getish Mamo - Kelebe Aydelem - (Official Audio Video) - New Ethiopian Music 2015 by Legend Entertainment 6 years ago 5 minutes, 40 seconds 121,027 views",Legend Entertainment,121027,121043,16
378,"Ethiopia - Michael Lema - Astawesalew - (Official Music Video) - New Ethiopian Music 2015 by Legend Entertainment 6 years ago 4 minutes, 33 seconds 362,719 views",Legend Entertainment,362719,362865,146
379,"Ethiopia - WINTA: The Show - Episode #52 by Legend Entertainment 6 years ago 21 minutes 53,877 views",Legend Entertainment,53877,53877,0
380,"Ethiopia - Abebe Kefeni - Jininna - (Official Music Video) - New Ethiopian Music 2015 by Legend Entertainment 6 years ago 5 minutes, 59 seconds 126,209 views",Legend Entertainment,126209,126221,12
381,"Ethiopia - Eniyachew Fanto and Messay Goa - Regga Hawassa - New Ethiopian Music 2015 by Legend Entertainment 6 years ago 5 minutes, 51 seconds 19,877 views",Legend Entertainment,19877,19878,1
382,"Ethiopia - Mentesnot Tilahun - Yekelkel - (Official Music Video) - New Ethiopian Music 2015 by Legend Entertainment 6 years ago 5 minutes, 4 seconds 85,590 views",Legend Entertainment,85590,85595,5
383,"Ethiopia - Abinet Agonafir - Manew Yalew - (Official Music Video) - New Ethiopian Music 2015 by Legend Entertainment 6 years ago 5 minutes, 41 seconds 1,409,518 views",Legend Entertainment,1409518,1410373,855
384,"Ethiopia - Tomi Zuk - Sika Endayat - (Official Musik Video) - New Ethiopian Music 2015 by Legend Entertainment 6 years ago 4 minutes, 53 seconds 37,220 views",Legend Entertainment,37220,37223,3
385,"Ethiopia - Mamila Lukas - Harerga - (Official Music Video) - New Ethiopian Music 2015 by Legend Entertainment 6 years ago 5 minutes, 50 seconds 457,178 views",Legend Entertainment,457178,457798,620
386,"Ethiopia - Bre Bright - Mearey - (Official Music Video) - New Ethiopian Music 2015 by Legend Entertainment 6 years ago 5 minutes, 11 seconds 1,726,414 views",Legend Entertainment,1726414,1728169,1755
387,"Ethiopia - WINTA: The Show - Episode #50 by Legend Entertainment 6 years ago 1 hour, 1 minute 65,967 views",Legend Entertainment,65967,65969,2
388,"Ethiopia - Mestawet Adegeh - Ayna Aye - (Official Music Video) - New Ethiopian Music 2015 by Legend Entertainment 6 years ago 4 minutes, 9 seconds 86,331 views",Legend Entertainment,86331,86336,5
389,"Ethiopia - Binny Lastta - Alohe - (Official Audio Video) - New Ethiopian Music 2015 by Legend Entertainment 6 years ago 7 minutes, 48 seconds 49,241 views",Legend Entertainment,49241,49243,2
390,"Ethiopia - Ziggy Zaga - Feraw - (Official Audio Video) - New Ethiopian music 2015 by Legend Entertainment 6 years ago 5 minutes, 30 seconds 91,465 views",Legend Entertainment,91465,91467,2
391,"Wendi Mak - Kebedegn - (Official Audio Video) - New Ethiopian Music 2015 by Legend Entertainment 6 years ago 4 minutes, 48 seconds 196,338 views",Legend Entertainment,196338,196338,0
392,"Ethiopia - WINTA: The Show - Episode #49 by Legend Entertainment 6 years ago 24 minutes 36,682 views",Legend Entertainment,36682,36704,22
393,"Andinet Bogale - Na beyign - (Official Music Video) - New Ethiopian Music 2015 by Legend Entertainment 6 years ago 5 minutes, 39 seconds 42,463 views",Legend Entertainment,42463,42463,0
394,"Ethiopia - Sami Tesfaye - Nafkot - (Official Music Video) - New Ethiopian Music 2015 by Legend Entertainment 6 years ago 5 minutes, 38 seconds 59,236 views",Legend Entertainment,59236,59237,1
395,"Temesgen Gebregziabher - Ney Jema - (Official Music Video) New Ethiopian Music 2015 by Legend Entertainment 6 years ago 5 minutes, 2 seconds 3,681,450 views",Legend Entertainment,3681450,3690635,9185
396,"Ethiopia - Michael Lema - Des Bilagnalach - (Official Music Video) - New Ethiopian Music 2015 by Legend Entertainment 6 years ago 3 minutes, 37 seconds 35,640 views",Legend Entertainment,35640,35676,36
397,"Ethiopia - Tamrat Desta - Fitsum Selam - (Official Music Video) - New Ethiopian Music 2015 by Legend Entertainment 6 years ago 5 minutes, 23 seconds 1,510,141 views",Legend Entertainment,1510141,1511420,1279
398,"Ethiopia - Rahel Haile - Awdeamtena - (Official Music Video) - New Music Video 2015 by Legend Entertainment 6 years ago 5 minutes, 59 seconds 855,219 views",Legend Entertainment,855219,855808,589
399,"Ethiopia - Selemon Shanko - Awanday - (Official Music Video) - New Ethiopian Music 2015 by Legend Entertainment 6 years ago 5 minutes, 46 seconds 13,142 views",Legend Entertainment,13142,13142,0
400,"Ethiopia - Mekdes Abebe - Ende helm - New Ethiopian Music 2015 by Legend Entertainment 6 years ago 6 minutes, 20 seconds 354,864 views",Legend Entertainment,354864,354916,52
401,"Ethiopia - Yohanes (Jona) - Fidel - (Official Music Video) - New Ethiopian Music 2015 by Legend Entertainment 6 years ago 3 minutes, 39 seconds 19,067 views",Legend Entertainment,19067,19088,21
402,"Ethiopia - BIbi Kabtamu - Ababicho - (Official Music Video) - New Ethiopian Music 2015 by Legend Entertainment 6 years ago 4 minutes, 55 seconds 42,526 views",Legend Entertainment,42526,42566,40
403,"Ethiopia - Daniel Sintayehu - Fereche - (Official Music Video) - New Ethiopian Music 2015 by Legend Entertainment 6 years ago 5 minutes, 26 seconds 16,165 views",Legend Entertainment,16165,16209,44
404,"Ethiopia - Izak Asefa - Ney Jima - (Official Music Video) - New Ethiopian Music 2015 by Legend Entertainment 6 years ago 5 minutes, 33 seconds 19,725 views",Legend Entertainment,19725,19740,15
405,"Ethiopia - Mieraf Assefa - Wendime Hunegn Alechign -  New Ethiopian Music 2015 by Legend Entertainment 6 years ago 5 minutes, 46 seconds 79,563 views",Legend Entertainment,79563,79578,15
406,"Ethiopia - Biniyam Eshetu - Balawkish Min Neber - (Official Music Video) - New Ethiopian Music 2015 by Legend Entertainment 6 years ago 5 minutes 14,259 views",Legend Entertainment,14259,14264,5
407,"Ethiopia - Ethio Afro Dance - (Official Dance Video) - New Ethiopian Music 2015 by Legend Entertainment 6 years ago 5 minutes, 9 seconds 25,861 views",Legend Entertainment,25861,25865,4
408,"Ethiopia - Abeba Zemu - Tamen - (Official Music Video) - New Ethiopian Music 2015 by Legend Entertainment 6 years ago 4 minutes, 1 second 10,678 views",Legend Entertainment,10678,10679,1
409,"Ethiopia - WINTA: The Show - Episode #47 by Legend Entertainment 6 years ago 28 minutes 68,432 views",Legend Entertainment,68432,68434,2
410,"Ethiopia - Biniyam Eshetu - Ilyahay - (Official Music Video) - Ethiopian Music 2015 by Legend Entertainment 6 years ago 5 minutes, 38 seconds 10,038 views",Legend Entertainment,10038,10041,3
411,"Ethiopia - Danawit mohamed - Gedelegn - (Official Music Video) - Ethiopian Music 2015 by Legend Entertainment 6 years ago 5 minutes, 11 seconds 10,193 views",Legend Entertainment,10193,10197,4
412,"Bahil - Beweketu Sewmehon - Gusem Gusem - (Official Music Video) - New Ethiopian Music 2015 by Legend Entertainment 6 years ago 5 minutes, 38 seconds 439,454 views",Legend Entertainment,439454,439635,181
413,"Ethiopia - Henok Muhdin - Jichisa - (Official Music Video) - New Ethiopian Music 2015 by Legend Entertainment 6 years ago 4 minutes, 35 seconds 14,276 views",Legend Entertainment,14276,14277,1
414,"Ethiopia - Dereje Bezuwerk - Lefew Nana - (Official Music Video) - New Ethiopian Music 2015 by Legend Entertainment 6 years ago 7 minutes, 21 seconds 83,751 views",Legend Entertainment,83751,83791,40
415,"Ethiopia - Moges Mebratu - Yene Hasab - (Official Music Video) - New Ethiopian Music 2015 by Legend Entertainment 6 years ago 4 minutes, 27 seconds 28,095 views",Legend Entertainment,28095,28127,32
416,"Ethiopia - Aschenaki Bekele - Nana (Official New Video) New Ethiopian Music 2015 by Legend Entertainment 6 years ago 4 minutes, 52 seconds 10,414 views",Legend Entertainment,10414,10414,0
417,"Ethiopia - Abdu Hussen - Yewelo Lej - (Official Music Video) - New Ethiopian Music 2015 by Legend Entertainment 6 years ago 6 minutes, 20 seconds 131,376 views",Legend Entertainment,131376,131390,14
418,"Ethiopia - Biniyam Eshetu - Guramayle - (Official Music video) New Ethiopian Music 2015 by Legend Entertainment 6 years ago 5 minutes, 8 seconds 10,798 views",Legend Entertainment,10798,10807,9
419,"Bahil - Bewketu Sewmehon - Tederegelet - (Official Music Video) New Ethiopian Music 2015 by Legend Entertainment 6 years ago 6 minutes, 12 seconds 64,059 views",Legend Entertainment,64059,64094,35
420,"Ethiopia - Meron Aple - Atrak - (Official Music Video) New Ethiopian Music 2015 by Legend Entertainment 6 years ago 4 minutes, 5 seconds 22,163 views",Legend Entertainment,22163,22164,1
421,"Ethiopia - WINTA: The Show - Episode #46 by Legend Entertainment 6 years ago 42 minutes 58,356 views",Legend Entertainment,58356,58361,5
422,"Ethiopia - Teddy Yon ft. Ella Man - Banchi mekgnat  - New Ethiopian Music 2015 by Legend Entertainment 6 years ago 4 minutes, 52 seconds 40,181 views",Legend Entertainment,40181,40250,69
423,"Ethiopia - Izak Asefa - Yamral - (Officiall Music Video) New Ethiopian Music 2015 by Legend Entertainment 6 years ago 4 minutes, 9 seconds 72,898 views",Legend Entertainment,72898,72907,9
424,"Ethiopia - Semahegn Asfaw - Nesh Lena - (Official Music Video) New Ethiopian Music 2015 by Legend Entertainment 6 years ago 4 minutes, 41 seconds 37,954 views",Legend Entertainment,37954,37956,2
425,"Ethiopia - Yared Elmneh - Aykebdem wey - (Official Music Video) New Ethiopian Music 2015 by Legend Entertainment 6 years ago 4 minutes, 41 seconds 43,662 views",Legend Entertainment,43662,43666,4
426,"Ethiopia - WINTA: The Show - Episode #43 by Legend Entertainment 6 years ago 31 minutes 35,661 views",Legend Entertainment,35661,35664,3
427,"Ethiopia - Tamrat Seleshi - Haregye - (Official Music Video) - New Ethiopian Music 2015 by Legend Entertainment 7 years ago 6 minutes, 18 seconds 50,503 views",Legend Entertainment,50503,50510,7
428,"Bahil - Beweketu Sewmehon - Walech bayne laye - (Official Music Video) New Ethiopian Music 2015 by Legend Entertainment 7 years ago 4 minutes, 49 seconds 207,032 views",Legend Entertainment,207032,207090,58
429,"Ethiopia - Girum Janoye - Yanin Gara - (Official Music Video) New Ethiopian Music 2015 by Legend Entertainment 7 years ago 4 minutes, 42 seconds 194,578 views",Legend Entertainment,194578,194618,40
430,"Ethiopia - Behailu Bayou - Feta Feta - (Official Music Video) New Ethiopian Music 2015 by Legend Entertainment 7 years ago 5 minutes, 1 second 25,259,369 views",Legend Entertainment,25259369,25345739,86370
431,"Ethiopia - Fitsum G/tsadik - Sam argegn - (Official Music Video) New Ethiopian Music 2015 by Legend Entertainment 7 years ago 5 minutes, 22 seconds 53,886 views",Legend Entertainment,53886,53915,29
432,"Ethiopia - Temesgen Tafese - Ergba - (Official Music Video) New Ethiopian Music 2015 by Legend Entertainment 7 years ago 5 minutes, 32 seconds 21,778 views",Legend Entertainment,21778,21779,1
433,"Ethiopia - Mustefa JiJiga - Ethiopiaye - (Official Music Video) New Ethiopian Music 2015 by Legend Entertainment 7 years ago 4 minutes, 18 seconds 42,993 views",Legend Entertainment,42993,43023,30
434,"Ethiopia - Moges Mebratu - Melisegn - (Official Music Video) New Ethiopian Music 2015 by Legend Entertainment 7 years ago 5 minutes, 48 seconds 21,594 views",Legend Entertainment,21594,21599,5
435,"Ethiopia - Kichini Goa - Dolebo - (Official Music Video) - New Ethiopian Music 2015 by Legend Entertainment 7 years ago 4 minutes, 3 seconds 602,380 views",Legend Entertainment,602380,602838,458
436,"Ethiopia - WINTA: The Show - Episode #42 by Legend Entertainment 7 years ago 33 minutes 40,468 views",Legend Entertainment,40468,40470,2
437,"Ethiopia - Ashenafi Geremew ft. Fiker - Weretegna - (Official Music Video) New Ethiopian Music 2015 by Legend Entertainment 7 years ago 5 minutes, 51 seconds 2,182,475 views",Legend Entertainment,2182475,2183484,1009
438,"Ethiopia - Ziggy Zaga and Dark I - Techawet Densu (Gbadu) -  New Ethiopian Music 2015 by Legend Entertainment 7 years ago 3 minutes, 53 seconds 30,658 views",Legend Entertainment,30658,30664,6
439,"Ethiopia - Tamrat Desta - Lijemamregn New - (Official Music Video) - New Ethiopian Music 2015 by Legend Entertainment 7 years ago 5 minutes, 4 seconds 3,693,928 views",Legend Entertainment,3693928,3698328,4400
440,"Alemeya Getachew - Bey Kora - (Official Music Video) by Legend Entertainment 7 years ago 5 minutes, 35 seconds 255,639 views",Legend Entertainment,255639,255743,104
441,"Ethiopia - WINTA: The Show - Episode #41 by Legend Entertainment 7 years ago 33 minutes 62,097 views",Legend Entertainment,62097,62097,0
442,"Ethiopia - Adamu Male - Abren keren - (Official Music video) New Ethiopian Music 2015 by Legend Entertainment 7 years ago 4 minutes, 34 seconds 33,061 views",Legend Entertainment,33061,33061,0
443,"Ethiopia - Sami Tesfiye ( Sami Habesha) - Maleda - (Official Music Video) New Ethiopian Music 2015 by Legend Entertainment 7 years ago 4 minutes, 51 seconds 56,365 views",Legend Entertainment,56365,56368,3
444,"Ethiopia - Enkutatash Beshah - Eshi Bel (Official Music Video) New Ethiopian Music 2015 by Legend Entertainment 7 years ago 4 minutes, 3 seconds 142,466 views",Legend Entertainment,142466,142491,25
445,"Ethiopia - Frehiwot Sleshi - Asamenegn - (Official Music Video) New Ethiopian Music 2015 by Legend Entertainment 7 years ago 4 minutes, 33 seconds 79,667 views",Legend Entertainment,79667,79689,22
446,"Ethiopia - Adnew Bekele - Hagera (Officiall Audio Video) New Ethiopian Music 2015 by Legend Entertainment 7 years ago 5 minutes, 22 seconds 10,991 views",Legend Entertainment,10991,10991,0
447,"Ethiopia - Rahel Haile - Ho Belani Ho - (Official Music Video) New Ethiopian Music 2015 by Legend Entertainment 7 years ago 6 minutes, 36 seconds 50,097 views",Legend Entertainment,50097,50141,44
448,"Ethiopia - Rahel Haile - Welelay ( ወለላይ ) -(Official Music Video) New Ethiopian Music 2015 by Legend Entertainment 7 years ago 6 minutes, 44 seconds 1,938,654 views",Legend Entertainment,1938654,1948147,9493
449,"Ethiopia - Hahu Beatz - Yibelu - (Official Music Video) New Ethiopian Music 2015 by Legend Entertainment 7 years ago 4 minutes, 3 seconds 14,819 views",Legend Entertainment,14819,14844,25
450,"Ethiopia - Mamila Lukas - Yazilign ketero (Official Music Video) New Ethiopian Music 2015 by Legend Entertainment 7 years ago 5 minutes, 37 seconds 1,884,146 views",Legend Entertainment,1884146,1885947,1801
451,"Ethiopia - Fitsum G.Tsadik - Tew Ketema (Official Audio Video) New Ethiopian Music 2015 by Legend Entertainment 7 years ago 5 minutes, 24 seconds 91,696 views",Legend Entertainment,91696,91698,2
452,"Mamila Lukas - Zago - (Official Music Video) New Ethiopian Music 2015 by Legend Entertainment 7 years ago 6 minutes, 4 seconds 2,845,916 views",Legend Entertainment,2845916,2850332,4416
453,"Ethiopia - Yosef Abeje - Jeba - (Official Music Video) New Ethiopian Music 2015 by Legend Entertainment 7 years ago 4 minutes, 29 seconds 41,316 views",Legend Entertainment,41316,41333,17
454,"Ethiopia - Mekdes Hailu - Min Libleh (Offical Music Video) New Ethiopian Music 2015 by Legend Entertainment 7 years ago 4 minutes, 9 seconds 2,029,425 views",Legend Entertainment,2029425,2032452,3027
455,"Ethiopia - Daniel Mehrte - Lalo - (Official Music Video) New Ethiopian Music 2015 by Legend Entertainment 7 years ago 4 minutes, 34 seconds 31,689 views",Legend Entertainment,31689,31697,8
456,"Bre Bright - Funga - (Official Music Video) New Ethiopian Music 2015 by Legend Entertainment 7 years ago 4 minutes, 8 seconds 68,726 views",Legend Entertainment,68726,68744,18
457,"Ethiopia - Mikiyas Kebede (Miky Gondergna) - Sergegna - New Ethiopian Music 2015 by Legend Entertainment 7 years ago 3 minutes, 43 seconds 44,992 views",Legend Entertainment,44992,45000,8
458,"Ethiopia - Yamlaksira - Besmish - (Official Audio Video) New Ethiopian Music 2015 by Legend Entertainment 7 years ago 6 minutes, 23 seconds 28,273 views",Legend Entertainment,28273,28273,0
459,"Ethiopia - Tamrat Desta - Aykebdem hoy - (Official Music Video) New Ethiopian Music 2015 by Legend Entertainment 7 years ago 4 minutes, 30 seconds 723,498 views",Legend Entertainment,723498,725415,1917
460,"Ethiopia - Esubalew Yetayew (Yeshi) - hoyahoye - (Official Music Video) New Ethiopian Music 2015 by Legend Entertainment 7 years ago 4 minutes, 32 seconds 380,570 views",Legend Entertainment,380570,380744,174
461,"Yonni Wube & Nhatty Man Ft. Abashi - Addis Abaye - (Official Music video) New Ethiopian Music by Legend Entertainment 7 years ago 6 minutes, 21 seconds 97,430 views",Legend Entertainment,97430,97480,50
462,"Ethiopia - WINTA: The Show - Episode #37 by Legend Entertainment 7 years ago 30 minutes 35,984 views",Legend Entertainment,35984,35985,1
463,"Ethiopia - Yared Negu - Yebelegn - (Official Music Video) - NEW ETHIOPIAN MUSIC 2015 by Legend Entertainment 7 years ago 4 minutes, 25 seconds 1,306,480 views",Legend Entertainment,1306480,1307847,1367
464,"Ethiopia - Fitsum Gebretsadik - Were (Official Music Video) - New Ethiopian music 2015 by Legend Entertainment 7 years ago 4 minutes, 5 seconds 619,950 views",Legend Entertainment,619950,620033,83
465,"Ethiopia - WINTA: The Show - Episode #36 by Legend Entertainment 7 years ago 17 minutes 32,224 views",Legend Entertainment,32224,32226,2
466,"Ethiopia - Alos Band - Geba Telegnalech - (Official Music Video) Ethiopian Music by Legend Entertainment 7 years ago 6 minutes, 2 seconds 121,820 views",Legend Entertainment,121820,121889,69
467,"Ethiopia - Sisay Lukas (Mamila) - Mamasita - (Offical Music Video) - NEW ETHIOPIAN MUSIC 2015 by Legend Entertainment 7 years ago 4 minutes, 41 seconds 88,848 views",Legend Entertainment,88848,88888,40
468,"Ethiopia - Sisay Lukas (Mamila) - Eskemeche - (Offical Music Video) - New Ethiopian Music 2015 by Legend Entertainment 7 years ago 5 minutes, 39 seconds 263,657 views",Legend Entertainment,263657,264519,862
469,"Ethiopia - Sisay Lukas (Mamila), Kichini & Teddy Afro - Eso Eso - New Ethiopian Music by Legend Entertainment 7 years ago 5 minutes, 7 seconds 401,750 views",Legend Entertainment,401750,403763,2013
470,"Ethiopia - WINTA: The Show - Episode #35 by Legend Entertainment 7 years ago 24 minutes 57,661 views",Legend Entertainment,57661,57663,2
471,"Ethiopia - Tamrat Desta - Besua ena Bayne - (Official Music Video) - NEW ETHIOPIAN MUSIC 2015 by Legend Entertainment 7 years ago 5 minutes, 13 seconds 1,523,846 views",Legend Entertainment,1523846,1525007,1161
472,"Ethiopia - Fikir AB - Tenagera - (Official Music Video) - NEW ETHIOPIAN MUSIC 2015 by Legend Entertainment 7 years ago 5 minutes, 33 seconds 1,878,734 views",Legend Entertainment,1878734,1879753,1019
473,"Ethiopia - Deme Lula - Tenkish Gela - (Official Music Video) ETHIOPIAN NEW MUSIC 2015 by Legend Entertainment 7 years ago 5 minutes, 11 seconds 711,575 views",Legend Entertainment,711575,711650,75
474,"Ethiopia - WINTA: The Show - Episode #34 by Legend Entertainment 7 years ago 22 minutes 24,555 views",Legend Entertainment,24555,24556,1
475,"Ethiopia - Biniyam Assefa - Demo And Ande - (Official Music Video) ETHIOPIAN NEW MUSIC 2014 by Legend Entertainment 7 years ago 4 minutes, 43 seconds 24,496 views",Legend Entertainment,24496,24506,10
476,"Ethiopia - Mulugeta Alemu - Ney - (Official Music Video) - ETHIOPIAN NEW MUSIC 2014 by Legend Entertainment 7 years ago 4 minutes, 33 seconds 144,918 views",Legend Entertainment,144918,145049,131
477,"Ahmed Teshome (Denbi) - Betezetaw Feress - (Official Music Video) -  NEW ETHIOPIAN MUSIC 2015 by Legend Entertainment 7 years ago 4 minutes, 41 seconds 1,893,812 views",Legend Entertainment,1893812,1911351,17539
478,"Kasahun Legesse - Nanaye - (Official Music Video)NEW ETHIOPIAN MUSIC 2015 by Legend Entertainment 7 years ago 5 minutes, 33 seconds 694,139 views",Legend Entertainment,694139,694256,117
479,"Ethiopia - Tegist Kiros - Zena - (Official Music Video) - New ETHIOPIAN MUSIC 2015 by Legend Entertainment 7 years ago 5 minutes, 21 seconds 1,354,364 views",Legend Entertainment,1354364,1354922,558
480,"Ethiopia - Tigest Afewerk - Ata Gudam - (Official Audio Vidoe) ETHIOPIAN NEW MUSIC 2014 by Legend Entertainment 7 years ago 8 minutes, 59 seconds 850,988 views",Legend Entertainment,850988,851020,32
481,"Ethiopia - WINTA: The Show - Episode #33 by Legend Entertainment 7 years ago 22 minutes 26,478 views",Legend Entertainment,26478,26481,3
482,"Ethiopia - Wendi Mak - Yamarew Yimta - (Offical Music Video) -NEW ETHIOPIAN MUSIC 2015 by Legend Entertainment 7 years ago 6 minutes, 24 seconds 1,732,689 views",Legend Entertainment,1732689,1733810,1121
483,"Ethiopia - Abel Mulugeta - Sidet - (Official Audio Video) Ethiopian new Music 2014 by Legend Entertainment 7 years ago 5 minutes, 11 seconds 42,982 views",Legend Entertainment,42982,42994,12
484,"Ethiopia - Abel Mulugeta - Tizita - (Official Audio Video) Ethiopian new Music 2014 by Legend Entertainment 7 years ago 4 minutes, 30 seconds 78,243 views",Legend Entertainment,78243,78275,32
485,"Ethiopia - WINTA: The Show - Episode #31 by Legend Entertainment 7 years ago 26 minutes 64,246 views",Legend Entertainment,64246,64258,12
486,"Ethiopia - WINTA: The Show - Episode #30 by Legend Entertainment 7 years ago 16 minutes 55,444 views",Legend Entertainment,55444,55447,3
487,"Ethiopia - WINTA: The Show - Episode #29 by Legend Entertainment 7 years ago 34 minutes 264,594 views",Legend Entertainment,264594,265241,647
488,"Ethiopia - Teddy Afro - Live in Frankfurt - 31.12.14 by Legend Entertainment 7 years ago 3 minutes, 3 seconds 16,341 views",Legend Entertainment,16341,16342,1
489,"Ethiopia - WINTA - WINTA: The Show - Episode #28 by Legend Entertainment 7 years ago 16 minutes 38,696 views",Legend Entertainment,38696,38697,1
490,"Ethiopia - WINTA - WINTA: The Show - Episode #27 by Legend Entertainment 7 years ago 26 minutes 42,878 views",Legend Entertainment,42878,42881,3
491,"Ethiopia - Mulugeta Eshete - Getse Berekete - Official Audio Video - ETHIOPIOAN NEW MUSIC 2014 by Legend Entertainment 7 years ago 3 minutes, 44 seconds 12,892 views",Legend Entertainment,12892,12892,0
492,"Ethiopia - Wendi Mak - live concert in Israel by Legend Entertainment 7 years ago 50 seconds 67,371 views",Legend Entertainment,67371,67389,18
493,"Ethiopia - WINTA - WINTA: The Show - Episode #26 by Legend Entertainment 7 years ago 34 minutes 157,702 views",Legend Entertainment,157702,157716,14
494,"Ethiopia - Wendi Mak - Lela - Official Music Video - ETHIOPIAN NEW MUSIC 2014 by Legend Entertainment 7 years ago 5 minutes, 35 seconds 477,372 views",Legend Entertainment,477372,477778,406
495,"Ethiopia - Wendi Mak - Yamarew - Official Music Video - ETHIOPIAN NEW MUSIC 2014 by Legend Entertainment 7 years ago 6 minutes, 17 seconds 71,344 views",Legend Entertainment,71344,71358,14
496,"Ethiopia - Abenet Demissie - Mar Mar - Offcial Music Video - Ethiopian new music 2014 by Legend Entertainment 7 years ago 4 minutes, 20 seconds 306,799 views",Legend Entertainment,306799,306860,61
497,"Ethiopia - WINTA - WINTA: The Show - Episode #25 by Legend Entertainment 7 years ago 11 minutes, 14 seconds 26,703 views",Legend Entertainment,26703,26709,6
498,"Ethiopia - Ethiopia - Wendi Mak - Shire shire - (Official Music Video) NEW ETHIOPIAN MUSIC 2015 by Legend Entertainment 7 years ago 7 minutes, 22 seconds 2,987,851 views",Legend Entertainment,2987851,2989656,1805
499,"Ethiopia - WINTA - WINTA: The Show - Episode #24 by Legend Entertainment 7 years ago 14 minutes, 1 second 29,538 views",Legend Entertainment,29538,29538,0
500,Ethiopia - WINTA - WINTA: The Show - Episode #21 by Legend Entertainment 7 years ago 17 minutes 489 views,Legend Entertainment,489,489,0
501,"Ethiopia - WINTA - WINTA: The Show - Episode #23 by Legend Entertainment 7 years ago 21 minutes 36,983 views",Legend Entertainment,36983,36984,1
502,"Ethiopia - WINTA - WINTA: The Show - Episode #22 by Legend Entertainment 7 years ago 28 minutes 64,506 views",Legend Entertainment,64506,64513,7
503,"Ethiopia - Kimo Salih - Men lameta - ETHIOPIAN NEW MUSIC 2014 by Legend Entertainment 7 years ago 5 minutes, 10 seconds 79,499 views",Legend Entertainment,79499,79508,9
504,"Ethiopia - Meshesha Nekatibeb - Tenafkignalesh - Ethiopian new Music 2014 by Legend Entertainment 7 years ago 7 minutes, 7 seconds 34,905 views",Legend Entertainment,34905,34909,4
505,"Ethiopia - Ella Man - Maneneten - New Ethiopian Music 2014 by Legend Entertainment 7 years ago 4 minutes, 25 seconds 49,957 views",Legend Entertainment,49957,49980,23
506,"Ethiopia - Rodas Workye - Mengedegnaw Lebe - New Ethiopian Music 2014 by Legend Entertainment 7 years ago 5 minutes, 56 seconds 22,780 views",Legend Entertainment,22780,22793,13
507,"Ethiopia - Winta Show - Ye Meskel Teyake by Legend Entertainment 7 years ago 4 minutes, 52 seconds 22,988 views",Legend Entertainment,22988,22990,2
508,"Ethiopia - WINTA - WINTA: The Show - Episode #21 by Legend Entertainment 7 years ago 17 minutes 78,168 views",Legend Entertainment,78168,78170,2
509,"Ethiopia - Elias Assefa - Set Alamnem - Ethiopian new Music 2014 by Legend Entertainment 7 years ago 5 minutes, 33 seconds 49,551 views",Legend Entertainment,49551,49556,5
510,"Ethiopia - Temesgen Gebregziabher - Yemeskel Let Mata - ETHIOPIAN NEW MUSIC 2014 by Legend Entertainment 7 years ago 6 minutes, 1 second 737,661 views",Legend Entertainment,737661,738315,654
511,"Ethiopia - WINTA - WINTA: The Show - Episode #20 by Legend Entertainment 7 years ago 17 minutes 24,825 views",Legend Entertainment,24825,24825,0
512,"Ethiopia - Smizz Mayle - Anchin Bicha - Official Video - ETHIOPIAN NEW MUSIC 2014 by Legend Entertainment 7 years ago 6 minutes, 50 seconds 32,323 views",Legend Entertainment,32323,32340,17
513,"Ethiopia - WINTA - WINTA: The Show - Episode #19 by Legend Entertainment 7 years ago 23 minutes 72,409 views",Legend Entertainment,72409,72411,2
514,"Ethiopia - Ethiopian New Year - Enkuan Aderesachu - New Year Wishes by Legend Entertainment 7 years ago 2 minutes, 45 seconds 73,271 views",Legend Entertainment,73271,73277,6
515,"Ethiopia - Temesgen Gebregziabher- Yemeskel Let Mata - Music video Making ETHIOPIAN NEW MUSIC 2014 by Legend Entertainment 7 years ago 1 minute, 41 seconds 60,317 views",Legend Entertainment,60317,60331,14
516,"Ethiopia - Abel Mulugeta - Addis Amet Addis Neger - ETHIOPIAN NEW MUSIC 2014 by Legend Entertainment 7 years ago 5 minutes, 18 seconds 42,165 views",Legend Entertainment,42165,42171,6
517,"Ethiopia - Mulugeta Eshete ft. Zigi Zaga - Tolo Bel - ETHIOPIAN NEW MUSIC 2014 by Legend Entertainment 7 years ago 4 minutes, 8 seconds 169,380 views",Legend Entertainment,169380,169404,24
518,"Ethiopia - WINTA - WINTA: The Show - Episode #18 by Legend Entertainment 7 years ago 18 minutes 37,619 views",Legend Entertainment,37619,37622,3
519,"Ethiopia - Mike Afa - Tehun Dehna - (Official Music Video) ETHIOPIAN NEW MUSIC 2014 by Legend Entertainment 7 years ago 5 minutes, 31 seconds 355,820 views",Legend Entertainment,355820,355895,75
520,"Ethiopia - Dagi Hanazi (Dagem Adane) - Siyamah - (Official Music Video) ETHIOPIAN NEW MUSIC 2014 by Legend Entertainment 7 years ago 4 minutes, 20 seconds 37,148 views",Legend Entertainment,37148,37153,5
521,"Ethiopia - Kichini (Temesgen Goa) - Yomu - (Official Music Video) Ethiopian New Music 2014 by Legend Entertainment 7 years ago 4 minutes, 14 seconds 124,048 views",Legend Entertainment,124048,124068,20
522,"Ethiopia - Kichini (Temesgen Goa) - Abeka - (Official Music Video) ETHIOPIAN NEW MUSIC 2014 by Legend Entertainment 7 years ago 3 minutes, 43 seconds 121,052 views",Legend Entertainment,121052,121116,64
523,"Ethiopia - WINTA - WINTA: The Show - Episode #17 by Legend Entertainment 7 years ago 19 minutes 76,081 views",Legend Entertainment,76081,76087,6
524,"Ethiopia - Meskier Tilahun - Anten yilegnal- ETHIOPIAN NEW MUSIC 2014 by Legend Entertainment 7 years ago 4 minutes, 34 seconds 434,179 views",Legend Entertainment,434179,434195,16
525,"Ethiopia - Temesgen Gebregziabher - Yemeskel Let Mata - ETHIOPIAN NEW MUSIC 2014 by Legend Entertainment 7 years ago 5 minutes, 37 seconds 140,632 views",Legend Entertainment,140632,140664,32
526,"Ethiopia - WINTA - WINTA: The Show - Episode #16 by Legend Entertainment 7 years ago 18 minutes 109,982 views",Legend Entertainment,109982,109989,7
527,"Alemeye Getachew - Anlakekem - (Official Audio Video) by Legend Entertainment 7 years ago 5 minutes, 28 seconds 452,269 views",Legend Entertainment,452269,452364,95
528,"Ethiopia - Dani Roma - Konjo Nat - (Official Audio Video) ETHIOPIAN NEW MUSIC 2014 by Legend Entertainment 7 years ago 4 minutes, 50 seconds 43,048 views",Legend Entertainment,43048,43055,7
529,"Ethiopia - WINTA - WINTA: The Show - Episode #15 by Legend Entertainment 7 years ago 36 minutes 441,291 views",Legend Entertainment,441291,441319,28
530,"Ethiopia - Abel Mulugeta - Taxi - (Official Audio Video) Ethiopian New Music 2014 by Legend Entertainment 7 years ago 3 minutes, 56 seconds 35,509 views",Legend Entertainment,35509,35511,2
531,"Ethiopia - Biruk Lino - Esua Bicha Nat - (Official Video) ETHIOPIAN NEW MUSIC 2014 by Legend Entertainment 7 years ago 4 minutes, 30 seconds 68,628 views",Legend Entertainment,68628,68641,13
532,"Ethiopia - WINTA - WINTA: The Show - Episode #14 by Legend Entertainment 7 years ago 17 minutes 48,580 views",Legend Entertainment,48580,48581,1
533,"Ethiopia - Getnet Demissie - Tena Yistilign - (Official Music Video) ETHIOPIAN NEW MUSIC 2014 by Legend Entertainment 7 years ago 4 minutes, 48 seconds 79,947 views",Legend Entertainment,79947,79966,19
534,"Ethiopia - Mulugeta Lema (Mule) - Sitota - (Official Music Video) ETHIOPIAN NEW MUSIC 2014 by Legend Entertainment 7 years ago 5 minutes, 13 seconds 107,435 views",Legend Entertainment,107435,107453,18
535,"Mentesnot Tilahun - Saysh - (Official Music Video) ETHIOPIAN NEW MUSIC 2014 by Legend Entertainment 7 years ago 5 minutes, 24 seconds 692,363 views",Legend Entertainment,692363,692441,78
536,"Ethiopia - Nebiyu Solomon (Neba) - Endalay - (Official Music Video) ETHIOPIAN NEW MUSIC 2014 by Legend Entertainment 7 years ago 3 minutes, 59 seconds 36,759 views",Legend Entertainment,36759,36764,5
537,"Ethiopia - WINTA - WINTA: The Show - Episode #13 by Legend Entertainment 7 years ago 18 minutes 49,375 views",Legend Entertainment,49375,49376,1
538,"Ethiopia - Temesgen Gebregziabher ( Temu ) New Version of ""Tegetatemu"" ETHIOPIAN NEW MUSIC 2014 by Legend Entertainment 7 years ago 4 minutes, 53 seconds 267,969 views",Legend Entertainment,267969,267996,27
539,"Ethiopia - WINTA - WINTA: The Show - Episode #12 by Legend Entertainment 7 years ago 21 minutes 41,117 views",Legend Entertainment,41117,41119,2
540,"Ethiopia - Girum Janoye - Lefiker - (Official Audio Video) ETHIOPIAN NEW MUSIC 2014 by Legend Entertainment 7 years ago 3 minutes, 25 seconds 241,251 views",Legend Entertainment,241251,241266,15
541,"Ethiopia - Kinfe Mudesir - Nafkot- (Official Music Video) ETHIOPIAN NEW MUSIC 2014 by Legend Entertainment 7 years ago 4 minutes, 8 seconds 23,736 views",Legend Entertainment,23736,23738,2
542,"Ethiopia - Bini Lasta - Abejehu Gonder - (Official Music Video) ETHIOPIAN NEW MUSIC 2014 by Legend Entertainment 7 years ago 5 minutes, 2 seconds 237,200 views",Legend Entertainment,237200,237278,78
543,"Ethiopia - Yemane Sibagadis - Gizew - (Official Music Video) ETHIOPIAN NEW MUSIC 2014 by Legend Entertainment 7 years ago 4 minutes, 49 seconds 59,428 views",Legend Entertainment,59428,59440,12
544,"Ethiopia - WINTA - WINTA: The Show - Episode #11 by Legend Entertainment 7 years ago 14 minutes, 45 seconds 70,002 views",Legend Entertainment,70002,70005,3
545,"Ethiopia - Ethiopia - WINTA - WINTA: The Show - Episode #10 by Legend Entertainment 7 years ago 13 minutes, 25 seconds 42,405 views",Legend Entertainment,42405,42407,2
546,"Ethiopia - WINTA - WINTA: The Show - Episode #9 by Legend Entertainment 7 years ago 12 minutes, 25 seconds 68,008 views",Legend Entertainment,68008,68011,3
547,"Ethiopia - Wendi Mak - Mela' - (Official Audio Video) ETHIOPIAN NEW MUSIC 2014 by Legend Entertainment 7 years ago 5 minutes, 26 seconds 363,378 views",Legend Entertainment,363378,363537,159
548,"Ethiopia - WINTA - WINTA: The Show - Episode #8 by Legend Entertainment 7 years ago 14 minutes, 9 seconds 47,919 views",Legend Entertainment,47919,47925,6
549,"Ethiopia - Ras Biruk - Bezu Were - (Official Music Video) Ethiopian new music 2014 by Legend Entertainment 7 years ago 4 minutes, 10 seconds 136,713 views",Legend Entertainment,136713,136834,121
550,"Ethiopia - Edidiya Ayele - Kafehe Kafehe - (Official Music Video) Ethiopian New Music 2014 by Legend Entertainment 7 years ago 4 minutes, 49 seconds 851,742 views",Legend Entertainment,851742,851968,226
551,"Ethiopia - WINTA - WINTA: The Show - Episode #7 by Legend Entertainment 7 years ago 11 minutes, 33 seconds 275,414 views",Legend Entertainment,275414,275423,9
552,"Ethiopia - Kibresfaw Habte (kb-man) - Endenema - (Official Video) New Ethiopian Music 2014 by Legend Entertainment 7 years ago 7 minutes, 51 seconds 465,844 views",Legend Entertainment,465844,465895,51
553,"Ethiopia - WINTA - WINTA: The Show - Episode #6 by Legend Entertainment 7 years ago 14 minutes, 30 seconds 38,522 views",Legend Entertainment,38522,38523,1
554,"Nhatty Man - ""ጭፈራዬ"" Chiferaye - Wine n Go Down -  New Ethiopian Music 2014 by Legend Entertainment 7 years ago 4 minutes, 2 seconds 542,827 views",Legend Entertainment,542827,542911,84
555,"Ethiopia - WINTA - WINTA: The Show - Episode #5 by Legend Entertainment 7 years ago 8 minutes, 23 seconds 31,054 views",Legend Entertainment,31054,31055,1
556,"Ethiopia - Abel Mulugeta - Lib be 40 Amet - (Official Video) - Ethiopian New Music 2014 by Legend Entertainment 7 years ago 5 minutes, 23 seconds 3,819,961 views",Legend Entertainment,3819961,3822659,2698
557,"Ethiopia - WINTA - WINTA: The Show - Episode #4 by Legend Entertainment 7 years ago 15 minutes 47,852 views",Legend Entertainment,47852,47856,4
558,"Ethiopia - WINTA - WINTA: The Show - Episode #3 by Legend Entertainment 7 years ago 20 minutes 52,976 views",Legend Entertainment,52976,52979,3
559,"Ethiopia - Abel Mulugeta - Leb Be 40 Amet - (Official Audio Video) New Ethiopian Music 2014 by Legend Entertainment 7 years ago 4 minutes, 55 seconds 73,150 views",Legend Entertainment,73150,73161,11
560,"Ethiopia - WINTA - WINTA: The Show - Episode #2 by Legend Entertainment 7 years ago 13 minutes, 11 seconds 41,885 views",Legend Entertainment,41885,41889,4
561,"Ethiopia - New Ethiopian Music 2014 Ras Biruk - Bezu Were - (Official Audio Video) by Legend Entertainment 7 years ago 3 minutes, 48 seconds 19,354 views",Legend Entertainment,19354,19357,3
562,"Ethiopia - WINTA - WINTA: The Show - Stay tuned for YON ADDIS!!! by Legend Entertainment 7 years ago 36 seconds 21,363 views",Legend Entertainment,21363,21364,1
563,"Ethiopia - New Ethio Music 2014 Belay Melese - Qebechilegn - (Official Video) by Legend Entertainment 7 years ago 5 minutes, 17 seconds 320,573 views",Legend Entertainment,320573,320636,63
564,"Wendi Mak - Men Yetrash - (Official Video) - Ethiopian Music by Legend Entertainment 7 years ago 5 minutes, 53 seconds 15,640,676 views",Legend Entertainment,15640676,15683006,42330
565,"Ethiopia - New Ethiopian Music 2014 Amaya by Wendi Mak - (Official Video) by Legend Entertainment 7 years ago 4 minutes, 31 seconds 1,025,720 views",Legend Entertainment,1025720,1026218,498
566,"Ethiopian New Music 2014 Terefe Assefa - Ye Orit Hager - (Official Audio Video) by Legend Entertainment 7 years ago 4 minutes, 55 seconds 51,348 views",Legend Entertainment,51348,51359,11
567,"Ethiopia - WINTA - WINTA: The Show - Episode #1 by Legend Entertainment 7 years ago 8 minutes, 7 seconds 42,642 views",Legend Entertainment,42642,42671,29
568,"Ethiopia - Winta The Show - Stay tuned for friday! by Legend Entertainment 7 years ago 1 minute, 39 seconds 9,565 views",Legend Entertainment,9565,9565,0
569,"Ethiopia - New Ethiopian Music 2014 Ras Biruk - Maha Melicio - How Long - Tribute to Saudi Migrants by Legend Entertainment 7 years ago 3 minutes, 12 seconds 16,233 views",Legend Entertainment,16233,16235,2
570,"Ethiopia - New Ethiopian Music 2014 Ras Biruk - Rello - Reggae and Ethiopian cultural music by Legend Entertainment 7 years ago 4 minutes, 6 seconds 12,106 views",Legend Entertainment,12106,12109,3
571,"Ethiopia - WINTA - Winta The Show - This friday - Stay tuned! by Legend Entertainment 7 years ago 1 minute, 39 seconds 5,195 views",Legend Entertainment,5195,5195,0
572,"Ethiopia - New Ethiopian Music 2014 Mentesnot Tilahun - Kanchi Lela - (Official Audio Video) by Legend Entertainment 7 years ago 4 minutes, 22 seconds 21,655 views",Legend Entertainment,21655,21656,1
573,"Ethiopia - WINTA - New Ethiopian Music show 2014 Winta - The Show coming soon ... by Legend Entertainment 7 years ago 40 seconds 9,766 views",Legend Entertainment,9766,9767,1
574,"Mesfin Bekele - Ayhonem - (Official Audio Video) - New Ethiopian Music 2014 by Legend Entertainment 7 years ago 5 minutes, 50 seconds 651,114 views",Legend Entertainment,651114,651148,34
575,"Ethiopia - New Ethiopian Music 2014 Samuel Mekebo - Yeta Yetal - (Official Audio Video) by Legend Entertainment 7 years ago 3 minutes, 56 seconds 151,799 views",Legend Entertainment,151799,151819,20
576,"Ethiopia - New Ethiopian New Music 2014 - Semna Werk by Abel Mulugeta - (Official Audio Video) by Legend Entertainment 7 years ago 5 minutes, 19 seconds 56,741 views",Legend Entertainment,56741,56820,79
577,"Ethiopia - New Ethiopian Music 2014 by Atfchalew by Aster Girma - (Official Audio Video) by Legend Entertainment 7 years ago 6 minutes, 25 seconds 25,190 views",Legend Entertainment,25190,25195,5
578,"Ethiopia - New Ethiopian Music 2014 Aster Girma - Eshi - (Official Audio Video) by Legend Entertainment 7 years ago 5 minutes, 53 seconds 72,683 views",Legend Entertainment,72683,72688,5
579,"Ethiopia - New Ethiopian Music 2014 - Telehegn Setker by Aster Girma - (Official Audio Video) by Legend Entertainment 7 years ago 5 minutes, 45 seconds 26,575 views",Legend Entertainment,26575,26581,6
580,"Ethiopia - New Ethiopian Music 2014 Dkamen Ayto by Aster Girma - (Official Audio Video) by Legend Entertainment 7 years ago 6 minutes, 24 seconds 15,194 views",Legend Entertainment,15194,15198,4
581,"Ethiopia - New Ethiopian MUsic 2014 - Hede Alu Geubleu by Aster Girma - (Official Audio Video) by Legend Entertainment 7 years ago 5 minutes, 13 seconds 12,261 views",Legend Entertainment,12261,12263,2
582,"Ethiopia - New Ethiopian Music 2014 Kurat Aylut by Aster Girma - (Official Audio Video) by Legend Entertainment 7 years ago 4 minutes, 51 seconds 12,866 views",Legend Entertainment,12866,12867,1
583,"Ethiopia - New ethiopian Music 2014 - Ywekqew Yesmaw by Aster Girma - (Official Audio Video) by Legend Entertainment 7 years ago 6 minutes, 6 seconds 29,628 views",Legend Entertainment,29628,29637,9
584,"Ethiopia - New Ethiopian Music 2014 Norkut Eskahun by Aster Girma - (Official Audio Video) by Legend Entertainment 7 years ago 4 minutes, 1 second 8,021 views",Legend Entertainment,8021,8041,20
585,"Ethiopia - New Ethiopian Music 2014 - Aleh Wey by Aster Girma - (Official Audio Video) by Legend Entertainment 7 years ago 7 minutes, 4 seconds 20,710 views",Legend Entertainment,20710,20715,5
586,"Ethiopia - New Ethiopian Music 2014 Yemaychal Yelem by Aster Girma - (Official Audio Video) by Legend Entertainment 7 years ago 4 minutes, 21 seconds 25,983 views",Legend Entertainment,25983,25988,5
587,"Ethiopia - New Ethiopian Music 2014 - Atasmegnegn by Aster Girma - (Official Audio Video) by Legend Entertainment 7 years ago 4 minutes, 43 seconds 7,374 views",Legend Entertainment,7374,7376,2
588,"Ethiopia - New Ethiopian Music 2014 Tebqegn by Aster Girma - (Official Audio Video) by Legend Entertainment 7 years ago 5 minutes, 3 seconds 19,438 views",Legend Entertainment,19438,19444,6
589,"Ethiopia - Abel Mulugeta - Wedo Wedo - (Official Video) Ethiopian New Music 2014 by Legend Entertainment 7 years ago 4 minutes, 12 seconds 43,100 views",Legend Entertainment,43100,43164,64
590,"Ethiopia - Abel Mulugeta - Yeker Beyeshalehu - (Official Video) Ethiopian New Music 2014 by Legend Entertainment 7 years ago 4 minutes, 40 seconds 81,929 views",Legend Entertainment,81929,82017,88
591,"Ethiopia - Abel Mulugeta - Yehun - (Official Audio Video) New Ethiopian Music 2014 by Legend Entertainment 7 years ago 5 minutes, 49 seconds 119,445 views",Legend Entertainment,119445,119546,101
592,"Ethiopia - Abel Mulugeta - Yemote Laysema - (Official Video) Ethiopian New Music 2014 by Legend Entertainment 7 years ago 3 minutes, 17 seconds 45,632 views",Legend Entertainment,45632,45697,65
593,"Ethiopia - Abel Mulugeta - Shukren - (Official Audio Video) New Ethiopian Music 2014 by Legend Entertainment 7 years ago 4 minutes, 48 seconds 201,621 views",Legend Entertainment,201621,201858,237
594,"Ethiopia - Abel Mulugeta - Demo Yehen Semon - (Official Video) New Ethiopian Music 2014 by Legend Entertainment 7 years ago 4 minutes, 4 seconds 65,241 views",Legend Entertainment,65241,65310,69
595,"Ethiopia - Aster Girma - Baytewar - (Official Video) by Legend Entertainment 7 years ago 4 minutes, 34 seconds 31,430 views",Legend Entertainment,31430,31434,4
596,"Ethiopia - Aster Girma - Awdamet - (Official Video) by Legend Entertainment 7 years ago 5 minutes, 48 seconds 8,249 views",Legend Entertainment,8249,8250,1
597,"Ethiopia - Aster Girma - Nebere Siraye - (Official Video) by Legend Entertainment 7 years ago 4 minutes, 21 seconds 9,162 views",Legend Entertainment,9162,9165,3
598,"Ethiopia - Aster Girma - Atnageregn - (Official Video) by Legend Entertainment 7 years ago 3 minutes, 54 seconds 12,079 views",Legend Entertainment,12079,12083,4
599,"Ethiopia - Aster Girma - Yedilen Filega - (Official Video) by Legend Entertainment 7 years ago 4 minutes, 48 seconds 14,114 views",Legend Entertainment,14114,14115,1
600,"Ethiopia - Aster Girma - Eyulgn - (Official Video) by Legend Entertainment 7 years ago 3 minutes, 52 seconds 12,639 views",Legend Entertainment,12639,12643,4
601,"Ethiopia - New Ethiopan Music 2014 Abrham Belayneh - Babafayo - (Official Video) by Legend Entertainment 7 years ago 5 minutes, 21 seconds 8,434,264 views",Legend Entertainment,8434264,8453406,19142
602,"Ethiopia - Aster Girma - Yenafekegn - (Official Video) by Legend Entertainment 7 years ago 4 minutes, 40 seconds 29,356 views",Legend Entertainment,29356,29362,6
603,"Ethiopia - Aster Girma - Ekefegn - (Official Video) by Legend Entertainment 7 years ago 5 minutes, 2 seconds 128,870 views",Legend Entertainment,128870,128884,14
604,"Ethiopia - Aster Girma - Naw Ende - (Official Video) by Legend Entertainment 7 years ago 4 minutes, 47 seconds 14,633 views",Legend Entertainment,14633,14636,3
605,"Ethiopia - Aster Girma - Enja - (Official Video) by Legend Entertainment 7 years ago 4 minutes, 25 seconds 8,287 views",Legend Entertainment,8287,8293,6
606,"Ethiopia - Aster Girma - Enat - (Official Video) by Legend Entertainment 7 years ago 6 minutes, 6 seconds 11,353 views",Legend Entertainment,11353,11355,2
607,"Ethiopia - Aster Girma - Nega Nega - (Official Video) by Legend Entertainment 7 years ago 3 minutes, 52 seconds 10,001 views",Legend Entertainment,10001,10002,1
608,"Ethiopia - New Ethiopian Music 2014 - Abel Mulugeta - Gedam No.2 - (Official Audio Video) by Legend Entertainment 7 years ago 5 minutes, 6 seconds 138,118 views",Legend Entertainment,138118,138285,167
609,"Ethiopia - Abel Mulugeta - Qetero - (Official Audio Video) by Legend Entertainment 7 years ago 4 minutes, 8 seconds 34,256 views",Legend Entertainment,34256,34308,52
610,"Ethiopia - Abel Mulugeta - Atengerugn - (Official Audio Video) by Legend Entertainment 7 years ago 5 minutes, 6 seconds 80,235 views",Legend Entertainment,80235,80412,177
611,"Ethiopia - Abel Mulugeta - Wedo Aysekem Terse - (Official Audio Video) by Legend Entertainment 7 years ago 4 minutes, 36 seconds 32,160 views",Legend Entertainment,32160,32214,54
612,"Ethiopia - Abel Mulugeta - Enderase - (Official Audio Video) by Legend Entertainment 7 years ago 4 minutes, 26 seconds 58,058 views",Legend Entertainment,58058,58164,106
613,"Ethiopia - New Ethiopian Music 2014 - Abel Mulugeta - Tegereme - (Official Audio Video) by Legend Entertainment 7 years ago 4 minutes, 57 seconds 695,208 views",Legend Entertainment,695208,695336,128
614,"Ethiopia - New Ethiopian Music 2014 - Abel Mulugeta - Kome - (Official Audio Video) by Legend Entertainment 7 years ago 4 minutes, 8 seconds 73,099 views",Legend Entertainment,73099,73223,124
615,"Ethiopia - Abel Mulugeta - Ene Malet - (Official Audio Video) by Legend Entertainment 7 years ago 3 minutes, 52 seconds 43,150 views",Legend Entertainment,43150,43225,75
616,"Ethiopia - Abel Mulugeta - Yaluten Yebelu - (Official Audio Video) by Legend Entertainment 7 years ago 3 minutes, 47 seconds 72,197 views",Legend Entertainment,72197,72575,378
617,"Ethiopia - Abel Mulugeta - Astewel Chuheten - (Official Audio Video) by Legend Entertainment 7 years ago 3 minutes, 55 seconds 27,942 views",Legend Entertainment,27942,27990,48
618,"Temesgen Gebregziabher - Korahubesh - (Official Video) by Legend Entertainment 7 years ago 6 minutes, 32 seconds 1,924,604 views",Legend Entertainment,1924604,1925072,468
619,"Ethiopia - Smizz Mayle - Marrkognal - ETHIOPIAN NEW MUSIC 2014 by Legend Entertainment 8 years ago 6 minutes, 17 seconds 39,398 views",Legend Entertainment,39398,39402,4
620,"Ethiopia - New Ethio Music 2014 - Eyew na ena by Mahider Zeleke - Ethiopian. (Official Video) by Legend Entertainment 8 years ago 4 minutes, 27 seconds 364,803 views",Legend Entertainment,364803,364832,29
621,"Ethiopia - New Ethio Music 2014 - Fiker Bene Lay by Anteneh Werash - Ethiopian. (Official Video) by Legend Entertainment 8 years ago 8 minutes, 7 seconds 919,895 views",Legend Entertainment,919895,919988,93
622,"Ethiopia - New Ethio Music 2014 - Yazagagnal by Abebbe Kefeni - Ethiopian.(Official Video) by Legend Entertainment 8 years ago 6 minutes, 16 seconds 21,999 views",Legend Entertainment,21999,22005,6
623,"Ethiopia - Abebbe Kefeni - Yalechibeten - (Official Video) New Ethiopian Music 2014 by Legend Entertainment 8 years ago 6 minutes, 34 seconds 36,073 views",Legend Entertainment,36073,36078,5
624,"Ethiopia - New Ethio Music 2014 - Addis Ababa by Eyobe Lemma - Ethiopia. by Legend Entertainment 8 years ago 5 minutes, 35 seconds 134,061 views",Legend Entertainment,134061,134077,16
625,"Ethiopia - New Ethiopian Music 2014 - Enderase by Abel Mulugeta - Ethiopian. by Legend Entertainment 8 years ago 4 minutes, 24 seconds 589,022 views",Legend Entertainment,589022,589083,61
626,"Ethiopia - New Ethio Music 2014 - Nurosh Kewenz Wedya by Demisu Belete (Official Video) - Ethiopian. by Legend Entertainment 8 years ago 5 minutes, 23 seconds 54,019 views",Legend Entertainment,54019,54025,6
627,"Ethiopian Music 2014 - Aymokerem by Elias Getachew (Official Video) - Ethiopian. by Legend Entertainment 8 years ago 4 minutes, 14 seconds 43,544 views",Legend Entertainment,43544,43548,4
628,"Ethiopia - New Ethio Music 2014 - Gud Fela by Demisu Belete - Ethiopian. by Legend Entertainment 8 years ago 4 minutes, 40 seconds 102,794 views",Legend Entertainment,102794,102809,15
629,"Ethiopia - New Ethio Music 2014 - Belu Enji by Eyobe Lemma (Official Video) - Ethiopian. by Legend Entertainment 8 years ago 4 minutes, 6 seconds 55,724 views",Legend Entertainment,55724,55735,11
630,"Ethiopia - New Ethio Music 2014 - Wana Lay by Azeb Wendwosen - Ethiopian. by Legend Entertainment 8 years ago 5 minutes, 23 seconds 167,863 views",Legend Entertainment,167863,167960,97
631,"Ethiopia - BEST New Ethiopian Music 2014 Azeb Wendwosen - Tadia Lemin - (Official Video) by Legend Entertainment 8 years ago 4 minutes, 40 seconds 126,166 views",Legend Entertainment,126166,126177,11
632,"Ethiopia - BEST New Ethiopian Music 2014 Mentesnot Tilahun - Tamagn Negn (Official Video) by Legend Entertainment 8 years ago 5 minutes, 28 seconds 43,085 views",Legend Entertainment,43085,43093,8
633,"Ethiopia - BEST New Ethiopian Music 2014 Fisum T - Addis Abeba (Official Video) by Legend Entertainment 8 years ago 5 minutes, 4 seconds 148,384 views",Legend Entertainment,148384,148418,34
634,"Nhatty Man - Des Yibelegn - (Official Music Video) by Legend Entertainment 8 years ago 5 minutes, 4 seconds 68,184 views",Legend Entertainment,68184,68323,139
635,"Nhatty Man - Sifeked -  (Official Music Video) by Legend Entertainment 8 years ago 4 minutes, 35 seconds 49,527 views",Legend Entertainment,49527,49549,22
636,"Ethiopia - Temesgen Gebregziabher - Eko Men Gebash (Official Audio Video) by Legend Entertainment 8 years ago 5 minutes, 50 seconds 9,941 views",Legend Entertainment,9941,9950,9
637,"Ethiopia - BEST New Ethiopian Music 2014 Derese Bisrat - Lakomelza (Official Video) by Legend Entertainment 8 years ago 5 minutes, 48 seconds 75,102 views",Legend Entertainment,75102,75107,5
638,"Ethiopia - BEST New Ethiopian Music 2014 Derese Bisrat - Kunkua (Official Video) by Legend Entertainment 8 years ago 4 minutes, 52 seconds 23,165 views",Legend Entertainment,23165,23169,4
639,"Nhatty Man - Altamenshim - (Official Music Video) by Legend Entertainment 8 years ago 4 minutes, 51 seconds 283,595 views",Legend Entertainment,283595,283826,231
640,"Nhatty Man - Shengai - (Official Music Video) by Legend Entertainment 8 years ago 4 minutes, 54 seconds 83,284 views",Legend Entertainment,83284,83475,191
641,"Nhatty Man - Lebea - (Official Music Video) by Legend Entertainment 8 years ago 4 minutes, 48 seconds 201,651 views",Legend Entertainment,201651,201689,38
642,"Nhatty Man - Nefs - (Official Music Video) by Legend Entertainment 8 years ago 4 minutes, 24 seconds 84,216 views",Legend Entertainment,84216,84235,19
643,"Ethiopia - BEST New Ethiopian Music 2014 Girum Tamirat - Balegebashim (Official Video) by Legend Entertainment 8 years ago 6 minutes, 24 seconds 149,055 views",Legend Entertainment,149055,149068,13
644,"Ethiopia - BEST New Ethiopian Music 2014 Temesgen Gebregziabher - Eko Men Gebash by Legend Entertainment 8 years ago 5 minutes, 50 seconds 188,474 views",Legend Entertainment,188474,188525,51
645,"Ethiopia - Elias Getachew - Fikire Yene Nesh - (Official Video) new single 2014 by Legend Entertainment 8 years ago 5 minutes, 3 seconds 104,774 views",Legend Entertainment,104774,104808,34
646,"Ethiopia - Addis Gurmessa - Sinqesh Yehun - (Official Video) - Ethiopian new music 2014 by Legend Entertainment 8 years ago 7 minutes, 23 seconds 384,371 views",Legend Entertainment,384371,384572,201
647,"Ethiopia - Elias Getachew - Tagebignalesh Woye - (Official Video) Ethiopian Music 2014 by Legend Entertainment 8 years ago 4 minutes, 41 seconds 17,134 views",Legend Entertainment,17134,17136,2
648,"Ethiopia - Zerihun Demesse - Bati - (Official Video) Ethiopian Music 2014 by Legend Entertainment 8 years ago 6 minutes, 26 seconds 158,341 views",Legend Entertainment,158341,159678,1337
649,"Ethiopia - Abel Mulugeta - Gedam Gebash Alu Ethio One Love - (Official Video) Ethiopian Music 2014 by Legend Entertainment 8 years ago 5 minutes, 49 seconds 76,125 views",Legend Entertainment,76125,76152,27
650,"Ethiopia - Abel Mulugeta Kome Ethio One Love - (Official Video) by Legend Entertainment 8 years ago 4 minutes, 9 seconds 273,938 views",Legend Entertainment,273938,276801,2863
651,"Ethiopia - BEST New Ethiopian Music 2014 Abel Mulugeta Semignma - (Official Video) by Legend Entertainment 8 years ago 5 minutes, 49 seconds 439,369 views",Legend Entertainment,439369,441746,2377
652,"Ethiopia - BEST New Ethiopian Music 2014 Samson Mekonen - Are Melsun Sechign - (Official Video) by Legend Entertainment 8 years ago 3 minutes, 21 seconds 12,235 views",Legend Entertainment,12235,12257,22
653,"Ethiopia - BEST New Ethiopian Music 2014 Abel Mulugeta - Konjo Nat - (Official Video) by Legend Entertainment 8 years ago 4 minutes, 57 seconds 98,741 views",Legend Entertainment,98741,98800,59
654,"Ethiopia - BEST New Ethiopian Music 2013 Abel Mulugeta - Wedaj Alegne Beye - (Official Video) by Legend Entertainment 8 years ago 4 minutes, 3 seconds 46,399 views",Legend Entertainment,46399,46414,15
655,"Ethiopia - BEST New Ethiopian Music 2013 Abel Mulugeta - Mata Mata2 - (Official Video) by Legend Entertainment 8 years ago 2 minutes, 16 seconds 8,095 views",Legend Entertainment,8095,8098,3
656,"Ethiopia - BEST New Ethiopian Music 2014 Abel Mulugeta - Alamen Alena - (Official Video) by Legend Entertainment 8 years ago 4 minutes, 14 seconds 117,056 views",Legend Entertainment,117056,117141,85
657,"Ethiopia - BEST New Ethiopian Music 2014 Abel Mulugeta - Simagn Hagere - (Official Video) by Legend Entertainment 8 years ago 4 minutes, 21 seconds 40,493 views",Legend Entertainment,40493,40505,12
658,"Ethiopia - BEST New Ethiopian Music 2013 Abel Mulugeta - Alamashem - (Official Video) by Legend Entertainment 8 years ago 4 minutes, 24 seconds 69,873 views",Legend Entertainment,69873,69913,40
659,"Ethiopia - BEST New Ethiopian Music 2013 Abel Mulugeta - Ney Samigna - (Official Video) by Legend Entertainment 8 years ago 4 minutes, 36 seconds 59,681 views",Legend Entertainment,59681,59736,55
660,"Ethiopia - Ethiopian new music 2013 Girum Tamirat - Balegebashim - (Official Audio) by Legend Entertainment 8 years ago 5 minutes, 13 seconds 5,152 views",Legend Entertainment,5152,5154,2
661,"Ethiopia - BEST New Ethiopian Music 2014 Demelash Negusie - Ethiopia -  [NEW! Video Music 2013] by Legend Entertainment 8 years ago 5 minutes, 9 seconds 69,469 views",Legend Entertainment,69469,69476,7
662,"Ethiopia - BEST New Ethiopian Music 2014 Demelash Negusie - Enka Bey Enka - (Official Video) by Legend Entertainment 8 years ago 5 minutes, 40 seconds 111,039 views",Legend Entertainment,111039,111046,7
663,"Ethiopia - BEST New Ethiopian Music 2014 Demelash Negusie - Awida -  [NEW! Video Music 2013] by Legend Entertainment 8 years ago 5 minutes, 25 seconds 35,945 views",Legend Entertainment,35945,35951,6
664,"Ethiopia - BEST New Ethiopian Music 2014 Demelash Negusie - Kanchi Tedebiqe - (Official Video) by Legend Entertainment 8 years ago 4 minutes, 44 seconds 88,176 views",Legend Entertainment,88176,88183,7
665,"Ethiopia - BEST New Ethiopian Music 2014 Elias Getachew - Tebechisa - [NEW! Video Music 2013] by Legend Entertainment 8 years ago 4 minutes, 57 seconds 29,859 views",Legend Entertainment,29859,29861,2
666,"Ethiopia - BEST New Ethiopian Music 2014 Elias Getachew - Esetageba - (Official Video) by Legend Entertainment 8 years ago 5 minutes, 1 second 58,150 views",Legend Entertainment,58150,58165,15
667,"Ethiopia - BEST New Ethiopian Music 2013 Elias Getachew - Andafta -  [NEW! Video Music 2013] by Legend Entertainment 8 years ago 4 minutes, 34 seconds 18,128 views",Legend Entertainment,18128,18132,4
668,"Ethiopia - BEST New Ethiopian Music 2013 Aster Girma - Eshy (Official Video) [NEW! Video Music 2013] by Legend Entertainment 8 years ago 5 minutes, 27 seconds 337,450 views",Legend Entertainment,337450,337775,325
669,"Ethiopia - New Ethiopian music 2014 - Aster Girma - Siraye - (Official Video) by Legend Entertainment 8 years ago 4 minutes, 25 seconds 448,328 views",Legend Entertainment,448328,448601,273
670,"Ethiopia - BEST New Ethiopian Music 2014 Aster Girma - Awdamet - (Official Video) by Legend Entertainment 8 years ago 5 minutes, 41 seconds 173,096 views",Legend Entertainment,173096,173143,47
671,"Ethiopia - Temesgen Gebregziabher (TEMU) - Tegetatemu - (Official Audio) New Ethiopian music 2013 by Legend Entertainment 8 years ago 4 minutes, 29 seconds 92,130 views",Legend Entertainment,92130,92181,51
672,"Ethiopia - Temesgen Gebregziabher (TEMU) - Korahubesh - (Official Audio) New Ethiopian music 2013 by Legend Entertainment 8 years ago 5 minutes, 59 seconds 41,623 views",Legend Entertainment,41623,41647,24
673,"Ethiopia - BEST New Ethiopian Music 2013 Temesgen Gebregziabher (TEMU) - Ketema - (Official Audio) by Legend Entertainment 8 years ago 3 minutes, 48 seconds 53,382 views",Legend Entertainment,53382,53415,33
674,"Ethiopia - Temesgen Gebregziabher (TEMU) - Tekeymkuat - (Official Audio) by Legend Entertainment 8 years ago 4 minutes, 51 seconds 56,548 views",Legend Entertainment,56548,56571,23
675,"Ethiopia - Temesgen Gebregziabher (TEMU) - Konjo Nat - (Official Audio) New Ethiopian music 2013 by Legend Entertainment 8 years ago 4 minutes, 18 seconds 46,750 views",Legend Entertainment,46750,46778,28
676,"Ethiopia - Temesgen Gebregziabher (TEMU) - Lebichaye - (Official Audio) New Ethiopian music 2013 by Legend Entertainment 8 years ago 3 minutes, 31 seconds 69,974 views",Legend Entertainment,69974,70026,52
677,"Ethiopia - Temesgen Gebregziabher (TEMU) - Yene Feker - (Official Audio) New Ethiopian music 2013 by Legend Entertainment 8 years ago 5 minutes, 45 seconds 105,830 views",Legend Entertainment,105830,105851,21
678,"Ethiopia - Lebe nedo by Temesgen Gebregziabher (Temu) Ethiopian music 2014 (Official video) by Legend Entertainment 8 years ago 7 minutes, 25 seconds 3,954,482 views",Legend Entertainment,3954482,3960405,5923
679,"Ethiopia - Lij Yared - Suda - (Official Video) Ethiopian Music 2014 by Legend Entertainment 8 years ago 3 minutes, 44 seconds 125,491 views",Legend Entertainment,125491,125514,23
680,"Yon Addis ft. Nhatty Man - Alat Mela - (Official Music Video) - New Ethiopian Music 2015 by Legend Entertainment 8 years ago 4 minutes, 24 seconds 116,926 views",Legend Entertainment,116926,116998,72
681,"Solomon Yikunoamlak - Nekae Brle (ነቓዕ ብርለ) - New Tigrigna Music 2022 | Official Video by Lele Entertainment 2 weeks ago 4 minutes, 33 seconds 675,871 views",Lele Entertainment,675871,853619,177748
682,"ሰሎሞን ይኩኖኣምላክ ኣብ ቀረባ እዋን by Lele Entertainment 3 weeks ago 13 seconds 4,122 views",Lele Entertainment,4122,4758,636
683,"Mekete and Ashenda San Diego Tigray Community 2021 by Lele Entertainment 5 months ago 22 minutes 3,519 views",Lele Entertainment,3519,3640,121
684,"Meket & Ashenda Tigray 2021 CA San Diego by Lele Entertainment 6 months ago 8 minutes, 54 seconds 3,361 views",Lele Entertainment,3361,3422,61
685,"ግጥሚ ኣብ ኣሸንዳን መኸተ ትግራይ Meket & Ashenda Tigray 2021 CA San Diego by Lele Entertainment 6 months ago 1 minute, 51 seconds 2,048 views",Lele Entertainment,2048,2114,66
686,"Dj Moris ft Raza Raya & Wedi Fetaw - HiE (ሒእ!) - New Tigrigna Music 2021 (Official Music) by Lele Entertainment 6 months ago 4 minutes, 2 seconds 2,433 views",Lele Entertainment,2433,2529,96
687,"Tsegay Solomon (T-Ibex) - Tegaru | ፀጋይ ሰለሞን - ተጋሩ - New Tigrigna Music 2021 by Lele Entertainment 10 months ago 4 minutes, 24 seconds 7,860 views",Lele Entertainment,7860,7955,95
688,"Tsegay Solomon (T-Ibex) - Fithi | ፀጋይ ሰለሞን - ፍትሒ - New Tigrigna Music 2021 by Lele Entertainment 10 months ago 4 minutes, 20 seconds 3,438 views",Lele Entertainment,3438,3525,87
689,"Yared Berhe (ያሬድ በርሀ) - Nmeninetey (ንመንነተይ) | New Tigrigna Music 2021 | Official Video by Lele Entertainment 1 year ago 6 minutes, 29 seconds 39,145 views",Lele Entertainment,39145,39321,176
690,"Fiseha Gebel (ፍስሃ ገበል) - Luba (ሉባ) |  New Tigrigna Music 2021 #LekatitAdena by Lele Entertainment 1 year ago 6 minutes, 49 seconds 57,114 views",Lele Entertainment,57114,57275,161
691,"Tumzgi Nirea (Tomi) - Jeganuna (ጀጋኑና) New Tigrigna Music 2021 | Official Video by Lele Entertainment 1 year ago 4 minutes, 24 seconds 94,300 views",Lele Entertainment,94300,95376,1076
692,"Ephrem Hagos (ኤፍሬም ሓጎስ) | Dehaykum SemiAe (ደሃይኹም ሰሚዐ) - New Tigrigna Music 2021 by Lele Entertainment 1 year ago 6 minutes, 7 seconds 122,657 views",Lele Entertainment,122657,122876,219
693,"Haw - Tigrigna poem | ሓው - ትግርኛ ግጥሚ #1 by Lele Entertainment 1 year ago 3 minutes, 59 seconds 6,519 views",Lele Entertainment,6519,6575,56
694,"Rediet Tsegay (ረድኤት ፀጋይ) - Eza Meret (እዛ መሬት) | Official Music 2021 #TigrayGenocide by Lele Entertainment 1 year ago 5 minutes, 6 seconds 9,116 views",Lele Entertainment,9116,9160,44
695,"መፃወድያ ድራማ ክፋል 45 | Metsawedya Episode 45 by Lele Entertainment 1 year ago 29 minutes 86,724 views",Lele Entertainment,86724,87402,678
696,"መፃወድያ ድራማ ክፋል 44 | Metsawedya Episode 44 by Lele Entertainment 1 year ago 23 minutes 82,199 views",Lele Entertainment,82199,82521,322
697,"ጓዳ 2 - ብክትራን ዓመፅ ተደፊራ ሂወታ ዝሰኣነት ንእስቲ - ሓቀኛ ናይ ገበን ታሪክ | Guada 2 - True Crime Story by Lele Entertainment 1 year ago 29 minutes 88,268 views",Lele Entertainment,88268,88364,96
698,"መፃወድያ ድራማ ክፋል 43 | Metsawedya Episode 43 by Lele Entertainment 1 year ago 21 minutes 68,212 views",Lele Entertainment,68212,68505,293
699,"ጓዳ 1 - ኣብ ሻወር ተቐቲላ ዝተረኸበት - ሓቀኛ ናይ ገበን ታሪክ | Guada 1 - True Crime Story by Lele Entertainment 1 year ago 30 minutes 81,481 views",Lele Entertainment,81481,81534,53
700,"መፃወድያ ድራማ ክፋል 42 | Metsawedya Episode 42 by Lele Entertainment 1 year ago 24 minutes 70,792 views",Lele Entertainment,70792,71086,294
701,"ፍቕርን ክራርን- ሓዱሽ ናይ ትግርኛ ድራማ | Fikrn Kirarn - Tigrigna Comedy Drama 2020 by Lele Entertainment 1 year ago 35 minutes 106,572 views",Lele Entertainment,106572,106865,293
702,"መፃወድያ ድራማ ክፋል 41 | Metsawedya Episode 41 by Lele Entertainment 1 year ago 26 minutes 77,876 views",Lele Entertainment,77876,78163,287
703,"Mebrahtu Guesh - Tesfa Aleni (መብራህቱ ጉዑሽ - ተስፋ ኣለኒ) - New Tigrigna Music Video 2020 by Lele Entertainment 1 year ago 5 minutes, 9 seconds 2,809 views",Lele Entertainment,2809,3024,215
704,"Bruk Redae Kiyaye - ብሩክ ረዳኢ(ኪያ) ኪያዬ - New Ethiopian Music 2020 | Official Music by Lele Entertainment 1 year ago 4 minutes, 19 seconds 6,913 views",Lele Entertainment,6913,6995,82
705,"መፃወድያ ድራማ ክፋል 40 | Metsawedya Episode 40 by Lele Entertainment 1 year ago 22 minutes 81,817 views",Lele Entertainment,81817,82104,287
706,"መፃወድያ ድራማ ክፋል 39 | Metsawedya Episode 39 by Lele Entertainment 1 year ago 23 minutes 78,238 views",Lele Entertainment,78238,78519,281
707,"ለቱ - ሓዱሽ ናይ ትግርኛ ድራማ | Letu - Tigrigna Comedy Drama 2020 by Lele Entertainment 1 year ago 29 minutes 88,012 views",Lele Entertainment,88012,88153,141
708,"መፃወድያ ድራማ ክፋል 38 | Metsawedya Episode 38 by Lele Entertainment 1 year ago 23 minutes 76,486 views",Lele Entertainment,76486,76747,261
709,"Ashenda 2020 with Lele Show by Lele Entertainment 1 year ago 4 minutes, 19 seconds 3,528 views",Lele Entertainment,3528,3541,13
710,"መፀት መፀት ኣሸንዳ ዕምበብ  መፀት | Metset Metset Ashenda Embeb Metset   | Ashenda 2020 by Lele Entertainment 1 year ago 3 minutes, 55 seconds 6,403 views",Lele Entertainment,6403,6416,13
711,"መፃወድያ ድራማ ክፋል 37 | Metsawedya Episode 37 by Lele Entertainment 1 year ago 23 minutes 80,380 views",Lele Entertainment,80380,80640,260
712,"መፃወድያ ድራማ - ምዕራፍ 4 - ፃንሒት ምስ ተዋሳእቲ 2ይ ክፋል  | Season 4 Interview with Metsawedya Cast Part 2 by Lele Entertainment 1 year ago 25 minutes 20,929 views",Lele Entertainment,20929,21054,125
713,"መፃወድያ ድራማ - ምዕራፍ 4 - ፃንሒት ምስ ተዋሳእቲ 1ይ ክፋል  | Season 4 Interview with Metsawedya Cast Part 1 by Lele Entertainment 1 year ago 26 minutes 20,230 views",Lele Entertainment,20230,20327,97
714,"Corona Entay Eyu Mis Jamuye Gualyatu ጃሙየ ብዛዕባ ኮረና ድትብሎ እንሀዋ by Lele Entertainment 1 year ago 10 minutes, 51 seconds 14,870 views",Lele Entertainment,14870,14881,11
715,"ቕልስ ምስ ኮረና - ትግርኛ ድራማ | Qlis Mis Corona - New Tigrigna Comedy Drama 2020 by Lele Entertainment 1 year ago 31 minutes 103,785 views",Lele Entertainment,103785,103829,44
716,"ሓድጋይ ሓዳግ - ሓዱሽ ትግርኛ ድራማ | Hadgay Hadag - New Tigrigna Comedy Drama 2020 by Lele Entertainment 1 year ago 25 minutes 12,824 views",Lele Entertainment,12824,12833,9
717,"Tumzgi Nirea (Tomi) - Tigraway (ትግራዋይ) New Tigrigna Music 2020 | Official Video by Lele Entertainment 1 year ago 4 minutes, 7 seconds 88,123 views",Lele Entertainment,88123,89863,1740
718,"መፃወድያ ድራማ ክፋል 36 | Metsawedya Episode 36 by Lele Entertainment 1 year ago 34 minutes 118,601 views",Lele Entertainment,118601,118942,341
719,"መፃወድያ ድራማ ክፋል 35 | Metsawedya Episode 35 by Lele Entertainment 1 year ago 29 minutes 85,901 views",Lele Entertainment,85901,86181,280
720,"መፃወድያ ድራማ ክፋል 34 | Metsawedya Episode 34 by Lele Entertainment 1 year ago 28 minutes 95,706 views",Lele Entertainment,95706,96040,334
721,"ስዋን ፅዋን - ትግርኛ ድራማ | Swan Tsiwan - New Tigrigna Comedy Drama 2020 by Lele Entertainment 1 year ago 40 minutes 155,706 views",Lele Entertainment,155706,156008,302
722,"መፃወድያ ድራማ ክፋል 33 | Metsawedya Episode 33 by Lele Entertainment 1 year ago 24 minutes 90,916 views",Lele Entertainment,90916,91168,252
723,"መፃወድያ ድራማ ክፋል 32 | Metsawedya Episode 32 by Lele Entertainment 1 year ago 29 minutes 80,407 views",Lele Entertainment,80407,80676,269
724,"መፃወድያ ድራማ ክፋል 31 | Metsawedya Episode 31 by Lele Entertainment 1 year ago 28 minutes 80,931 views",Lele Entertainment,80931,81209,278
725,"Rahwa ft Mehari Hagos - Kweghido ክወግሒ'ዶ | New Tigrigna Music 2020 by Lele Entertainment 1 year ago 3 minutes, 47 seconds 10,222 views",Lele Entertainment,10222,10240,18
726,"#StayHome Exercise With Mebrat Tadelle by Lele Entertainment 1 year ago 7 minutes, 18 seconds 2,786 views",Lele Entertainment,2786,2789,3
727,"መፃወድያ ድራማ ክፋል 30 | Metsawedya Episode 30 by Lele Entertainment 1 year ago 25 minutes 82,812 views",Lele Entertainment,82812,83063,251
728,"Sintayoh Tadelle -  እምበይተይ ሃመዓላ Embeytey HameAla | Ane Hagos Challenge 2020 by Lele Entertainment 1 year ago 3 minutes, 55 seconds 12,709 views",Lele Entertainment,12709,12730,21
729,"ደፊረ ክምርዐወኪ 2 - ትግርኛ ድራማ  | Defire Kmuriaeweki 2 - New Tigrigna Drama 2020 by Lele Entertainment 1 year ago 36 minutes 152,643 views",Lele Entertainment,152643,152739,96
730,"መፃወድያ ድራማ ክፋል 29 | Metsawedya Episode 29 by Lele Entertainment 1 year ago 23 minutes 94,589 views",Lele Entertainment,94589,94833,244
731,"መፃወድያ ድራማ ክፋል 28 | Metsawedya Drama Episode 28 by Lele Entertainment 1 year ago 24 minutes 77,868 views",Lele Entertainment,77868,78129,261
732,"ሃብዮ - ትግርኛ ድራማ | Habyo - New Tigrigna Comedy Drama 2020 by Lele Entertainment 1 year ago 28 minutes 235,503 views",Lele Entertainment,235503,235701,198
733,"Lele Show with Sintayoh Amharic on Corona Virus |  ለለ ሾው ከ ስንታዮህ ስለ ኮረና ቫይረስ  መልእክት by Lele Entertainment 1 year ago 5 minutes, 59 seconds 2,515 views",Lele Entertainment,2515,2520,5
734,"መፃወድያ ድራማ ክፋል 27 | Metsawedya Episode 27 by Lele Entertainment 1 year ago 28 minutes 86,955 views",Lele Entertainment,86955,87254,299
735,"Lele Show With Sintayoh on Corona Virus | Exercise while Stay At Home | ለለ ሾው ምስ ስንታዮህ ብዛዕባ ኮረና ቫይረስ by Lele Entertainment 1 year ago 17 minutes 2,991 views",Lele Entertainment,2991,2992,1
736,"Corona Virus መልእክት ከሞዴል አርቲስት መብራት ታደለ በትግርኛ እና አማርኛ  በኮረና በሽታ ማን ይጎዳል? Corona Virus ቀልድ አይደለም!!! by Lele Entertainment 1 year ago 3 minutes, 31 seconds 7,450 views",Lele Entertainment,7450,7463,13
737,"መፃወድያ ድራማ ክፋል 26 | Metsawedya Episode 26 by Lele Entertainment 1 year ago 25 minutes 80,779 views",Lele Entertainment,80779,81077,298
738,"መፃወድያ ድራማ ክፋል 25 | Metsawedya Episode 25 by Lele Entertainment 1 year ago 24 minutes 86,799 views",Lele Entertainment,86799,87071,272
739,"መፃወድያ ድራማ - ምዕራፍ 3 - ፃንሒት ምስ ተዋሳእቲ | Season 3 - Interview with Metsawedya Cast by Lele Entertainment 1 year ago 32 minutes 60,166 views",Lele Entertainment,60166,60348,182
740,"Bererti Embebatat (በረርቲ ዕምበባታት) - New Ethiopian Tigrigna Drama - Part 4 & Final by Lele Entertainment 1 year ago 15 minutes 22,323 views",Lele Entertainment,22323,22334,11
741,"Bererti Embebatat (በረርቲ ዕምበባታት) - New Ethiopian Tigrigna Drama - Part 3 by Lele Entertainment 1 year ago 24 minutes 43,257 views",Lele Entertainment,43257,43273,16
742,"Bererti Embebatat (በረርቲ ዕምበባታት) - New Ethiopian Tigrigna Drama - Part 2 by Lele Entertainment 2 years ago 25 minutes 41,057 views",Lele Entertainment,41057,41065,8
743,"Bererti Embebatat (በረርቲ ዕምበባታት) - New Ethiopian Tigrigna Drama - Part 1 by Lele Entertainment 2 years ago 26 minutes 30,485 views",Lele Entertainment,30485,30492,7
744,"Fre Zenebe - Nberuley (ንበሩለይ) - New Ethiopian Tigrigna Music 2020 by Lele Entertainment 2 years ago 4 minutes, 51 seconds 56,014 views",Lele Entertainment,56014,56080,66
745,"Kidane Wedi Ale - Arha Weyanay (ኣርሓ ወያናይ) - New Ethiopian Tigrigna Music 2020 by Lele Entertainment 2 years ago 7 minutes, 5 seconds 2,525,877 views",Lele Entertainment,2525877,2538288,12411
746,"Tigray Female Orkestra Band - Lekatit Adena (ለካቲት ኣዴና) by Eyasu Berhe by Lele Entertainment 2 years ago 5 minutes, 10 seconds 150,709 views",Lele Entertainment,150709,152160,1451
747,"Selamawit Abraha - Baska Hananeta (ባስካ ሓናኔታ) - New Ethiopian Irob Music 2020 | ቋንቋ ሳሆ(ኢሮብ) by Lele Entertainment 2 years ago 6 minutes, 25 seconds 31,518 views",Lele Entertainment,31518,31659,141
748,"Tumzgi Nirea (Tomi) - Tigraway (ትግራዋይ) New Tigrigna Music 2020 by Lele Entertainment 2 years ago 3 minutes, 52 seconds 121,886 views",Lele Entertainment,121886,122247,361
749,"Zinabu Abadi - Mocha (ሞቻ) - New Ethiopian Tigrigna Music 2020 | Rayuma by Lele Entertainment 2 years ago 7 minutes, 18 seconds 442,913 views",Lele Entertainment,442913,443716,803
750,"Ephrem Amare - Atiyo - Amazing Live Performance - Los Angeles - Part 2 by Lele Entertainment 2 years ago 8 minutes, 19 seconds 4,283 views",Lele Entertainment,4283,4289,6
751,"Ephrem Amare - Asey - Amazing Live Performance 2020 - Los Angeles - Part 1 by Lele Entertainment 2 years ago 9 minutes, 34 seconds 3,899 views",Lele Entertainment,3899,3907,8
752,"መፃወድያ ድራማ ክፋል 24 | Metsawedya Episode 24 by Lele Entertainment 2 years ago 29 minutes 108,300 views",Lele Entertainment,108300,108563,263
753,"ፍቅሪ ሎሚ - ሙዚቃዊ ድራማ | Fikri Lomi - New Habesha Musical Drama 2020 by Lele Entertainment 2 years ago 5 minutes, 35 seconds 25,571 views",Lele Entertainment,25571,25583,12
754,"Kotsero Wushma (ቆፀሮ ውሽማ) - New Tigrigna Comedy Drama 2020 by Lele Entertainment 2 years ago 22 minutes 328,796 views",Lele Entertainment,328796,329060,264
755,"መፃወድያ ድራማ ክፋል 23 | Metsawedya Episode 23 by Lele Entertainment 2 years ago 30 minutes 80,610 views",Lele Entertainment,80610,80883,273
756,"መፃወድያ ድራማ ክፋል 22 | Metsawedya Episode 22 by Lele Entertainment 2 years ago 29 minutes 72,414 views",Lele Entertainment,72414,72659,245
757,"ደፊረ ክምርዐወኪ 1 - ትግርኛ ድራማ | Defire Kmuriaeweki 1 - New Tigrigna Drama 2020 by Lele Entertainment 2 years ago 20 minutes 182,892 views",Lele Entertainment,182892,182941,49
758,"ወዮ - ትግርኛ ድራማ - ክፋል 12 - መወዳእታ ቀዳማይ ምዕራፍ by Lele Entertainment 2 years ago 21 minutes 19,898 views",Lele Entertainment,19898,19906,8
759,"መፃወድያ ድራማ ክፋል 21 | Metsawedya Episode 21 by Lele Entertainment 2 years ago 25 minutes 82,006 views",Lele Entertainment,82006,82249,243
760,"ወዮ - ትግርኛ ድራማ - ክፋል 11 | Weyo - Tigrigna Drama - Part 11 by Lele Entertainment 2 years ago 24 minutes 9,083 views",Lele Entertainment,9083,9092,9
761,"John Tadesse  - Dedihreki (ደድሕረኺ) - New Ethiopian Tigrigna Music 2019 | Official Video by Lele Entertainment 2 years ago 5 minutes, 14 seconds 15,771 views",Lele Entertainment,15771,15783,12
762,"መፃወድያ ድራማ ክፋል 20 | Metsawedya Episode 20 by Lele Entertainment 2 years ago 25 minutes 75,707 views",Lele Entertainment,75707,75968,261
763,"ወዮ - ትግርኛ ድራማ - 10ይ ክፋል | Weyo - Tigrigna Drama - Part 10 by Lele Entertainment 2 years ago 21 minutes 4,972 views",Lele Entertainment,4972,4979,7
764,"Solomon Yikunoamlak - Emhoy Azmera (እምሆይ ኣዝመራ) - New Ethiopian Tigrigna Music 2019 | Official Video by Lele Entertainment 2 years ago 6 minutes, 18 seconds 412,281 views",Lele Entertainment,412281,422363,10082
765,"ወዮ - ትግርኛ ድራማ - 9ይ ክፋል | Weyo - Tigrigna Drama - Part 9 by Lele Entertainment 2 years ago 21 minutes 29,147 views",Lele Entertainment,29147,29183,36
766,"መፃወድያ ድራማ ክፋል 19 | Metsawedya Episode 19 by Lele Entertainment 2 years ago 28 minutes 69,008 views",Lele Entertainment,69008,69253,245
767,"ወዮ - ትግርኛ ድራማ - 8ይ ክፋል | Weyo - Tigrigna Drama - Part 8 by Lele Entertainment 2 years ago 22 minutes 18,713 views",Lele Entertainment,18713,18739,26
768,"መፃወድያ ድራማ ክፋል 18 | Metsawedya Episode 18 by Lele Entertainment 2 years ago 25 minutes 68,527 views",Lele Entertainment,68527,68776,249
769,"Raya Vs San Francisco - Hashenge - ሕልመይ  - Lele Show with Sintayoh by Lele Entertainment 2 years ago 17 minutes 2,684 views",Lele Entertainment,2684,2686,2
770,"Nebyat Hagos (ነብያት ሓጎስ) - Harertay (ሃረርታይ) | New Ethiopian Tigrigna Music 2019 by Lele Entertainment 2 years ago 6 minutes, 23 seconds 54,250 views",Lele Entertainment,54250,54310,60
771,"Hermela Haftay & Meron Haftay (Neaki ena Nekedim) ሄርሜላ ሃፍታይን ሜሮን ሃፍታይን  / Tigray Music 2022 by Liham Melody 8 days ago 4 minutes, 34 seconds 8,998 views",Liham Melody,8998,11519,2521
772,"Mulubrhan Fiseha Wari (Grim'ba)  ሙሉእብርሃን ፍሰሃ ዋሪ (ግርም'ባ)  / Tigray Music 2022 by Liham Melody 3 weeks ago 4 minutes, 19 seconds 266,281 views",Liham Melody,266281,333779,67498
773,"Alem Tesfay (Hawerya Selam) ኣለም ተስፋይ (ሃወርያ ሰላም) / Tigray Music 2022 by Liham Melody 1 month ago 5 minutes, 10 seconds 9,760 views",Liham Melody,9760,10098,338
774,"Netsanet Tesfay (Ajona) ነፃነት ተስፋይ (ኣጆና) / Tigray Music 2022 by Liham Melody 1 month ago 5 minutes, 40 seconds 21,495 views",Liham Melody,21495,23403,1908
775,"Tadese Fisto (Hikey Mingagay) ታደሰ ደስታ ፊስቶ (ሕቐይ ምንጋጋይ) / Tigray Music 2022 by Liham Melody 1 month ago 5 minutes, 41 seconds 34,884 views",Liham Melody,34884,37379,2495
776,"Simon Kahsay (Hilfi Kulu) ስምኦን ካሕሳይ (ሕልፊ ኹሉ) / Tigray Music 2022 by Liham Melody 1 month ago 5 minutes, 18 seconds 33,971 views",Liham Melody,33971,34458,487
777,"Embaye Dadimas (Dagmawi) እምባየ ደዲማስ (ዳግማዊ) New Tigrigna Poem by Liham Melody 1 month ago 6 minutes, 59 seconds 33,273 views",Liham Melody,33273,33484,211
778,"Kibrom Birhane (Akabtsom) ክብሮም ብርሃነ (ኣቃብፆም ) Tigray Music 2022 by Liham Melody 2 months ago 6 minutes, 16 seconds 55,594 views",Liham Melody,55594,59374,3780
779,"Gebremeskel Gebresilassie (Reaya Eski) ገብረመስቀል ገብረስላሴ (ረአያ እስኪ) / Tigray Music 2021 by Liham Melody 2 months ago 6 minutes 8,940 views",Liham Melody,8940,9040,100
780,"Rahwa Gali (Hezi do Heshe )ራህዋ ጋሊ (ሐዚ ዶ ሐሸ) / Tigray Music 2021 by Liham Melody 2 months ago 5 minutes, 57 seconds 49,538 views",Liham Melody,49538,51369,1831
781,"Kibrom Gebrehiwet (Adey)ክብሮም ገብረሂወት  (ዓደይ) /  Tigray Music 2021 by Liham Melody 2 months ago 4 minutes, 56 seconds 9,609 views",Liham Melody,9609,9841,232
782,"Helen Hadush (Embila)ሄለን ሓዱሽ (እምቢላ) / Tigray Music 2021 by Liham Melody 2 months ago 4 minutes, 31 seconds 40,863 views",Liham Melody,40863,41325,462
783,"Temesgen Teklay (Hdri Aleni)ተመስገን ተኽላይ (ሕድሪ ኣለኒ )Tigray Music 2021 by Liham Melody 2 months ago 7 minutes, 37 seconds 97,355 views",Liham Melody,97355,100472,3117
784,"Mebrahtu Binyam (Ambesa Bereka )መብራህቱ ቢንያም (ኣምበሳ በረኻ) Tigray Music 2021 by Liham Melody 2 months ago 5 minutes, 26 seconds 16,283 views",Liham Melody,16283,16412,129
785,"Mehari Mersi (Abelom Koded)መሓሪ መርሲ (ኣበሎም ኮደድ by Liham Melody 2 months ago 4 minutes, 46 seconds 15,992 views",Liham Melody,15992,16493,501
786,"Kinfe Gebregergis (Mebrek) - ክንፈ ገብረገርግስ (መብረቕ) / Tigray Music 2021 by Liham Melody 2 months ago 6 minutes, 28 seconds 73,633 views",Liham Melody,73633,76711,3078
787,"Kidane Birhane (Tigraway ) - ኪዳነ ብርሃነ (ትግራዋይ) / Tigray Music 2021 by Liham Melody 2 months ago 6 minutes, 59 seconds 70,234 views",Liham Melody,70234,72621,2387
788,"Hafte Gebrehiwet (Situm Sire) - ሃፍተ ገብረሂወት (ስጡም ስረ)  / Tigray Music 2021 by Liham Melody 2 months ago 6 minutes, 23 seconds 52,829 views",Liham Melody,52829,53333,504
789,"Gzachew Solomon (Anbesa Bereka) - ግዛቸው ሰለሞን (ኣንበሳ በረኻ) / Tigray Music 2021 by Liham Melody 3 months ago 6 minutes, 16 seconds 308,085 views",Liham Melody,308085,310902,2817
790,"Alu Dancer & Lominat Hayelom (Bahrna) - ኣሉ ዳንሰርን ሎሚናት ሓየሎምን (ባሕርና) Tigray Music 2021 by Liham Melody 3 months ago 3 minutes, 9 seconds 28,317 views",Liham Melody,28317,28477,160
791,"Kibrom Gebrehiwet (Tigray) - ክብሮም ገብረሂወት (ትግራይ) / Tigray Music 2021 by Liham Melody 3 months ago 6 minutes, 50 seconds 75,057 views",Liham Melody,75057,75635,578
792,"Lielti Aregay & Goitom Hailemaryam- Hantin Bokrin I ልእልቲ ኣረጋይን ጎይቶኦም ሃይለማርያምን -ሓንትን ቦኽርን by Liham Melody 3 months ago 5 minutes, 10 seconds 21,176 views",Liham Melody,21176,21786,610
793,"Michaele Kiros (Sandale) - Amora / ሚኪኤለ ኪሮስ(ሳንዳለ) -ኣሞራ / Tigray Music 2021 by Liham Melody 3 months ago 7 minutes, 4 seconds 110,455 views",Liham Melody,110455,111997,1542
794,"Angesom Ejargew(Menkis) - Adeyma | ኣንገሶም እጃርገዉ (መንኪስ) - ዓደይ'ማ / Tigray Music (Official Video) by Liham Melody 3 months ago 5 minutes, 20 seconds 54,188 views",Liham Melody,54188,54359,171
795,"Assefa Romha(Belo) ኣሰፉ ሮምሃ (በሎ) Tigray Music (Official Video) by Liham Melody 3 months ago 6 minutes, 13 seconds 52,356 views",Liham Melody,52356,52603,247
796,"Hermela Haftay & Meron Haftay (Waero) ሄርሜላ ሃፍታይን ሜሮን ሃፍታይን(ዋዕሮ) Tigray Music (Official Video) by Liham Melody 3 months ago 4 minutes, 6 seconds 79,938 views",Liham Melody,79938,80417,479
797,"Tsigereda Demoz (Eti Demom)ፅጌሬዳ ደሞዝ(እቲ ደሞም) Tigray Music (Official Video) by Liham Melody 3 months ago 5 minutes, 33 seconds 6,466 views",Liham Melody,6466,6561,95
798,"Lielti Aregay & Goitom Hailemariam (Abesku Abiluwom) Tigray Music (Official Video) by Liham Melody 3 months ago 5 minutes, 14 seconds 25,907 views",Liham Melody,25907,26056,149
799,"Gereziher Hadgay (Metsaku) ገሄር ሓድጋይ (መፃኹ) Tigray Music (Official Video) by Liham Melody 3 months ago 7 minutes, 19 seconds 109,527 views",Liham Melody,109527,110075,548
800,"Berihu Mehari (Zigerm eyu) በሪሁ መሓሪ (ዝገም 'ዩ) Tigray Music (Official Video) by Liham Melody 3 months ago 5 minutes, 8 seconds 71,881 views",Liham Melody,71881,72339,458
801,"Berihu Gebremariam (Merkni) በሪሁ ገብረማርያም (መርቕኒ) Tigray Music (Official Video) by Liham Melody 3 months ago 5 minutes, 20 seconds 20,192 views",Liham Melody,20192,20263,71
802,"Abrehet Abdu (Hamel ) ኣብረሀት ዓብዱ (ሃመል) Tigray Music (Official Video) by Liham Melody 3 months ago 5 minutes, 36 seconds 109,350 views",Liham Melody,109350,109934,584
803,"Yemane Kiday (GENA) የማነ ኪዳይ (ገና) Tigray Music (Official Video) by Liham Melody 4 months ago 5 minutes, 35 seconds 7,191 views",Liham Melody,7191,7206,15
804,"Kinfe Gebregergis (Fekari Werari) Tigray Music (Official Video) by Liham Melody 4 months ago 6 minutes, 2 seconds 146,643 views",Liham Melody,146643,147028,385
805,"Fandem Wahid (Kinsiesie Ena) ፋንደም ዋህድ (ክንስዕስዕ ኢና) Tigray Music (Official Video) by Liham Melody 4 months ago 5 minutes, 8 seconds 10,498 views",Liham Melody,10498,10526,28
806,"Adey G/michael (Wusediya) ኣደይ ገብረሚካኤል (ውሰድያ) Tigray Music (Official Video) by Liham Melody 4 months ago 6 minutes, 38 seconds 99,714 views",Liham Melody,99714,100008,294
807,"Yaru Makaveli x Narry x Yada sads x Ruta x Frew x danay x donat - CYPHER WEYN 2 / Tigray Music by Liham Melody 4 months ago 6 minutes, 23 seconds 490,483 views",Liham Melody,490483,499249,8766
808,"Suzi Aklilu (Wueletka) ሱዚ ኣክሊሉ (ውዕለትካ) / Tigray Music (Official Video) by Liham Melody 4 months ago 4 minutes, 15 seconds 20,004 views",Liham Melody,20004,20040,36
809,"Shmendi Gebremariam (Berkley) ሽመንዲ ገ/ማርያም (በርኽለይ)  / Tigray Music (Official Video) by Liham Melody 4 months ago 6 minutes, 9 seconds 190,537 views",Liham Melody,190537,190817,280
810,"Tsegaluel Hailemariam (Selalia Aba Dahri) ፀጋልላኡል ሃ/ማርያም (ሰላሊዓ ኣባ ዳህሪ) Tigray Music (Official Video) by Liham Melody 4 months ago 6 minutes, 20 seconds 735,347 views",Liham Melody,735347,748069,12722
811,"Milaw Tesfay (Kfue Aderie) ሚላው ተስፋይ (ኩፉእ ኣደሬ) Tigray Music (Official Video) by Liham Melody 4 months ago 10 minutes, 4 seconds 868,335 views",Liham Melody,868335,875297,6962
812,"Gezae Ftwi Adey (edilegna) ገዛኢ ፍትዊ ዓደይ (ዕድለኛ) Tigray Music (Official Video) by Liham Melody 4 months ago 4 minutes, 26 seconds 29,346 views",Liham Melody,29346,29516,170
813,"Goitom Gebriye (Weyane Ena) ጎይተኦም ገብርየ (ወያነ ኢና) Tigray Music (Official Video) by Liham Melody 5 months ago 6 minutes, 40 seconds 167,075 views",Liham Melody,167075,167386,311
814,"Gebru Gebremedhin (Fano) - Kihdet | ገብሩ ገብረመድህን (ፋኖ) - ክሕደት / Tigray Music (Official Video) by Liham Melody 5 months ago 6 minutes, 3 seconds 627,445 views",Liham Melody,627445,629424,1979
815,"Tiemtu Gebrehiwet (Nirimey)  ጥዕምቱ ገብረሂወት (ንሪመይ) Tigray Music (Official Video) by Liham Melody 6 months ago 5 minutes, 11 seconds 14,198 views",Liham Melody,14198,14236,38
816,"Rigiat Girmay & Meseret Hailu (Ashenda) ርግኣት ግርማይን መሰረት ሃይሉን (ኣሸንዳ) Tigray Music (Official Video) by Liham Melody 6 months ago 5 minutes, 44 seconds 18,119 views",Liham Melody,18119,18184,65
817,"Mulubrhan Fisseha (Wari) - Cha | ሙሉብርሃን ፍስሃ (ዋሪ) ''ቻ'' Tigray Music (Official Video) by Liham Melody 6 months ago 6 minutes, 41 seconds 943,615 views",Liham Melody,943615,948461,4846
818,"Timnit Welday (Segar) ትምኒት ወልዳይ (ሰጋር) Tigray Music (Official Video) by Liham Melody 7 months ago 7 minutes, 21 seconds 4,260,116 views",Liham Melody,4260116,4320858,60742
819,"Birtukuan & Damo - Tigraway Hayelom (ትግራዋይ ሓየሎም) Tigray Music (Official Video) by Liham Melody 8 months ago 3 minutes, 25 seconds 28,587 views",Liham Melody,28587,28612,25
820,"Saron Mamuye - Seabeni (ሰዓበኒ) Tigray Music (Official Video) by Liham Melody 8 months ago 4 minutes, 18 seconds 23,297 views",Liham Melody,23297,23321,24
821,"Solyana Ftwi - Men'yu Zhizbi (መን’ዩ  ዝህዝቢ) Tigray Music (Official Video) by Liham Melody 8 months ago 5 minutes, 46 seconds 67,936 views",Liham Melody,67936,68052,116
822,"Coming Soon New Tigrigna Music Video By Solyana Ftwi ''Men'yu Zhizbi'' by Liham Melody 9 months ago 38 seconds 32,254 views",Liham Melody,32254,32274,20
823,"Eden Gebreslassie - Halimela Tigray (ሓሊመልኪ ትግራይ) Tigray Music (Official Video) by Liham Melody 9 months ago 5 minutes, 16 seconds 23,963 views",Liham Melody,23963,23981,18
824,"Haftu Haileselassie (Nihnbeb Alena) ሃፍቱ ሃ/ስላሴ (ንሕንበብለና) Tigray Music (Official Video) by Liham Melody 9 months ago 5 minutes, 24 seconds 50,912 views",Liham Melody,50912,50990,78
825,"Aregawi Tesfay (Tigray Adey) ኣረጋዊ ተስፋይ  (ትግራይ  ዓደይ) Tigray Music (Official Video) by Liham Melody 10 months ago 6 minutes, 31 seconds 427,978 views",Liham Melody,427978,429643,1665
826,"ዕዳ ልበይ  Eda Libey - ሙሉጌታ ደስታ Mulugeta Desta - New Tigrigna Music 2021 (Official Video) by Liham Melody 11 months ago 6 minutes, 16 seconds 24,418 views",Liham Melody,24418,24447,29
827,"ትብርሃኒላ TIBRHANILA - ግደይ ተስፋይ Gidey Tesfay - New Tigrigna Music 2021 by Liham Melody 11 months ago 6 minutes, 11 seconds 49,650 views",Liham Melody,49650,49699,49
828,"ኣለና Alena - Asfaw Jeb Jeb Tigrigna Music 2021 (Official Video) by Liham Melody 11 months ago 5 minutes, 34 seconds 86,838 views",Liham Melody,86838,86908,70
829,"Temesgen Zegeye (Aya Baelu) - ተመስገን ዘገየ (ኣያ ባዕሉ) New Tigrigna Music 2021 (Official Video) by Liham Melody 1 year ago 5 minutes, 32 seconds 179,842 views",Liham Melody,179842,180222,380
830,"Solomon kirarye, Tirhas kobeley and Asfaw Jeb Jeb - Hagere Tigray I ሃገረ ትግራይ - Tigrigna Music 2021 by Liham Melody 1 year ago 4 minutes, 12 seconds 161,327 views",Liham Melody,161327,161574,247
831,"Alazar Atsebeha  - (Selam Lechi) ኣልኣዛር አጽበሃ (ሰላም ለቺ ትግራይ ) New Tigrigna Music 2021 (Official Video) by Liham Melody 1 year ago 5 minutes, 59 seconds 870,114 views",Liham Melody,870114,872921,2807
832,"Milaw Tesfay - (Weniye Weni) ሚላው ተስፋይ (ወኒየ ወኒ) Tigray Music (Official Video) by Liham Melody 1 year ago 6 minutes, 19 seconds 1,245,812 views",Liham Melody,1245812,1264650,18838
833,"Mebrahtom Hailay (Akeza) መብራህቶም  ሃይላይ (ኣኸዛ) Ethiopian Tigrigna Music (Official Video) by Liham Melody 1 year ago 4 minutes, 48 seconds 61,218 views",Liham Melody,61218,61333,115
834,"Yapi Mapi (Hello) ያፒ ማፒ (ሄሎ) Ethiopian Tigrigna Music (Official Video) by Liham Melody 1 year ago 5 minutes, 3 seconds 322,172 views",Liham Melody,322172,323180,1008
835,"Dejen Tafere - (Afliyani) ደጀን ታፈረ (ኣፍልያኒ) Ethiopian Tigrigna Music (Official Video) by Liham Melody 1 year ago 6 minutes 53,639 views",Liham Melody,53639,53694,55
836,"Tesfalem G/her (Eneyo) ተስፋኣለም ገ/ሄር (እነዮ) Ethiopian Erop Music (Official Video) by Liham Melody 1 year ago 5 minutes, 17 seconds 43,476 views",Liham Melody,43476,43533,57
837,"Filimon Equbay & Bereket Mesele - Mantay Rekibe / Ethiopian Tigrigna Music (Official Video) by Liham Melody 1 year ago 3 minutes, 49 seconds 24,015 views",Liham Melody,24015,24045,30
838,"Berhe Kahsay - Kebid'yu | ከቢድ 'ዩ (Official Video) Ethiopian Tigrigna Music 2020 by Liham Melody 1 year ago 4 minutes, 46 seconds 12,607 views",Liham Melody,12607,12625,18
839,"Guanche Berhe (Wari) - Ketsawuteki / New Tigrigna Music 2020 (Official Video) by Liham Melody 1 year ago 4 minutes, 2 seconds 15,835 views",Liham Melody,15835,15854,19
840,"Alay Solomon - Keremela (Official Video) New Tigrigna Music 2020 by Liham Melody 1 year ago 5 minutes, 24 seconds 14,689 views",Liham Melody,14689,14712,23
841,"Samual Kiros & Tirhas Gebre - Hamatey Gorihen / New Traditional Tigrigna Music (Official Video) by Liham Melody 1 year ago 5 minutes, 13 seconds 96,606 views",Liham Melody,96606,96923,317
842,"Natnael Gebregziher - Tigray / New Traditional Tigrigna Music (Official Video) by Liham Melody 1 year ago 5 minutes, 15 seconds 14,223 views",Liham Melody,14223,14267,44
843,"Mengisteab Tadese - Aleki do | ኣለኺ ዶ / New Traditional Tigrigna Music (Official Video) by Liham Melody 1 year ago 5 minutes, 32 seconds 47,515 views",Liham Melody,47515,47617,102
844,"Meron OG ft  Amon X Betty -Tegaru | ተጋሩ (Official Video) New Tigrigna Music 2020 by Liham Melody 1 year ago 4 minutes, 55 seconds 14,738 views",Liham Melody,14738,14784,46
845,"Shiferaw Negasi - Deme gibu | ደመ ግቡ (Official Video) Ethiopian Music 2020 by Liham Melody 1 year ago 4 minutes, 57 seconds 10,637 views",Liham Melody,10637,10650,13
846,"Kisanet W/abraha & Kibeat Hailay-Hadush Amet | ሓዱሽ ዓመት / Traditional Tigrigna Music (Official Video) by Liham Melody 1 year ago 5 minutes, 32 seconds 38,308 views",Liham Melody,38308,38339,31
847,"Tsega Asfaw - Shdenay | ሽደናይ / New Traditional Tigrigna Music (Official Video) by Liham Melody 1 year ago 5 minutes, 13 seconds 41,368 views",Liham Melody,41368,41413,45
848,"Berhe Meresa (ወዲ ማርሰ) - Hameyeki Raya | ሃመየኺ ራያ / New Traditional Tigrigna Music (Official Video) by Liham Melody 1 year ago 7 minutes, 7 seconds 456,973 views",Liham Melody,456973,461804,4831
849,"Fre Zenebe - Gud Semia | ጉድ ሰሚዐ (Official Video) New Tigrigna Music 2020 by Liham Melody 1 year ago 6 minutes, 36 seconds 266,532 views",Liham Melody,266532,266864,332
850,"Tesfay Gidey - Weyzerit Tigray / Traditional Tigrigna Music (Official Video) by Liham Melody 1 year ago 6 minutes, 2 seconds 41,587 views",Liham Melody,41587,41766,179
851,"Selam Hailu - Aminey | ኣሚነይ / Traditional Tigrigna Music (Official Video) by Liham Melody 1 year ago 4 minutes, 37 seconds 46,482 views",Liham Melody,46482,46526,44
852,"Belaynesh Ftsumbrhan - Tslal Hiwetey / Ethiopian Tigrigna Music 2020 (Official Video) by Liham Melody 1 year ago 6 minutes, 4 seconds 44,234 views",Liham Melody,44234,44284,50
853,"Meareg Hiwet - WENAM | ወናም / New Traditional Tigrigna Music (Official Video) by Liham Melody 1 year ago 6 minutes, 27 seconds 38,167 views",Liham Melody,38167,38211,44
854,"Masho Yemane - ኣሸንዳ / Traditional Ashenda Music (Official Video) by Liham Melody 1 year ago 6 minutes, 30 seconds 85,134 views",Liham Melody,85134,85342,208
855,"Tesfu Gebreyesus (Chelsi) - Tembeney Welela | ተምቤነይ ወለላ /Traditional Tigrigna Music (Official Video) by Liham Melody 1 year ago 5 minutes, 47 seconds 19,295 views",Liham Melody,19295,19307,12
856,"Kebedu Gebrekidan - Ahay Laley / NewTraditional Tigrigna & Agew Music (Official Video) by Liham Melody 1 year ago 4 minutes, 52 seconds 45,063 views",Liham Melody,45063,45129,66
857,"Hrit Hailemariam - Ashenda / Traditional Tigrigna Ashenda Music (Official Video) by Liham Melody 1 year ago 6 minutes, 49 seconds 219,040 views",Liham Melody,219040,219667,627
858,"Tsegaluel Hailemariam - RIHUS EGRI | ርሑስ እግሪ / Traditional Tigrigna Wedding Music (Official Video) by Liham Melody 1 year ago 9 minutes, 17 seconds 443,728 views",Liham Melody,443728,444807,1079
859,"Meretu Shushay - Weyni Zelela | ወይኒ ዘለላ (Official Video) Ethiopian Tigrigna Music by Liham Melody 1 year ago 5 minutes, 18 seconds 24,689 views",Liham Melody,24689,24744,55
860,"Lelti Aregay - Mear Tsebay / New Traditional Tigrigna Music (Official Video) by Liham Melody 1 year ago 5 minutes, 15 seconds 209,787 views",Liham Melody,209787,210411,624
861,"Senait Abebe - Werkimahzal'le | ወርቂማሕዛል'ለ / New Ethiopian Traditional Erob Music (Official Video) by Liham Melody 1 year ago 6 minutes, 47 seconds 483,549 views",Liham Melody,483549,488320,4771
862,"Natnael Hagos - Ziyaday | ዝያዳይ (Official Video) Ethiopian Tigrigna Music by Liham Melody 1 year ago 4 minutes, 49 seconds 80,689 views",Liham Melody,80689,80746,57
863,"Hagos Zeray - Nigsti Fikiri / New Tigrigna Music 2020 (Official Video) by Liham Melody 1 year ago 5 minutes, 10 seconds 12,313 views",Liham Melody,12313,12354,41
864,"Freweyni Tesfay - Nay Men Yikewn (Official Video) Ethiopian Tigrigna Music 2020 by Liham Melody 1 year ago 4 minutes, 35 seconds 16,009 views",Liham Melody,16009,16029,20
865,"Shumuye Birhane - Fkri Aykonen (Official Video) New Tigrigna Music 2020 by Liham Melody 1 year ago 5 minutes, 50 seconds 15,109 views",Liham Melody,15109,15140,31
866,"Kibrom Gebrehiwet - Kahta | ቃሕታ (Official Video) Ethiopian Tigrigna Music by Liham Melody 1 year ago 4 minutes, 20 seconds 203,682 views",Liham Melody,203682,203863,181
867,"Berihu Mehari - Ata Zawuney | ኣታ ዛውነይ (Official Video) Ethiopian Tigrigna Music by Liham Melody 1 year ago 5 minutes, 13 seconds 31,764 views",Liham Melody,31764,31810,46
868,"Amanual Tesfay - Gual Abo Mihrey  / Traditional Tigrigna Music (Official Video) by Liham Melody 1 year ago 5 minutes, 29 seconds 33,999 views",Liham Melody,33999,34039,40
869,"Temesgen Ataklti - Rozina | ሮዚና / New Ethiopian Tigrigna Music (Official Video) by Liham Melody 1 year ago 4 minutes, 49 seconds 31,407 views",Liham Melody,31407,31438,31
870,"Haileab Tsegay - Birhan Libey | ብርሃን ልበይ / New Ethiopian Tigrigna Music (Official Video) by Liham Melody 1 year ago 4 minutes, 52 seconds 9,367 views",Liham Melody,9367,9385,18
871,"Tsegay Haregot - Lomi Grim | ሎሚ ግርም / New Ethiopian Tigrigna Music (Official Video) by Liham Melody 1 year ago 5 minutes, 42 seconds 47,190 views",Liham Melody,47190,47235,45
872,"Alem Berhe - Waero Tigraweyti / New Ethiopian Traditional Tigrigna Music (Official Video) by Liham Melody 1 year ago 4 minutes, 47 seconds 15,982 views",Liham Melody,15982,16018,36
873,"Buzayehu Weldeslassie - Seamni | ስዓምኒ (Official Video) Ethiopian Tigrigna Music by Liham Melody 1 year ago 4 minutes, 50 seconds 33,510 views",Liham Melody,33510,33584,74
874,"Angesom Hailu - Adi Jeganu (Official Video) New Tigrigna Music 2020 by Liham Melody 1 year ago 6 minutes, 34 seconds 42,565 views",Liham Melody,42565,42595,30
875,"Yehualashet Abreha - Zebibey | ዘቢበይ (Official Video) Ethiopian Tigrigna Music 2020 by Liham Melody 1 year ago 4 minutes, 4 seconds 8,942 views",Liham Melody,8942,8955,13
876,"Samson Gebremeskel - Nifaker (Official Video) New Tigrigna Music 2020 by Liham Melody 1 year ago 5 minutes, 53 seconds 12,725 views",Liham Melody,12725,12739,14
877,"Various Artists - Yikre Nikiblelina | ይቕረ ንኽብለልና (Official Video) New Tigrigna Music 2020 by Liham Melody 1 year ago 4 minutes, 33 seconds 11,697 views",Liham Melody,11697,11706,9
878,"Various Artists - Medhin Alem (Official Video) Tigrigna Music 2020 by Liham Melody 1 year ago 4 minutes, 35 seconds 17,558 views",Liham Melody,17558,17590,32
879,"Dejen Fisehaye - Mamaye | ማማየ (Official Video) Ethiopian Tigrigna Music 2020 by Liham Melody 1 year ago 5 minutes, 43 seconds 11,708 views",Liham Melody,11708,11737,29
880,"Various Artists - Negari Aynidlo (Official Video) Tigrigna Music 2020 by Liham Melody 1 year ago 4 minutes, 14 seconds 7,883 views",Liham Melody,7883,7894,11
881,"Ataklti Hailemariam - Shkor / New Ethiopian Tigrigna Music 2020 (Official Video) by Liham Melody 1 year ago 4 minutes, 58 seconds 13,897 views",Liham Melody,13897,13921,24
882,"Kibrom Tsegay & Kidst Birhane - Kihalif'yu (Official Video) Tigrigna Music 2020 by Liham Melody 1 year ago 4 minutes, 36 seconds 7,257 views",Liham Melody,7257,7265,8
883,"Haftom Gebreyohannes - Girma Mogos / New Ethiopian Tigrigna Music 2020 (Official Video) by Liham Melody 1 year ago 5 minutes, 28 seconds 15,754 views",Liham Melody,15754,15774,20
884,"Hiwet Kalayu - Masharada / New Ethiopian Traditional Tigrigna Music (Official Video) by Liham Melody 1 year ago 6 minutes, 3 seconds 147,742 views",Liham Melody,147742,148192,450
885,"Nigsti Kahsay - Tehishukas | ንግስቲ ካሕሳይ - ተሕሹካስ / New Ethiopian Tigrigna Music (Official Video) by Liham Melody 1 year ago 5 minutes, 6 seconds 89,386 views",Liham Melody,89386,89548,162
886,"Gebremehin Gidey - Habereta Nedmits / New Tigrigna Music (Official Video) by Liham Melody 1 year ago 5 minutes, 18 seconds 12,506 views",Liham Melody,12506,12513,7
887,"Legesse Teklegergis - Nieniba | ለገሰ ተ/ገርግስ - ንዕኒ'ባ / Traditional Tigrigna Music (Official Video) by Liham Melody 1 year ago 6 minutes, 51 seconds 266,897 views",Liham Melody,266897,267409,512
888,"Shumuye Birhane -  Midhan Hiwet | ምድሓን ሂወት / New Tigrigna Music (Official Video) by Liham Melody 1 year ago 6 minutes, 57 seconds 69,603 views",Liham Melody,69603,69706,103
889,"Tsegaluel Hailemariam - Nikelakel Korona / New Tigrigna Music (Official Video) by Liham Melody 1 year ago 4 minutes, 27 seconds 7,568 views",Liham Melody,7568,7587,19
890,"Tsiruy Alefe - tiway Tiwaye | ፅሩይ ኣለፈ - ጥዋይ ጥዋየ / Traditional Tigrigna Music (Official Video) by Liham Melody 1 year ago 6 minutes, 43 seconds 275,826 views",Liham Melody,275826,276611,785
891,"Alu Ft Ashu - Aye.....Gize (Official Video) Tigrigna Music 2020 by Liham Melody 1 year ago 2 minutes, 44 seconds 4,928 views",Liham Melody,4928,4940,12
892,"Gebremedhin Riesom - Tezsemreley (Official Video) New Tigrigna Music 2020 by Liham Melody 1 year ago 7 minutes, 25 seconds 35,600 views",Liham Melody,35600,35646,46
893,"Birtukuan Mebratu  & Teklehaymanot Kinfe - Nirehahak | ንረሓሓቕ (Official Video) Tigrigna Music 2020 by Liham Melody 1 year ago 2 minutes, 15 seconds 49,697 views",Liham Melody,49697,49739,42
894,"Girmay Goytom - Awanawinkni | ኣዋናዊንክኒ (Official Video) Tigrigna Music 2020 by Liham Melody 1 year ago 3 minutes, 42 seconds 11,780 views",Liham Melody,11780,11788,8
895,"Birhanu Mache & Hussen Berahle - ኮረና ቫይረስ ንከላኸል (Official Video) Tigrigna Music 2020 by Liham Melody 1 year ago 3 minutes, 55 seconds 34,592 views",Liham Melody,34592,34645,53
896,"Kibrom Negasi - Venusey | ቬኑሰይ (Official Video) Tigrigna Music 2020 by Liham Melody 1 year ago 4 minutes, 44 seconds 13,596 views",Liham Melody,13596,13626,30
897,"Tsegaluel Hailemariam - ንከላኸል ኮረና (Official Audio) New Tigrigna Music by Liham Melody 1 year ago 4 minutes, 17 seconds 12,180 views",Liham Melody,12180,12181,1
898,"Haftom Gebremeskel - Nitsbuk'yu | ንፅቡቕ 'ዩ (Official Video) Tigrigna Music 2020 by Liham Melody 1 year ago 5 minutes, 14 seconds 24,357 views",Liham Melody,24357,24391,34
899,"Various Artists - (Corona COVID-19) SELAMTANA | ሰላምታና (Official Video) Tigrigna Music 2020 by Liham Melody 1 year ago 2 minutes, 51 seconds 53,671 views",Liham Melody,53671,53679,8
900,"Samual Sbhatleab - Nay Felemay | ናይ ፈለማይ (Official Video) Ethiopian Tigrigna Music 2020 by Liham Melody 1 year ago 4 minutes, 22 seconds 17,566 views",Liham Melody,17566,17588,22
901,"Ataklti Gereziher Awalom | ኣውዓሎም (Official Video) Ethiopian Tigrigna Music by Liham Melody 1 year ago 9 minutes, 11 seconds 34,615 views",Liham Melody,34615,35466,851
902,"Fikadu Mebrahtom - Tsgerada (Official Video) Tigrigna Music 2020 by Liham Melody 1 year ago 4 minutes, 48 seconds 9,921 views",Liham Melody,9921,9928,7
903,"Merhawit Teklehiwet - Nitearek | ንተዓረቕ (Official Video) Ethiopian Tigrigna Music by Liham Melody 1 year ago 5 minutes, 40 seconds 25,334 views",Liham Melody,25334,25398,64
904,"Shewit Mezgebo - Eza meret | እዛ መሬት (Official Video) Ethiopian Tigrigna Music 2020 by Liham Melody 1 year ago 4 minutes, 2 seconds 554,666 views",Liham Melody,554666,559462,4796
905,"Tumzgi Nirea (Tomi) - Embeytey | እምበይተይ (Official Video) New Tigrigna Music 2020 by Liham Melody 1 year ago 5 minutes, 34 seconds 16,251 views",Liham Melody,16251,16291,40
906,"Helen Tsegay - Mesetay | መሰታይ (Official Video) Ethiopian Tigrigna Music by Liham Melody 2 years ago 4 minutes, 18 seconds 22,715 views",Liham Melody,22715,22737,22
907,"Kidane Gebremariam - Mearo | ማዓሮ (Official Video) Tigrigna Music 2020 by Liham Melody 2 years ago 6 minutes, 22 seconds 59,292 views",Liham Melody,59292,59483,191
908,"Kelemu Yemane - Tsigereda (Official Video) Ethiopian Tigrigna Music 2020 by Liham Melody 2 years ago 4 minutes, 43 seconds 23,346 views",Liham Melody,23346,23357,11
909,"Mebrahtu Guesh - Mezgebe kalat  (Official Video) Ethiopian Tigrigna Music 2020 by Liham Melody 2 years ago 4 minutes, 30 seconds 10,833 views",Liham Melody,10833,10842,9
910,"Gebregzabher and Abraham - Abeden | ኣበደን  (Official Video) New Tigrigna Music 2020 by Liham Melody 2 years ago 5 minutes, 51 seconds 34,827 views",Liham Melody,34827,34849,22
911,"Guanche Berhe - Gual Baba 2 (Official Video) Ethiopian Tigrigna Music 2020 by Liham Melody 2 years ago 5 minutes, 48 seconds 76,523 views",Liham Melody,76523,76577,54
912,"Abraha Hagos (Gura) - Adela (Official Video) Ethiopian Erob Music by Liham Melody 2 years ago 6 minutes, 45 seconds 92,692 views",Liham Melody,92692,92918,226
913,"Fanial Welday - Arma Nay selam (Official Video) Ethiopian Tigrigna Music by Liham Melody 2 years ago 4 minutes, 53 seconds 16,509 views",Liham Melody,16509,16545,36
914,"Senay Baraki - Hindeye Hindeye | ህንደየ ህንደየ (Official Video) Ethiopian Tigrigna Music 2020 by Liham Melody 2 years ago 7 minutes, 3 seconds 643,880 views",Liham Melody,643880,644925,1045
915,"Gebrewahid Gebrealif  Adey'ye | ኣደይ'የ (Official Video) Ethiopian Tigrigna Music 2020 by Liham Melody 2 years ago 4 minutes, 26 seconds 147,978 views",Liham Melody,147978,149363,1385
916,"Solomon Bayre (Wedi Bayre) SERDO | ሰርዶ (Official Video) Ethiopian Tigrigna Music by Liham Melody 2 years ago 6 minutes, 37 seconds 108,576 views",Liham Melody,108576,108808,232
917,"Hagos Gebremedhin - Letshey | ለትሸይ (Official Video) Ethiopian Tigrigna Music by Liham Melody 2 years ago 4 minutes, 8 seconds 540,928 views",Liham Melody,540928,542347,1419
918,"Tsegaluel Hailemariam - Shew Wuney | ሸው ውነይ (Official Video) Ethiopian Tigrigna Music 2020 by Liham Melody 2 years ago 5 minutes, 51 seconds 860,533 views",Liham Melody,860533,862709,2176
919,"Birtukuan Mebrahtu - Faduma | ፋዱማ (Official Video) Ethiopian Tigrigna Music 2020 by Liham Melody 2 years ago 6 minutes, 7 seconds 400,124 views",Liham Melody,400124,403541,3417
920,"Bereket Tesfay - Hanti'ya Libey | ሓንቲ'ያ ልበይ (Official Video) Tigrigna Music by Liham Melody 2 years ago 5 minutes, 55 seconds 13,977 views",Liham Melody,13977,13986,9
921,"Degef Miruts - Beal Zinar (Official Video) Tigrigna Music 2020 by Liham Melody 2 years ago 5 minutes, 18 seconds 60,661 views",Liham Melody,60661,60687,26
922,"Hailay Meles - Ambaley | ዓምባለይ (Official Video) Tigrigna Music 2020 by Liham Melody 2 years ago 8 minutes, 48 seconds 270,372 views",Liham Melody,270372,272954,2582
923,"Tsegay Nega - Brburey | ብርቡረይ (Official Video) Tigrigna Music by Liham Melody 2 years ago 8 minutes, 39 seconds 94,289 views",Liham Melody,94289,94358,69
924,"Ashenafi Demeke - Kalamdeki | ካላምደኪ (Official Video) Tigrigna Music by Liham Melody 2 years ago 7 minutes, 54 seconds 1,237,303 views",Liham Melody,1237303,1239940,2637
925,"Efoyta Tekia - Ftiw  (Official Video) Ethiopian Tigrigna Music by Liham Melody 2 years ago 4 minutes, 31 seconds 43,894 views",Liham Melody,43894,43916,22
926,"Weldegebrial Teklay - Kemti Nay Kedem (Official Video) Ethiopian Tigrigna Music by Liham Melody 2 years ago 7 minutes, 4 seconds 1,782,393 views",Liham Melody,1782393,1784243,1850
927,"Welay Yohannes - Ati Birey Birey  (Official Video) Ethiopian Traditional Tigrigna Music by Liham Melody 2 years ago 6 minutes, 39 seconds 373,079 views",Liham Melody,373079,373613,534
928,"Filimon Equbay - Yikre | ይቕረ  (Official Video) Tigrigna Music by Liham Melody 2 years ago 4 minutes, 33 seconds 24,568 views",Liham Melody,24568,24587,19
929,"Sosna Kahsu - Arha Libey (Official Video) Ethiopian Tigrigna Music by Liham Melody 2 years ago 5 minutes, 22 seconds 26,412 views",Liham Melody,26412,26426,14
930,"AMA & Yordanos /JOJO/ - Hilina | ሕልና (Official Video) New Tigrigna Music by Liham Melody 2 years ago 5 minutes, 51 seconds 34,559 views",Liham Melody,34559,34716,157
931,"Medhanit Fkademariam - Tigraway (Official Video) Ethiopian Tigrigna Music by Liham Melody 2 years ago 4 minutes, 36 seconds 61,320 views",Liham Melody,61320,61450,130
932,"Getachew Kidane - Adey Shefena | ኣደይ ሸፈና (Official Video) Ethiopian Tigrigna Music by Liham Melody 2 years ago 6 minutes, 16 seconds 866,445 views",Liham Melody,866445,868838,2393
933,"Berhe Fisuh - Kutlayma | ኩትላይማ  (Official Video) Ethiopian Erob Music by Liham Melody 2 years ago 6 minutes, 10 seconds 98,079 views",Liham Melody,98079,98405,326
934,"Filimon Bekele - Weyza Tigray  (Official Video) Ethiopian Tigrigna Music by Liham Melody 2 years ago 7 minutes, 24 seconds 169,730 views",Liham Melody,169730,170214,484
935,"Mulugeta Hagos - May Weyni (Official Video) Ethiopian Tigrigna Music by Liham Melody 2 years ago 5 minutes, 40 seconds 76,430 views",Liham Melody,76430,76693,263
936,"HAF G - Habruwa | ሓብሩዋ (Official Video) Ethiopian Tigrigna Music 2019 by Liham Melody 2 years ago 4 minutes, 4 seconds 9,989 views",Liham Melody,9989,10001,12
937,"Gidey Meles - Daero | ዳዕሮ (Official Video) Ethiopian Tigrigna Music by Liham Melody 2 years ago 4 minutes, 37 seconds 39,342 views",Liham Melody,39342,39360,18
938,"Raza Raya - Maeda Rayotot | ማዕዳ ራዮቶት Part 1 by Liham Melody 2 years ago 6 minutes, 33 seconds 11,610 views",Liham Melody,11610,11660,50
939,"Tesfu Gebreyesus (Chelsi) - Temeniyeya (Official Video) Ethiopian Tigrigna Music 2019 by Liham Melody 2 years ago 6 minutes, 12 seconds 22,647 views",Liham Melody,22647,22680,33
940,"Tadese Desta (Fisto Mekelle) - Tewerwaray (Official Video) Ethiopian Tigrigna Music 2019 by Liham Melody 2 years ago 4 minutes, 18 seconds 153,224 views",Liham Melody,153224,153344,120
941,"Hadush Tekeste - Fikri'yu Nebari | ፍቕሪ 'ዩ ነባሪ (Official Video) Ethiopian Tigrigna Music 2019 by Liham Melody 2 years ago 6 minutes, 21 seconds 19,112 views",Liham Melody,19112,19140,28
942,"Gebrekirstos Welday - Semiruley | ሰሚሩለይ / Ethiopian Tigrigna Music (Official Video) by Liham Melody 2 years ago 4 minutes, 13 seconds 16,872 views",Liham Melody,16872,16883,11
943,"Filimon Bekele - Mase Awlo (Official Video) Ethiopian Tigrigna Music 2019 by Liham Melody 2 years ago 9 minutes, 24 seconds 1,698,791 views",Liham Melody,1698791,1704167,5376
944,"Gebremedhin Gebreslassie - Ruhus Engdea  (Official Video) Ethiopian Tigrigna Music by Liham Melody 2 years ago 5 minutes, 54 seconds 81,533 views",Liham Melody,81533,81714,181
945,"Tesfamariam Gebremeskel - Adeday (Official Video) Ethiopian Tigrigna Music by Liham Melody 2 years ago 6 minutes, 29 seconds 250,695 views",Liham Melody,250695,251002,307
946,"Zayd Kahsay - Tegezime  (Official Video) Ethiopian Tigrigna Music by Liham Melody 2 years ago 4 minutes, 14 seconds 40,174 views",Liham Melody,40174,40197,23
947,"Gebrehiwet Gebremariam - Gumaye / Ethiopian Tigrigna Music (Official Video) by Liham Melody 2 years ago 6 minutes, 19 seconds 42,258 views",Liham Melody,42258,42278,20
948,"Samsom Tadesse - Gual Bashay (Official Video) Ethiopian Tigrigna Music by Liham Melody 2 years ago 5 minutes, 20 seconds 104,679 views",Liham Melody,104679,104733,54
949,"Shushay Gebregergs - Tegaru (Official Video) Ethiopian Tigrigna Music by Liham Melody 2 years ago 4 minutes, 55 seconds 28,125 views",Liham Melody,28125,28135,10
950,"Kiros Gebremedhin - Tslal Memona (Official Video) Ethiopian Tigrigna Music 2019 by Liham Melody 2 years ago 6 minutes, 46 seconds 212,750 views",Liham Melody,212750,213005,255
951,"Asfaw Abay - Gamey Welela (Official Video) Ethiopian Tigrigna Music by Liham Melody 2 years ago 4 minutes, 16 seconds 28,980 views",Liham Melody,28980,28995,15
952,"Tium Hailu - Fkiri Tium | ፍቕሪ ጥዑም (Official Video) Ethiopian Tigrigna Music by Liham Melody 2 years ago 4 minutes, 51 seconds 22,812 views",Liham Melody,22812,22832,20
953,"Gebrehiwet Gebremariam - Guya Guya | ጉያ ጉያ / Ethiopian Tigrigna Music 2019 (Official Video) by Liham Melody 2 years ago 6 minutes, 7 seconds 230,439 views",Liham Melody,230439,231009,570
954,"Halefom Beranto - Anbesa Bereka (Official Video) Ethiopian Tigrigna Music by Liham Melody 2 years ago 9 minutes, 17 seconds 137,581 views",Liham Melody,137581,137775,194
955,"Yibrah Kunom - Atum Tegaru (Official Video) Ethiopian Tigrigna Music by Liham Melody 2 years ago 6 minutes, 47 seconds 867,077 views",Liham Melody,867077,868445,1368
956,"Misgna Goitom - Ayterfin Nimeskel  (Official Video) Ethiopian Tigrigna Music by Liham Melody 2 years ago 5 minutes, 4 seconds 72,443 views",Liham Melody,72443,72476,33
957,"Tirhas Alem - measye measye | ሜስየ ሜስየ (Official Video) Ethiopian Tigrigna Music by Liham Melody 2 years ago 5 minutes, 26 seconds 116,948 views",Liham Melody,116948,117013,65
958,"Haftom Gebrehiwet - Tmnitey | ትምኒተይ  (Official Video) Ethiopian Tigrigna Music by Liham Melody 2 years ago 4 minutes, 37 seconds 15,379 views",Liham Melody,15379,15386,7
959,"Roman Gebreanenia - Wedi Ketema (Official Video) Ethiopian Tigrigna Music 2019 by Liham Melody 2 years ago 4 minutes, 37 seconds 25,608 views",Liham Melody,25608,25618,10
960,"Abrehet Berhe (Asimba) - Kahano | ካሓኖ (Official Video) Ethiopian Music 2019 by Liham Melody 2 years ago 6 minutes, 59 seconds 54,207 views",Liham Melody,54207,54298,91
961,"Milaw Tesfay - Tikurye Tikurye | ጥቁርየ ጥቁርየ  (Official Video) Ethiopian Tigrigna Music 2019 by Liham Melody 2 years ago 6 minutes, 20 seconds 3,797,810 views",Liham Melody,3797810,3843079,45269
962,"Azeb Berihu - Agame | ዓጋመ (Official Video) Ethiopian Music 2019 by Liham Melody 2 years ago 6 minutes, 18 seconds 43,323 views",Liham Melody,43323,43338,15
963,"Tamrat Gebreslassie - Ftaw | ፍታው / Ethiopian Tigrigna Music 2019 (Official Video) by Liham Melody 2 years ago 7 minutes, 52 seconds 1,647,316 views",Liham Melody,1647316,1660595,13279
964,"Temesgen Teklay - Mishiko Ayney | ምሽኮ ዓይነይ (Official Video) Ethiopian Music 2019 by Liham Melody 2 years ago 6 minutes, 59 seconds 1,002,878 views",Liham Melody,1002878,1005034,2156
965,"Fantu Getachew - Armeday | ዓርመዳይ (Official Video) Ethiopian Traditional Tigrigna Music 2019 by Liham Melody 2 years ago 6 minutes, 13 seconds 140,785 views",Liham Melody,140785,140905,120
966,"Tsriti Mruts - Aya Beyene | ኣያ በየነ / Ethiopian Tigrigna Music (Official Video) by Liham Melody 2 years ago 5 minutes, 17 seconds 52,269 views",Liham Melody,52269,52275,6
967,"Tesfalem Gebreslassie - Buna Wuney | ቡና ውነይ / Ethiopian Tigrigna Music (Official Video) by Liham Melody 2 years ago 5 minutes, 33 seconds 76,576 views",Liham Melody,76576,76615,39
968,"Teka Shmuye - Sga Hamed Tigray / Ethiopian Tigrigna Music (Official Video) by Liham Melody 2 years ago 6 minutes, 50 seconds 22,992 views",Liham Melody,22992,22995,3
969,"Adhanom Keshi - RAKA | ራካ / Ethiopian Music (Official Video) by Liham Melody 2 years ago 5 minutes, 49 seconds 44,357 views",Liham Melody,44357,44385,28
970,"Senay Baraki - Wana Wana | ዋና ዋና / Ethiopian Tigrigna Music (Official Video) by Liham Melody 2 years ago 6 minutes, 15 seconds 343,517 views",Liham Melody,343517,345209,1692
971,"Mentsegeba Abraha - Zlelye | ዝለሊየ  / Ethiopian Tigrigna Music 2019 (Official Video) by Liham Melody 2 years ago 4 minutes, 36 seconds 48,257 views",Liham Melody,48257,48308,51
972,"Merhawit Haile - Wiembeb | ወዕምበብ (Official Video) Ethiopian Traditional Tigrigna Music 2019 by Liham Melody 2 years ago 7 minutes, 20 seconds 87,062 views",Liham Melody,87062,87082,20
973,"Mebrahtu Hadush - Aleku Belni | ኣለኹ በልኒ / Ethiopian Tigrigna Music (Official Video) by Liham Melody 2 years ago 5 minutes, 38 seconds 380,117 views",Liham Melody,380117,381439,1322
974,"Mebrhit Tsegau - Korerma Mayle | ኮረርማ ማይለ (Official Video) Ethiopian Traditional Tigrigna Music 2019 by Liham Melody 2 years ago 6 minutes, 23 seconds 747,730 views",Liham Melody,747730,749722,1992
975,"Selam Baraki - Kahani Gde | ካሃኒ ግደ / Ethiopian Erop Music (Official Video) by Liham Melody 2 years ago 5 minutes, 21 seconds 34,988 views",Liham Melody,34988,35043,55
976,"Mekonen Fseha - Tdeliyo / Ethiopian Tigrigna Music (Official Video) by Liham Melody 2 years ago 4 minutes, 45 seconds 13,879 views",Liham Melody,13879,13898,19
977,"Desta Gebrekidan - Niesnet | ንእስነት / Ethiopian Tigrigna Music (Official Video) by Liham Melody 2 years ago 6 minutes, 9 seconds 343,463 views",Liham Melody,343463,343864,401
978,"Birtukuan Mebrahtu - Awaldo | ኣዋልዶ / Ethiopian Tigrigna Music (Official Video) by Liham Melody 2 years ago 6 minutes, 29 seconds 422,230 views",Liham Melody,422230,422724,494
979,"Kisanet Atsbeha - Shambel | ሻምበል / Ethiopian Tigrigna Music (Official Video) by Liham Melody 2 years ago 5 minutes, 59 seconds 111,815 views",Liham Melody,111815,111974,159
980,"kalayu Baro - HaJano | ሃጃኖ / Ethiopian Tigrigna Music (Official Video) by Liham Melody 2 years ago 7 minutes, 10 seconds 366,733 views",Liham Melody,366733,367363,630
981,"Tewelde Gebregziher - Emem | ዕመም / Ethiopian Tigrigna Music (Official Video) by Liham Melody 2 years ago 5 minutes, 40 seconds 29,769 views",Liham Melody,29769,29806,37
982,"Ataklti Tsrota - Mearg | ማዓርግ / Ethiopian Traditional Music 2019 (Official Video) by Liham Melody 2 years ago 5 minutes, 40 seconds 126,156 views",Liham Melody,126156,126541,385
983,"Kiros Girmay - Nekele Libey | ነቐለ ልበይ / Ethiopian Tigrigna Music (Official Video) by Liham Melody 2 years ago 5 minutes, 49 seconds 119,291 views",Liham Melody,119291,119381,90
984,"Yohannes Mahdere - Adey | ዓደይ / Tigrigna Music 2019 (Official Video) by Liham Melody 2 years ago 5 minutes, 38 seconds 26,712 views",Liham Melody,26712,26719,7
985,"Aregawi Tesfay - AJRE | ኣጅሬ / Ethiopian Tigrigna Music (Official Video) by Liham Melody 2 years ago 5 minutes, 33 seconds 902,872 views",Liham Melody,902872,909025,6153
986,"Kinfe Gebregergis - Ati nieba | ኣቲ ንዒ'ባ / Ethiopian Music 2019 (Official Video) by Liham Melody 2 years ago 6 minutes, 22 seconds 458,976 views",Liham Melody,458976,461432,2456
987,"Mebrhit Tsegau - Neani Shdonay | ናዓኒ ሽዶናይ / Ethiopian Tigrigna Music (Official Video) by Liham Melody 2 years ago 6 minutes, 53 seconds 1,870,422 views",Liham Melody,1870422,1872777,2355
988,"Mekdes Hailemariam - Wusedeni | ውሰደኒ / Ethiopian Tigrigna Music 2019 (Official Video) by Liham Melody 2 years ago 5 minutes, 9 seconds 31,222 views",Liham Melody,31222,31242,20
989,"Samual Tesfay - Asena | ኣሰና / Ethiopian Traditional Music 2019 (Official Video) by Liham Melody 2 years ago 5 minutes, 50 seconds 260,188 views",Liham Melody,260188,260582,394
990,"Hagos Berhe - Elil Endo Bela | ዕልል 'ን በላ / Ethiopian Tigrigna Music 2019 (Official Video) by Liham Melody 2 years ago 7 minutes, 18 seconds 80,515 views",Liham Melody,80515,80545,30
991,"Berihu Mehari - Tigray / Tigrigna Music (Official Video) by Liham Melody 2 years ago 4 minutes, 50 seconds 56,836 views",Liham Melody,56836,56922,86
992,"Meresa Tsegay - Shkonina / Ethiopian Tigrigna Music 2019 (Official Video) by Liham Melody 2 years ago 5 minutes, 35 seconds 45,342 views",Liham Melody,45342,45351,9
993,"Ataklti Fishale - Nigsti Fkri / Tigrigna Music (Official Video) by Liham Melody 2 years ago 4 minutes, 20 seconds 49,164 views",Liham Melody,49164,49185,21
994,"Tesfay Birhane - Leminey / Traditional Tigrigna Music 2019 (Official Video) by Liham Melody 2 years ago 6 minutes, 43 seconds 483,586 views",Liham Melody,483586,485567,1981
995,"Fiseha Hailay - ALAD | ኣላድ / Ethiopian Traditional Music 2019 (Official Video) by Liham Melody 2 years ago 6 minutes, 45 seconds 983,869 views",Liham Melody,983869,988215,4346
996,"Filmon Atalay - Edilegna | ዕድለኛ - Ethiopian Tigrigna Music 2019 (Official Video) by Liham Melody 2 years ago 6 minutes, 1 second 30,533 views",Liham Melody,30533,30543,10
997,"Teame Teklehaimanot - Wey Zemen / Ethiopian Traditional  Music 2019 (Official Video) by Liham Melody 2 years ago 6 minutes, 1 second 62,096 views",Liham Melody,62096,62119,23
998,"Endrias Tadese - Halwuley / Traditional Tigrigna Music 2019 (Official Video) by Liham Melody 2 years ago 7 minutes, 20 seconds 1,016,944 views",Liham Melody,1016944,1018222,1278
999,"Kibrom Desta - Men Yingera | መን ይንገራ - Ethiopian Music 2019 (Official Video) by Liham Melody 2 years ago 5 minutes, 29 seconds 103,151 views",Liham Melody,103151,103166,15
1000,"Aregawi Desta - Kendiley / Ethiopian Tigrigna Music 2019 (Official Video) by Liham Melody 2 years ago 6 minutes, 15 seconds 54,327 views",Liham Melody,54327,54349,22
1001,"Danial Haileslassie - Kwusen Telo (ክውሰን ተሎ) Ethiopian Tigrigna Music (Official Video) by Liham Melody 2 years ago 6 minutes, 30 seconds 85,686 views",Liham Melody,85686,85747,61
1002,"Rshan Mebrahtom - Yaytey (ያይተይ) Ethiopian Tigrigna Music (Official Video) by Liham Melody 2 years ago 4 minutes, 4 seconds 31,115 views",Liham Melody,31115,31120,5
1003,"Tesfalem Gebreslassie - Shgomaney / Ethiopian Tigrigna Music 2019 (Official Video) by Liham Melody 2 years ago 6 minutes, 38 seconds 136,404 views",Liham Melody,136404,136575,171
1004,"Brhanu Kidanu - Msli Kumenaki / Ethiopian Music 2019 (Official Video) by Liham Melody 2 years ago 4 minutes, 31 seconds 41,771 views",Liham Melody,41771,41787,16
1005,"Alula Gebremariam - Halaley | ሓላለይ / Ethiopian Tigrigna Music (Official Video) by Liham Melody 2 years ago 4 minutes, 52 seconds 48,636 views",Liham Melody,48636,48650,14
1006,"Gereziher Hadgay - Birhan Liayni / Ethiopian Traditional  Music 2019 (Official Video) by Liham Melody 2 years ago 6 minutes, 45 seconds 740,185 views",Liham Melody,740185,743817,3632
1007,"Hayelom Haileleul - Gergsu / Ethiopian Tigrigna Music 2019 (Official Video) by Liham Melody 2 years ago 4 minutes, 56 seconds 55,788 views",Liham Melody,55788,55801,13
1008,"Alem Teweldebrhan - Gelebeli / Tigrigna Music (Official Video) by Liham Melody 2 years ago 5 minutes, 10 seconds 22,743 views",Liham Melody,22743,22761,18
1009,"kalayu Baro - Jano / Ethiopian Traditional  Music 2019 (Official Video) by Liham Melody 2 years ago 6 minutes, 27 seconds 381,944 views",Liham Melody,381944,382563,619
1010,"Hailay Demoz - Lomeanti / Ethiopian Tigrigna Music 2019 (Official Video) by Liham Melody 2 years ago 4 minutes, 49 seconds 53,214 views",Liham Melody,53214,53235,21
1011,"Asefa Reda - Manzay / Ethiopian Tigrigna Music (Official Video) by Liham Melody 2 years ago 4 minutes, 51 seconds 92,476 views",Liham Melody,92476,92531,55
1012,"Frezgi Hailay - Gorzo / Ethiopian Tigrigna Music 2019 (Official Video) by Liham Melody 2 years ago 5 minutes, 6 seconds 70,787 views",Liham Melody,70787,70808,21
1013,"Rshan Haben - Beal Gutena / Ethiopian Traditional  Music 2019 (Official Video) by Liham Melody 2 years ago 5 minutes, 16 seconds 133,993 views",Liham Melody,133993,134040,47
1014,"Mulalem Slasie - Dferi / Ethiopian Tigrigna Music 2019 (Official Video) by Liham Melody 2 years ago 5 minutes, 28 seconds 34,514 views",Liham Melody,34514,34536,22
1015,"Milaw Tesfay - Sembeli / Ethiopian Traditional  Music 2019 (Official Video) by Liham Melody 2 years ago 7 minutes, 29 seconds 1,172,632 views",Liham Melody,1172632,1174472,1840
1016,"Mussie Hailu - Nie ruru / Ethiopian Tigrigna Music (Official Video) by Liham Melody 2 years ago 4 minutes, 52 seconds 47,294 views",Liham Melody,47294,47308,14
1017,"Elsa Weldejewergs - WANA / Ethiopian Tigrigna Music 2019 (Official Video) by Liham Melody 2 years ago 4 minutes, 40 seconds 155,305 views",Liham Melody,155305,155603,298
1018,"Kidu Mewezer - Netselaye (ነፀላየ) - Ethiopian Traditional  Music 2019 (Official Video) by Liham Melody 2 years ago 6 minutes, 40 seconds 722,066 views",Liham Melody,722066,723848,1782
1019,"Hagos Tadese - Shelalmwa / Traditional Tigrigna Music 2019 (Official Video) by Liham Melody 2 years ago 6 minutes, 7 seconds 32,442 views",Liham Melody,32442,32452,10
1020,"Kidane Birhane - Ashemuna Leyley / Ethiopian Traditional  Music 2019 (Official Video) by Liham Melody 2 years ago 6 minutes, 38 seconds 2,829,366 views",Liham Melody,2829366,2851270,21904
1021,"Liya Solomon - Keywesdaley / Ethiopian Music 2019 (Official Video) by Liham Melody 2 years ago 4 minutes, 39 seconds 16,506 views",Liham Melody,16506,16515,9
1022,"Msgna Asmelash - Zban Fekar Lbi / Ethiopian Music 2019 (Official Video) by Liham Melody 2 years ago 3 minutes, 54 seconds 22,514 views",Liham Melody,22514,22523,9
1023,"Kidane Dane (Wedi Dane) - Lambadina / New Traditional Tigrigna Music 2019 (Official Video) by Liham Melody 2 years ago 7 minutes, 24 seconds 976,730 views",Liham Melody,976730,978041,1311
1024,"Ftsum Hagos - Rekibeya / Ethiopian Music 2019 (Official Video) by Liham Melody 2 years ago 4 minutes, 34 seconds 16,813 views",Liham Melody,16813,16820,7
1025,"Ashenafi Gebremichael - Sga Bitsot / Ethiopian Music 2019 (Official Video) by Liham Melody 2 years ago 6 minutes, 24 seconds 53,845 views",Liham Melody,53845,53873,28
1026,"Gebremeskel Gebreslassie - Abyet Tsray / New Traditional Tigrigna Music (Official Video) by Liham Melody 2 years ago 7 minutes, 10 seconds 231,827 views",Liham Melody,231827,231979,152
1027,"Serej (ሰረጅ)Tigrigna Film Trailer by Liham Melody 2 years ago 1 minute, 51 seconds 5,432 views",Liham Melody,5432,5433,1
1028,"Bisrat Fiseha - Alaytey / Ethiopian Music 2019 (Official Video) by Liham Melody 2 years ago 5 minutes, 29 seconds 27,127 views",Liham Melody,27127,27131,4
1029,"Kdsti Hagos - Gobezay / Ethiopian Music 2019 (Official Video) by Liham Melody 2 years ago 5 minutes, 6 seconds 113,812 views",Liham Melody,113812,113863,51
1030,"Kv Yolo Ft. Jojo - ሰብ ሰብ ሰብ / Ethiopian Music 2019 (Official Video) by Liham Melody 2 years ago 3 minutes, 55 seconds 12,181 views",Liham Melody,12181,12195,14
1031,"Haftom Gereziher - Atyo Harif (ኣትዮ ሓሪፍ) Ethiopian Music 2019 (Official Video) by Liham Melody 2 years ago 3 minutes, 50 seconds 75,529 views",Liham Melody,75529,75628,99
1032,"Weldegebrial Teklay - Hamawuti / New Traditional Tigrigna Music (Official Video) by Liham Melody 2 years ago 7 minutes, 10 seconds 829,758 views",Liham Melody,829758,832369,2611
1033,"Netsanet Tesfay - Hallo Beleni / Ethiopian Music 2019 (Official Video) by Liham Melody 2 years ago 5 minutes, 4 seconds 905,519 views",Liham Melody,905519,906606,1087
1034,"Idris Barbar - Felimu / Kunama Music (Official Video) by Liham Melody 2 years ago 5 minutes, 31 seconds 69,634 views",Liham Melody,69634,69753,119
1035,"Meswani - Ane Goytay / Ethiopian Music 2019 (Official Video) by Liham Melody 2 years ago 4 minutes, 15 seconds 25,437 views",Liham Melody,25437,25472,35
1036,"Hayelom Kahsay - Nisa Gebenegna  / Ethiopian Tigrigna Music 2019 (Official Video) by Liham Melody 2 years ago 3 minutes, 58 seconds 53,984 views",Liham Melody,53984,54015,31
1037,"Weldu Haben - Shelalime / Traditional Tigrigna Music 2019 (Official Video) by Liham Melody 2 years ago 4 minutes, 50 seconds 71,751 views",Liham Melody,71751,71769,18
1038,"Zaed Abrehaley - Mrutsey (ምሩፀይ) Ethiopian Tigrigna Music (Official Video) by Liham Melody 2 years ago 5 minutes, 12 seconds 43,423 views",Liham Melody,43423,43431,8
1039,"Danial Gebreslassie - Zeytitikae / Ethiopian Tigrigna Music 2019 (Official Video) by Liham Melody 3 years ago 4 minutes, 14 seconds 30,147 views",Liham Melody,30147,30150,3
1040,"Abrahaley Kidane - Miriuy (ምርኡይ) Ethiopian Tigrigna Music 2019 (Official Video) by Liham Melody 3 years ago 5 minutes, 34 seconds 23,386 views",Liham Melody,23386,23390,4
1041,"Zemen Alemseged - Dmtsi Hzbi / Ethiopian Tigrigna Music 2019 (Official Video) by Liham Melody 3 years ago 5 minutes, 28 seconds 1,715,688 views",Liham Melody,1715688,1719620,3932
1042,"Hermon Sntayehu - Hakimey / Ethiopian Tigrigna Music (Official Video) by Liham Melody 3 years ago 4 minutes, 58 seconds 20,278 views",Liham Melody,20278,20289,11
1043,"Azeb Berihu - Tslaley (ፅላለይ) Traditional Tigrigna Music (Official Video) by Liham Melody 3 years ago 5 minutes, 24 seconds 150,007 views",Liham Melody,150007,150109,102
1044,"Fishale Asfehaley - Aster  / Tigrigna Music 2019 (Official Video) by Liham Melody 3 years ago 4 minutes, 53 seconds 18,466 views",Liham Melody,18466,18470,4
1045,"Mussie Shakur - Chebsi / New Ethiopian Music 2019 (Official Video) by Liham Melody 3 years ago 3 minutes, 10 seconds 11,971 views",Liham Melody,11971,11979,8
1046,"Ephrem Welday - Nbeyna'ya (ንበይና'ያ) Ethiopian Tigrigna Music (Official Video) by Liham Melody 3 years ago 4 minutes, 54 seconds 47,832 views",Liham Melody,47832,47864,32
1047,"Solomon Gebreslassie - HAZI / Traditional Tigrigna Music 2019 (Official Video) by Liham Melody 3 years ago 4 minutes, 47 seconds 233,068 views",Liham Melody,233068,233127,59
1048,"Amanual  Aregawi - Nafikeyom / Tigrigna Music 2019 (Official Video) by Liham Melody 3 years ago 5 minutes, 25 seconds 86,821 views",Liham Melody,86821,87088,267
1049,"Same Seyoum - Hasab Libey (Official Video) by Liham Melody 3 years ago 5 minutes, 4 seconds 84,693 views",Liham Melody,84693,84795,102
1050,"Tumzgi Nirea (Tomi) - Meskir Anta Semay / Tigrigna Music 2019 (Official Audio) by Liham Melody 3 years ago 4 minutes, 22 seconds 10,943 views",Liham Melody,10943,10944,1
1051,"Natnael Negasi - Gasha'ye Nifkri / Ethiopian Music 2019 (Official Video) by Liham Melody 3 years ago 4 minutes, 54 seconds 27,641 views",Liham Melody,27641,27646,5
1052,"Eden Gebreslassie - Beal Shgut  / Ethiopian Tigrigna Music 2019 (Official Video) by Liham Melody 3 years ago 5 minutes, 36 seconds 135,323 views",Liham Melody,135323,135464,141
1053,"Negasi Haileslassie - Werki Hizaba  / Ethiopian Tigrigna Music (Official Video) by Liham Melody 3 years ago 6 minutes, 56 seconds 506,160 views",Liham Melody,506160,508421,2261
1054,"Aflam Tigrigna Film Trailer by Liham Melody 3 years ago 2 minutes, 26 seconds 25,537 views",Liham Melody,25537,25643,106
1055,"Kifle Berhe - HIji Girm / Tigrigna Weddding Music (Official Video) by Liham Melody 3 years ago 6 minutes, 48 seconds 24,956 views",Liham Melody,24956,24970,14
1056,"Abrehet Yohannes - Shir Shir / Ethiopian Music 2019 (Official Video) by Liham Melody 3 years ago 4 minutes, 58 seconds 66,772 views",Liham Melody,66772,66778,6
1057,"Tsegazeab Gedamu - Rekibeya / Ethiopian Traditional Tigrigna Music (Official Video) by Liham Melody 3 years ago 5 minutes, 5 seconds 59,141 views",Liham Melody,59141,59185,44
1058,"Kide Zenawi - Kuta Habuley / New Traditional Tigrigna Music (Official Video) by Liham Melody 3 years ago 7 minutes, 1 second 1,335,565 views",Liham Melody,1335565,1344070,8505
1059,"Chento Ft. John Tadesse - ቁፅሪ ሓደ / New Ethiopian Music 2019 (Official Video) by Liham Melody 3 years ago 3 minutes, 18 seconds 16,020 views",Liham Melody,16020,16025,5
1060,"Michaele Aregay - Alilalom (ዓልላሎም) New Ethiopian Traditional Tigrigna Music (Official Video) by Liham Melody 3 years ago 6 minutes, 33 seconds 86,926 views",Liham Melody,86926,86957,31
1061,"G/slassie G/michael (Chu Chu) - Degim do Ferihe / New Traditional Tigrigna Music (Official Video) by Liham Melody 3 years ago 7 minutes, 41 seconds 1,183,055 views",Liham Melody,1183055,1199259,16204
1062,"Atsede Kasa Ta....! by Liham Melody 3 years ago 10 minutes, 25 seconds 300,494 views",Liham Melody,300494,300798,304
1063,"Armias Araya - Misaki /  Ethiopian Traditional Tigrigna Music (Official Video) by Liham Melody 3 years ago 5 minutes, 15 seconds 70,074 views",Liham Melody,70074,70145,71
1064,"Berhe Tareke - Shrbe (ሽርበ) Traditional Tigrigna Music 2019 (Official Video) by Liham Melody 3 years ago 6 minutes, 31 seconds 146,206 views",Liham Melody,146206,146439,233
1065,"Mick and Hayu ft. Nahom - Wubetwa / New Ethiopian Music 2019 (Official Video) by Liham Melody 3 years ago 4 minutes, 17 seconds 14,803 views",Liham Melody,14803,14807,4
1066,"Goitom Mulaw - Kuni Kemlibey / New Music 2019 (Official Video) by Liham Melody 3 years ago 5 minutes, 5 seconds 42,072 views",Liham Melody,42072,42103,31
1067,"Mati Tade - Rekibeya / New Ethiopian Tigrigna Music 2019 (Official Video) by Liham Melody 3 years ago 6 minutes, 13 seconds 23,378 views",Liham Melody,23378,23401,23
1068,"Lominat Hayelom - LOMINEYE / New Ethiopian Music 2019 (Official Video) by Liham Melody 3 years ago 4 minutes, 12 seconds 149,842 views",Liham Melody,149842,149919,77
1069,"Yohannes Bayre (Wedi Bayru) - Abrle (ኣ'ብርለ) New Ethiopian Tigrigna Music 2019 (Official Video) by Liham Melody 3 years ago 6 minutes, 41 seconds 1,050,211 views",Liham Melody,1050211,1061187,10976
1070,"Tamrat Gebreslassie ''ሓምሳ ጎማ'' - Knebr Eye gena / New Traditional Tigrigna Music (Official Video) by Liham Melody 3 years ago 7 minutes, 17 seconds 935,296 views",Liham Melody,935296,938697,3401
1071,"Yapi Mapi - DYSTOPIA (ድስቶጵያ) / New Ethiopian Music 2019 (Official Video) by Liham Melody 3 years ago 6 minutes, 12 seconds 122,835 views",Liham Melody,122835,123063,228
1072,"Bereket Weldemichael - Dihri Kelem / New Ethiopian Tigrigna Music 2019 (Official Video) by Liham Melody 3 years ago 3 minutes, 48 seconds 12,584 views",Liham Melody,12584,12588,4
1073,"Gere Fisehaye & Hayleab Fisehaye - Afkirnaki Kltena / New Eritrea Music 2019 (Official Video) by Liham Melody 3 years ago 6 minutes, 32 seconds 25,086 views",Liham Melody,25086,25091,5
1074,"Walta Takele - Hileley / New Traditional Tigrigna Music 2019 (Official Video) by Liham Melody 3 years ago 5 minutes, 23 seconds 68,575 views",Liham Melody,68575,68630,55
1075,"Miligas ft. Jahomi Jhon Cash & Mame - Kibir letiwlid / New Ethiopian Music (Official Video) by Liham Melody 3 years ago 4 minutes, 20 seconds 10,100 views",Liham Melody,10100,10104,4
1076,"Berihu Mehari - Tigray Adey / New Tigrigna Music 2018 (Official Audio) by Liham Melody 3 years ago 4 minutes, 5 seconds 46,688 views",Liham Melody,46688,46751,63
1077,"Desu Ayba - Robue Tikreyeni / New Ethiopian Traditional Tigrigna Music (Official Video) by Liham Melody 3 years ago 6 minutes, 58 seconds 467,887 views",Liham Melody,467887,470883,2996
1078,"Awet Hagos - Hzbi Tigray / New Eritrea Music 2018 (Official Audio) by Liham Melody 3 years ago 5 minutes, 57 seconds 69,395 views",Liham Melody,69395,69432,37
1079,"Goyteom Gebremedhin (Gojo) Alekhuni / New Tigrigna Music 2018 (Official Video) by Liham Melody 3 years ago 4 minutes, 43 seconds 20,452 views",Liham Melody,20452,20463,11
1080,"Tesfaldet Zeru - Bigrichit / New Tigrigna Music 2018 (Official Video) by Liham Melody 3 years ago 4 minutes, 42 seconds 22,322 views",Liham Melody,22322,22327,5
1081,"Meresa Abraha - Desbehalit / New Traditional Tigrigna Music 2018 (Official Video) by Liham Melody 3 years ago 4 minutes, 10 seconds 25,253 views",Liham Melody,25253,25260,7
1082,"Letay Mesfin - Ab kulu Wudi (ኣብ ኹሉ ውዲ) New Traditional Tigrigna Music 2018 (Official Video) by Liham Melody 3 years ago 6 minutes, 40 seconds 226,110 views",Liham Melody,226110,226333,223
1083,"Zekarias G/tsadik - Yimles do Yikewun / New Tigrigna Music 2018 (Official Video) by Liham Melody 3 years ago 3 minutes, 50 seconds 27,188 views",Liham Melody,27188,27207,19
1084,"Tsgab Hailu - Asena Batsiay (ኣሰና ባፅዐይ) New Tigrigna Music 2018 (Official Video) by Liham Melody 3 years ago 4 minutes, 13 seconds 16,230 views",Liham Melody,16230,16232,2
1085,"Birhan G/her - Melseley / New Ethiopian Tgrigna Music 2018 (Official Video) by Liham Melody 3 years ago 4 minutes, 40 seconds 67,275 views",Liham Melody,67275,67284,9
1086,"Tumzgi Nirea (Tomi) - Fikri tuem / New Tigrigna Music 2018 (Official Video) by Liham Melody 3 years ago 5 minutes, 37 seconds 64,690 views",Liham Melody,64690,64699,9
1087,"Miruts Abrha (Rewina) - Bryamin / New Ethiopian Tigrigna Music 2018 (Official Audio) by Liham Melody 3 years ago 5 minutes, 34 seconds 14,369 views",Liham Melody,14369,14382,13
1088,"John Tadesse - Ene negn Ethiopia (እኔ ነኝ ኢትዮጵያ) New Ethiopian Music 2018 (Official Video) by Liham Melody 3 years ago 5 minutes, 43 seconds 10,504 views",Liham Melody,10504,10508,4
1089,"Mahlet Znabu - Menikani Dika (መኒኻኒ ዲኻ) New Ethiopian Tigrigna Music 2018 (Official Video) by Liham Melody 3 years ago 4 minutes, 56 seconds 46,420 views",Liham Melody,46420,46437,17
1090,"Tarekegn Kebede - Shegune / New Ethiopian Music 2018 (Official Video) by Liham Melody 3 years ago 4 minutes, 49 seconds 10,936 views",Liham Melody,10936,10944,8
1091,"Aron Nova ft. Babesho - Tega Bey / New Ethiopian Music 2018 (Official Video) by Liham Melody 3 years ago 4 minutes, 20 seconds 16,932 views",Liham Melody,16932,16940,8
1092,"Michaele Berihu - Kunjina / New Ethiopian Tigrigna Music 2018 (Official Video) by Liham Melody 3 years ago 5 minutes, 16 seconds 30,048 views",Liham Melody,30048,30073,25
1093,"Goitom Gebrye - Resiekiyo Diyu / New Ethiopian Tigrigna Music (Official Video) by Liham Melody 3 years ago 4 minutes, 31 seconds 90,354 views",Liham Melody,90354,90532,178
1094,"Gebregzabiher Kebede - Gual Ketema / New Ethiopian Traditional Tigrigna Music (Official Video) by Liham Melody 3 years ago 7 minutes, 6 seconds 331,176 views",Liham Melody,331176,333346,2170
1095,"Sami Ft. Heri - Brki Mesiluwa (ብርቂ መሲሉዋ) New Ethiopian Music 2018 (Official Video) by Liham Melody 3 years ago 4 minutes, 4 seconds 21,816 views",Liham Melody,21816,21823,7
1096,"Tesfay Mebrahtom - Tefetawit (ተፈታዊት) New Ethiopian Tigrigna Music (Official Video) by Liham Melody 3 years ago 5 minutes, 2 seconds 25,106 views",Liham Melody,25106,25106,0
1097,"Gebrehiwet Gebremariam - Ata Elilye / New Ethiopian Traditional Tigrigna Music (Official Video) by Liham Melody 3 years ago 6 minutes, 6 seconds 304,258 views",Liham Melody,304258,305624,1366
1098,"Merhawit Gebregergis - Bokuri Lomin  / New Ethiopian Tigrigna Music (Official Video) by Liham Melody 3 years ago 5 minutes, 42 seconds 654,851 views",Liham Melody,654851,656491,1640
1099,"John Tadesse - Zena Tigrigna / New Ethiopian Tigrigna Music  (Official Audio) by Liham Melody 3 years ago 3 minutes, 9 seconds 12,264 views",Liham Melody,12264,12270,6
1100,"Ashenafi Gebremichael - Seyimeki (ሰይመኪ) New Ethiopian Tigrigna Music (Official Video) by Liham Melody 3 years ago 5 minutes, 29 seconds 37,349 views",Liham Melody,37349,37368,19
1101,"AMA - Kigeyish Eye (ክገይሽ እየ ) New  Tigrigna Music 2018 (Official Video) by Liham Melody 3 years ago 6 minutes 170,402 views",Liham Melody,170402,170715,313
1102,"Haftom Birhane - NGSTEY (ንግስተይ) New Ethiopian Tigrigna Music 2018 (Official Video) by Liham Melody 3 years ago 4 minutes, 48 seconds 82,107 views",Liham Melody,82107,82155,48
1103,"Seyfu Hailu - Selam Kelele / New Ethiopian Music 2018 (Official Audio) by Liham Melody 3 years ago 4 minutes, 29 seconds 4,454 views",Liham Melody,4454,4455,1
1104,"Gerensie Gebrehiwet - Kolia Tigray / New Ethiopian Tigrigna Music 2018 (Official Video) by Liham Melody 3 years ago 6 minutes, 13 seconds 214,095 views",Liham Melody,214095,215392,1297
1105,"Mulu Alemu - Meskeley / New Ethiopian Traditional Tigrigna Music 2018 (Official Video) by Liham Melody 3 years ago 6 minutes, 57 seconds 28,270 views",Liham Melody,28270,28280,10
1106,"Gereziher Hadgay (Wed Hadgay) Koremele  / New Ethiopian Tigrigna Music (Official Video) by Liham Melody 3 years ago 5 minutes, 49 seconds 1,745,608 views",Liham Melody,1745608,1760344,14736
1107,"Tikue Weldu - Niadey Ele /ንዓደይ ኢለ/ New Ethiopian Tigrigna Music 2018 (Official Video) by Liham Melody 3 years ago 5 minutes, 49 seconds 410,061 views",Liham Melody,410061,413920,3859
1108,"Aregawi Tesfay - Lesalso  / New Ethiopian Tigrigna Music (Official Video) by Liham Melody 3 years ago 6 minutes, 5 seconds 1,809,386 views",Liham Melody,1809386,1811937,2551
1109,"Danial G/medhin - Mahtsen Ade /ማህፀን ኣደ/ New Ethiopian Tigrigna Music 2018 (Official Video) by Liham Melody 3 years ago 5 minutes, 17 seconds 22,799 views",Liham Melody,22799,22803,4
1110,"Hermon Kahsay (DJ Hermi) ft Ashu & Aki - Weylekey/ New Ethiopian Music 2018 (Official Video) by Liham Melody 3 years ago 3 minutes, 31 seconds 13,843 views",Liham Melody,13843,13855,12
1111,"Bereket Msgna - Yibel /ይበል/ New Ethiopian Tigrigna Music (Official Video) by Liham Melody 3 years ago 5 minutes, 10 seconds 121,698 views",Liham Melody,121698,122073,375
1112,"Filimon Bekele - Brimoye /ብሪሞየ/ New Ethiopian Tigrigna Music 2018 (Official Video) by Liham Melody 3 years ago 5 minutes, 45 seconds 1,900,726 views",Liham Melody,1900726,1914255,13529
1113,"Atsbha Hailu - HADE / New Ethiopian Tigrigna Music 2018 (Official Video) by Liham Melody 3 years ago 4 minutes, 41 seconds 21,666 views",Liham Melody,21666,21667,1
1114,"Huluf Alemu & Grmawit Tadesse - Temearare / New Ethiopian Tigrigna Music  (Official Audio) by Liham Melody 3 years ago 5 minutes, 47 seconds 166,570 views",Liham Melody,166570,166717,147
1115,"Poem by Fiseha Gebru - Axumawit Kingdom by Liham Melody 3 years ago 7 minutes, 1 second 8,981 views",Liham Melody,8981,8990,9
1116,"Filmon Bekele - yibel Mewsbo / New Ethiopian Traditional Tigrigna Music (Official Video) by Liham Melody 3 years ago 8 minutes, 16 seconds 537,708 views",Liham Melody,537708,538640,932
1117,"Sami Gebreslassie - Mamet / New Ethiopian Tigrigna Music (Official Video) by Liham Melody 3 years ago 5 minutes, 31 seconds 30,152 views",Liham Melody,30152,30158,6
1118,"Aster Tekeste - Ashenda (ኣሸንዳ) / New Ethiopian Traditional Tigrigna Music (Official Video) by Liham Melody 3 years ago 7 minutes, 52 seconds 1,033,826 views",Liham Melody,1033826,1034476,650
1119,"Ermias Kahsay - Natna / New Ethiopian Traditional Tigrigna Music (Official Video) by Liham Melody 3 years ago 5 minutes, 57 seconds 32,671 views",Liham Melody,32671,32683,12
1120,"Kibrom Gebrehiwet - Kichiney / New Ethiopian Tigrigna Music 2018 (Official Video) by Liham Melody 3 years ago 5 minutes, 40 seconds 5,294,714 views",Liham Melody,5294714,5347226,52512
1121,"China & Lwam - Ashenda Bela / New Ethiopian Traditional Tigrigna Music (Official Video) by Liham Melody 3 years ago 7 minutes, 12 seconds 78,610 views",Liham Melody,78610,78674,64
1122,"Tesfalem Gebreslassie - Aboya Mimihdar / New Ethiopian Tigrigna Music (Official Video) by Liham Melody 3 years ago 6 minutes, 31 seconds 34,222 views",Liham Melody,34222,34252,30
1123,"Ksanet , Enbeba & Aster - Ashenda / New Ethiopian Traditional Tigrigna Music (Official Video) by Liham Melody 3 years ago 6 minutes, 22 seconds 87,338 views",Liham Melody,87338,87368,30
1124,"Teklay Weldu - Nisa Ketalitey / New Ethiopian Tigrigna Music (Official Video) by Liham Melody 3 years ago 5 minutes, 36 seconds 35,391 views",Liham Melody,35391,35396,5
1125,"Mulugeta Girmay - Mama Nafika / New Ethiopian Tigrigna Music (Official Video) by Liham Melody 3 years ago 4 minutes, 53 seconds 782,718 views",Liham Melody,782718,782770,52
1126,"Gebrehiwet Gebremeskel - Merkuley / New Ethiopian Tigrigna Music (Official Video) by Liham Melody 3 years ago 5 minutes, 13 seconds 51,417 views",Liham Melody,51417,51445,28
1127,"Genet Gebregziabher - Ashenda / New Ethiopian Traditional Tigrigna Music (Official Video) by Liham Melody 3 years ago 6 minutes, 16 seconds 459,165 views",Liham Melody,459165,459524,359
1128,"Ftsum Girmay - Za Niesnet / New Ethiopian Tigrigna Music (Official Video) by Liham Melody 3 years ago 6 minutes, 24 seconds 225,009 views",Liham Melody,225009,225170,161
1129,"Gidey Meles - Temerawuni / New Ethiopian Tigrigna Music (Official Video) by Liham Melody 3 years ago 4 minutes, 31 seconds 63,724 views",Liham Melody,63724,63831,107
1130,"Tsgereda Demoz - Ashenda / New Ethiopian Traditional Music (Official Video) by Liham Melody 3 years ago 7 minutes 42,511 views",Liham Melody,42511,42547,36
1131,"Birhane Abraha - Asmera Mekelle / New Ethiopian Tigrigna Music (Official Video) by Liham Melody 3 years ago 5 minutes, 46 seconds 32,750 views",Liham Melody,32750,32759,9
1132,"Ataklti Zeweldi - Malefya / New Ethiopian Tigrigna Music (Official Video) by Liham Melody 3 years ago 5 minutes, 51 seconds 63,182 views",Liham Melody,63182,63205,23
1133,"Tinkish Raya Band - Hagerna / New Ethiopian Music (Official Video) by Liham Melody 3 years ago 6 minutes, 6 seconds 54,085 views",Liham Melody,54085,54119,34
1134,"Senait AShebir - Wegihu do Gena / New Ethiopian Tigrigna Music (Official Video) by Liham Melody 3 years ago 6 minutes, 5 seconds 96,072 views",Liham Melody,96072,96172,100
1135,"Birhane Gebru - Selel Beluye / New Ethiopian Tigrigna Music (Official Video) by Liham Melody 3 years ago 5 minutes, 56 seconds 214,979 views",Liham Melody,214979,215216,237
1136,"Filimon Atalay - ZELELA / New Ethiopian Tigrigna Music (Official Video) by Liham Melody 3 years ago 5 minutes 22,772 views",Liham Melody,22772,22788,16
1137,"Haftu Haileslassie - MANA WANA / New Ethiopian Tigrigna Music 2018 (Official Video) by Liham Melody 3 years ago 4 minutes, 40 seconds 34,049 views",Liham Melody,34049,34051,2
1138,"Kinfe Gebregergis - Ati Shikorina / New Ethiopian Tigrigna Music (Official Video) by Liham Melody 3 years ago 7 minutes, 24 seconds 5,628,997 views",Liham Melody,5628997,5657536,28539
1139,"Aregawi Tesfay - Wuey Seyab / New Ethiopian Tigrigna Music (Official Video) by Liham Melody 3 years ago 6 minutes, 42 seconds 5,327,659 views",Liham Melody,5327659,5345804,18145
1140,"Zenawit Nayzgi - Hiteteni / New Ethiopian Tigrigna Music (Official Video) by Liham Melody 3 years ago 6 minutes, 9 seconds 54,408 views",Liham Melody,54408,54422,14
1141,"Mola Gezae - WEYNO / New Ethiopian Music (Official Video) by Liham Melody 3 years ago 6 minutes, 10 seconds 23,603 views",Liham Melody,23603,23606,3
1142,"Solomon Yikunoamlak - Harirey (HAREGU 2) New Ethiopian Tigrigna Music (Official Audio) by Liham Melody 3 years ago 5 minutes, 1 second 296,422 views",Liham Melody,296422,299643,3221
1143,"Mitslal Wekele - Birhan Tsehay / New Ethiopian Music (Official Video) by Liham Melody 3 years ago 6 minutes, 14 seconds 166,601 views",Liham Melody,166601,166805,204
1144,"Birtukuan Mebrahtu - GERE (ገሬ) New Ethiopian Music (Official Video) by Liham Melody 3 years ago 5 minutes, 37 seconds 894,083 views",Liham Melody,894083,903152,9069
1145,"Gebrehiwet Gebremariam (ምራጭ) Msaki Welel / New Ethiopian Music (Official Video) by Liham Melody 3 years ago 7 minutes, 18 seconds 1,763,222 views",Liham Melody,1763222,1775611,12389
1146,"Rahel Fiyorina - TSURURAY / New Ethiopian Tigrigna Music 2018 (Official Video) by Liham Melody 3 years ago 5 minutes, 33 seconds 36,627 views",Liham Melody,36627,36642,15
1147,"Raza Raya - Gogo Moklo Hachin / New Ethiopian Traditional Music 2018 (Official Video) by Liham Melody 3 years ago 5 minutes, 36 seconds 681,421 views",Liham Melody,681421,685367,3946
1148,"Nguse Abadi - ZEMAY (ዘማይ) New Ethiopian Traditional Music 2018 (Official Video) by Liham Melody 3 years ago 8 minutes, 39 seconds 8,966,715 views",Liham Melody,8966715,8984305,17590
1149,"Maekele Gebreyohanes - CheleYa / New Ethiopian Tigrigna Music (Official Video) by Liham Melody 3 years ago 6 minutes, 17 seconds 125,738 views",Liham Melody,125738,126227,489
1150,"Abraham Gebremedhn & AMA - Temesgen / New Tigrigna Wedding Song  (Official Video) by Liham Melody 3 years ago 6 minutes 62,055 views",Liham Melody,62055,62088,33
1151,"Dj Moris and Raza Raya - Endiey endiey / New Ethiopian Tigrigna Music 2018 (Official Video) by Liham Melody 3 years ago 4 minutes, 25 seconds 134,095 views",Liham Melody,134095,134868,773
1152,"Alemayehu Hafte - Tsmedlo belo / New Ethiopian Traditional Music 2018 (Official Video) by Liham Melody 3 years ago 5 minutes, 41 seconds 73,234 views",Liham Melody,73234,73308,74
1153,"Medhanit Fikremariam - Ayni Wana / New Ethiopian Traditional Music 2018 (Official Video) by Liham Melody 3 years ago 5 minutes, 31 seconds 238,942 views",Liham Melody,238942,239239,297
1154,"Amanual Tesfay - Seb Mukaney / New Ethiopian Tigrigna Music (Official Video) by Liham Melody 3 years ago 7 minutes, 36 seconds 22,488 views",Liham Melody,22488,22499,11
1155,"Fiseha Hailay (Wedi Tsehay) Werhi Tri / New Ethiopian Traditional Music 2018 (Official Video) by Liham Melody 3 years ago 7 minutes 2,238,495 views",Liham Melody,2238495,2241384,2889
1156,"Solomon Yikunoamlak - Haregu 1  / New Ethiopian Tigrigna Music (Official Audio) by Liham Melody 3 years ago 4 minutes, 8 seconds 503,252 views",Liham Melody,503252,506357,3105
1157,"Mulugeta Gebru - GAMEY / New Ethiopian Tigrigna Music (Official Video) by Liham Melody 3 years ago 5 minutes, 59 seconds 92,145 views",Liham Melody,92145,92228,83
1158,"Raza Raya - Amesalti / New Ethiopian Traditional Music 2018 (Official Video) by Liham Melody 3 years ago 5 minutes, 58 seconds 1,238,197 views",Liham Melody,1238197,1250512,12315
1159,"Awet Gebremedhin - Bitanya / New Ethiopian Music  (Official Video) by Liham Melody 3 years ago 4 minutes, 40 seconds 23,641 views",Liham Melody,23641,23652,11
1160,"Berihu Mehari - Tsehayom Berikulom / New Ethiopian Tigrigna Music (Official Video) by Liham Melody 3 years ago 6 minutes, 8 seconds 274,099 views",Liham Melody,274099,274384,285
1161,"Hlina Tesfay - Hadanay / New Ethiopian Tigrigna Music 2018 (Official Video) by Liham Melody 3 years ago 6 minutes, 58 seconds 61,113 views",Liham Melody,61113,61121,8
1162,"Berihu Mehari - EMBEYTEY / New Ethiopian Tigrigna Music (Official Video) by Liham Melody 3 years ago 6 minutes, 9 seconds 1,180,999 views",Liham Melody,1180999,1182910,1911
1163,"Girmay Gebrehiwet - Konjo Kulaten / New Ethiopian Tigrigna Music 2018 (Official Video) by Liham Melody 3 years ago 5 minutes, 59 seconds 53,081 views",Liham Melody,53081,53100,19
1164,"Genet Yemane - Yihuw / New Ethiopian Tigrigna Music (Official Video) by Liham Melody 3 years ago 6 minutes, 59 seconds 77,291 views",Liham Melody,77291,77428,137
1165,"Tesfay (Wedi Meles) - Semirulom / New Ethiopian Tigrigna Music (Official Video) by Liham Melody 3 years ago 7 minutes, 9 seconds 96,674 views",Liham Melody,96674,96752,78
1166,"Tsegay Gebremedhin - Fekarey / Ethiopian Tigrigna Music 2018 (Official Video) by Liham Melody 3 years ago 7 minutes, 2 seconds 26,108 views",Liham Melody,26108,26123,15
1167,"Fisaha Alemseged - WEYNI / New Ethiopian Tigrigna Music 2018 (Official Video) by Liham Melody 3 years ago 5 minutes, 46 seconds 508,085 views",Liham Melody,508085,512026,3941
1168,"Tesfalem Berhe & Henok Tafere - Ambesa / Ethiopian Tigrigna Music 2018 (Official Video) by Liham Melody 3 years ago 4 minutes, 30 seconds 12,451 views",Liham Melody,12451,12454,3
1169,"Fiseha Hailay (Wedi Tsehay) Hezi Beli / New Ethiopian Tigrigna Music (Official Video) by Liham Melody 3 years ago 6 minutes, 38 seconds 1,804,562 views",Liham Melody,1804562,1810531,5969
1170,"Mamit Negash (Halefay) - Zeytmino / New Ethiopian Tigrigna Music 2018 (Official Video) by Liham Melody 3 years ago 5 minutes, 16 seconds 370,223 views",Liham Melody,370223,370981,758
1171,"Tesfalem Berhe -Kndey Des tibli / Ethiopian Tigrigna Music 2018 (Official Video) by Liham Melody 3 years ago 4 minutes, 46 seconds 48,460 views",Liham Melody,48460,48466,6
1172,"Mebrhit Weldegebriel - Gobez Eka / New Ethiopian Tigrigna Music 2018 (Official Video) by Liham Melody 4 years ago 6 minutes, 4 seconds 27,781 views",Liham Melody,27781,27794,13
1173,"Atsbha Hailu - Emntey (እምንተይ) New Ethiopian Tigrigna Music 2018 (Official Video) by Liham Melody 4 years ago 4 minutes, 12 seconds 188,286 views",Liham Melody,188286,188320,34
1174,"Tomas Mekonen & Shushay Tareke - Nihzbey / New Ethiopian Tigrigna Music  (Official Video) by Liham Melody 4 years ago 5 minutes, 12 seconds 26,608 views",Liham Melody,26608,26612,4
1175,"Haftom Alem -  (ቀፃሊ) New Ethiopian Tigrigna Music (Official Video) by Liham Melody 4 years ago 6 minutes, 17 seconds 17,631 views",Liham Melody,17631,17634,3
1176,"Atsbha Hailu - Tigray  / New Ethiopian Tigrigna Music  (Official Video) by Liham Melody 4 years ago 4 minutes, 24 seconds 85,772 views",Liham Melody,85772,85793,21
1177,"Haftamu Adlhay - Halietay Direakum / New Ethiopian Tigrigna  Music (Official Video) by Liham Melody 4 years ago 6 minutes, 27 seconds 76,575 views",Liham Melody,76575,76583,8
1178,"Tesfalem Gebreslassie - Tadelesh  / New Ethiopian Tigrigna Music 2018 (Official Video) by Liham Melody 4 years ago 6 minutes, 29 seconds 358,293 views",Liham Melody,358293,359880,1587
1179,"Znabu Abadi - Harestaye/ New Ethiopian Music 2018 (Official Video) by Liham Melody 4 years ago 8 minutes, 5 seconds 424,773 views",Liham Melody,424773,426332,1559
1180,"Gebremedhin Kasa - Abzi geza Kielel kelo / New Ethiopian Music 2018 (Official Video) by Liham Melody 4 years ago 8 minutes, 3 seconds 1,220,021 views",Liham Melody,1220021,1229352,9331
1181,"Tesfay Gidey - Malefya Wuray / New Ethiopian Music (Official Video) by Liham Melody 4 years ago 7 minutes, 36 seconds 267,028 views",Liham Melody,267028,268400,1372
1182,"Fre Zenebe - Nibeyney Ye / New Ethiopian Tigrigna Music 2018 (Official Video) by Liham Melody 4 years ago 5 minutes, 20 seconds 487,692 views",Liham Melody,487692,488146,454
1183,"Tesfalem Gebreslassie - Gafew lele / New Ethiopian Tigrigna Music 2018 (Official Video) by Liham Melody 4 years ago 6 minutes, 12 seconds 97,434 views",Liham Melody,97434,97606,172
1184,"Teklehaymanot Kinfe - Klite tsehaye / New Ethiopian Music (Official Video) by Liham Melody 4 years ago 7 minutes, 57 seconds 4,518,915 views",Liham Melody,4518915,4541346,22431
1185,"Elsa Weldejewergs - Hreseley / New Ethiopian Music 2018 (Official Video) by Liham Melody 4 years ago 6 minutes, 39 seconds 1,755,010 views",Liham Melody,1755010,1765528,10518
1186,"Selam Abreha - Bizban Fikri / New Ethiopian Music (Official Video) by Liham Melody 4 years ago 5 minutes, 16 seconds 23,893 views",Liham Melody,23893,23896,3
1187,"Temesgen Teklay - Gual Hamatey / New Ethiopian Music (Official Video) by Liham Melody 4 years ago 6 minutes 662,205 views",Liham Melody,662205,665022,2817
1188,"Roza Birhane - Yehrirkani / New Ethiopian Music (Official Video) by Liham Melody 4 years ago 4 minutes, 44 seconds 41,894 views",Liham Melody,41894,41911,17
1189,"Tesfalem Tefera - Asey (ኣሰይ) / New Ethiopian Music (Official Video) by Liham Melody 4 years ago 4 minutes, 45 seconds 28,825 views",Liham Melody,28825,28832,7
1190,"Sintayehu Molla - Girma Alem / New Ethiopian Music (Official Video) by Liham Melody 4 years ago 5 minutes, 24 seconds 54,094 views",Liham Melody,54094,54101,7
1191,"Birhane Gebru (Wedi Gebru) - Berika Tsehayna / New Ethiopian Music (Official Video) by Liham Melody 4 years ago 5 minutes, 32 seconds 410,424 views",Liham Melody,410424,412606,2182
1192,"Tirhas Alem - Aseye New EthiopianTigrigna Music (Official Video) by Liham Melody 4 years ago 5 minutes, 52 seconds 18,205 views",Liham Melody,18205,18212,7
1193,"Kiflom Gebremariam - Metselel / New Ethiopian Music (Official Video) by Liham Melody 4 years ago 5 minutes, 1 second 385,543 views",Liham Melody,385543,386741,1198
1194,"Meles Kahsay - Jenjine  / New Ethiopian Music (Official Video) by Liham Melody 4 years ago 5 minutes, 45 seconds 147,569 views",Liham Melody,147569,147594,25
1195,"Keshi Haftu (Tigrigna Comedy) by Liham Melody 4 years ago 1 minute, 45 seconds 84,323 views",Liham Melody,84323,84371,48
1196,"Ajeb Hintsa - Tsnue Hizbi / New Ethiopian Tigrigna Music (Official Music Video) by Liham Melody 4 years ago 5 minutes, 33 seconds 32,863 views",Liham Melody,32863,32894,31
1197,"Tsigab Tekalign - Mesanitey / New Ethiopian Tigrigna Music (Official Music Video) by Liham Melody 4 years ago 4 minutes, 7 seconds 18,511 views",Liham Melody,18511,18513,2
1198,"Tsegazeab Gebreslassie (እመንኒ) New Ethiopian Music (Official Video) by Liham Melody 4 years ago 3 minutes, 32 seconds 11,677 views",Liham Melody,11677,11690,13
1199,"Tsgereda Demewoz - BAHLNA  / New Ethiopian Music (Official Music Video) by Liham Melody 4 years ago 4 minutes, 54 seconds 126,078 views",Liham Melody,126078,126109,31
1200,"Eyasu Gebreziher (Hingidu) - Wursi / New Ethiopian Tigrigna Music (Official Music Video) by Liham Melody 4 years ago 6 minutes, 16 seconds 57,880 views",Liham Melody,57880,57897,17
1201,"Tedros Gano & Asfaw gebrecherkos - Nimeskeley / New Ethiopian Tigrigna Music (Official Music Video) by Liham Melody 4 years ago 6 minutes, 51 seconds 43,189 views",Liham Melody,43189,43200,11
1202,"Mesfin Alemu - Meskel / New Ethiopian Music (Official Music Video) by Liham Melody 4 years ago 6 minutes, 20 seconds 29,751 views",Liham Melody,29751,29755,4
1203,"Gerezgiher Hadgay - Aranshi Beliaye / New Ethiopian Music (Official Music Video) by Liham Melody 4 years ago 6 minutes, 23 seconds 943,790 views",Liham Melody,943790,948253,4463
1204,"Flimon Bekele - Hiwetye Hiwetye / New Ethiopian Music (Official Music Video) by Liham Melody 4 years ago 7 minutes, 5 seconds 4,386,828 views",Liham Melody,4386828,4422556,35728
1205,"Ashu and Bini - Ako akokay / New Ethiopian Music (Official Music Video) by Liham Melody 4 years ago 5 minutes, 4 seconds 88,964 views",Liham Melody,88964,88976,12
1206,"Mengasha Redae - Geday Mama / New Ethiopian Music (Official Music Video) by Liham Melody 4 years ago 9 minutes, 24 seconds 1,305,090 views",Liham Melody,1305090,1320936,15846
1207,"Amare Asefa - Meskelna / New Ethiopian Music (Official Music Video) by Liham Melody 4 years ago 7 minutes 116,796 views",Liham Melody,116796,116894,98
1208,"Filmon Bekele - Hasab Libom Semiratlom / New Ethiopian Music (Official Music Video) by Liham Melody 4 years ago 7 minutes, 50 seconds 2,704,612 views",Liham Melody,2704612,2714888,10276
1209,"Abraha Barento - Gimja / New Ethiopian Music (Official Music Video) by Liham Melody 4 years ago 7 minutes, 10 seconds 252,703 views",Liham Melody,252703,254260,1557
1210,"Hintsa Leake - Nimeskeley  / New Ethiopian Music (Official Music Video) by Liham Melody 4 years ago 6 minutes, 44 seconds 86,395 views",Liham Melody,86395,86397,2
1211,"Trhas Techane - Gutena / New EthiopianTigrigna Music (Official Music Video) by Liham Melody 4 years ago 4 minutes, 18 seconds 51,524 views",Liham Melody,51524,51535,11
1212,"Gezae Araya - Beka  / New Ethiopian Tigrigna Music (Official Music Video) by Liham Melody 4 years ago 5 minutes, 16 seconds 23,935 views",Liham Melody,23935,23946,11
1213,"Rshan Mebratu - Tigray Kolile  / New EthiopianTigrigna Music (Official Video) by Liham Melody 4 years ago 4 minutes, 34 seconds 28,031 views",Liham Melody,28031,28056,25
1214,"Tsehaye Kinfe - Gue Lominey / New Ethiopian Music (Official Music Video) by Liham Melody 4 years ago 5 minutes, 41 seconds 236,522 views",Liham Melody,236522,237527,1005
1215,"Hagos G/medihin & Selam Fiseha - MASHOY / EthiopianTigrigna Music (Official Music Video) by Liham Melody 4 years ago 5 minutes, 38 seconds 233,398 views",Liham Melody,233398,234604,1206
1216,"Meaza yohanns - Ashenda / New Ethiopian Music (Official Music Video) by Liham Melody 4 years ago 7 minutes, 38 seconds 41,231 views",Liham Melody,41231,41242,11
1217,"Debesay Zegeye - Kidanay merhaye / New Ethiopian Traditional Music (Official Music Video) by Liham Melody 4 years ago 7 minutes, 42 seconds 1,609,950 views",Liham Melody,1609950,1619480,9530
1218,"Solomon Yikunoamlak - Koleu Tigray / New Ethiopian Tigrigna Music 2018 (Official Music Video) by Liham Melody 4 years ago 6 minutes, 36 seconds 4,047,640 views",Liham Melody,4047640,4089736,42096
1219,"Tsgereda Demewoz - Shifon / New Ethiopian Tigrigna Music (Official Music Video) by Liham Melody 4 years ago 6 minutes, 28 seconds 119,605 views",Liham Melody,119605,119635,30
1220,"Hareg Hiluf - Ashenda Embeb / New Ethiopian Music (Official Music Video) by Liham Melody 4 years ago 7 minutes, 27 seconds 573,029 views",Liham Melody,573029,573438,409
1221,"Fantu Getachew - Ashenda / New Ethiopian Tigrigna Music (Official Music Video) by Liham Melody 4 years ago 6 minutes, 41 seconds 257,926 views",Liham Melody,257926,258094,168
1222,"Mulu Gebrewahd - Ayniwari / New Ethiopian Music (Official Music Video) by Liham Melody 4 years ago 7 minutes 175,546 views",Liham Melody,175546,175644,98
1223,"Hermela Abraha - ASHENDA / New EthiopianTigrigna Music (Official Music Video) by Liham Melody 4 years ago 5 minutes, 51 seconds 135,216 views",Liham Melody,135216,135414,198
1224,"Tsgereda Demewoz - Ashenda / New Ethiopian Tigrigna Music (Official Music Video) by Liham Melody 4 years ago 6 minutes, 43 seconds 283,782 views",Liham Melody,283782,284014,232
1225,"Gimja Bihonegn - Kikteleka Do / New EthiopianTigrigna Music (Official Music Video) by Liham Melody 4 years ago 5 minutes, 54 seconds 133,438 views",Liham Melody,133438,133609,171
1226,"Hayelom Teka - Shamaneki Derbini / New EthiopianTigrigna Music (Official Music Video) by Liham Melody 4 years ago 6 minutes, 58 seconds 332,038 views",Liham Melody,332038,332574,536
1227,"Hermela Abraha - Asit /ኣሲት New EthiopianTigrigna Music (Official Music Video) by Liham Melody 4 years ago 6 minutes, 24 seconds 581,420 views",Liham Melody,581420,582758,1338
1228,"Tirhas Gebremedhin - Mealibo Yeintey (Official Music Video) New EthiopianTigrigna Music by Liham Melody 4 years ago 4 minutes, 43 seconds 25,345 views",Liham Melody,25345,25349,4
1229,"Metsae Gebrekidan - Aminey / New EthiopianTigrigna Music (Official Music Video) by Liham Melody 4 years ago 4 minutes, 52 seconds 52,991 views",Liham Melody,52991,53027,36
1230,"Zeaman Girmay - Ayekum / New EthiopianTigrigna Music (Official Music Video) by Liham Melody 4 years ago 3 minutes, 52 seconds 32,795 views",Liham Melody,32795,32828,33
1231,"Tamrat Amare - Merahi Alem (Official Music Video) New Ethiopian Tigrigna Music by Liham Melody 4 years ago 5 minutes, 46 seconds 176,824 views",Liham Melody,176824,177064,240
1232,"Metsae Gebrekidan - Habana / New EthiopianTigrigna Music (Official Music Video) by Liham Melody 4 years ago 5 minutes, 10 seconds 141,337 views",Liham Melody,141337,141433,96
1233,"Kibrom Tikue - Tigrigna Instrumental Classical Music(Official Audio) Kibrom Tikue by Liham Melody 4 years ago 4 minutes, 11 seconds 25,042 views",Liham Melody,25042,25073,31
1234,"Tsegu Weldemariam - Fkiri Terasinu / New Ethiopian Tigrigna Music (Official Video) by Liham Melody 4 years ago 5 minutes, 45 seconds 16,948 views",Liham Melody,16948,16953,5
1235,"Gebreslassie Gebremichael (ChuChu) - Eshururu  (Official Music Video) New Ethiopian Tigrigna Music by Liham Melody 4 years ago 7 minutes, 22 seconds 586,808 views",Liham Melody,586808,588832,2024
1236,"Tadese Fisto Mekelle - Ati Weyino / New Ethiopian Tigrigna Music (Official Video) by Liham Melody 4 years ago 5 minutes, 27 seconds 199,418 views",Liham Melody,199418,199621,203
1237,"Nuguse Abadi - Ab Kal Ntsinae (Official Music Video) New Ethiopian Tigrigna Music by Liham Melody 4 years ago 7 minutes, 5 seconds 1,020,592 views",Liham Melody,1020592,1021561,969
1238,"Teklay Weldu - Yitrefki (Official Music Video) New Ethiopian Tigrigna Music by Liham Melody 4 years ago 5 minutes, 47 seconds 17,016 views",Liham Melody,17016,17019,3
1239,"Yared Tadese - Wehabit (Official Music Video) New Ethiopian Tigrigna Music by Liham Melody 4 years ago 6 minutes, 52 seconds 137,958 views",Liham Melody,137958,138003,45
1240,"Ze Aman Girmay - Awdeamet (Official Music Video) New Ethiopian Music by Liham Melody 4 years ago 7 minutes, 18 seconds 1,008,691 views",Liham Melody,1008691,1010301,1610
1241,"Temesgen Teklay - Telaelu Weney (Official Music Video) New Ethiopian Tigrigna Music by Liham Melody 4 years ago 6 minutes, 37 seconds 1,328,388 views",Liham Melody,1328388,1332215,3827
1242,"Awetash Ftwi - Zewzew (Official Music Video) New Ethiopian Music by Liham Melody 4 years ago 6 minutes, 59 seconds 870,765 views",Liham Melody,870765,885380,14615
1243,"Adhanom Keshi - Digrnoy (Official Music Video) New Ethiopian Traditional Erob Music by Liham Melody 4 years ago 6 minutes, 7 seconds 65,821 views",Liham Melody,65821,65862,41
1244,"Mehari Zeru - Newgehayo (Official Music Video) New Ethiopian Music by Liham Melody 4 years ago 5 minutes, 54 seconds 123,580 views",Liham Melody,123580,123988,408
1245,"Kinfe Gebregergis - Bahli Adey (Official Music Video) New Ethiopian Traditional Tigrigna Music by Liham Melody 4 years ago 6 minutes, 37 seconds 660,535 views",Liham Melody,660535,662057,1522
1246,"Kidane Brhane - Aleki do / New Traditional Tigrgna Music (Official Video) by Liham Melody 4 years ago 5 minutes, 40 seconds 43,075 views",Liham Melody,43075,43120,45
1247,"Gebremariyam Gebre (3G) - Abebaye / New Ethiopian Tigrigna Music by Liham Melody 4 years ago 6 minutes, 10 seconds 121,718 views",Liham Melody,121718,121887,169
1248,"Tamrat Amare - Atsey Yohannes (Official Music Video) New Tigrigna Music by Liham Melody 4 years ago 6 minutes, 11 seconds 471,505 views",Liham Melody,471505,472551,1046
1249,"Teklay Gdey - Lemlem Dasom (Official Music Video) New Ethiopian Music by Liham Melody 4 years ago 7 minutes, 12 seconds 405,471 views",Liham Melody,405471,406605,1134
1250,"Shushay Tareke - Nie Tiray / New Ethiopian Tigrigna Music (Official Video) by Liham Melody 4 years ago 6 minutes, 33 seconds 18,835 views",Liham Melody,18835,18848,13
1251,"Haftom Tesfay - Zekireki / New Ethiopian Tigrigna Music (Official Video) by Liham Melody 4 years ago 6 minutes, 23 seconds 12,947 views",Liham Melody,12947,12954,7
1252,"Zenawi Hailemariam - Tsritey (Official Music Video) New Ethiopian Music 2017 by Liham Melody 4 years ago 4 minutes, 58 seconds 215,742 views",Liham Melody,215742,216320,578
1253,"Keshi Haftu - New Tigrigna Comedy by Liham Melody 4 years ago 9 minutes, 35 seconds 379,822 views",Liham Melody,379822,379979,157
1254,"Fre Abrha - Alemamdeni / New Ethiopian Tigrigna Music (Official Video) by Liham Melody 5 years ago 6 minutes, 24 seconds 26,642 views",Liham Melody,26642,26648,6
1255,"Fitawrary kibromma - Mekelle Mekelle  (Official Music Video) New Ethiopian Music by Liham Melody 5 years ago 5 minutes, 9 seconds 43,819 views",Liham Melody,43819,44014,195
1256,"Haftom Ayalew - Kikurkeaki Demo / New Ethiopian Tigrigna Music (Official Video) by Liham Melody 5 years ago 5 minutes, 51 seconds 10,344 views",Liham Melody,10344,10346,2
1257,"Mulugeta Gebretsadik - Mikrtey / New Ethiopian Tigrigna Music (Official Video) by Liham Melody 5 years ago 4 minutes, 25 seconds 25,412 views",Liham Melody,25412,25421,9
1258,"Yapi Mapi - Masharada (Official Music Video) New Tigrigna Hip Hop Bemesenko by Liham Melody 5 years ago 4 minutes, 55 seconds 249,845 views",Liham Melody,249845,250607,762
1259,"Zekarias G/tsadik - Hade Nerna  / New Tigrigna Music  (Official Video) by Liham Melody 5 years ago 4 minutes, 40 seconds 9,863 views",Liham Melody,9863,9863,0
1260,"Selemon Welday - Belni Kisen  / NewEthiopian Tigrigna Music  (Official Video) by Liham Melody 5 years ago 5 minutes, 56 seconds 235,702 views",Liham Melody,235702,236441,739
1261,"Girmay Kidane /Skuf/ - Dekeye /New Tigrigna Musical Drama (Official Video) by Liham Melody 5 years ago 7 minutes, 47 seconds 12,158 views",Liham Melody,12158,12169,11
1262,"Meseret G/tsadik /Gual Zoba/ - Anbesa Yimesil / New Tigrigna Music 2017 (Official Video) by Liham Melody 5 years ago 6 minutes, 13 seconds 605,642 views",Liham Melody,605642,606499,857
1263,"Daniel Asfaha - Zri / New Ethiopian Tigrigna Music  (Official Video) by Liham Melody 5 years ago 6 minutes, 58 seconds 16,065 views",Liham Melody,16065,16066,1
1264,"Daniel Asfaha - Zebzeb Beli / New Tigrigna Music 2017 (Official Video) by Liham Melody 5 years ago 6 minutes, 31 seconds 14,201 views",Liham Melody,14201,14204,3
1265,"Amleset Gebrehaweria - Neani'ba / New Ethiopian Tigrigna Music  (Official Video) by Liham Melody 5 years ago 6 minutes, 12 seconds 213,082 views",Liham Melody,213082,213152,70
1266,"Selomon Ykunoamlak - Adey Slas / New Ethiopian Tigrigna Music 2017 (Official Video) by Liham Melody 5 years ago 5 minutes, 32 seconds 787,442 views",Liham Melody,787442,791580,4138
1267,"Nguse Abadi - Tsray Zdeleye / New Ethiopan Tigrigna music (Official Video) by Liham Melody 5 years ago 8 minutes, 16 seconds 6,047,747 views",Liham Melody,6047747,6080801,33054
1268,"Merhawit Tuem - Adayndedirke/ New Ethiopian Erob Music 2017 (Official Video) by Liham Melody 5 years ago 4 minutes, 39 seconds 108,869 views",Liham Melody,108869,109159,290
1269,"Aynalem Hadush - Weni / ወኒ / New Ethiopian Tigrigna Music 2017 (Official Video) by Liham Melody 5 years ago 5 minutes, 58 seconds 389,488 views",Liham Melody,389488,389710,222
1270,"Tsegay Abreha - Etifikreyn Fikrikin / New / Ethiopian Tigrigna Music (Official Video) by Liham Melody 5 years ago 5 minutes, 6 seconds 24,041 views",Liham Melody,24041,24043,2
1271,"Kiflom  G/mariam (kuda) - Enkuae Tealele / New Ethiopian tigrigna Music (Official Video) by Liham Melody 5 years ago 7 minutes, 46 seconds 1,240,696 views",Liham Melody,1240696,1243763,3067
1272,"Jop Tekle - mizer / New Ethiopian Tigrigna Music (Official Video) by Liham Melody 5 years ago 5 minutes, 37 seconds 26,036 views",Liham Melody,26036,26040,4
1273,"Tsegay (Wedi Hailu) - Zeywealnayo / New Ethiopian tigrigna Music 2017 (Official Video) by Liham Melody 5 years ago 6 minutes, 25 seconds 676,121 views",Liham Melody,676121,676401,280
1274,"Mekseb  Weldu - Rekibeyo / New Ethiopian Tigrigna Music 2017  (Official Video) by Liham Melody 5 years ago 4 minutes, 34 seconds 18,997 views",Liham Melody,18997,19000,3
1275,"Yared Berhe - Tetsebeyni / New Ethiopian Tigrigna Music (Official Video) by Liham Melody 5 years ago 5 minutes, 29 seconds 37,030 views",Liham Melody,37030,37082,52
1276,"Haftom Gebremichael - Ashemuna / New Ethiopian tigrigna Music (Official Video) by Liham Melody 5 years ago 4 minutes, 49 seconds 48,422 views",Liham Melody,48422,48438,16
1277,"Birhanu Teka - Awagieni / New Ethiopian Tigrigna Music (Official Video) by Liham Melody 5 years ago 5 minutes, 53 seconds 79,734 views",Liham Melody,79734,79815,81
1278,"Ashenafi Birhane (Ashu) & fire - TaTa / New Ethiopian Music (Official Video) by Liham Melody 5 years ago 4 minutes, 3 seconds 11,479 views",Liham Melody,11479,11483,4
1279,"Tsegalul Hailemariam - Tigraway / New Ethiopian tigrigna Music (Official Video) by Liham Melody 5 years ago 6 minutes, 5 seconds 96,644 views",Liham Melody,96644,96738,94
1280,"Maekele Gebreyohanes - Zingibaba / New Ethiopian Tigrigna Music (Official Video) by Liham Melody 5 years ago 6 minutes, 18 seconds 266,685 views",Liham Melody,266685,266911,226
1281,"Amanual Yemane - Meareye /መዓረየ/ New Ethiopian Music (Official Video) by Liham Melody 5 years ago 5 minutes, 32 seconds 7,052,761 views",Liham Melody,7052761,7069571,16810
1282,"Berihu Mehari - Aytirhakni / New Ethiopian Tigrigna Music (Official Video) by Liham Melody 5 years ago 5 minutes, 10 seconds 700,654 views",Liham Melody,700654,700911,257
1283,"Teame Teklehaimanot - Abeyebeye Kinigane  / New Tigrigna Music (Official Video) by Liham Melody 5 years ago 5 minutes, 44 seconds 702,288 views",Liham Melody,702288,702978,690
1284,"Raza Raya - Tigray Adey / New Ethiopian Tigrigna Raya Music (Official Video) by Liham Melody 5 years ago 5 minutes, 55 seconds 403,832 views",Liham Melody,403832,404523,691
1285,"Mizan Negasi (Mizu) - Aytemarireni / New Ethiopian Tigrigna Music (Official Video) by Liham Melody 5 years ago 5 minutes, 3 seconds 43,712 views",Liham Melody,43712,43741,29
1286,"Desta Gebregergs - Newih Kumet / New Ethiopian Tigrigna Music (Official Video) by Liham Melody 5 years ago 5 minutes, 32 seconds 578,760 views",Liham Melody,578760,580664,1904
1287,"Girmay Gebremariam - Zawyay / New Ethiopian Tigrigna Music (Official Video) by Liham Melody 5 years ago 5 minutes, 22 seconds 21,749 views",Liham Melody,21749,21751,2
1288,"Teklay Woldu - Fikri yu Emnetey / New Ethiopian Tigrigna Music (Official Video) by Liham Melody 5 years ago 7 minutes, 28 seconds 8,980 views",Liham Melody,8980,8982,2
1289,"Rahwa Gali - Kemey Kikonelka / New Ethiopian Tigrigna Music (Official Video) by Liham Melody 5 years ago 6 minutes, 7 seconds 140,399 views",Liham Melody,140399,140764,365
1290,"Tamrat Amare - Kseni / New Ethiopian Tigrigna Music (Official Video) by Liham Melody 5 years ago 5 minutes, 55 seconds 193,599 views",Liham Melody,193599,193806,207
1291,"Henok Aregawi - Agame Adigrat / New Ethiopian Tigrigna Music (Official Video) by Liham Melody 5 years ago 6 minutes, 22 seconds 80,364 views",Liham Melody,80364,80448,84
1292,"Lwam Bahta - Eti Zelmedkani / New Ethiopian Tigrigna Music (Official Video) by Liham Melody 5 years ago 5 minutes, 57 seconds 18,915 views",Liham Melody,18915,18923,8
1293,"Hermela Abreha - Keberoy / New Ethiopian Tigrigna Music (Official Video) by Liham Melody 5 years ago 5 minutes, 42 seconds 1,601,694 views",Liham Melody,1601694,1603385,1691
1294,"Birhanu Mache - Ayam Belu / New Ethiopian Tigrigna Raya Music (Official Video) by Liham Melody 5 years ago 6 minutes, 6 seconds 1,583,475 views",Liham Melody,1583475,1592367,8892
1295,"Merhawi Guesh - Aytimetsinin Diki / New Ethiopian Tigrigna Music (Official Video) by Liham Melody 5 years ago 5 minutes, 9 seconds 13,217 views",Liham Melody,13217,13228,11
1296,"Berhe Wedi Marse - Alilalom  / New Ethiopian Tigrigna Raya Music (Official Video) by Liham Melody 5 years ago 6 minutes, 48 seconds 152,403 views",Liham Melody,152403,152484,81
1297,"Tesfalem Gebremichael - Ktsawet'ye / New Ethiopian Tigrigna Music (Official Video) by Liham Melody 5 years ago 5 minutes, 44 seconds 143,972 views",Liham Melody,143972,144023,51
1298,"Fanial Welday - Mitsyay dema  / New Ethiopian Tigrigna Music (Official Video) by Liham Melody 5 years ago 4 minutes, 51 seconds 20,334 views",Liham Melody,20334,20345,11
1299,"Yonas Haile - Fitiwtuw / New Ethiopian Tigrigna Music (Official Video) by Liham Melody 5 years ago 5 minutes, 19 seconds 281,310 views",Liham Melody,281310,281418,108
1300,"Gebru G/mariam (Wedi Shambel) - I Love You /New Ethiopian Tigrigna Music (Official Video) by Liham Melody 5 years ago 8 minutes, 15 seconds 681,554 views",Liham Melody,681554,685052,3498
1301,"Girmay Gebremariam - Quaenenen / New Ethiopian Tigrigna Music 2016 (Official Video) by Liham Melody 5 years ago 5 minutes, 10 seconds 116,648 views",Liham Melody,116648,116737,89
1302,"Mearg Tsegay - Hoye Hoye  / New Ethiopian Tigrigna Music (Official Video) by Liham Melody 5 years ago 4 minutes, 39 seconds 19,891 views",Liham Melody,19891,19894,3
1303,"Alemayehu Hafte - laza' welela  / New Ethiopian Tigrigna Raya Music (Official Video) by Liham Melody 5 years ago 5 minutes, 27 seconds 1,191,014 views",Liham Melody,1191014,1196062,5048
1304,"Ashenafi Gebremichael - Hirfaney  / New Ethiopian Tigrigna Music (Official Video) by Liham Melody 5 years ago 5 minutes, 37 seconds 14,452 views",Liham Melody,14452,14459,7
1305,"Alula Gebremariam - Seb Kem Falu / New Ethiopian Tigrigna Music (Official Video) by Liham Melody 5 years ago 5 minutes, 55 seconds 267,452 views",Liham Melody,267452,267593,141
1306,"Yohannes Bayru - Nmeskeley / New Ethiopian Tigrigna Music (Official Video) by Liham Melody 5 years ago 6 minutes, 55 seconds 153,722 views",Liham Melody,153722,153803,81
1307,"Filmon Bekele - Des Behalit / New Ethiopian Tigrigna Music (Official Video) by Liham Melody 5 years ago 6 minutes, 38 seconds 620,161 views",Liham Melody,620161,622067,1906
1308,"Yoseif Reda - Lmeskeley / New Ethiopian Traditional Music (Official Video) by Liham Melody 5 years ago 6 minutes, 41 seconds 301,364 views",Liham Melody,301364,301463,99
1309,"Tsegalul Hailemariam - Weyno / New Ethiopian Tigrigna Music (Official Audio) by Liham Melody 5 years ago 6 minutes, 6 seconds 58,889 views",Liham Melody,58889,58919,30
1310,"Ruta Tesfay - Eifoytay / New Ethiopian Music  (Official Video) by Liham Melody 5 years ago 5 minutes, 54 seconds 93,687 views",Liham Melody,93687,93884,197
1311,"Solomon Yikunoamlak - Adey Silas / New Ethiopian Tigrigna Music (Official Audio) by Liham Melody 5 years ago 5 minutes, 14 seconds 56,169 views",Liham Melody,56169,56219,50
1312,"Fiseha Hailay - Ruhus Awdeamet  /New Ethiopian Tigrigna Music (Official Video) by Liham Melody 5 years ago 7 minutes, 33 seconds 2,616,141 views",Liham Melody,2616141,2629495,13354
1313,"Tamrat Gebreslassie /50 goma/ - Wedi Hangadey / New Ethiopian Tigrigna Music (Official Video) by Liham Melody 5 years ago 8 minutes, 29 seconds 1,616,126 views",Liham Melody,1616126,1622101,5975
1314,"Mulugeta Hagos - Gize Eyu Jigna /New Ethiopian Tigrigna Music (Official Video) by Liham Melody 5 years ago 6 minutes, 5 seconds 42,824 views",Liham Melody,42824,42923,99
1315,"Mebrahtom Asfaw - Temam  / New Ethiopian Tigrigna Music  (Official Video) by Liham Melody 5 years ago 5 minutes, 20 seconds 33,525 views",Liham Melody,33525,33535,10
1316,"Berhe Wedi Marse - Kukuye  / New Ethiopian Tigrigna Music (Official Video) by Liham Melody 5 years ago 7 minutes, 10 seconds 238,186 views",Liham Melody,238186,238331,145
1317,"Birtukuan Mebrahtu - Gue Leminey /New Ethiopian Traditional Tigrigna Music (Official Video) by Liham Melody 5 years ago 4 minutes, 51 seconds 237,349 views",Liham Melody,237349,237443,94
1318,"Teklehaymanot Knfe - Keebdana Elenye / New Tigrigna Ashenda Music (Official Video) by Liham Melody 5 years ago 7 minutes, 14 seconds 519,048 views",Liham Melody,519048,520949,1901
1319,"Raza Raya - Mahazaye /New Ethiopian Traditional Tigrigna Music (Official Video) by Liham Melody 5 years ago 5 minutes, 9 seconds 1,095,352 views",Liham Melody,1095352,1097683,2331
1320,"Sisay G/gergis - Ajokiye /  New Ethiopian Tigrigna Music 2016 (Official Video) by Liham Melody 5 years ago 6 minutes, 8 seconds 135,698 views",Liham Melody,135698,135722,24
1321,"Asfaw Girmay - Kol'a Tigray  / New Ethiopian Tigrigna Music 2016 (Official Video) by Liham Melody 5 years ago 6 minutes, 3 seconds 442,902 views",Liham Melody,442902,443091,189
1322,"Yohannes Bayru - Mearey / New Ethiopian Traditional Music (Official Video) by Liham Melody 5 years ago 6 minutes, 22 seconds 39,589 views",Liham Melody,39589,39598,9
1323,"Gezae Fitwi - Taemi  Fikri / New Ethiopian Tigrigna Music 2016 (Official Video) by Liham Melody 5 years ago 4 minutes, 55 seconds 113,585 views",Liham Melody,113585,113828,243
1324,"Filmon Bekele - Meskel Ab Agame / New Ethiopian Traditional Tigrigna Music (Official Video) by Liham Melody 5 years ago 6 minutes, 52 seconds 366,933 views",Liham Melody,366933,368858,1925
1325,"Zekariyas Gebretsadk (Zaki) - Kembiwaza / New Tigrigna Music 2016 (Official Video) by Liham Melody 5 years ago 5 minutes, 41 seconds 12,661 views",Liham Melody,12661,12661,0
1326,"Adhanom Subagadis - Nagasn Kohabe / New Ethiopian Traditional Erop Music  (Official Video) by Liham Melody 5 years ago 5 minutes, 40 seconds 46,094 views",Liham Melody,46094,46149,55
1327,"Fre Zenebe - ኣታ ሕራይ ለየ /New Ethiopian Tigrigna Music  (Official Video) by Liham Melody 5 years ago 4 minutes, 36 seconds 1,327,254 views",Liham Melody,1327254,1327857,603
1328,"Teklay G/michael - Shikor  /New Ethiopian Tigrigna Music (Official Video) by Liham Melody 5 years ago 6 minutes, 49 seconds 404,551 views",Liham Melody,404551,404803,252
1329,"3g /Ksanet/ - Ayaminin (ኣይኣምንን)  New Ethiopian Tigrigna Music  (Official Video) by Liham Melody 5 years ago 6 minutes, 28 seconds 35,544 views",Liham Melody,35544,35548,4
1330,"Gebrehiwet Gebru (Gere Afro) - Zyada kulen / New EthiopianTigrigna Music  (Official Video) by Liham Melody 5 years ago 5 minutes, 26 seconds 22,484 views",Liham Melody,22484,22499,15
1331,"Tesfay Gidey - Zawyay / New Ethiopian Tigrigna Music (Official Video) by Liham Melody 5 years ago 6 minutes, 22 seconds 144,620 views",Liham Melody,144620,144696,76
1332,"Zenebe Welay - Aykermn Eye / New Ethiopian Traditional Tigrigna Music  (Official Video) by Liham Melody 5 years ago 5 minutes, 38 seconds 362,689 views",Liham Melody,362689,362844,155
1333,"Alazar Atsbeha (Aleco) - Medina / New Ethiopian  Tigrigna Music (Official Video) by Liham Melody 5 years ago 6 minutes, 41 seconds 142,380 views",Liham Melody,142380,142574,194
1334,"Tirhas Alem - Asey / Ethiopian Traditional Tigrigna Music (Official Video) by Liham Melody 5 years ago 5 minutes, 52 seconds 28,175 views",Liham Melody,28175,28202,27
1335,"Gidey Aweteheygn - Eza Abay Gualye / New Ethiopian Traditional Tigrigna Music  (Official Video) by Liham Melody 5 years ago 6 minutes, 48 seconds 171,939 views",Liham Melody,171939,171992,53
1336,"Zenawi H/mariem - Nie Kedam / New Ethiopian Tigrigna Music  (Official Audio) by Liham Melody 5 years ago 4 minutes, 31 seconds 22,371 views",Liham Melody,22371,22373,2
1337,"Zenawi Abraha - Smitey /New Ethiopian Tigrigna Music (Official Video) by Liham Melody 5 years ago 5 minutes, 59 seconds 13,636 views",Liham Melody,13636,13647,11
1338,"Gzachew Solomon - 70 Enderta / New Ethiopian Tigrigna Music  (Official Video) by Liham Melody 5 years ago 5 minutes, 58 seconds 75,217 views",Liham Melody,75217,75322,105
1339,"Kalayu G/her - Desdes /New Ethiopian Tigrigna Music (Official Video) by Liham Melody 5 years ago 6 minutes, 14 seconds 100,895 views",Liham Melody,100895,100920,25
1340,"Solomon Yikunoamlak - Salaki /ሳላኺ  New Ethiopian Tigrigna Music (Official Video) by Liham Melody 5 years ago 6 minutes, 26 seconds 2,459,078 views",Liham Melody,2459078,2463399,4321
1341,"Rahel Tsegay - Halaley / New Ethiopian Tigrigna Music (Official Video) by Liham Melody 5 years ago 5 minutes, 33 seconds 42,013 views",Liham Melody,42013,42045,32
1342,"Haftom Tesfay - Entay Mibelki /New Ethiopian Tigrigna Music (Official Video) by Liham Melody 5 years ago 6 minutes, 20 seconds 29,768 views",Liham Melody,29768,29772,4
1343,"Gebrehiwet Hadush - Ati Wezam/ New Ethiopian Tigrigna Music (Official Video) by Liham Melody 5 years ago 5 minutes, 56 seconds 321,508 views",Liham Melody,321508,321633,125
1344,"Ze Aman Girmay - Deki Adey New Ethiopian Tigrigna Music (Official Video) by Liham Melody 5 years ago 7 minutes, 23 seconds 2,322,814 views",Liham Melody,2322814,2329574,6760
1345,"Almaz Kiros - Emun Aminey  New Ethiopian Traditional Tigrigna Music (Official Video) by Liham Melody 5 years ago 5 minutes 135,455 views",Liham Melody,135455,135509,54
1346,"Genet Gidey - Tesalite / New Ethiopian Tigrigna Music (Official Video) by Liham Melody 5 years ago 5 minutes, 57 seconds 93,838 views",Liham Melody,93838,93926,88
1347,"Rezene Tseame - Nsenay Ygbero / New Ethiopian Music (Official Video) by Liham Melody 5 years ago 5 minutes, 53 seconds 105,829 views",Liham Melody,105829,106340,511
1348,"Meseret Werku - Tium / New Ethiopian Traditional Tigrigna Music (Official Video) by Liham Melody 5 years ago 5 minutes, 22 seconds 22,733 views",Liham Melody,22733,22749,16
1349,"Tsige Kahsay - Weynay  New Ethiopian Tigrigna Music (Official Video) by Liham Melody 5 years ago 6 minutes, 6 seconds 164,328 views",Liham Melody,164328,164422,94
1350,"Yeshi Birhane - Asa Kabaro New Ethiopian Traditional Erob Music (Official Video) by Liham Melody 5 years ago 5 minutes, 57 seconds 1,911,021 views",Liham Melody,1911021,1917947,6926
1351,"Brtawit Tadesse - Quah sem/ቋሕ ስም New Ethiopian Tigrigna Music (Official Video) by Liham Melody 5 years ago 6 minutes, 27 seconds 112,650 views",Liham Melody,112650,112759,109
1352,"Trhas Tareke (Kobeley) & Ali Danto - SOT/ሶት New Ethiopian Music 2016 (Official Video) by Liham Melody 5 years ago 4 minutes, 37 seconds 42,378 views",Liham Melody,42378,42389,11
1353,"Yeshi Birhane - Meklitey /መኽሊተይ New Ethiopian Traditional Tigrigna Music (Official Video) by Liham Melody 5 years ago 5 minutes, 28 seconds 886,073 views",Liham Melody,886073,890087,4014
1354,"Afewerki G/kidan - Lemlem Das / New Ethiopian Tigrigna Music (Official Video) by Liham Melody 5 years ago 6 minutes, 12 seconds 44,016 views",Liham Melody,44016,44050,34
1355,"Azmera Chekol - Senselomay / New Ethiopian Traditional Tigrigna Music (Official Video) by Liham Melody 5 years ago 4 minutes, 18 seconds 30,174 views",Liham Melody,30174,30189,15
1356,"Kidist Brhane - Reime / New Ethiopian Traditional Tigrigna Music (Official Video) by Liham Melody 5 years ago 5 minutes, 44 seconds 48,187 views",Liham Melody,48187,48191,4
1357,"ወዮ! Weyo / Tigrigna Drama by Liham Melody 5 years ago 1 minute, 52 seconds 57,697 views",Liham Melody,57697,57705,8
1358,"Mulugeta Hagos - Shukor / New Ethiopian Tigrigna Music (Official Video) by Liham Melody 5 years ago 6 minutes, 18 seconds 1,366,096 views",Liham Melody,1366096,1367112,1016
1359,"Temetu G/hiwet - Bikebero Tiri / New Ethiopian Traditional Tigrigna Music (Official Video) by Liham Melody 5 years ago 5 minutes, 49 seconds 448,815 views",Liham Melody,448815,449721,906
1360,"Kinfe G/gergis - Gamakum / New Ethiopian Wedding Music (Official Video) by Liham Melody 5 years ago 5 minutes, 56 seconds 368,380 views",Liham Melody,368380,368828,448
1361,"Raza Raya - Asli /ኣስሊ New Ethiopian Traditional Music (Official Video) by Liham Melody 5 years ago 6 minutes, 19 seconds 724,682 views",Liham Melody,724682,725782,1100
1362,"Nuguse Abadi - Hura Seleste / New Ethiopian Traditional Music (Official Video) by Liham Melody 5 years ago 6 minutes, 9 seconds 559,056 views",Liham Melody,559056,560279,1223
1363,"Tsegalul Hailemariam - Manta tsehay / New Ethiopian Tigrigna Music (Official Video) by Liham Melody 5 years ago 6 minutes 135,170 views",Liham Melody,135170,135284,114
1364,"Zenawi H/mariam - Shikorina/ሽኮሪና New Ethiopian Tigrigna Music (Official Video) by Liham Melody 5 years ago 4 minutes, 30 seconds 208,879 views",Liham Melody,208879,208978,99
1365,"Selamawit Kelelom - Kichiney / New Ethiopian Traditional Music (Official Video) by Liham Melody 5 years ago 5 minutes, 12 seconds 17,380 views",Liham Melody,17380,17381,1
1366,"Solomon Hailu - Kidi /ኪዲ  New Ethiopian Tigrigna Music (Official Video) by Liham Melody 5 years ago 6 minutes, 57 seconds 70,647 views",Liham Melody,70647,70709,62
1367,"Selam Dimtsu - Dilyetey / New Ethiopian Traditional Music Official Video by Liham Melody 5 years ago 5 minutes, 2 seconds 29,240 views",Liham Melody,29240,29243,3
1368,"Yohannes Haftu (Jhon) - Lilo /ሊሎ New Ethiopian Traditional Music (Official Video) by Liham Melody 5 years ago 5 minutes, 40 seconds 406,368 views",Liham Melody,406368,407611,1243
1369,"Binyam Yemane - Firdey/ፍርደይ New Ethiopian Tigrigna Music (Official Video) by Liham Melody 5 years ago 6 minutes, 41 seconds 1,077,269 views",Liham Melody,1077269,1079243,1974
1370,"Efrem G/tsadik - Abti Ruba /አብቲ ሩባ New Ethiopian Traditional Tigrigna Music (Official Video) by Liham Melody 5 years ago 5 minutes, 22 seconds 28,128 views",Liham Melody,28128,28134,6
1371,"G/slassie G/michael (Wedi Mhrey) - chuchu /ቹቹ  New Ethiopian Traditional Music (Official Video) by Liham Melody 6 years ago 6 minutes, 29 seconds 364,818 views",Liham Melody,364818,367265,2447
1372,"Efrem G/tsadik - Nabra Alem / New Ethiopian Tigrigna Music (Official Video) by Liham Melody 6 years ago 4 minutes, 35 seconds 36,349 views",Liham Melody,36349,36368,19
1373,"Znabu Kiros - Mergti /ምዕርግቲ New Ethiopian Traditional Tigrigna Music (Official Video) by Liham Melody 6 years ago 5 minutes, 54 seconds 235,474 views",Liham Melody,235474,235635,161
1374,"Adey G/michael - Ruhus Gama /ርሑስ ጋማ New Ethiopian Wedding Music (Official Video) by Liham Melody 6 years ago 5 minutes 93,227 views",Liham Melody,93227,93265,38
1375,"Kiros Girmay - Entay Alewo /እንታይ ኣለዎ New Ethiopian Tigrigna Music (Official Video) by Liham Melody 6 years ago 6 minutes, 9 seconds 71,953 views",Liham Melody,71953,71956,3
1376,"Aynalem Mahari - Syum Kiblaka /  New Ethiopian Traditional Tigrigna Music (Official Video) by Liham Melody 6 years ago 5 minutes, 16 seconds 65,182 views",Liham Melody,65182,65201,19
1377,"Kiros Girmay - Merhaba / New Ethiopian Tigrigna Music (Official Video) by Liham Melody 6 years ago 5 minutes, 31 seconds 140,849 views",Liham Melody,140849,140891,42
1378,"Solomon Yikunoamlak - Muley /ሙለይ New Ethiopian Traditional Tigrigna Music (Official Video) by Liham Melody 6 years ago 7 minutes, 1 second 729,013 views",Liham Melody,729013,732280,3267
1379,"Henok Tafere - Zyaday /ዝያዳይ New Ethiopian Tigrigna Music (Official Video) by Liham Melody 6 years ago 6 minutes, 33 seconds 35,955 views",Liham Melody,35955,36016,61
1380,"Birtukuan Mebrahtu - Beal Mido /በዓል ሚዶ New Ethiopian Traditional Tigrigna Music (Official Video) by Liham Melody 6 years ago 4 minutes, 52 seconds 119,367 views",Liham Melody,119367,119429,62
1381,"Fitawrary Kibromma & Aregay G/medhin - Akaflyen / New Ethiopian Music (Official Audio) by Liham Melody 6 years ago 4 minutes, 42 seconds 9,483 views",Liham Melody,9483,9488,5
1382,"Mulgeta Kahsay - Chaw/ ቻው New Ethiopian Tigrigna Music (Official Video) by Liham Melody 6 years ago 6 minutes, 40 seconds 124,175 views",Liham Melody,124175,124303,128
1383,"Meaza Yohannes - Keytehmeni /ከይተሕመኒ New Ethiopian Traditional Tigrigna Music (Official Video) by Liham Melody 6 years ago 6 minutes, 53 seconds 444,180 views",Liham Melody,444180,445392,1212
1384,"Teame Zewde - Tehaguese / New Ethiopian Tigrigna  Music (Official Video) by Liham Melody 6 years ago 5 minutes, 1 second 13,291 views",Liham Melody,13291,13296,5
1385,"Asefa G/michael - Sanday ሳንዳይ New Tigrigna Wedding Music (Official Video) by Liham Melody 6 years ago 6 minutes, 33 seconds 664,856 views",Liham Melody,664856,667198,2342
1386,"Tsegalul Hailemariam - ወይን ባዓል ስረ New Ethiopian Tigrigna Music (Official Video) by Liham Melody 6 years ago 6 minutes 242,218 views",Liham Melody,242218,242420,202
1387,"Henok Tafere - Kelebey / New Ethiopian Tigrigna Music (Official Video) by Liham Melody 6 years ago 6 minutes, 23 seconds 96,942 views",Liham Melody,96942,96953,11
1388,"Mebrahtu Hgiorgis - Bertiou Fkrki / በርቲዑ ፍቕርኺ New Ethiopian Tigrigna Music (Official Video) by Liham Melody 6 years ago 5 minutes, 26 seconds 9,005 views",Liham Melody,9005,9009,4
1389,"Teklebrhan Tsegay - Fkedley / New Ethiopian Tigrigna Music (Official Video) by Liham Melody 6 years ago 5 minutes, 32 seconds 98,070 views",Liham Melody,98070,98082,12
1390,"Mulubrhan Fisseha (Wari) - Gabzni /ጋብዝኒ New Ethiopian Tigrigna Music (Official Video) by Liham Melody 6 years ago 6 minutes, 14 seconds 2,362,811 views",Liham Melody,2362811,2368052,5241
1391,"Hagos Mahari - Ashealey meley /ኣሸዓለይ መለይ New Ethiopian Traditional Music (Official Video) by Liham Melody 6 years ago 5 minutes, 16 seconds 1,730,082 views",Liham Melody,1730082,1734170,4088
1392,"Haile Adhana - Mear teb /መዓር ጠብ New Ethiopian Traditional Tigrigna Raya Music (Official Video) by Liham Melody 6 years ago 5 minutes, 59 seconds 206,002 views",Liham Melody,206002,206056,54
1393,"Mizan Tesfay - Tezarebiba ተዛረቢ'ባ New Ethiopian Traditional Tigrigna Music (Official Video) by Liham Melody 6 years ago 7 minutes, 15 seconds 292,454 views",Liham Melody,292454,294015,1561
1394,"Yitbarek Mesfin - Selel Beliley ሰለል በልለይ New Ethiopian Traditional Tigrigna Music (Official Video) by Liham Melody 6 years ago 5 minutes, 20 seconds 60,907 views",Liham Melody,60907,60928,21
1395,"Goyteom Tamrat - Rigbey / New Ethiopian Tigrigna Music (Official Video) by Liham Melody 6 years ago 5 minutes, 45 seconds 32,071 views",Liham Melody,32071,32073,2
1396,"Merkeb Bonitua & Mearg tsegay - Kunama / New Ethiopian Kunama Music (Official Video) by Liham Melody 6 years ago 4 minutes, 38 seconds 39,756 views",Liham Melody,39756,39855,99
1397,"Yapi Mapi ft. Raza Raya - Rayuma New Ethiopian Music mix with modern Style (Official Video) by Liham Melody 6 years ago 4 minutes, 41 seconds 133,380 views",Liham Melody,133380,133525,145
1398,"Haftom Berhe - EDO'E ኢዶእ  New Ethiopian Tigrigna Music (Official Video) by Liham Melody 6 years ago 5 minutes, 1 second 40,290 views",Liham Melody,40290,40318,28
1399,"Nigus Gidey - Afatitkna ኣፋጢጥክና New Ethiopian Tigrigna Music (Official Video) by Liham Melody 6 years ago 5 minutes, 39 seconds 129,431 views",Liham Melody,129431,129510,79
1400,"Yohannes Bayru - Mearey / New Ethiopian Traditional Tigrigna Music (Official Video) by Liham Melody 6 years ago 6 minutes, 22 seconds 55,725 views",Liham Melody,55725,55797,72
1401,"kefey Hagos #Kemb waza waza# ከም ብዋዛ ዋዛ New Ethiopian Tigrigna Music (Official Video) by Liham Melody 6 years ago 6 minutes, 28 seconds 89,951 views",Liham Melody,89951,90016,65
1402,"Desta Berhe - Sgem / New Ethiopian Traditional Tigrigna Music (Official Video) by Liham Melody 6 years ago 5 minutes, 25 seconds 96,029 views",Liham Melody,96029,96202,173
1403,"Fana Negash - Sebey ሰበይ New Ethiopian Traditional Tigrigna Music (Official Video) by Liham Melody 6 years ago 5 minutes, 11 seconds 393,684 views",Liham Melody,393684,394284,600
1404,"Hagush Gebregziher - Yitsbeleku / New Ethiopian Traditional Tigrigna Music (Official Video) by Liham Melody 6 years ago 6 minutes, 46 seconds 64,812 views",Liham Melody,64812,64843,31
1405,"Alemnesh Dessie - awujeley / New Ethiopian Tigrigna Music (Official Audio) by Liham Melody 6 years ago 5 minutes, 38 seconds 14,062 views",Liham Melody,14062,14068,6
1406,"Shushay Tareke /Wedi Tareke/ - ንዒ ጥራይ / New Traditional Tigrigna Music (Official Video) by Liham Melody 6 years ago 6 minutes, 34 seconds 38,206 views",Liham Melody,38206,38212,6
1407,"Rahel Getachew - Ayam bel ኣያም በል New Ethiopian Traditional Tigrigna Music (Official Video) by Liham Melody 6 years ago 6 minutes, 12 seconds 231,167 views",Liham Melody,231167,231252,85
1408,"Eyerusalem Belete - Tetselaway tsehaye / New Ethiopian Traditional Tigrigna Music (Official Video) by Liham Melody 6 years ago 5 minutes, 33 seconds 148,568 views",Liham Melody,148568,148689,121
1409,"Muez G/medhin /Muji/ - Jigna Yelen Ab Fkri / New Ethiopian tigiriga music 2015 (Official Video) by Liham Melody 6 years ago 4 minutes, 11 seconds 9,570 views",Liham Melody,9570,9574,4
1410,"John Tadesse - Selam Belni / New tigiriga music 2015 (Official Video) by Liham Melody 6 years ago 4 minutes, 7 seconds 18,731 views",Liham Melody,18731,18736,5
1411,"Assefa G/michael - Bealti Kebero በዓልቲ ከበሮ New Ethiopian Traditional Tigrigna Music (Official Video) by Liham Melody 6 years ago 5 minutes, 38 seconds 1,343,096 views",Liham Melody,1343096,1344901,1805
1412,"Semere Andom &  Kidist Birhane - Mehanenit / New Tigrigna Music(Official Video) by Liham Melody 6 years ago 5 minutes, 16 seconds 34,314 views",Liham Melody,34314,34333,19
1413,"Solomon Gebreziher - Astewelya Tazereba / New Ethiopian Tigrigna Music(Official Video) by Liham Melody 6 years ago 3 minutes, 23 seconds 8,233 views",Liham Melody,8233,8237,4
1414,"Gidey Tesfay- Mis Wedi Rubay / New Tigrigna Music(Official Video) by Liham Melody 6 years ago 6 minutes, 39 seconds 11,145 views",Liham Melody,11145,11146,1
1415,"Tesfealem Gebreslassie - Sgemey ስገመይ New Ethiopian Traditional Tigrigna Music (Official Video) by Liham Melody 6 years ago 6 minutes, 39 seconds 638,128 views",Liham Melody,638128,638483,355
1416,"Gidey Tesfay - Ayfalkin ኣይፋልክን New Ethiopian Tigrigna Music(Official Video) by Liham Melody 6 years ago 7 minutes 188,949 views",Liham Melody,188949,189622,673
1417,"Amanual Yemane - Nafkot ናፍቆት New Ethiopian Tigrigna Music (Official Video) by Liham Melody 6 years ago 4 minutes, 22 seconds 585,760 views",Liham Melody,585760,597755,11995
1418,"Tesfay Gidey - Tum were ጥዑም ወረ  New Ethiopian Wedding Tigrigna Music (Official Video) by Liham Melody 6 years ago 7 minutes, 1 second 958,935 views",Liham Melody,958935,961010,2075
1419,"Girmay Atsbeha /Temechikni/ Nebsi Neger New Tigrigna music(Official Video) by Liham Melody 6 years ago 6 minutes, 3 seconds 78,557 views",Liham Melody,78557,78716,159
1420,"Ze Aman Girmay - Rhus Gama / New Ethiopian Music (Official Video) by Liham Melody 6 years ago 5 minutes, 35 seconds 34,524 views",Liham Melody,34524,34532,8
1421,"Lominat Hayelom - Selam ሰላም New Ethiopian Tigrigna Music (Official Video) by Liham Melody 6 years ago 6 minutes, 14 seconds 116,781 views",Liham Melody,116781,116834,53
1422,"Fstum Hagos - Bagum / New Ethiopian Music (Official Video) by Liham Melody 6 years ago 5 minutes, 20 seconds 8,592 views",Liham Melody,8592,8597,5
1423,"Michaele Berhe - Menabrtey / New Tigrigna Music (Official Video) by Liham Melody 6 years ago 5 minutes, 49 seconds 39,487 views",Liham Melody,39487,39496,9
1424,"Desta G/gergis - Bahlawi Chira  New Traditional Tigrigna Music (Official Video) by Liham Melody 6 years ago 6 minutes, 23 seconds 433,006 views",Liham Melody,433006,434510,1504
1425,"Yeshi Birhane - Syemaye ስየማየ New Traditional Tigrigna Music (Official Video) by Liham Melody 6 years ago 5 minutes, 44 seconds 3,030,311 views",Liham Melody,3030311,3039630,9319
1426,"Zenawi H/maryam - (ደንሺልኝ) New EThiopianl Music (Official Video) by Liham Melody 6 years ago 5 minutes, 16 seconds 27,444 views",Liham Melody,27444,27472,28
1427,"Haftom Zeratsyon - Hoya Hoye / New Ethiopian Tigrigna Music (Official Video) by Liham Melody 6 years ago 6 minutes, 29 seconds 190,511 views",Liham Melody,190511,190529,18
1428,"Kisanet Wintom - Meskeley / New Traditional Tigrigna Music (Official Video) by Liham Melody 6 years ago 5 minutes, 6 seconds 373,934 views",Liham Melody,373934,375123,1189
1429,"Kibrom Gebrehiwet - Meaza Lbey / New Ethiopian Music (Official Video) by Liham Melody 6 years ago 5 minutes, 20 seconds 21,833 views",Liham Melody,21833,21866,33
1430,"Kflom G/mariam - Tigraweyti / New Ethiopian Tigrigna Music (Official Video) by Liham Melody 6 years ago 6 minutes, 14 seconds 378,326 views",Liham Melody,378326,378943,617
1431,"Solomon Yikunoamlak - Zeytmno  New Ethiopian Tigrigna Music(Official Video) by Liham Melody 6 years ago 6 minutes, 2 seconds 785,810 views",Liham Melody,785810,790745,4935
1432,"Kibrom Birhane - Maza zelewo geza New Tigrigna Wedding Music (Official Video) by Liham Melody 6 years ago 7 minutes, 54 seconds 4,657,173 views",Liham Melody,4657173,4671104,13931
1433,"Nigsti Demeke - WELEBAY / New Traditional Tigrigna Music 2015 (Official Video) by Liham Melody 6 years ago 5 minutes, 55 seconds 24,997 views",Liham Melody,24997,25011,14
1434,"Brtawit Tadese - ASHKORAY / New  Traditional Tigrigna Music (Official Video) by Liham Melody 6 years ago 5 minutes, 45 seconds 19,529 views",Liham Melody,19529,19539,10
1435,"Trhas Kobeley - Eman Bihaki New Ethiopian TraditionalTigrigna Music (Official Video) by Liham Melody 6 years ago 6 minutes, 20 seconds 1,146,280 views",Liham Melody,1146280,1148310,2030
1436,"Winta Brhane - Godaney / New Traditional Tigrigna Music (Official Video) by Liham Melody 6 years ago 5 minutes, 3 seconds 133,629 views",Liham Melody,133629,133890,261
1437,"Dawit Nega - Baba Elen (ባባ ኢለን) Ethiopian TraditionalTigrigna Music (Official Video) by Liham Melody 6 years ago 6 minutes, 28 seconds 8,538,407 views",Liham Melody,8538407,8546207,7800
1438,"New  Traditional Tigrigna Ashenda Music 2015 አሸንዳ Aster Tekeste Ayni Wari አይኒ ዋሪ by Liham Melody 6 years ago 6 minutes, 50 seconds 433,588 views",Liham Melody,433588,433798,210
1439,"Yared Halefom - Kedawitey / New Tigrigna Music 2015 by Liham Melody 6 years ago 6 minutes, 37 seconds 21,119 views",Liham Melody,21119,21134,15
1440,"Selam Fseha - Nifikri Amine / New Traditional Tigrigna Music by Liham Melody 6 years ago 6 minutes, 12 seconds 305,396 views",Liham Melody,305396,305617,221
1441,"New Traditional Tigrigna music Kinfe G /gergis AYNI BLEN ዓይኒ ብሌን by Liham Melody 6 years ago 6 minutes, 30 seconds 842,837 views",Liham Melody,842837,844289,1452
1442,"New Traditional Tigrigna Music 2015 Halefom Barentu # RAYA  RAYUMA# by Liham Melody 6 years ago 8 minutes, 11 seconds 2,399,266 views",Liham Melody,2399266,2406861,7595
1443,"New Tigrigna Music 2015 Semira Weldu #Weynay Wedi# by Liham Melody 6 years ago 6 minutes, 15 seconds 15,228 views",Liham Melody,15228,15232,4
1444,"New Traditional Tigrigna Music 2015 Tamrat G/slasie (50 Goma) ሽምጣ ሰለስተ እመት Shmta 3 Emet by Liham Melody 6 years ago 8 minutes, 6 seconds 888,113 views",Liham Melody,888113,890435,2322
1445,"Teklay G/michael - Deki adey / New Traditional Tigrigna Music by Liham Melody 6 years ago 6 minutes, 21 seconds 104,727 views",Liham Melody,104727,104823,96
1446,"Thank you to Girmay Gebru the Autor, poet and journalist by Liham Melody 6 years ago 12 minutes, 40 seconds 7,581 views",Liham Melody,7581,7590,9
1447,"Book launch Ceremony of 2036 at rahel art gallery by Liham Melody 6 years ago 14 minutes, 11 seconds 3,757 views",Liham Melody,3757,3762,5
1448,"New Ethiopian Tigrigna Music 2015 Gezae Fitwi #Tsor fekar lbey# by Liham Melody 6 years ago 4 minutes, 58 seconds 101,608 views",Liham Melody,101608,101951,343
1449,"Tamrat G/slasie (50 goma) Shelawun ሸላውን New Ethiopian  Music 2015 by Liham Melody 6 years ago 7 minutes, 49 seconds 618,244 views",Liham Melody,618244,618660,416
1450,"Aynalem Hadush -KUMEL ኩመል New Tigrigna Traditional Music 2015 by Liham Melody 6 years ago 5 minutes, 49 seconds 107,514 views",Liham Melody,107514,107675,161
1451,"Fre Zenebe -Syumey ስዩመይ New Ethiopian Tigrigna Music by Liham Melody 6 years ago 5 minutes, 37 seconds 79,710 views",Liham Melody,79710,79730,20
1452,"Solomon Yikunoamlak - Zeytmino ዘይትምኖ  New Tigrigna Music (Official Oudio) by Liham Melody 6 years ago 5 minutes, 53 seconds 50,650 views",Liham Melody,50650,50756,106
1453,"Art Awarded for Solomon Yikunoamlak at Rahel Art Gallery by Liham Melody 6 years ago 14 minutes, 50 seconds 25,223 views",Liham Melody,25223,25317,94
1454,"Muez G/medhin (Muji) Tesfa / New Tigrigna Music Video by Liham Melody 6 years ago 3 minutes, 53 seconds 7,407 views",Liham Melody,7407,7408,1
1455,"Tigray Art Award  2015  መድረኽ ሽልማት ኪነጥበባት ትግራይ /መሽኪት/2007 by Liham Melody 6 years ago 36 minutes 11,509 views",Liham Melody,11509,11513,4
1456,"Seyfu haylu - Edilegna / New Ethiopian Music 2015 by Liham Melody 6 years ago 5 minutes, 33 seconds 23,096 views",Liham Melody,23096,23102,6
1457,"Kisanet Wintom #Malefya# ማለፍያ New Ethiopian Music 2015 by Liham Melody 6 years ago 6 minutes, 6 seconds 1,421,740 views",Liham Melody,1421740,1424684,2944
1458,"Meseret Tigetu #Huqofeni# New Ethiopian Music 2015 by Liham Melody 6 years ago 5 minutes, 57 seconds 105,205 views",Liham Melody,105205,105268,63
1459,"Ze Aman Girmay #Assey# አሰይ New Ethiopian Wedding Music 2015 by Liham Melody 6 years ago 6 minutes, 35 seconds 4,375,573 views",Liham Melody,4375573,4384860,9287
1460,"Elsa gebru- Lilay ሊላይ  New Ethiopian Music 2015 by Liham Melody 6 years ago 6 minutes, 14 seconds 89,667 views",Liham Melody,89667,89674,7
1461,"Gzachew Solomon - Weni / New Traditional Tigrigna Music 2015 by Liham Melody 6 years ago 5 minutes, 23 seconds 42,545 views",Liham Melody,42545,42676,131
1462,"Aregawi Gebreziher - Bizey Seb / New Traditional Tigrigna Music 2015 by Liham Melody 6 years ago 6 minutes, 49 seconds 317,901 views",Liham Melody,317901,318000,99
1463,"New Tigrigna Music ''Alemey'' ዓለመይ Muez G/medhin /ሙጂ/ by Liham Melody 7 years ago 6 minutes, 31 seconds 73,670 views",Liham Melody,73670,73680,10
1464,"New Traditional Tigrigna Music ''Ayni faro'' ዓይኒ ፋሮ Meaza Yohannes by Liham Melody 7 years ago 6 minutes, 16 seconds 724,121 views",Liham Melody,724121,725801,1680
1465,"Yohans Haftu - Akbtsni / New Tigrigna Music Video by Liham Melody 7 years ago 6 minutes, 22 seconds 31,432 views",Liham Melody,31432,31482,50
1466,"Solomon yikunoamlak Lemineye ""ሎሚነይየ"" New Best Ethiopian Music Video 2015 by Liham Melody 7 years ago 6 minutes, 23 seconds 1,026,201 views",Liham Melody,1026201,1027489,1288
1467,"Lulom Abreha - Betey / New Tigrigna Music Video by Liham Melody 7 years ago 5 minutes, 30 seconds 452,587 views",Liham Melody,452587,453869,1282
1468,"Rezene teame - Bitaemi / New Ethiopian Tigrigna Music Video by Liham Melody 7 years ago 6 minutes, 15 seconds 170,327 views",Liham Melody,170327,171018,691
1469,"Shewit Mazgebo - Tsemaekani Best New Ethiopian Music 2015 by Liham Melody 7 years ago 5 minutes, 40 seconds 1,972,658 views",Liham Melody,1972658,1993203,20545
1470,"Znabu Kiros ""Zufane sara"" ዙፋነ ሳራ  New Tigrigna music by Liham Melody 7 years ago 5 minutes, 27 seconds 117,089 views",Liham Melody,117089,117171,82
1471,"Goyteom Tsigab /wedi  tsigab/ - Sga mama / New Ethiopian Music Video by Liham Melody 7 years ago 4 minutes, 23 seconds 31,768 views",Liham Melody,31768,31775,7
1472,"New Bahlawi Tigrigna Music 2014 Kinfe G/gergs by Liham Melody 7 years ago 6 minutes, 34 seconds 396,742 views",Liham Melody,396742,397143,401
1473,"Solomon Yikunoamlak - lomineye / New Best Ethiopian music Audio by Liham Melody 7 years ago 5 minutes, 44 seconds 182,297 views",Liham Melody,182297,182433,136
1474,"New Traditional Music ''50 goma'' tamrat G/slasie  Bahlawi kuda by Liham Melody 7 years ago 7 minutes, 13 seconds 1,896,632 views",Liham Melody,1896632,1905116,8484
1475,"Marta G/medhin - Kichiney / New Traditional Tigrigna Music Video by Liham Melody 7 years ago 5 minutes, 13 seconds 125,598 views",Liham Melody,125598,125612,14
1476,"New Tigrigna Music 2014  Dawit Nega /Deamena/ by Liham Melody 7 years ago 3 minutes, 36 seconds 67,715 views",Liham Melody,67715,67745,30
1477,"View Of Mekelle City by Liham Melody 7 years ago 1 minute, 53 seconds 3,273 views",Liham Melody,3273,3274,1
1478,"Solomon yikunoamlak - Ahadu / Ethiopian Traditional Tigrigna Music Video by Liham Melody 7 years ago 5 minutes, 22 seconds 127,065 views",Liham Melody,127065,127493,428
1479,"Shewit Bahta - Kidi Aytbeleni / New Tigrigna  Music 2014 by Liham Melody 7 years ago 5 minutes, 24 seconds 178,311 views",Liham Melody,178311,178316,5
1480,"Mehari Kiros - Fikri eyu sinkey / New Tigrigna Music Audio by Liham Melody 7 years ago 5 minutes, 12 seconds 11,457 views",Liham Melody,11457,11458,1
1481,"Ftsum Hagos - Kul Gizea / New Ethiopian Music Video by Liham Melody 7 years ago 4 minutes, 51 seconds 7,730 views",Liham Melody,7730,7734,4
1482,"Tigist Hailemichael - Amtseaya Fkri / New Tigrigna Music Video by Liham Melody 7 years ago 6 minutes, 15 seconds 51,683 views",Liham Melody,51683,51687,4
1483,"New Tigrigna Comedy  ''ጥንቁቅ'' by Liham Melody 7 years ago 2 minutes, 46 seconds 160,784 views",Liham Melody,160784,160852,68
1484,"Amanual Yemane - Dendanit / New Tigrigna  Music  Audio by Liham Melody 7 years ago 7 minutes, 14 seconds 129,587 views",Liham Melody,129587,129765,178
1485,"New Best Tigrigna Music  Dawit Nega ''Hdiyat Mekelle'' by Liham Melody 7 years ago 7 minutes, 13 seconds 271,890 views",Liham Melody,271890,272056,166
1486,"Gezae Ftwi - Lsan Albo / New Tigrigna Music Video by Liham Melody 8 years ago 6 minutes, 16 seconds 54,898 views",Liham Melody,54898,54926,28
1487,"New Traditional Tigrigna Music ''yehilaldo'' Kflom G.mariam (Kuda ንዒ ኩዳ) የሒላል ዶ by Liham Melody 8 years ago 6 minutes, 30 seconds 556,440 views",Liham Melody,556440,557423,983
1488,"Best Tigrigna Music Rahwa yemane Ft. tsegay & dawit by Liham Melody 8 years ago 6 minutes, 16 seconds 443,268 views",Liham Melody,443268,443366,98
1489,"Kidan Zerabruk - Neteba / New Traditional Tigrigna Music Video by Liham Melody 8 years ago 7 minutes, 7 seconds 135,317 views",Liham Melody,135317,135385,68
1490,"Hot New Ethiopian Music  Yasin Kedir Afar ""Yintibara"" by Liham Melody 8 years ago 4 minutes, 53 seconds 154,834 views",Liham Melody,154834,155458,624
1491,"Biniam Tinsue - Gorazu Adey / Ethiopian Traditional Tigrigna Music Video by Liham Melody 8 years ago 6 minutes, 10 seconds 151,319 views",Liham Melody,151319,151367,48
1492,"Yonas Haile - Nibiat Ywehasa /New Ethiopian Tigrigna music Video by Liham Melody 8 years ago 6 minutes, 52 seconds 4,404 views",Liham Melody,4404,4444,40
1493,"Haftom Zeratsyon - Hiliwliw (ሕልውልው) Ethiopian Tigrigna Music Video by Liham Melody 8 years ago 6 minutes 28,889 views",Liham Melody,28889,28929,40
1494,"Amanual Gebremeskel - Brey welelo / New Traditional tigrigna Music Video by Liham Melody 8 years ago 5 minutes, 57 seconds 37,232 views",Liham Melody,37232,37244,12
1495,"samson syum - Tezemite / New Tigrigna music Video by Liham Melody 8 years ago 5 minutes, 4 seconds 14,634 views",Liham Melody,14634,14645,11
1496,"Teame Zewde - Aykonetn / New Tigrigna Music Video by Liham Melody 8 years ago 5 minutes, 50 seconds 18,070 views",Liham Melody,18070,18075,5
1497,"Tsegalul Hailemariam - Alemamidki / New Ethiopian Tigrigna Music Video by Liham Melody 8 years ago 6 minutes, 46 seconds 39,087 views",Liham Melody,39087,39217,130
1498,"Felege Reda - Awdeamet / New Ethiopian Music Video 2013 by Liham Melody 8 years ago 6 minutes, 11 seconds 8,942 views",Liham Melody,8942,8949,7
1499,"Ashenda 2013 In Mekelle City by Liham Melody 8 years ago 1 minute, 59 seconds 29,284 views",Liham Melody,29284,29292,8
1500,"New Ethipian  Tigrigna Comedy by Liham Melody 8 years ago 7 minutes, 42 seconds 210,944 views",Liham Melody,210944,210964,20
1501,"Macammad Kasim - Amay / Ethiopian Afar Music Video 2013 by Liham Melody 8 years ago 4 minutes, 23 seconds 99,519 views",Liham Melody,99519,99699,180
1502,"Hailay Gebreanenia - Gdinyu / New Tigrigna Music Video by Liham Melody 8 years ago 5 minutes, 44 seconds 5,685 views",Liham Melody,5685,5685,0
1503,"ETHIOPIAN MUSIC NEW ASHENDA CELEBRATION by Liham Melody 8 years ago 5 minutes, 47 seconds 38,106 views",Liham Melody,38106,38116,10
1504,"Solomon YkunoaMlak - Teselef / Ethiopian Tigrigna Music Video by Liham Melody 8 years ago 6 minutes, 42 seconds 38,594 views",Liham Melody,38594,38728,134
1505,"Interview With Artist Solomon Ykunoamlak by Liham Melody 8 years ago 18 minutes 31,795 views",Liham Melody,31795,31891,96
1506,"Haftom G/michael - Wezamey / New Traditional Tigrigna Music by Liham Melody 8 years ago 6 minutes, 10 seconds 11,674 views",Liham Melody,11674,11683,9
1507,"Meseret G/medhin - Wedino / Ethiopian Tigrigna Music Video by Liham Melody 8 years ago 5 minutes, 13 seconds 435,420 views",Liham Melody,435420,435698,278
1508,"Tukue Weldu / New Tigrigna  Music  audio by Liham Melody 8 years ago 5 minutes, 21 seconds 10,311 views",Liham Melody,10311,10362,51
1509,"Ftsum hagos /weyley weyley/ Sala zom jeganu / NEW Tigrigna music Video by Liham Melody 8 years ago 4 minutes, 52 seconds 28,807 views",Liham Melody,28807,28812,5
1510,"Haileslassie Gusa /Wedi Gusa/ - megaleway / New Tigrigna Raya Traditional Music by Liham Melody 8 years ago 6 minutes, 35 seconds 163,914 views",Liham Melody,163914,164127,213
1511,"Yohannes Haftu - Gual Aboy Haile / New Traditional Tigrigna Music audio by Liham Melody 8 years ago 5 minutes, 32 seconds 76,471 views",Liham Melody,76471,77212,741
1512,"Ashenafi Girmay - Fenwiyo / New Tigrigna Miusic Video by Liham Melody 8 years ago 5 minutes, 7 seconds 7,712 views",Liham Melody,7712,7720,8
1513,"dawit nega /deamena/ New Ethiopian  music by Liham Melody 8 years ago 7 minutes, 22 seconds 254,184 views",Liham Melody,254184,254344,160
1514,"Mahari kiros - alem / New Ethiopian Tigrigna music Video by Liham Melody 8 years ago 4 minutes, 43 seconds 8,882 views",Liham Melody,8882,8887,5
1515,"Asfaw Birhane -Wolelo / New Traditional Tigrigna music Video by Liham Melody 8 years ago 6 minutes, 14 seconds 315,407 views",Liham Melody,315407,315503,96
1516,"Solomon Yikunoamlak -Teselef / New Tigrigna Music audio by Liham Melody 8 years ago 6 minutes, 45 seconds 55,611 views",Liham Melody,55611,55630,19
1517,"New Traditional Tigrigna Wedding Music by Liham Melody 9 years ago 5 minutes, 57 seconds 167,867 views",Liham Melody,167867,167889,22
1518,"ICE  MAN - Ashenda / Traditional Tigrigna Music Video by Liham Melody 9 years ago 4 minutes, 10 seconds 113,848 views",Liham Melody,113848,113854,6
1519,"Hareg Alemayohu - Kzazmo (ክዛዝሞ) New Tigrigna Music Video by Liham Melody 9 years ago 5 minutes, 39 seconds 27,666 views",Liham Melody,27666,27677,11
1520,"Tigrigna Snekal Artist Eyasu Berhe by Liham Melody 9 years ago 7 minutes, 12 seconds 82,655 views",Liham Melody,82655,82874,219
1521,"Ethiopian dalol Afar by Liham Melody 9 years ago 12 minutes, 29 seconds 4,555 views",Liham Melody,4555,4558,3
1522,"Hailay Gebru - Mifkar Kealyo / New Tigrigna Music Video by Liham Melody 9 years ago 6 minutes, 34 seconds 16,309 views",Liham Melody,16309,16313,4
1523,"Dejen Tsegay - Nafikeyom / New Tigrigna Temben Traditional Music by Liham Melody 9 years ago 5 minutes, 20 seconds 15,140 views",Liham Melody,15140,15166,26
1524,"Sintayehu Mola - Tslal Hager  ''ፅላል ሃገር''  /New Tigrigna Music  ''ፅላል ሃገር'' by Liham Melody 9 years ago 5 minutes, 22 seconds 13,909 views",Liham Melody,13909,13913,4
1525,"Anbesa Tekle - Mizer / New Traditional Tigrigna Music Video by Liham Melody 9 years ago 5 minutes, 47 seconds 95,982 views",Liham Melody,95982,97683,1701
1526,"Abeba Kiros - Tseba Tsegeb / New Ethiopian Tigrigna Music Video by Liham Melody 9 years ago 6 minutes, 27 seconds 86,953 views",Liham Melody,86953,86960,7
1527,"Meseret G.Medhin - Telal (ተልዓል) New Tigrigna music Video 2013 by Liham Melody 9 years ago 5 minutes, 35 seconds 69,093 views",Liham Melody,69093,69122,29
1528,"Interview with Artist Anbesa Tekle by Liham Melody 9 years ago 13 minutes, 58 seconds 45,931 views",Liham Melody,45931,46004,73
1529,"Helen Tsegay - Edilegna Eye -  Ethiopian Tigrigna musicVideo  Sidet by Liham Melody 9 years ago 6 minutes, 40 seconds 198,099 views",Liham Melody,198099,198390,291
1530,"Helen & lielti - Bahlina / New Traditional Tigrigna Ashenda Music Video by Liham Melody 9 years ago 6 minutes, 16 seconds 33,914 views",Liham Melody,33914,33920,6
1531,"Anbesa Tekle Tigrigna Music New school life by Liham Melody 9 years ago 6 minutes, 35 seconds 369,291 views",Liham Melody,369291,369716,425
1532,"New Tigrigna  Music by dawit Bawra by Liham Melody 9 years ago 4 minutes, 59 seconds 7,970 views",Liham Melody,7970,7975,5
1533,"Rahwa Yemane - Hariret / Best Traditional Tigrigna Music ራህዋ የማነ by Liham Melody 9 years ago 6 minutes, 28 seconds 206,307 views",Liham Melody,206307,206761,454
1534,"Kidane Alemayohu (wedi ale) - Kumel / New Tigrigna music Video by Liham Melody 9 years ago 6 minutes, 47 seconds 20,832 views",Liham Melody,20832,20846,14
1535,"Meses Baye - Keninye / NEW Ethiopian traditional Music Video by Liham Melody 9 years ago 3 minutes, 51 seconds 256,997 views",Liham Melody,256997,257110,113
1536,"New Cultural Tigrigna Music ባህላዊ ትግርኛ ደርፊ by Liham Melody 9 years ago 5 minutes, 33 seconds 468,875 views",Liham Melody,468875,470564,1689
1537,"Ethiopian Afar region by Liham Melody 9 years ago 8 minutes, 23 seconds 6,060 views",Liham Melody,6060,6061,1
1538,"Dejen , Eden , Milat &  Natnael - 12 Werat / New  Ethiopian  Music Video by Liham Melody 9 years ago 4 minutes, 30 seconds 39,525 views",Liham Melody,39525,39535,10
1539,"Dejen , filmon , natnael & melat - Well Come to my Country / Ethiopian Music Video by Liham Melody 9 years ago 5 minutes, 5 seconds 18,549 views",Liham Melody,18549,18551,2
1540,"Ethiopian Cultural Wedding In Tigray by Liham Melody 9 years ago 4 minutes, 16 seconds 352,376 views",Liham Melody,352376,352479,103
1541,"Mebratu H.gis - aynfalalen / New ethiopian Tigrigna Music Vdeo by Liham Melody 9 years ago 5 minutes, 52 seconds 8,968 views",Liham Melody,8968,8971,3
1542,"Marta Gebremedhn - Hadanay ማርታ ገ/መድህን ''ሃዳናይ'' /Traditional Tigrigna Music  Video by Liham Melody 9 years ago 5 minutes, 28 seconds 72,347 views",Liham Melody,72347,72365,18
1543,"solomon ykunoamlak ''Zeybelkni yelen'' Ethiopian music Video by Liham Melody 9 years ago 5 minutes, 39 seconds 90,533 views",Liham Melody,90533,91837,1304
1544,"New  afar music Yasin kedir by Liham Melody 9 years ago 5 minutes, 21 seconds 229,452 views",Liham Melody,229452,230422,970
1545,"tigrigna Temben Cultural Music by Liham Melody 9 years ago 4 minutes, 46 seconds 208,306 views",Liham Melody,208306,210103,1797
1546,"Felege Reda Dibeotey /New Tigrigna Traditional Tigrigna  Music Video by Liham Melody 9 years ago 6 minutes, 24 seconds 156,750 views",Liham Melody,156750,156896,146
1547,"Solomon Yikunoamlak - Kuraki Shwuhatyu / New Tigrigna Music Video by Liham Melody 9 years ago 5 minutes, 29 seconds 15,672 views",Liham Melody,15672,15816,144
1548,"Marta Gebremedhin - Adhneni / New Ethiopian Tigrigna Music by Liham Melody 9 years ago 5 minutes, 58 seconds 10,972 views",Liham Melody,10972,10990,18
1549,"Nahom Gebremeskel - yekenyelna / New Tigrigna Music Video by Liham Melody 9 years ago 3 minutes, 47 seconds 5,803 views",Liham Melody,5803,5815,12
1550,"Solomon Yikunoamlak - Meselal Hiwetey / New Ethiopian music Video by Liham Melody 9 years ago 6 minutes, 9 seconds 26,334 views",Liham Melody,26334,26706,372
1551,"Gebreslassie Amare - Africawit / New Ethiopian Music Video by Liham Melody 9 years ago 7 minutes, 1 second 5,454 views",Liham Melody,5454,5460,6
1552,"OMAR SHOOLI | HEESTII AROOS | OFFICIAL MUSIC VIDEO 2022 by Liibaan Jama 2 weeks ago 6 minutes, 22 seconds 8,811 views",Liibaan Jama,8811,11055,2244
1553,"HASHIM CADE | ARBACA SINIIN SUNDAN SONG | OFFICIAL MUSIC VIDEO 2022 by Liibaan Jama 2 weeks ago 6 minutes, 35 seconds 8,992 views",Liibaan Jama,8992,10150,1158
1554,"RAHMA HOLLYWOOD | GOBOLADA SOMALILAND | OFFICIAL MUSIC VIDEO 2022 by Liibaan Jama 3 weeks ago 4 minutes, 25 seconds 9,321 views",Liibaan Jama,9321,10125,804
1555,"SAACID KHALIIF | GALMUDUG | OFFICIAL MUSIC SONG 2022 by Liibaan Jama 1 month ago 3 minutes, 46 seconds 7,812 views",Liibaan Jama,7812,8287,475
1556,"FARXIYA FISKA IYO YURUB GEENYO | HEESTII BALEDWEYN | OFFICIAL MUSIC SONG 2022 by Liibaan Jama 1 month ago 6 minutes, 38 seconds 34,015 views",Liibaan Jama,34015,36345,2330
1557,"MOHAMED ROMEO | JACAYLKAN YAABKA | OFFICIAL MUSIC VIDEO 2022 by Liibaan Jama 1 month ago 5 minutes, 13 seconds 902,459 views",Liibaan Jama,902459,1031249,128790
1558,"RABAJ YARE | UBADKEN WADAKORSAN | OFFICIAL MUSIC VIDEO 2022 by Liibaan Jama 1 month ago 3 minutes, 26 seconds 8,715 views",Liibaan Jama,8715,9006,291
1559,"OMAR SHOOLI | SOMALI MASHUP SONGS | OFFICIAL MUSIC VIDEO 2022 by Liibaan Jama 1 month ago 5 minutes, 27 seconds 36,817 views",Liibaan Jama,36817,39205,2388
1560,"HASHIM CADE | MAYEELAAYE | OFFICIAL MUSIC VIDEO 2022 by Liibaan Jama 2 months ago 4 minutes, 35 seconds 44,577 views",Liibaan Jama,44577,49870,5293
1561,"ISKILAAJI | LABADARAN MID UUN DOORO | OFFICIAL MUSIC VIDEO 2022 by Liibaan Jama 2 months ago 5 minutes, 22 seconds 2,677,890 views",Liibaan Jama,2677890,2976894,299004
1562,"SAALAX SANAAG | AROOSKII MOHAMED IYO IMAN | OFFICIAL SONG 2022 by Liibaan Jama 2 months ago 5 minutes, 27 seconds 8,397 views",Liibaan Jama,8397,8834,437
1563,"QUEEN SHUKRINA | SADDEX IGU XIR | OFFICIAL MUSIC VIDEO 2022 by Liibaan Jama 2 months ago 4 minutes, 56 seconds 8,188 views",Liibaan Jama,8188,8419,231
1564,"ISKILAAJI | KAL DAWEEYA | OFFICIAL MUSIC VIDEO 2022 by Liibaan Jama 2 months ago 4 minutes, 23 seconds 400,187 views",Liibaan Jama,400187,424766,24579
1565,"DEEQA AHMED GAYDH | TIXGALIN | OFFICIAL MUSIC VIDEO 2021 by Liibaan Jama 3 months ago 4 minutes, 59 seconds 125,917 views",Liibaan Jama,125917,132474,6557
1566,"NIMCAAN HILAAC | CEELBUUR | OFFICIAL MUSIC VIDEO 2021 by Liibaan Jama 3 months ago 6 minutes, 25 seconds 466,366 views",Liibaan Jama,466366,474823,8457
1567,"QUEEN SHUKRINA | AMAAN BADAN | OFFICIAL MUSIC VIDEO 2021 by Liibaan Jama 3 months ago 6 minutes, 1 second 13,760 views",Liibaan Jama,13760,14050,290
1568,"MUNA MARIIS | LILAG KU ROONOW | OFFICIAL MUSIC VIDEO 2021 by Liibaan Jama 3 months ago 4 minutes, 28 seconds 10,603 views",Liibaan Jama,10603,10800,197
1569,"SHOBARE | XASUUS | OFFICIAL MUSIC VIDEO 2021 by Liibaan Jama 3 months ago 4 minutes, 28 seconds 8,150 views",Liibaan Jama,8150,8272,122
1570,"DJ FAWZI | BATI GANG | OFFICIAL MUSIC VIDEO 2021 by Liibaan Jama 3 months ago 2 minutes, 22 seconds 511,069 views",Liibaan Jama,511069,515474,4405
1571,"ABDIFATAH ALBAKRI | REER MUDUG MIYAA | OFFICIAL MUSIC VIDEO 2021 by Liibaan Jama 4 months ago 3 minutes, 51 seconds 12,953 views",Liibaan Jama,12953,13140,187
1572,"HAMDI XILKAS | JECEYL WAYA ARAGO | OFFICIAL MUSIC VIDEO 2021 by Liibaan Jama 4 months ago 6 minutes, 23 seconds 9,881 views",Liibaan Jama,9881,10003,122
1573,"LIIBAAN DOOR | KU DALXIIS BARI IYO PUTLAND | OFFICIAL MUSIC VIDEO 2021 by Liibaan Jama 4 months ago 5 minutes, 9 seconds 11,137 views",Liibaan Jama,11137,11477,340
1574,"HODAN ABDIRAHMAN | HEESTII HIRSHABELLE | OFFICIAL MUSIC VIDEO 2021 by Liibaan Jama 4 months ago 6 minutes, 6 seconds 19,987 views",Liibaan Jama,19987,20298,311
1575,"FARHIYA KABAYARE | HEESTII HIRSHABELLE | OFFICIAL MUSIC VIDEO 2021 by Liibaan Jama 4 months ago 6 minutes, 4 seconds 37,662 views",Liibaan Jama,37662,38792,1130
1576,"ABSHIR BIRMAD | NASIIBKA ANIGU MAMAYDHIN | OFFICIAL MUSIC VIDEO 2021 by Liibaan Jama 4 months ago 6 minutes, 21 seconds 9,340 views",Liibaan Jama,9340,9437,97
1577,"OMAR SHOOLI | TASHO | OFFICIAL MUSIC VIDEO 2021 by Liibaan Jama 4 months ago 5 minutes, 51 seconds 21,901 views",Liibaan Jama,21901,22360,459
1578,"ISKILAAJI | XISKA FURO QALBIGA XIDHO | OFFICIAL MUSIC VIDEO 2021 by Liibaan Jama 4 months ago 5 minutes, 32 seconds 396,953 views",Liibaan Jama,396953,404008,7055
1579,"SICIID GANEY | NARUURADI JACAYLKIYO | OFFICIAL MUSIC VIDEO 2021 by Liibaan Jama 4 months ago 5 minutes, 38 seconds 5,892 views",Liibaan Jama,5892,5960,68
1580,"SHUKRI SINDIKO | GAROOB | OFFICIAL MUSIC VIDEO 2021 by Liibaan Jama 5 months ago 5 minutes, 36 seconds 124,689 views",Liibaan Jama,124689,125818,1129
1581,"YURUB GEENYO, IFRAH HARGAISA, ASMA LOVE  | HEESTA AMAL DAHIR DAUD | OFFICIAL MUSIC VIDEO 2021 by Liibaan Jama 5 months ago 6 minutes, 2 seconds 253,297 views",Liibaan Jama,253297,255709,2412
1582,"DALMAR YARE | BAL SOO ORAD | OFFICIAL MUSIC VIDEO 2021 by Liibaan Jama 5 months ago 6 minutes, 54 seconds 464,850 views",Liibaan Jama,464850,472550,7700
1583,"MUSTAFE MAANO | ADAA DARAJADA HAGA | OFFICIAL MUSIC VIDEO 2021 by Liibaan Jama 5 months ago 3 minutes, 9 seconds 19,400 views",Liibaan Jama,19400,19579,179
1584,"YONIS IBRA | LAAB LAAB | OFFICIAL MUSIC VIDEO 2021 by Liibaan Jama 5 months ago 3 minutes, 6 seconds 10,326 views",Liibaan Jama,10326,10376,50
1585,"OMAR SHOOLI | JACEELKA | OFFICIAL MUSIC VIDEO 2021 by Liibaan Jama 5 months ago 7 minutes, 51 seconds 60,107 views",Liibaan Jama,60107,60358,251
1586,"JIMCAALE ZADRI | ALLOW NAGA HAY HUQDIISA | OFFICIAL MUSIC VIDEO 2021 by Liibaan Jama 5 months ago 5 minutes, 31 seconds 8,239 views",Liibaan Jama,8239,8286,47
1587,"NURADIN HASSAN AHMED NURKEY | AXDIGEENA DHOWRSAN | OFFICIAL MUSIC VIDEO 2021 by Liibaan Jama 6 months ago 6 minutes, 19 seconds 10,945 views",Liibaan Jama,10945,10999,54
1588,"ISKILAAJI | KOR UHAY JACAYLKAGA | OFFICIAL MUSIC VIDEO 2021 by Liibaan Jama 6 months ago 5 minutes, 15 seconds 988,575 views",Liibaan Jama,988575,1010861,22286
1589,"ANWAR KANU | WANAAGAAGA NUSQAAMIN | OFFICIAL MUSIC VIDEO 2021 by Liibaan Jama 6 months ago 5 minutes, 51 seconds 11,795 views",Liibaan Jama,11795,11838,43
1590,"FARTUUN BIRIMO | SAD IYO CALAF | OFFICIAL MUSIC VIDEO 2021 by Liibaan Jama 6 months ago 7 minutes, 9 seconds 234,352 views",Liibaan Jama,234352,235866,1514
1591,"ABDIRAHIM ALI BADHAN | DHAMAYS | OFFICIAL MUSIC VIDEO 2021 by Liibaan Jama 6 months ago 3 minutes, 45 seconds 13,500 views",Liibaan Jama,13500,13564,64
1592,"MOHAMED KAY | MARWADA NOLOSHEYDA | OFFICIAL MUSIC VIDEO 2021 by Liibaan Jama 6 months ago 4 minutes, 3 seconds 15,458 views",Liibaan Jama,15458,15505,47
1593,"FARTUUN QARAN | BOGAADIN | OFFICIAL MUSIC VIDEO 2021 by Liibaan Jama 7 months ago 4 minutes, 13 seconds 9,815 views",Liibaan Jama,9815,9889,74
1594,"ISKILAAJI | NABSIGAYGU KUMA DILO | OFFICIAL MUSIC VIDEO 2021 by Liibaan Jama 7 months ago 4 minutes, 28 seconds 944,599 views",Liibaan Jama,944599,955163,10564
1595,"AYAANLE PATO | MIYAAN KU CIDLAYN KARAA | OFFICIAL MUSIC VIDEO 2021 by Liibaan Jama 7 months ago 5 minutes, 12 seconds 28,218 views",Liibaan Jama,28218,28422,204
1596,"DALMAR YARE IYO NIMCAAN HILAAC | ADOO QALANJA AH MAXAA KU QAYIRAY | OFFICIAL MUSIC VIDEO 2021 by Liibaan Jama 7 months ago 3 minutes, 49 seconds 5,365,156 views",Liibaan Jama,5365156,5439228,74072
1597,"HASHIM CADE | DAL SHISHEEYE | OFFICIAL MUSIC VIDEO 2021 by Liibaan Jama 8 months ago 6 minutes, 24 seconds 94,582 views",Liibaan Jama,94582,98353,3771
1598,"DEEQA AHMED GAYDH | FARIIMAHA JACAYLKA  | OFFICIAL MUSIC VIDEO 2021 by Liibaan Jama 8 months ago 5 minutes, 3 seconds 1,256,278 views",Liibaan Jama,1256278,1274466,18188
1599,"ABDIRISAK BK IYO ROODO BEERLULA | MALAB JACEEL | OFFICIAL MUSIC VIDEO 2021 by Liibaan Jama 8 months ago 8 minutes, 2 seconds 27,490 views",Liibaan Jama,27490,27567,77
1600,"HASHIM CADE | DARYEEL MAHAASTEE | OFFICIAL MUSIC VIDEO 2021 by Liibaan Jama 8 months ago 6 minutes, 10 seconds 1,073,227 views",Liibaan Jama,1073227,1117039,43812
1601,"ISKILAAJI | WARKAAGOO SUGAN ISII | OFFICIAL MUSIC VIDEO 2021 by Liibaan Jama 8 months ago 5 minutes, 45 seconds 1,258,399 views",Liibaan Jama,1258399,1275576,17177
1602,"LIIBAAN DOOR IYO SAFIYO M DAAHIR | WAAD IGU HABOONTAHAY | OFFICIAL MUSIC VIDEO 2021 by Liibaan Jama 8 months ago 6 minutes, 11 seconds 109,166 views",Liibaan Jama,109166,111656,2490
1603,"XAYAT MEYDAL | HEESTII BAAQ | OFFICIAL MUSIC VIDEO 2021 by Liibaan Jama 8 months ago 5 minutes, 24 seconds 15,219 views",Liibaan Jama,15219,15269,50
1604,"FARTUUN BIRIMO | DHAG DHAG | OFFICIAL MUSIC VIDEO 2021 by Liibaan Jama 8 months ago 4 minutes, 59 seconds 332,566 views",Liibaan Jama,332566,334766,2200
1605,"SHUKRI SINDIKO | SIRMAQABE | OFFICIAL MUSIC VIDEO 2021 by Liibaan Jama 9 months ago 5 minutes, 36 seconds 28,376 views",Liibaan Jama,28376,28450,74
1606,"BOQORADII CODKA RAHMA HOLLYWOOD | HAYE HAYE | OFFICIAL MUSIC VIDEO 2021 by Liibaan Jama 9 months ago 4 minutes, 2 seconds 18,082 views",Liibaan Jama,18082,18139,57
1607,"ISKILAAJI | DADKAYGIIYOOW WAX MAQAL | OFFICIAL MUSIC VIDEO 2021 by Liibaan Jama 9 months ago 8 minutes, 17 seconds 125,337 views",Liibaan Jama,125337,125978,641
1608,"DEEQA AHMED GAYDH | MAAHMAAHDU WAA MURTIYEE | OFFICIAL MUSIC VIDEO 2021 by Liibaan Jama 9 months ago 5 minutes, 54 seconds 180,352 views",Liibaan Jama,180352,181692,1340
1609,"ISKILAAJI | DUN XARIIR AH | OFFICIAL MUSIC VIDEO 2021 by Liibaan Jama 9 months ago 4 minutes, 48 seconds 740,023 views",Liibaan Jama,740023,749732,9709
1610,"KING JACELOW | DHAAYAHA UROONEY | OFFICIAL MUSIC VIDEO 2021 by Liibaan Jama 9 months ago 5 minutes, 55 seconds 22,013 views",Liibaan Jama,22013,22058,45
1611,"ISKILAAJI | MAHAGRADE ISMACIIL | OFFICIAL MUSIC VIDEO 2021 by Liibaan Jama 10 months ago 5 minutes, 3 seconds 83,981 views",Liibaan Jama,83981,84186,205
1612,"LIIBAAN DOOR | AXSAN YAA MAKHLUUQ | OFFICIAL MUSIC VIDEO 2021 by Liibaan Jama 11 months ago 4 minutes, 52 seconds 11,393 views",Liibaan Jama,11393,11440,47
1613,"RAHMA HOLLYWOOD | HEESTII HARGEYSA | OFFICIAL MUSIC VIDEO 2021 by Liibaan Jama 11 months ago 7 minutes 17,438 views",Liibaan Jama,17438,17488,50
1614,"ISKILAAJI | MIYAANAN LAHAYN DAMIIR KU DAYN KARA OO KU NACA | OFFICIAL MUSIC VIDEO 2021 by Liibaan Jama 11 months ago 5 minutes, 18 seconds 2,915,888 views",Liibaan Jama,2915888,2950995,35107
1615,"CABDI ZAKI IYO KHADRA SALIMA | HEESTII WADA JIR | OFFICIAL MUSIC VIDEO 2021 by Liibaan Jama 11 months ago 5 minutes, 37 seconds 213,083 views",Liibaan Jama,213083,213712,629
1616,"AYAANLE PATO | ARXAN DARANIDAA | OFFICIAL MUSIC VIDEO 2021 by Liibaan Jama 11 months ago 5 minutes, 24 seconds 26,472 views",Liibaan Jama,26472,26551,79
1617,"SHUKRI SINDIKO | QIIRO | OFFICIAL MUSIC AUDIO 2021 by Liibaan Jama 1 year ago 4 minutes, 33 seconds 7,038 views",Liibaan Jama,7038,7056,18
1618,"HODAN ABDIRAHMAN | HEESTII JABRIL JIMCAALE | OFFICIAL MUSIC VIDEO 2021 by Liibaan Jama 1 year ago 4 minutes, 35 seconds 40,867 views",Liibaan Jama,40867,40947,80
1619,"ABSHIR BIRMAD | SHABKAX | OFFICIAL MUSIC VIDEO 2021 by Liibaan Jama 1 year ago 3 minutes, 56 seconds 170,857 views",Liibaan Jama,170857,172651,1794
1620,"ABDIFATAH HALDOR | HEESTII RUUN | OFFICIAL MUSIC VIDEO 2021 by Liibaan Jama 1 year ago 3 minutes, 57 seconds 10,141 views",Liibaan Jama,10141,10158,17
1621,"MOXAMED CURAD | NACIIMA | OFFICIAL MUSIC VIDEO 2021 by Liibaan Jama 1 year ago 4 minutes, 33 seconds 10,140 views",Liibaan Jama,10140,10154,14
1622,"YURUB DHEEMAN | KAWAAL JACEELKA | OFFICIAL MUSIC VIDEO 2021 by Liibaan Jama 1 year ago 4 minutes, 19 seconds 25,504 views",Liibaan Jama,25504,25624,120
1623,"FARHIYA KABAYARE IYO AYAANLE PATO | QABSO GACANTA OO QOYS ILA WADAAG | OFFICIAL MUSIC VIDEO 2021 by Liibaan Jama 1 year ago 5 minutes, 38 seconds 1,747,959 views",Liibaan Jama,1747959,1761004,13045
1624,"SALMA | WADADA KU QUL QUL | OFFICIAL MUSIC VIDEO 2021 by Liibaan Jama 1 year ago 2 minutes, 41 seconds 564,177 views",Liibaan Jama,564177,567392,3215
1625,"DEEQA AHMED GAYDH | HEESTII GUUL | OFFICIAL MUSIC VIDEO 2021 by Liibaan Jama 1 year ago 7 minutes, 55 seconds 11,565 views",Liibaan Jama,11565,11594,29
1626,"HAYAT MOUSTAPHA | HEESTII DHANBAAL | OFFICIAL MUSIC VIDEO 2021 by Liibaan Jama 1 year ago 5 minutes, 1 second 553,482 views",Liibaan Jama,553482,558425,4943
1627,"ISKILAAJI | XUSUUS JACAYL | OFFICIAL MUSIC VIDEO 2021 by Liibaan Jama 1 year ago 4 minutes, 37 seconds 620,137 views",Liibaan Jama,620137,621352,1215
1628,"DEEQA AHMED GAYDH | NAF AAD QADATEY | OFFICIAL MUSIC VIDEO 2021 by Liibaan Jama 1 year ago 4 minutes, 41 seconds 540,396 views",Liibaan Jama,540396,544531,4135
1629,"NAJMA NADAR | BASH BAAD TAHAY | OFFICIAL MUSIC VIDEO 2020 by Liibaan Jama 1 year ago 3 minutes, 59 seconds 18,752 views",Liibaan Jama,18752,18803,51
1630,"HASHIM CADE | HADII HAAR KU HAAYO | OFFICIAL MUSIC VIDEO 2020 by Liibaan Jama 1 year ago 7 minutes, 36 seconds 183,792 views",Liibaan Jama,183792,186732,2940
1631,"ISKILAAJI | HEESTII CALANYAHOW  | OFFICIAL VIDEO COMING SOON 2020 by Liibaan Jama 1 year ago 2 minutes, 38 seconds 18,546 views",Liibaan Jama,18546,18565,19
1632,"ISKILAAJI | HEESTII NAALO FASHION | OFFICIAL MUSIC VIDEO 2020 by Liibaan Jama 1 year ago 5 minutes, 31 seconds 205,357 views",Liibaan Jama,205357,206067,710
1633,"XANAAN WASHINGTON | KAALAY IGA TALAAL | OFFICIAL MUSIC VIDEO 2020 by Liibaan Jama 1 year ago 5 minutes, 14 seconds 20,230 views",Liibaan Jama,20230,20285,55
1634,"SHUKRI SINDIKO | GARDARO IYO GAF | OFFICIAL MUSIC VIDEO 2020 by Liibaan Jama 1 year ago 4 minutes, 57 seconds 167,208 views",Liibaan Jama,167208,167601,393
1635,"DEEQA AHMED GAYDH | AADMIGA KU JECEL | OFFICIAL MUSIC VIDEO 2020 by Liibaan Jama 1 year ago 6 minutes, 24 seconds 311,743 views",Liibaan Jama,311743,313585,1842
1636,"SALMA IYO IQRA YAREY | MAXAA DAHAB KAAGA DHIGAY | OFFICIAL MUSIC VIDEO 2020 by Liibaan Jama 1 year ago 3 minutes, 47 seconds 5,335,974 views",Liibaan Jama,5335974,5388974,53000
1637,"ZAAM LUCKY | QIYAAS | OFFICIAL MUSIC VIDEO 2020 by Liibaan Jama 1 year ago 5 minutes, 49 seconds 81,873 views",Liibaan Jama,81873,82079,206
1638,"HINDA HAPPY | TUSAALE | OFFICIAL MUSIC VIDEO 2020 by Liibaan Jama 1 year ago 3 minutes, 24 seconds 23,976 views",Liibaan Jama,23976,23994,18
1639,"ISKILAAJI | DADKII I DHALIILI JIREY | OFFICIAL MUSIC VIDEO 2020 by Liibaan Jama 1 year ago 6 minutes, 4 seconds 3,224,443 views",Liibaan Jama,3224443,3268677,44234
1640,"SAHAL NAQDI | QADRA | OFFICIAL MUSIC VIDEO 2020 by Liibaan Jama 1 year ago 4 minutes, 53 seconds 15,982 views",Liibaan Jama,15982,16021,39
1641,"HABAD OLAD | MARWA IDIL | OFFICIAL MUSIC VIDEO 2020 by Liibaan Jama 1 year ago 6 minutes, 16 seconds 99,076 views",Liibaan Jama,99076,99203,127
1642,"ISKILAAJI | HEESTII MUSHARAX XILDHIBAAN AMINA MAXAMED MURSAL | OFFICIAL SONG 2020 by Liibaan Jama 1 year ago 4 minutes, 35 seconds 13,138 views",Liibaan Jama,13138,13194,56
1643,"QAMAR SUUGANI | DAREEN CAASHAQ | OFFICIAL SONG 2020 by Liibaan Jama 1 year ago 4 minutes, 45 seconds 92,824 views",Liibaan Jama,92824,94075,1251
1644,"ISKILAAJI | SAREEYA | OFFICIAL MUSIC VIDEO 2020 by Liibaan Jama 1 year ago 4 minutes, 7 seconds 1,022,572 views",Liibaan Jama,1022572,1028397,5825
1645,"MUNO MARIIS | QULQUL QARAFTA IDHEJI | OFFICIAL MUSIC VIDEO 2020 by Liibaan Jama 1 year ago 4 minutes, 16 seconds 23,735 views",Liibaan Jama,23735,23795,60
1646,"ISKILAAJI | DHOOL BARI | OFFICIAL MUSIC VIDEO 2020 by Liibaan Jama 1 year ago 4 minutes, 26 seconds 405,455 views",Liibaan Jama,405455,406327,872
1647,"DEEQA AHMED GAYDH | BARASHO | OFFICIAL MUSIC VIDEO 2020 by Liibaan Jama 1 year ago 5 minutes, 37 seconds 719,510 views",Liibaan Jama,719510,724946,5436
1648,"OOMAAR FT. QUEEN  ZAYA | ROMANTIC | OFFICIAL MUSIC VIDEO 2020 by Liibaan Jama 1 year ago 4 minutes, 40 seconds 988,139 views",Liibaan Jama,988139,991815,3676
1649,"FARTUUN BIRIMO | DAN SHISHEEYE DIID | OFFICIAL MUSIC VIDEO 2020 by Liibaan Jama 1 year ago 5 minutes, 28 seconds 18,081 views",Liibaan Jama,18081,18132,51
1650,"ABDULLAHI BOQOL | WAA ADIGA | OFFICIAL MUSIC VIDEO 2020 by Liibaan Jama 1 year ago 6 minutes 16,918 views",Liibaan Jama,16918,16949,31
1651,"KING JACEELOW IYO DEEQA AHMED | JACEYLKAN  LADHUUBTEY | OFFICIAL MUSIC VIDEO 2020 by Liibaan Jama 1 year ago 7 minutes, 3 seconds 101,292 views",Liibaan Jama,101292,101469,177
1652,"ZEINAB LABADHAGAX | DAN GUUD | OFFICIAL SONG 2020 by Liibaan Jama 1 year ago 4 minutes, 58 seconds 9,364 views",Liibaan Jama,9364,9385,21
1653,"LIIBAAN DOOR | QURUXDIYO ILWAADKA | OFFICIAL MUSIC VIDEO 2020 by Liibaan Jama 1 year ago 4 minutes, 5 seconds 28,214 views",Liibaan Jama,28214,28334,120
1654,"SHOBARE IYO HODAN SHABIIN | DHIRTA KU JALEECDA | OFFICIAL MUSIC VIDEO 2020 by Liibaan Jama 1 year ago 6 minutes, 14 seconds 16,512 views",Liibaan Jama,16512,16523,11
1655,"AMIIN SHIDDO | SHIFFO | OFFICIAL MUSIC VIDEO 2020 by Liibaan Jama 1 year ago 5 minutes, 5 seconds 50,470 views",Liibaan Jama,50470,50535,65
1656,"MUKTAR ADEERO | SIDII GEELII HAWD JIREY | OFFICIAL MUSIC VIDEO 2020 by Liibaan Jama 1 year ago 4 minutes, 57 seconds 25,544 views",Liibaan Jama,25544,25630,86
1657,"IBRAHIM CAJAB CAJIIB | HUUNEY KAJOOG | OFFICIAL MUSIC SONG 2020 by Liibaan Jama 1 year ago 6 minutes, 32 seconds 7,641 views",Liibaan Jama,7641,7646,5
1658,"AHMED GAASHAANLE | DURUUF | OFFICIAL MUSIC VIDEO 2020 by Liibaan Jama 1 year ago 5 minutes, 18 seconds 12,532 views",Liibaan Jama,12532,12612,80
1659,"HASHIM CADE | BUURAAN KORAA | OFFICIAL MUSIC VIDEO 2020 by Liibaan Jama 1 year ago 5 minutes, 21 seconds 1,633,590 views",Liibaan Jama,1633590,1664569,30979
1660,"SHUKRI SINDIKO | SOO WADA BAX | OFFICIAL MUSIC VIDEO 2020 by Liibaan Jama 1 year ago 4 minutes, 44 seconds 29,040 views",Liibaan Jama,29040,29162,122
1661,"ISKILAAJI | CIDLA KALI HASACAB TUMAN | OFFICIAL MUSIC VIDEO 2020 by Liibaan Jama 1 year ago 4 minutes, 19 seconds 1,962,197 views",Liibaan Jama,1962197,1980064,17867
1662,"ABDIRISAK BK | HEESTII DIGNIIN | OFFICIAL MUSIC VIDEO 2020 by Liibaan Jama 1 year ago 8 minutes, 44 seconds 11,369 views",Liibaan Jama,11369,11407,38
1663,"HASHIM CADE | FT SAHRO CUMAR DHUULE HEESTII DHUUBO | OFFICIAL MUSIC VIDEO 2020 by Liibaan Jama 1 year ago 6 minutes, 1 second 537,580 views",Liibaan Jama,537580,541401,3821
1664,"SULDAN SEERAAR | NIMCO DEEQA | OFFICIAL SONG 2020 by Liibaan Jama 1 year ago 4 minutes, 32 seconds 48,699 views",Liibaan Jama,48699,48743,44
1665,"AHMED GAASHAANLE - LANBA MOORADIIS OFFICIAL MUSIC VIDEO 2020 by Liibaan Jama 1 year ago 6 minutes, 5 seconds 10,281 views",Liibaan Jama,10281,10310,29
1666,"KING JACELOW - HANA OFFICIAL MUSIC VIDEO 2020 by Liibaan Jama 1 year ago 6 minutes, 22 seconds 21,049 views",Liibaan Jama,21049,21104,55
1667,"HASHIM CADE | SUDANI SONG SABARTA | OFFICIAL MUSIC VIDEO 2020 by Liibaan Jama 1 year ago 8 minutes, 19 seconds 168,961 views",Liibaan Jama,168961,171958,2997
1668,"WARDA KARAMA - AXDI OFFICIAL MUSIC VIDEO 2020 by Liibaan Jama 1 year ago 4 minutes, 38 seconds 1,029,081 views",Liibaan Jama,1029081,1053116,24035
1669,"SIYAAD WANTED - HA NOQON QOF IS DHIIBA OFFICIAL MUSIC VIDEO 2020 by Liibaan Jama 1 year ago 4 minutes, 53 seconds 65,615 views",Liibaan Jama,65615,65764,149
1670,"ISKILAAJI - TOOSAN OFFICIAL MUSIC VIDEO 2020 by Liibaan Jama 1 year ago 5 minutes, 13 seconds 399,073 views",Liibaan Jama,399073,400787,1714
1671,"HINDA HAPPY IYO RIDWAN GALAYDH - HUBQAAD IYO QURUX OFFICIAL MUSIC VIDEO 2020 by Liibaan Jama 1 year ago 3 minutes, 15 seconds 38,435 views",Liibaan Jama,38435,38491,56
1672,"SAHAL NAQDI - INDHA NUURIYA OFFICIAL MUSIC VIDEO 2020 by Liibaan Jama 1 year ago 5 minutes, 27 seconds 9,835 views",Liibaan Jama,9835,9881,46
1673,"CABDI ZAKI - INTAAN DOQON SOO KAXEYSTOO OFFICIAL MUSIC VIDEO 2020 by Liibaan Jama 1 year ago 6 minutes, 36 seconds 706,825 views",Liibaan Jama,706825,713948,7123
1674,"ISKILAAJI - WALAAL ILA OROD OFFICIAL MUSIC VIDEO 2020 by Liibaan Jama 1 year ago 5 minutes, 20 seconds 218,021 views",Liibaan Jama,218021,219642,1621
1675,"NAJIIB DR FARAH IYO HODAN SHABIIN - HEESTII BULSOOY TAAGEER OFFICIAL MUSIC VIDEO 2020 by Liibaan Jama 1 year ago 5 minutes, 43 seconds 3,785 views",Liibaan Jama,3785,3788,3
1676,"NAJIIB DR FARAH IYO HODAN SHABIIN - HEESTII BULSHO OFFICIAL MUSIC VIDEO 2020 by Liibaan Jama 1 year ago 5 minutes, 48 seconds 2,649 views",Liibaan Jama,2649,2655,6
1677,"AMINA BROWN - DAWEEY NAFTANOO DARYEEL USAMEEY OFFICIAL MUSIC VIDEO 2020 by Liibaan Jama 1 year ago 5 minutes, 39 seconds 32,893 views",Liibaan Jama,32893,33001,108
1678,"HASHIM CADE - MIYAAD WELI ISLA QUMANTAHAY TRUE STORY OFFICIAL MUSIC VIDEO 2020 by Liibaan Jama 1 year ago 5 minutes, 37 seconds 65,489 views",Liibaan Jama,65489,66238,749
1679,"MAXAMED DABIIB - HAYGU DHIGIN OFFICIAL MUSIC VIDEO 2020 by Liibaan Jama 1 year ago 3 minutes, 45 seconds 558,864 views",Liibaan Jama,558864,560442,1578
1680,"KING JACELOW - GABDHAHA GALMUDUG OFFICIAL MUSIC VIDEO 2020 by Liibaan Jama 1 year ago 5 minutes, 14 seconds 76,106 views",Liibaan Jama,76106,76626,520
1681,"MOHAMED KAY – DHOOLEEY OFFICIAL MUSIC VIDEO 2020 by Liibaan Jama 1 year ago 4 minutes, 29 seconds 14,270 views",Liibaan Jama,14270,14281,11
1682,"ISKILAAJI IYO DEEQA AHMED - ASLUUBSAN OFFICIAL MUSIC VIDEO 2020 by Liibaan Jama 1 year ago 6 minutes, 52 seconds 1,184,082 views",Liibaan Jama,1184082,1187859,3777
1683,"ARAGSAN C/NASIR MACALI - SI WEYN BAA LAY HAYAA OFFICIAL MUSIC VIDEO 2020 by Liibaan Jama 1 year ago 6 minutes, 22 seconds 107,590 views",Liibaan Jama,107590,107763,173
1684,"ABDIFITAAX NAALO - KOOXDII BADA CAS KAALAY JALAQSANEEY OFFICIAL MUSIC VIDEO 2020 by Liibaan Jama 1 year ago 5 minutes, 51 seconds 12,692 views",Liibaan Jama,12692,12698,6
1685,"HAMDA XILKAS KOOXDII BADA CAS - HAMI OFFICIAL MUSIC VIDEO 2020 by Liibaan Jama 1 year ago 3 minutes, 51 seconds 11,517 views",Liibaan Jama,11517,11525,8
1686,"SALEEBAAN CAAQIL - NAJAX OFFICIAL MUSIC VIDEO 2020 by Liibaan Jama 1 year ago 6 minutes, 37 seconds 33,446 views",Liibaan Jama,33446,33499,53
1687,"ISKILAAJI – HEESTII HAYBADO OFFICIAL MUSIC VIDEO 2020 by Liibaan Jama 1 year ago 6 minutes, 7 seconds 1,425,374 views",Liibaan Jama,1425374,1433593,8219
1688,"FILSAN DHEEMAN - XURMO OFFICIAL MUSIC VIDEO 2020 by Liibaan Jama 1 year ago 5 minutes, 51 seconds 32,449 views",Liibaan Jama,32449,32496,47
1689,"ISKILAAJI - KUN JEER QOSOL MAALINTAADA OFFICIAL MUSIC VIDEO 2020 by Liibaan Jama 1 year ago 4 minutes, 20 seconds 10,332,363 views",Liibaan Jama,10332363,10438029,105666
1690,"QUEEN ZAYA - WIILYAHOW RUMEYSO OFFICIAL MUSIC VIDEO 2020 by Liibaan Jama 1 year ago 5 minutes, 22 seconds 52,820 views",Liibaan Jama,52820,52878,58
1691,"DALMAR YARE - FARXAD MIIDHAN OFFICIAL MUSIC VIDEO 2020 by Liibaan Jama 1 year ago 5 minutes, 41 seconds 620,178 views",Liibaan Jama,620178,622360,2182
1692,"KING JACELOW - ILA MALABSO CAASHAQA OFFICIAL MUSIC VIDEO 2020 by Liibaan Jama 1 year ago 4 minutes, 51 seconds 47,956 views",Liibaan Jama,47956,48020,64
1693,"ISKILAAJI - DADKAYGII DJIBOUTI OFFICIAL MUSIC VIDEO 2020 by Liibaan Jama 1 year ago 6 minutes, 18 seconds 168,379 views",Liibaan Jama,168379,168878,499
1694,"HABAD OLAD - DON'T WORRY OFFICIAL MUSIC VIDEO 2020 by Liibaan Jama 1 year ago 4 minutes, 6 seconds 412,233 views",Liibaan Jama,412233,413257,1024
1695,"DALMAR YARE - NABAD IYO NOLOL SILAC WAAYO ARAG KANOQO!! OFFICIAL MUSIC VIDEO 2020 by Liibaan Jama 1 year ago 4 minutes, 40 seconds 774,262 views",Liibaan Jama,774262,775568,1306
1696,"OOMAAR - DHALAN DHOOL OFFICIAL MUSIC VIDEO 2020 by Liibaan Jama 1 year ago 5 minutes, 14 seconds 304,768 views",Liibaan Jama,304768,305727,959
1697,"KOOXDII BADA CAS LIIBAAN DOOR - HAYGA JARIN SALAAMAHA (OFFICIAL MUSIC VIDEO) by Liibaan Jama 1 year ago 5 minutes 14,844 views",Liibaan Jama,14844,14870,26
1698,"KOOXDII BADA CAS SAAMIR YARE - HEESTII SHAX SHAX OFFICIAL MUSIC VIDEO 2020 by Liibaan Jama 1 year ago 5 minutes, 32 seconds 16,975 views",Liibaan Jama,16975,16988,13
1699,"ABDULLAHI BOQOL - XABADA UGU SHIDAN XAMAR OFFICIAL MUSIC VIDEO 2020 by Liibaan Jama 1 year ago 5 minutes, 4 seconds 147,773 views",Liibaan Jama,147773,148362,589
1700,"FARTUUN BIRIMO IYO KING JACELOW - FARSAMO OFFICIAL MUSIC VIDEO 2020 by Liibaan Jama 1 year ago 5 minutes, 49 seconds 227,728 views",Liibaan Jama,227728,228354,626
1701,"KOOXDII BADA CAS FARTUUN LAKI - HEESTII BAYDHABO OFFICIAL MUSIC VIDEO 2020 by Liibaan Jama 1 year ago 4 minutes, 56 seconds 10,618 views",Liibaan Jama,10618,10638,20
1702,"ANWAR KAANU - WAAN KUU IMAAN LAHAA OFFICIAL MUSIC VIDEO 2020 by Liibaan Jama 1 year ago 6 minutes, 38 seconds 7,175 views",Liibaan Jama,7175,7182,7
1703,"ZAAM LUCKY - SIBALAY HAYE OFFICIAL MUSIC VIDEO 2020 by Liibaan Jama 1 year ago 5 minutes, 45 seconds 24,771 views",Liibaan Jama,24771,24909,138
1704,"ABWAAN SADAAM AQLIMAAL - MANSADII DHEELI OFFICIAL MUSIC VIDEO 2020 by Liibaan Jama 1 year ago 3 minutes, 18 seconds 7,250 views",Liibaan Jama,7250,7251,1
1705,"SHACABKA FARIID - JIKRAAR OFFICIAL MUSIC VIDEO 2020 by Liibaan Jama 1 year ago 4 minutes, 58 seconds 10,244 views",Liibaan Jama,10244,10260,16
1706,"KOOXDII BADA CAS MUBAARAK OCTOBER - LA JOOG OFFICIAL MUSIC VIDEO 2020 by Liibaan Jama 1 year ago 7 minutes, 29 seconds 57,407 views",Liibaan Jama,57407,57528,121
1707,"KOOXDII BADA CAS DAAUD XANFAR - CALOLYOW OFFICIAL MUSIC VIDEO 2020 by Liibaan Jama 1 year ago 7 minutes, 55 seconds 694,895 views",Liibaan Jama,694895,699543,4648
1708,"ISKILAAJI - HA IIJABIN RUUX INECEB OFFICIAL MUSIC VIDEO 2020 by Liibaan Jama 1 year ago 5 minutes, 13 seconds 9,039,540 views",Liibaan Jama,9039540,9144009,104469
1709,"QASIIDO MIRA JANAAAD ABDI HEELO 2020 OFFICIAL MUSIC VIDEO (STUDIO LIIBAAN) by Liibaan Jama 1 year ago 6 minutes, 58 seconds 3,123 views",Liibaan Jama,3123,3127,4
1710,"KOOXDA HOBOLADA WAABARI QASIIDO KABAN BISHA SOON OFFICIAL MUSIC VIDEO (STUDIO LIIBAAN) by Liibaan Jama 1 year ago 6 minutes, 27 seconds 3,463 views",Liibaan Jama,3463,3468,5
1711,"KOOXDA WAABARI QASIIDO RAMADAAN KHEYRKIISA 2020 OFFICIAL MUSIC VIDEO (STUDIO LIIBAAN) by Liibaan Jama 1 year ago 7 minutes, 15 seconds 5,970 views",Liibaan Jama,5970,5978,8
1712,"A/BASID AWLIYO AND DALMAR YARE 2020 DHEEHASHO OFFICIAL VIDEO (DIRECTED BY STUDIO LIIBAAN) by Liibaan Jama 1 year ago 5 minutes, 40 seconds 106,221 views",Liibaan Jama,106221,107317,1096
1713,"KOOXDA WAABARI QASIIDO 2020 MA UDUCAYNAA OFFICIAL MUSIC VIDEO (STUDIO LIIBAAN) by Liibaan Jama 1 year ago 7 minutes, 24 seconds 4,288 views",Liibaan Jama,4288,4288,0
1714,"SAMIIR ZAAM - KAW MAHA OFFICIAL MUSIC VIDEO 2020 by Liibaan Jama 1 year ago 5 minutes, 14 seconds 49,887 views",Liibaan Jama,49887,50323,436
1715,"CORONAVIRUS SONG BY ABDIWAHAB ANTAR NAJI (OFFICIAL BY STUDIO LIIBAAN) by Liibaan Jama 1 year ago 2 minutes, 51 seconds 15,629 views",Liibaan Jama,15629,15633,4
1716,"SAHAL NAQDI IYO HANI UK 2020 HEESTII QOYS OFFICIAL SONG (BY STUDIO LIIBAAN) by Liibaan Jama 1 year ago 4 minutes, 21 seconds 21,922 views",Liibaan Jama,21922,21939,17
1717,"FARHIYA KABAYARE - NAJIS OFFICIAL MUSIC VIDEO 2020 by Liibaan Jama 1 year ago 6 minutes, 50 seconds 2,929,216 views",Liibaan Jama,2929216,2964187,34971
1718,"ISMAIL AFRO 2020 WAQTIGA DUNIDA OFFICIAL MUSIC VIDEO (STUDIO LIIBAAN) by Liibaan Jama 1 year ago 6 minutes, 28 seconds 12,614 views",Liibaan Jama,12614,12619,5
1719,"CABDI ZAKI IYO WARDA HAPPY - NACABKU HAA ISDALDALO OFFICIAL MUSIC VIDEO 2020 by Liibaan Jama 1 year ago 8 minutes, 40 seconds 935,550 views",Liibaan Jama,935550,938059,2509
1720,"LAYLA KOOTALI IYO GEEDI MOHAMED - KAFTANKUNA INOO FURAN OFFICIAL MUSIC VIDEO 2020 by Liibaan Jama 1 year ago 9 minutes 655,964 views",Liibaan Jama,655964,657862,1898
1721,"FARHIYA KABAYARE - ADIGOO XORA HADAL OFFICIAL MUSIC VIDEO 2020 by Liibaan Jama 1 year ago 4 minutes, 39 seconds 2,037,139 views",Liibaan Jama,2037139,2050062,12923
1722,"FARHIYA KABAYARE XAFLAD CASHO SHARAF HANI UK MINNEAPOLIS 2020 MAQAL DURBAANKA (OFFICIAL MUSIC VIDEO) by Liibaan Jama 1 year ago 4 minutes 334,562 views",Liibaan Jama,334562,335169,607
1723,"FARHIYA KABAYARE 2020 HEESTII NAJIS OFFICIAL SONG (DIRECTED BY STUDIO LIIBAAN) by Liibaan Jama 1 year ago 6 minutes, 31 seconds 214,566 views",Liibaan Jama,214566,214610,44
1724,"A/WAHAB ANTAR NAJI IYO WARDA KARAMA 2020 WAQTI DHAAXAA OFFICIAL MUSIC (DIRECTED BY STUDIO LIIBAAN) by Liibaan Jama 1 year ago 9 minutes, 8 seconds 33,582 views",Liibaan Jama,33582,33793,211
1725,"RAHMA K 2020 HADMA OFFICIAL SONG (DIRECTED BY STUDIO LIIBAAN) by Liibaan Jama 2 years ago 4 minutes, 49 seconds 6,465 views",Liibaan Jama,6465,6471,6
1726,"KHADRA SILIMO IYO YURUB GEENYO 2020 JABOUTAAY GOOB DALXIIS OFFICIAL MUSIC (BY STUDIO LIIBAAN) by Liibaan Jama 2 years ago 6 minutes, 51 seconds 45,611 views",Liibaan Jama,45611,45619,8
1727,"FUAD CADE 2020 JACAYL LA HUBO OFFICIAL MUSIC VIDEO 4K VIDEO (DIRECTED BY STUDIO LIIBAAN) by Liibaan Jama 2 years ago 5 minutes, 3 seconds 41,020 views",Liibaan Jama,41020,41078,58
1728,"RAHMA ROSE IYO HODAN NUR 2020 HEESTII IKRAN HERBAL OFFICIAL 4K VIDEO (DIRECTED BY STUDIO LIIBAAN) by Liibaan Jama 2 years ago 5 minutes, 52 seconds 22,200 views",Liibaan Jama,22200,22210,10
1729,"AHMED ZAKI IYO JIHAAN JALAQSAN 2020 DHAAYAHA KUGU EEGAY OFFICIAL SONG (DIRECTED BY STUDIO LIIBAAN) by Liibaan Jama 2 years ago 6 minutes, 23 seconds 17,666 views",Liibaan Jama,17666,17673,7
1730,"FARHIYA KABAYARE 2020 ADIGOO XORA HADAL  OFFICIAL SONG (DIRECTED BY STUDIO LIIBAAN) by Liibaan Jama 2 years ago 4 minutes, 46 seconds 310,731 views",Liibaan Jama,310731,310790,59
1731,"SALMA - WALAL TASHO BA KU LEEYAHAY (OFFICIAL MUSIC VIDEO) by Liibaan Jama 2 years ago 5 minutes, 39 seconds 267,821 views",Liibaan Jama,267821,268195,374
1732,"ZAKI YARE IYO NAJIIB ALFA 2020 NIMCO (OFFICIAL 4K MUSIC VIDEO) by Liibaan Jama 2 years ago 5 minutes, 44 seconds 95,146 views",Liibaan Jama,95146,95325,179
1733,"NAJIIB ALFA 2020 HAYAN (OFFICIAL MUSIC VIDEO) by Liibaan Jama 2 years ago 6 minutes, 38 seconds 465,032 views",Liibaan Jama,465032,465989,957
1734,"ZAKI YARE FEAT. HASH KETCHUM 2020 MALYUUN (LIVE PERFORMANCE ) by Liibaan Jama 2 years ago 3 minutes, 25 seconds 814,673 views",Liibaan Jama,814673,819102,4429
1735,"HINDA HAPPY 2020 BILAA CALEEG OFFICIAL VIDEO (DIRECTED BY STUDIO LIIBAAN) by Liibaan Jama 2 years ago 3 minutes, 31 seconds 197,073 views",Liibaan Jama,197073,197205,132
1736,"CUMAR CR 2020 HEESTII XAMAR OFFICIAL VIDEO (DIRECTED BY STUDIO LIIBAAN) by Liibaan Jama 2 years ago 5 minutes, 43 seconds 30,000 views",Liibaan Jama,30000,30059,59
1737,"FARTUUN BIRIMO 2020 WHATSAPP KAN KAA ARKAA OFFICIAL 4K VIDEO (DIRECTED BY STUDIO LIIBAAN) by Liibaan Jama 2 years ago 5 minutes, 35 seconds 436,362 views",Liibaan Jama,436362,436746,384
1738,"ABDISHAKUR ROFFA 2020 MILICSI (OFFICIAL MUSIC VIDEO) by Liibaan Jama 2 years ago 4 minutes, 32 seconds 18,441 views",Liibaan Jama,18441,18444,3
1739,"DEEQA AFRO & CIMRAAN QARAAMI 2020 ILA MEERAYSO OFFICIAL VIDEO (DIRECTED BY STUDIO LIIBAAN) by Liibaan Jama 2 years ago 3 minutes, 45 seconds 2,141,700 views",Liibaan Jama,2141700,2145815,4115
1740,"DALMAR YARE 2020 BANAADIR OFFICIAL 4K VIDEO (DIRECTED BY STUDIO LIIBAAN) by Liibaan Jama 2 years ago 4 minutes, 6 seconds 444,875 views",Liibaan Jama,444875,445879,1004
1741,"AWALE ADAN 2020 BAYDHABO LE EREE OFFICIAL SONG (DIRECTED BY STUDIO LIIBAAN) by Liibaan Jama 2 years ago 4 minutes, 34 seconds 71,324 views",Liibaan Jama,71324,71561,237
1742,"XAFSA XUBI IYO CAWIL CASHARA 2020 DALIILKA OFFICIAL 4K VIDEO (DIRECTED BY STUDIO LIIBAAN) by Liibaan Jama 2 years ago 4 minutes, 53 seconds 574,725 views",Liibaan Jama,574725,577018,2293
1743,"MUKTAR ADEERO AND KHADRA SILIMO FEAT BACKO  2020 ARAARAMI OROMO SONG (DIRECTED BY STUDIO LIIBAAN by Liibaan Jama 2 years ago 6 minutes, 15 seconds 47,548 views",Liibaan Jama,47548,47621,73
1744,"OOMAAR BARBAR 2020 SAGAL OFFICIAL 4K VIDEO (DIRECTED BY STUDIO LIIBAAN) by Liibaan Jama 2 years ago 3 minutes, 49 seconds 1,478,817 views",Liibaan Jama,1478817,1482926,4109
1745,"MUBAARAK OCTOBER 2020 MAKALA KICIYAA OFFICIAL 4K VIDEO (DIRECTED BY STUDIO LIIBAAN) by Liibaan Jama 2 years ago 6 minutes, 31 seconds 34,946 views",Liibaan Jama,34946,34960,14
1746,"LIIBAAN DENMARK 2020 GOB GOB DHASHAY OFFICIAL 4K VIDEO (DIRECTED BY STUDIO LIIBAAN) by Liibaan Jama 2 years ago 4 minutes, 35 seconds 30,798 views",Liibaan Jama,30798,30879,81
1747,"SHACABKA FARIID 2020 MA QABYAALADBAA GUURKU? JACAYL OFFICIAL 4K VIDEO (DIRECTED BY STUDIO LIIBAAN) by Liibaan Jama 2 years ago 5 minutes, 41 seconds 29,341 views",Liibaan Jama,29341,29353,12
1748,"SHUKRI SINDIKO 2019 AMUURI OFFICIAL 4K VIDEO (DIRECTED BY STUDIO LIIBAAN) by Liibaan Jama 2 years ago 6 minutes, 20 seconds 42,370 views",Liibaan Jama,42370,42467,97
1749,"SAMATAR YARE 2019 HEESTII GURXAN OFFICIAL 4K VIDEO (DIRECTED BY STUDIO LIIBAAN) by Liibaan Jama 2 years ago 3 minutes, 9 seconds 45,586 views",Liibaan Jama,45586,45660,74
1750,"MINDIYAHA DHIGA 2019 OFFICIAL VIDEO (DIRECTED BY STUDIO LIIBAAN) by Liibaan Jama 2 years ago 13 minutes, 51 seconds 341,625 views",Liibaan Jama,341625,341794,169
1751,"ABDINUUR JAZZ IYO DEEQA AHMED 2019 DARYEEL OFFICIAL 4K VIDEO (DIRECTED BY STUDIO LIIBAAN) by Liibaan Jama 2 years ago 5 minutes, 28 seconds 6,021,974 views",Liibaan Jama,6021974,6068500,46526
1752,"ZAKI YARE IYO FILSAN DHEEMAN 2019 ISKU DHIIG OFFICIAL 4K VIDEO (DIRECTED BY STUDIO LIIBAAN) by Liibaan Jama 2 years ago 3 minutes, 56 seconds 381,880 views",Liibaan Jama,381880,382162,282
1753,"HODAN ABDIRAHMAN IYO FUAD CADE 2019 XAASIDKU HA CAROODO OFFICIAL 4K VIDEO DIRECTED BY STUDIO LIIBAAN by Liibaan Jama 2 years ago 5 minutes, 21 seconds 788,875 views",Liibaan Jama,788875,789645,770
1754,"SAHAL NAQDI 2019 SALAL IYO SAYLAC OFFICIAL 4K VIDEO (DIRECTED BY STUDIO LIIBAAN) by Liibaan Jama 2 years ago 6 minutes, 30 seconds 27,350 views",Liibaan Jama,27350,27459,109
1755,"ASAD OHIO 2019 HEESTA SAMIIRA OFFICIAL SONG (DIRECTED BY STUDIO LIIBAAN) by Liibaan Jama 2 years ago 7 minutes, 22 seconds 5,793 views",Liibaan Jama,5793,5795,2
1756,"HODAN ABDIRAHMAN IYO AHMED DHEERE 2019 HUSSEIN UGU SHUBA OFFICIAL VIDEO DIRECTED BY STUDIO LIIBAAN) by Liibaan Jama 2 years ago 6 minutes, 42 seconds 13,007 views",Liibaan Jama,13007,13012,5
1757,"HODAN ABDIRAHMAN IYO AHMED DHEERE 2019 HUSSEIN COD SIIYA OFFICIAL VIDEO (DIRECTED BY STUDIO LIIBAAN) by Liibaan Jama 2 years ago 5 minutes, 5 seconds 8,250 views",Liibaan Jama,8250,8262,12
1758,"CALANKAA PUNTLAND 2019 OFFICIAL 4K VIDEO (DIRECTED BY STUDIO LIIBAAN) by Liibaan Jama 2 years ago 7 minutes, 29 seconds 14,667 views",Liibaan Jama,14667,14686,19
1759,"XAFLADII PUNTLAND EE MINNEAPOLIS 2019 OFFICIAL 4K VIDEO (DIRECTED BY STUDIO LIIBAAN) by Liibaan Jama 2 years ago 5 minutes, 23 seconds 6,533 views",Liibaan Jama,6533,6545,12
1760,"ABTI LIBAN IYO FUAD CADE BIYO ISKAGA DAR OFFICIAL VIDEO 4K (DIRECTED BY STUDIO LIIBAAN) by Liibaan Jama 2 years ago 9 minutes, 50 seconds 43,590 views",Liibaan Jama,43590,43600,10
1761,"PUNTLAND MARYAA TAGA 2019 OFFICIAL VIDEO 4K (DIRECTED BY STUDIO LIIBAAN) by Liibaan Jama 2 years ago 9 minutes, 15 seconds 7,356 views",Liibaan Jama,7356,7357,1
1762,"DEEQA AFRO 2019 IGA BADAN OFFICIAL VIDEO (DIRECTED BY STUDIO LIIBAAN) by Liibaan Jama 2 years ago 4 minutes, 11 seconds 807,389 views",Liibaan Jama,807389,810070,2681
1763,"NASTEEXO INDHO IYO HODAN SHIBIN 2019 WAR KACA OFFICIAL VIDEO 4K (DIRECTED BY STUDIO LIIBAAN) by Liibaan Jama 2 years ago 6 minutes, 44 seconds 18,280 views",Liibaan Jama,18280,18292,12
1764,"HODAN ABDIRAHMAN XAFLADII PUNTLAND EE MN 2019 OFFICIAL VIDEO 4K (DIRECTED BY STUDIO LIIBAAN) by Liibaan Jama 2 years ago 4 minutes, 54 seconds 50,633 views",Liibaan Jama,50633,51311,678
1765,"MOHAMED ALTA 2019 DOOKH OFFICIAL 4K VIDEO (DIRECTED BY STUDIO LIIBAAN) by Liibaan Jama 2 years ago 5 minutes, 20 seconds 678,553 views",Liibaan Jama,678553,679361,808
1766,"FUAD CADE 2019 MUQDISHAAY OOHINTAADU OFFICIAL VIDEO 4K (DIRECTED BY STUDIO LIIBAAN) by Liibaan Jama 2 years ago 6 minutes, 1 second 90,682 views",Liibaan Jama,90682,90708,26
1767,"ABDI HAHA 2019 WAAN KU SUGAYAA OFFICIAL VIDEO 4K (DIRECTED BY STUDIO LIIBAAN) by Liibaan Jama 2 years ago 4 minutes, 11 seconds 131,895 views",Liibaan Jama,131895,132250,355
1768,"A/CASIIS XILWA 2019 DAREEN OFFICIAL VIDEO 4K (DIRECTED BY STUDIO LIIBAAN) by Liibaan Jama 2 years ago 3 minutes, 36 seconds 533,632 views",Liibaan Jama,533632,535858,2226
1769,"ABDI HAHA 2019 KALTUUN OFFICIAL 4K VIDEO (DIRECTED BY STUDIO LIIBAAN) by Liibaan Jama 2 years ago 6 minutes, 5 seconds 37,675 views",Liibaan Jama,37675,37719,44
1770,"AHMED TAAJIR 2019 MUXUBO OFFICIAL 4K VIDEO (DIRECTED BY STUDIO LIIBAAN) by Liibaan Jama 2 years ago 6 minutes, 11 seconds 44,411 views",Liibaan Jama,44411,44428,17
1771,"HODAN ABDIRAHMAN 2019 HEESTII DJIBOUTI OFFICIAL 4K VIDEO (DIRECTED BY STUDIO LIIBAAN) by Liibaan Jama 2 years ago 5 minutes, 22 seconds 79,545 views",Liibaan Jama,79545,79590,45
1772,"RIWAAYADII CUSUB ABTI LIBAN IYO FILSAN SHORT FILMS DHICI BEENOWBEY OFFICIAL VIDEO BY STUDIO LIIBAAN by Liibaan Jama 2 years ago 17 minutes 237,550 views",Liibaan Jama,237550,237561,11
1773,"ZAKI YARE 2019 DHEEMAN DAY OFFICIAL 4K VIDEO (DIRECTED BY STUDIO LIIBAAN) by Liibaan Jama 2 years ago 4 minutes, 43 seconds 2,109,848 views",Liibaan Jama,2109848,2115595,5747
1774,"CAAMIR ZAKI IYO NIMCO DAREEN 2019 XANAANEE CASHAQA OFFICIAL VIDEO 4K (DIRECTED BY STUDIO LIIBAAN) by Liibaan Jama 2 years ago 6 minutes, 36 seconds 2,687,108 views",Liibaan Jama,2687108,2699891,12783
1775,"SULDAAN SEERAAR 2019 iiSOO NOQO OFFICIAL SONG (DIRECTED BY STUDIO LIIBAAN) by Liibaan Jama 2 years ago 5 minutes, 44 seconds 1,664,988 views",Liibaan Jama,1664988,1671735,6747
1776,"WARDA KARAMA 2019 QIYAAS OFFICIAL VIDEO 4K (DIRECTED BY STUDIO LIIBAAN) by Liibaan Jama 2 years ago 3 minutes, 21 seconds 1,225,449 views",Liibaan Jama,1225449,1230196,4747
1777,"DALMAR YARE 2019 KAALAY OFFICIAL VIDEO 4K (DIRECTED BY STUDIO LIIBAAN) by Liibaan Jama 2 years ago 7 minutes, 32 seconds 223,405 views",Liibaan Jama,223405,223624,219
1778,"HODAN ABDIRAHMAN - NIYADA AN KA WADA JOOGNO OFFICIAL MUSIC VIDEO by Liibaan Jama 2 years ago 6 minutes, 8 seconds 11,070,982 views",Liibaan Jama,11070982,11120523,49541
1779,"NASHIIDO ALLOW QIILSAN NOO BIXI  2019 OFFICIAL SONG (DIRECTED BY STUDIO LIIBAAN) by Liibaan Jama 2 years ago 3 minutes, 42 seconds 18,233 views",Liibaan Jama,18233,18237,4
1780,"A/BASID AWLIYO IYO DALMAR YARE 2019 HALDOOR OFFICIAL VIDEO 4K (DIRECTED BY STUDIO LIIBAAN) by Liibaan Jama 2 years ago 8 minutes, 56 seconds 354,856 views",Liibaan Jama,354856,356090,1234
1781,"QAASIN MACRUUF 2019 HEESTII HODAN OFFICIAL SONG (DIRECTED BY STUDIO LIIBAAN) by Liibaan Jama 2 years ago 5 minutes, 35 seconds 7,668 views",Liibaan Jama,7668,7672,4
1782,"ABDULLAHI BOQOL 2019 HANI OFFICIAL SONG (DIRECTED BY STUDIO LIIBAAN) by Liibaan Jama 2 years ago 4 minutes, 54 seconds 131,867 views",Liibaan Jama,131867,132160,293
1783,"SHACABKA FARIID - ASIYA OFFICIAL MUSIC VIDEO 2019 by Liibaan Jama 2 years ago 3 minutes, 48 seconds 20,175 views",Liibaan Jama,20175,20206,31
1784,"CAAQIL YARE 2019 TARIIK OFFICIAL 4K VIDEO (DIRECTED BY STUDIO LIIBAAN) by Liibaan Jama 2 years ago 4 minutes, 51 seconds 51,841 views",Liibaan Jama,51841,51846,5
1785,"SACIID TAARIIKH 2019 HEESTII SAGAL OFFICIAL VIDEO (DIRECTED BY STUDIO LIIBAAN) by Liibaan Jama 2 years ago 6 minutes, 51 seconds 53,511 views",Liibaan Jama,53511,53541,30
1786,"ISKILAAJI 2019 HEESTII AROOSKII KHADRA OFFICIAL SONG (DIRECTED BY STUDIO LIIBAAN) by Liibaan Jama 2 years ago 4 minutes, 26 seconds 39,148 views",Liibaan Jama,39148,39262,114
1787,"AMINA BROWN 2019 MALAB OFFICIAL VIDEO 4K (DIRECTED BY STUDIO LIIBAAN) by Liibaan Jama 2 years ago 4 minutes, 50 seconds 56,907 views",Liibaan Jama,56907,56942,35
1788,"YURUB BELLA IYO FAHAD JALLE 2019 DHUUXAAD KU MILAN YAHAY OFFICIAL VIDEO (DIRECTED BY STUDIO LIIBAAN) by Liibaan Jama 2 years ago 4 minutes, 46 seconds 12,726 views",Liibaan Jama,12726,12732,6
1789,"SAMATAR YARE 2019 HEESTII XALI OFFICIAL SONG (DIRECTED BY STUDIO LIIBAAN) by Liibaan Jama 2 years ago 5 minutes, 8 seconds 8,571 views",Liibaan Jama,8571,8575,4
1790,"ABDIRISAAQ SALEEBAAN GAAS 2019 DAREEN IYO JACAYL OFFICIAL SONG (DIRECTED BY STUDIO LIIBAAN) by Liibaan Jama 2 years ago 5 minutes, 52 seconds 8,915 views",Liibaan Jama,8915,8919,4
1791,"SAMATAR YARE 2019 WALWAL OFFICIAL SONG (DIRECTED BY STUDIO LIIBAAN) by Liibaan Jama 2 years ago 6 minutes, 17 seconds 12,685 views",Liibaan Jama,12685,12687,2
1792,"CAAQIL YARE 2019 DJIBOUTI OFFICIAL VIDEO 4K (DIRECTED BY STUDIO LIIBAAN) by Liibaan Jama 2 years ago 4 minutes, 53 seconds 24,105 views",Liibaan Jama,24105,24113,8
1793,"WARDA KARAMA 2019 MA DHARAKTOOY OFFICIAL SONG (DIRECTED BY STUDIO LIIBAAN) by Liibaan Jama 2 years ago 4 minutes, 30 seconds 32,490 views",Liibaan Jama,32490,32634,144
1794,"SHUKRI SINDIKO 2019 NAFYAHAY I FURO OFFICIAL VIDEO 4K (DIRECTED BY STUDIO LIIBAAN) by Liibaan Jama 3 years ago 5 minutes, 51 seconds 121,951 views",Liibaan Jama,121951,122098,147
1795,"XARIIR AHMED CABDULLAHI 2019 DAACAD IYO DUMAR KALA DHEER OFFICIAL SONG (DIRECTED BY STUDIO LIIBAAN) by Liibaan Jama 3 years ago 4 minutes, 11 seconds 22,393 views",Liibaan Jama,22393,22423,30
1796,"ABDIRISAQ ISMACIL ANSHAX 2019 HEESTII DHAWRSAN OFFICIAL SONG (DIRECTED BY STUDIO LIIBAAN) by Liibaan Jama 3 years ago 4 minutes, 40 seconds 9,900 views",Liibaan Jama,9900,9902,2
1797,"ABDULLAHI BOQOL 2019 AMAAL OFFICIAL SONG (DIRECTED BY STUDIO LIIBAAN) by Liibaan Jama 3 years ago 5 minutes, 23 seconds 39,989 views",Liibaan Jama,39989,40075,86
1798,"LIBAN 3K FT QUEEN ZAYA 2019 ARE YOU READY OFFICIAL VIDEO 4K (DIRECTED BY STUDIO LIIBAAN) by Liibaan Jama 3 years ago 3 minutes, 20 seconds 485,957 views",Liibaan Jama,485957,486309,352
1799,"M DJIBOUTI IYO SAHRO CUMAR DHUULE 2019 HABLIHII PUNTLAND OFFICIAL VIDEO  BY STUDIO LIIBAAN) by Liibaan Jama 3 years ago 3 minutes, 54 seconds 8,855 views",Liibaan Jama,8855,8856,1
1800,"BOQOR MATAAN FEAT SALMA 2019 HASALDHIGO OFFICIAL 4K VIDEO BY STUDIO LIIBAAN) by Liibaan Jama 3 years ago 3 minutes, 35 seconds 957,017 views",Liibaan Jama,957017,958165,1148
1801,"FANAANIINTII NORTH AMERICA 2019 PUTLAND GAARSII MIDNIMO OFFICIAL VIDEO (DIRECTED BY STUDIO LIIBAAN) by Liibaan Jama 3 years ago 6 minutes, 23 seconds 8,054 views",Liibaan Jama,8054,8057,3
1802,"FANAANIINTII NORTH AMERICA 2019 WAA MAALIN WAYN OFFICIAL VIDEO 4K (DIRECTED BY STUDIO LIIBAAN) by Liibaan Jama 3 years ago 6 minutes, 41 seconds 16,926 views",Liibaan Jama,16926,16927,1
1803,"SAHRO OMAR DHUULE 2019 XASUUSTII MAGOOL OFFICIAL VIDEO 4K (DIRECTED BY STUDIO LIIBAAN) by Liibaan Jama 3 years ago 4 minutes, 43 seconds 75,254 views",Liibaan Jama,75254,75322,68
1804,"AHMED BUDUL 2019 HEESTII FARDOWSAGYMLIFE OFFICIAL SONG (DIRECTED BY STUDIO LIIBAAN) by Liibaan Jama 3 years ago 6 minutes, 9 seconds 22,344 views",Liibaan Jama,22344,22348,4
1805,"MUBARAK OCTOBER 2019 HEESTII HANI OFFICIAL SONG 4K (DIRECTED BY STUDIO LIIBAAN) by Liibaan Jama 3 years ago 5 minutes, 52 seconds 15,813 views",Liibaan Jama,15813,15818,5
1806,"SALMA 2019 MA GARBA JACAYL OFFICIAL VIDEO 4K (DIRECTED BY STUDIO LIIBAAN) by Liibaan Jama 3 years ago 3 minutes, 45 seconds 559,310 views",Liibaan Jama,559310,559699,389
1807,"AHMED GAASHAANLE 2019 SHAKAAL OFFICIAL SONG (DIRECTED BY STUDIO LIIBAAN) by Liibaan Jama 3 years ago 5 minutes, 2 seconds 10,611 views",Liibaan Jama,10611,10618,7
1808,"DEEQA AHMED 2019 LIBIN OFFICIAL SONG (DIRECTED BY STUDIO LIIBAAN) by Liibaan Jama 3 years ago 6 minutes, 39 seconds 24,836 views",Liibaan Jama,24836,24885,49
1809,"HODAN ABDIRAHMAN IYO DALMAR YARE 2018 DIYAASBURAA HAYGU DORAN SONG  (DIRECTED BY STUDIO LIIBAAN) by Liibaan Jama 3 years ago 4 minutes, 34 seconds 39,363 views",Liibaan Jama,39363,39370,7
1810,"HODAN ABDIRAHMAN 2018 ASAD BUU SHACABKANI DALBADAY OFFICIAL SONG (DIRECTED BY STUDIO LIIBAAN) by Liibaan Jama 3 years ago 5 minutes, 35 seconds 34,978 views",Liibaan Jama,34978,35112,134
1811,"FANAANIINTA NORTH AMERICA 2018 SAHANKAGU WAA GUUL OFFICIAL VIDEO 4K (DIRECTED BY STUDIO LIIBAAN) by Liibaan Jama 3 years ago 5 minutes, 24 seconds 7,956 views",Liibaan Jama,7956,7958,2
1812,"MOHAMED NASH IYO HODAN ABDIRAHMAN 2018 DHAANTO NOGOB OFFICIAL VIDEO 4K (DIRECTED BY STUDIO LIIBAAN) by Liibaan Jama 3 years ago 5 minutes, 55 seconds 129,670 views",Liibaan Jama,129670,129860,190
1813,"HODAN ABDIRAHMAN 2018 MIDNIMO OFFICIAL VIDEO 4K (DIRECTED BY STUDIO LIIBAAN) by Liibaan Jama 3 years ago 5 minutes, 20 seconds 68,020 views",Liibaan Jama,68020,68091,71
1814,"RAHMO ABDI IYO CAAQIL YARE 2018 DHIGI MAAYO TUUTAHA OFFICIAL VIDEO 4K (DIRECTED BY STUDIO LIIBAAN) by Liibaan Jama 3 years ago 5 minutes, 20 seconds 97,108 views",Liibaan Jama,97108,97274,166
1815,"WARDA KARAMA 2018 AMINA DOORTA OFFICIAL SONG (DIRECTED BY STUDIO LIIBAAN) by Liibaan Jama 3 years ago 4 minutes, 53 seconds 11,652 views",Liibaan Jama,11652,11670,18
1816,"NIMCO DAREEN 2018 HEESTII GOOBILE OFFICIAL SONG (DIRECTED BY STUDIO LIIBAAN) by Liibaan Jama 3 years ago 4 minutes, 52 seconds 29,099 views",Liibaan Jama,29099,29158,59
1817,"LAKI HAJI WACAYS 2018 DHARAARTII LAJOOGABA OFFICIAL SONG (DIRECTED BY STUDIO LIIBAAN) by Liibaan Jama 3 years ago 5 minutes, 46 seconds 27,494 views",Liibaan Jama,27494,27505,11
1818,"DALMAR, HODAN, JAWHAR 2018 AROOSKII ABDI IYO IFRAH OFFICIAL VIDEO 4K (DIRECTED BY STUDIO LIIBAAN) by Liibaan Jama 3 years ago 6 minutes, 1 second 158,401 views",Liibaan Jama,158401,158520,119
1819,"HANI UK IYO A/WAHAB ANTAR NAJI 2018 KOR KAYGA BAL TAABO OFFICIAL VIDEO 4K DIRECTED BY STUDIO LIIBAAN by Liibaan Jama 3 years ago 4 minutes, 16 seconds 965,454 views",Liibaan Jama,965454,966861,1407
1820,"OOMAAR 2018 DHAN DHEH OFFICIAL VIDEO 4K (DIRECTED BY STUDIO LIIBAAN) by Liibaan Jama 3 years ago 3 minutes, 18 seconds 2,172,122 views",Liibaan Jama,2172122,2174709,2587
1821,"ABDULLAHI BOQOL 2018 RAYAN OFFICIAL 4K VIDEO (DIRECTED BY STUDIO LIIBAAN) by Liibaan Jama 3 years ago 5 minutes, 46 seconds 110,623 views",Liibaan Jama,110623,110800,177
1822,"WARDA KARAMA 2018 WAAN KAA HELAA SOMALI MUSEUM 5TH ANNIVERSARY OFFICIAL VIDEO 4K (BY STUDIO LIIBAAN) by Liibaan Jama 3 years ago 5 minutes, 42 seconds 190,086 views",Liibaan Jama,190086,191000,914
1823,"WARDA KARAMA 2018 CEELKA SOO JIID SOMALI MUSEUM 5TH ANNIVERSARY OFICIAL VIDEO 4K (BY STUDIO LIIBAAN) by Liibaan Jama 3 years ago 3 minutes, 42 seconds 296,739 views",Liibaan Jama,296739,298143,1404
1824,"MOHAMED SOMALI 2018 HEESTII HAMDA IDIL OFFICIAL SONG (DIRECTED BY STUDIO LIIBAAN) by Liibaan Jama 3 years ago 5 minutes 8,547 views",Liibaan Jama,8547,8549,2
1825,"OOMAAR 2018 RUUX CIDLA AH OFFICIAL VIDEO 4K (DIRECTED BY STUDIO LIIBAAN) by Liibaan Jama 3 years ago 4 minutes, 12 seconds 697,002 views",Liibaan Jama,697002,700270,3268
1826,"ABDIRAZAK ASHUUKE 2018 NAF KU JAMATAY OFFICIAL VIDEO 4K (DIRECTED BY STUDIO LIIBAAN) by Liibaan Jama 3 years ago 4 minutes, 56 seconds 180,955 views",Liibaan Jama,180955,181080,125
1827,"OOMAAR 2018 XURMO OFFICIAL VIDEO 4K (DIRECTED BY STUDIO LIIBAAN) by Liibaan Jama 3 years ago 4 minutes, 42 seconds 669,429 views",Liibaan Jama,669429,672038,2609
1828,"DEEQA AHMED 2018 HEESTII XUBI OFFICIAL SONG (DIRECTED BY STUDIO LIIBAAN) by Liibaan Jama 3 years ago 7 minutes, 30 seconds 9,273 views",Liibaan Jama,9273,9283,10
1829,"ABDIRAHMAN DOWLO Feat HABAD OLAD 2018 DEQA EBYAN OFFICIAL VIDEO (DIRECTED BY STUDIO LIIBAAN) by Liibaan Jama 3 years ago 3 minutes, 36 seconds 16,136 views",Liibaan Jama,16136,16136,0
1830,"AWALE ADAN 2018 SULDAAN SEERAAR IYO MARWADIISA AMUUN HEESTII GUDOON SAN OFFICIAL SONG BY LIBAAN JAMA by Liibaan Jama 3 years ago 6 minutes, 28 seconds 106,375 views",Liibaan Jama,106375,106427,52
1831,"SAHAL KASKEEY 2018 CASHAQU HA AHADO XOR OFFICIAL 4K VIDEO (DIRECTED BY STUDIO LIIBAAN) by Liibaan Jama 3 years ago 4 minutes, 9 seconds 32,119 views",Liibaan Jama,32119,32131,12
1832,"ABDULLAHI BOQOL 2018 FILSAN OFFICIAL SONG (DIRECTED BY STUDIO LIIBAAN) by Liibaan Jama 3 years ago 6 minutes, 6 seconds 13,581 views",Liibaan Jama,13581,13585,4
1833,"OOMAAR 2018 DHEEMANTII PUNTLAND OFFICIAL SONG (DIRECTED BY STUDIO LIIBAAN) by Liibaan Jama 3 years ago 4 minutes, 18 seconds 53,301 views",Liibaan Jama,53301,53408,107
1834,"LAYLO KOOTILI 2018 WAA YAAB OFFICIAL SONG (DIRECTED BY STUDIO LIIBAAN) by Liibaan Jama 3 years ago 5 minutes, 8 seconds 7,124 views",Liibaan Jama,7124,7125,1
1835,"DAUD YARE 2018 DHIB LA AAN OFFICIAL 4K VIDEO (DIRECTED BY STUDIO LIIBAAN) by Liibaan Jama 3 years ago 4 minutes, 45 seconds 15,407 views",Liibaan Jama,15407,15423,16
1836,"CANAB INDHODEEQ 2018 XILO OFFICIAL 4K VIDEO (DIRECTED BY STUDIO LIIBAAN) by Liibaan Jama 3 years ago 7 minutes, 29 seconds 161,455 views",Liibaan Jama,161455,162350,895
1837,"ALI OSMAN 2018 AARJI OFFICIAL VIDEO (DIRECTED BY STUDIO LIIBAAN) by Liibaan Jama 3 years ago 6 minutes, 24 seconds 7,361 views",Liibaan Jama,7361,7368,7
1838,"FUAD XAMARAAWI 2018 DUFAAN OFFICIAL 4K VIDEO (DIRECTED BY STUDIO LIIBAAN) by Liibaan Jama 3 years ago 6 minutes, 3 seconds 60,298 views",Liibaan Jama,60298,60598,300
1839,"SOODHAWEENTII DALMAR YARE TORONTO CANADA  OFFICIAL VIDEO (DIRECTED BY STUDIO LIIBAAN) by Liibaan Jama 3 years ago 14 minutes, 21 seconds 23,427 views",Liibaan Jama,23427,23430,3
1840,"AWALE ADAN 2018 NASSAB OFFICIAL VIDEO (DIRECTED BY STUDIO LIIBAAN) by Liibaan Jama 3 years ago 8 minutes, 22 seconds 602,807 views",Liibaan Jama,602807,606018,3211
1841,"DALMAR YARE 2018 GPS TA NOLOSHA OFFICIAL 4K VIDEO (DIRECTED BY STUDIO LIIBAAN) by Liibaan Jama 3 years ago 4 minutes, 54 seconds 2,002,374 views",Liibaan Jama,2002374,2006946,4572
1842,"NIMCAAN HILAAC 2018 HEESTII LUUL OFFICIAL SONG (DIRECTED BY STUDIO LIIBAAN) by Liibaan Jama 3 years ago 7 minutes, 10 seconds 53,312 views",Liibaan Jama,53312,53490,178
1843,"SALMA 2018 BOGII JACAYKA OFFICIAL 4K VIDEO (DIRECTED BY STUDIO LIIBAAN) by Liibaan Jama 3 years ago 5 minutes, 39 seconds 6,142,602 views",Liibaan Jama,6142602,6165397,22795
1844,"DALMAR YARE 2018 LIVE CONCERT OFFICIAL VIDEO (DIRECTED BY STUDIO LIIBAAN) by Liibaan Jama 3 years ago 5 minutes, 23 seconds 13,129 views",Liibaan Jama,13129,13129,0
1845,"DEEQA AHMED IYO ABDIRAHMAN DOWLO 2018 NITAAQO OFFICIAL VIDEO (DIRECTED BY STUDIO LIIBAAN) by Liibaan Jama 3 years ago 6 minutes, 34 seconds 612,038 views",Liibaan Jama,612038,614154,2116
1846,"OOMAAR IYO ZAKI YARE 2018 HEESTII CALANKA OFFICIAL VIDEO (DIRECTED BY STUDIO LIIBAAN) by Liibaan Jama 3 years ago 5 minutes, 44 seconds 452,623 views",Liibaan Jama,452623,453608,985
1847,"ISKILAJI IYO RAHMA ROSE 2018 CALMASHO  OFFICIAL VIDEO (DIRECTED BY STUDIO LIIBAAN) by Liibaan Jama 3 years ago 7 minutes, 20 seconds 287,084 views",Liibaan Jama,287084,287797,713
1848,"AWALE ADAN 2018 DURRIYADDI OFFICIAL VIDEO (DIRECTED BY STUDIO LIIBAAN) by Liibaan Jama 3 years ago 6 minutes, 24 seconds 1,665,426 views",Liibaan Jama,1665426,1669770,4344
1849,"OOMAAR 2018 DJIBOUTI OFFICIAL VIDEO (DIRECTED BY STUDIO LIIBAAN) by Liibaan Jama 3 years ago 7 minutes, 32 seconds 185,290 views",Liibaan Jama,185290,185365,75
1850,"WARDA KARAMA 2018 QEYS IYO LEYLA OFFICIAL VIDEO (DIRECTED BY STUDIO LIIBAAN) by Liibaan Jama 3 years ago 4 minutes, 12 seconds 519,374 views",Liibaan Jama,519374,521533,2159
1851,"ILHAN GUCCI 2018 MAXAAN KAA NAWILAA OFFICIAL VIDEO (DIRECTED BY STUDIO LIIBAAN) by Liibaan Jama 3 years ago 6 minutes, 1 second 74,823 views",Liibaan Jama,74823,74837,14
1852,"DALMAR YARE 2018 HOBYO OFFICIAL VIDEO (DIRECTED BY STUDIO LIIBAAN) by Liibaan Jama 3 years ago 4 minutes, 58 seconds 2,033,531 views",Liibaan Jama,2033531,2041919,8388
1853,"JIDO KOOSTO 2018 LABO QORI JAAD OFFICIAL VIDEO 4K (DIRECTED BY STUDIO LIIBAAN) by Liibaan Jama 3 years ago 4 minutes, 50 seconds 69,031 views",Liibaan Jama,69031,69096,65
1854,"ABDULLAHI GOOF 2018 SOO LAABO LADAN OFFICIAL VIDEO 4K (DIRECTED BY STUDIO LIIBAAN) by Liibaan Jama 3 years ago 4 minutes, 43 seconds 15,431 views",Liibaan Jama,15431,15442,11
1855,"AHMED ZAKI 2018 UGBAAD OFFICIAL VIDEO 4K (DIRECTED BY STUDIO LIIBAAN) by Liibaan Jama 3 years ago 6 minutes, 23 seconds 532,464 views",Liibaan Jama,532464,533104,640
1856,"HODAN ABDIRAHMAN AND MUKTAR ADEERO 2018 BAKAR WAAREE OFFICIAL SONG (DIRECTED BY STUDIO LIIBAAN) by Liibaan Jama 3 years ago 7 minutes, 55 seconds 45,651 views",Liibaan Jama,45651,45742,91
1857,"XASAN CAGAARAN 2018 DAMBI OFFICIAL VIDEO 4K (DIRECTED BY STUDIO LIIBAAN) by Liibaan Jama 3 years ago 5 minutes, 47 seconds 146,696 views",Liibaan Jama,146696,147858,1162
1858,"CANAB INDHODEEQ 2018 GABATI OFFICIAL VIDEO 4K (DIRECTED BY STUDIO LIIBAAN) by Liibaan Jama 3 years ago 5 minutes, 46 seconds 46,738 views",Liibaan Jama,46738,46952,214
1859,"SOWDHAWEENTA MADAXWAYNAHA S,LAND 2018 HEESTII TISQAAD OFFICIAL VIDEO 4K (DIRECTED BY STUDIO LIIBAAN) by Liibaan Jama 3 years ago 5 minutes 50,078 views",Liibaan Jama,50078,50183,105
1860,"LIBAN KIJELE 2018 BASHAAL OFFICIAL VIDEO 4K (DIRECTED BY STUDIO LIIBAAN) by Liibaan Jama 3 years ago 6 minutes, 7 seconds 169,713 views",Liibaan Jama,169713,170513,800
1861,"SAMATAR YARE 2018 QALBI OFFICIAL VIDEO 4k (DIRECTED BY STUDIO LIIBAAN) by Liibaan Jama 3 years ago 3 minutes, 43 seconds 37,785 views",Liibaan Jama,37785,37797,12
1862,"WARDA KARAMA 2018 KUU OLOLAYAA OFFICIAL VIDEO 4K (DIRECTED BY STUDIO LIIBAAN) by Liibaan Jama 3 years ago 5 minutes, 18 seconds 190,229 views",Liibaan Jama,190229,190490,261
1863,"OOMAAR FEAT RAHMA ROSE 2018 BARI SHALAYTO OFFICIAL VIDEO HQ (DIRECTED BY STUDIO LIIBAAN) by Liibaan Jama 3 years ago 4 minutes, 12 seconds 5,449,075 views",Liibaan Jama,5449075,5478069,28994
1864,"KHADRA SILIMA 2018 GOCASHO OFFICIAL SONG (DIRECTED BY STUDIO LIIBAAN) by Liibaan Jama 3 years ago 5 minutes, 55 seconds 15,790 views",Liibaan Jama,15790,15796,6
1865,"RAHMA ROSE FEAT ABDIWAHAB ANTAR NAAJI 2018 BALANTII OFFICIAL VIDEO HQ (DIRECTED BY STUDIO LIIBAAN) by Liibaan Jama 3 years ago 6 minutes, 28 seconds 4,138,577 views",Liibaan Jama,4138577,4162444,23867
1866,"SAHAL KASKEEY 2018 NAWAL OFFICIAL VIDEO 4K  (DIRECTED BY STUDIO LIIBAAN) by Liibaan Jama 3 years ago 5 minutes, 41 seconds 89,535 views",Liibaan Jama,89535,89716,181
1867,"ISKILAAJI 2018 XIRIIR AMA XUJO OFFICIAL VEDIO (DIRECTED BY STUDIO LIIBAAN) by Liibaan Jama 3 years ago 5 minutes, 11 seconds 170,144 views",Liibaan Jama,170144,170291,147
1868,"ZAKI YARE IYO RAHMA ROSE 2018 RAALI ii NOQO OFFICIAL VIDEO 4K (DIRECTED BY STUDIO LIIBAAN) by Liibaan Jama 4 years ago 4 minutes, 27 seconds 697,976 views",Liibaan Jama,697976,699110,1134
1869,"ZAKI YARE 2018 HAMDA OFFICIAL SONG (DIRECTED BY STUDIO LIIBAAN) by Liibaan Jama 4 years ago 4 minutes, 10 seconds 22,021 views",Liibaan Jama,22021,22028,7
1870,"ISKILAAJI 2018 WAANO OFFICIAL VIDEO HQ (DIRECTED BY STUDIO LIIBAAN) by Liibaan Jama 4 years ago 5 minutes, 4 seconds 3,231,570 views",Liibaan Jama,3231570,3259171,27601
1871,"DALMAR YARE IYO RAHMA ROSE 2018 JEESJEES OFFICIAL VIDEO (DIRECTED BY STUDIO LIIBAAN) by Liibaan Jama 4 years ago 8 minutes, 22 seconds 382,608 views",Liibaan Jama,382608,382905,297
1872,"ISKILAAJI 2018 DEEQA DHOOL OFFICIAL SONG (DIRECTED BY STUDIO LIIBAAN) by Liibaan Jama 4 years ago 6 minutes, 33 seconds 515,944 views",Liibaan Jama,515944,517426,1482
1873,"NAJWA BOSTON 2018 TAWAAWAC OFFICIAL VIDEO HQ (DIRECTED BY STUDIO LIIBAAN) by Liibaan Jama 4 years ago 5 minutes, 1 second 483,654 views",Liibaan Jama,483654,483698,44
1874,"ZAKI YARE 2018 MAYLA HAYSAA OFFICIAL VIDEO HQ (DIRECTED BY STUDIO LIIBAAN) by Liibaan Jama 4 years ago 4 minutes, 48 seconds 911,456 views",Liibaan Jama,911456,912391,935
1875,"ABDIRAHMAN DOWLO 2018 SUMAYA OFFICIAL VIDEO (DIRECTED BY STUDIO LIIBAAN) by Liibaan Jama 4 years ago 2 minutes, 53 seconds 1,025,185 views",Liibaan Jama,1025185,1025249,64
1876,"ABDIRAHMAN DOWLO 2018 BIDHAN QURUX OFFICIAL VIDEO HQ (DIRECTED BY STUDIO LIIBAAN) by Liibaan Jama 4 years ago 4 minutes, 46 seconds 1,114,075 views",Liibaan Jama,1114075,1114134,59
1877,"OOMAAR 2018 BARBAR OFFICIAL VIDEO HQ (DIRECTED BY STUDIO LIIBAAN) by Liibaan Jama 4 years ago 4 minutes, 43 seconds 11,360,844 views",Liibaan Jama,11360844,11392263,31419
1878,"XANFAR YARE 2018 HEESTII DAKADA OFFICIAL SONG 4K (DIRECTED BY STUDIO LIIBAAN) by Liibaan Jama 4 years ago 3 minutes, 53 seconds 16,198 views",Liibaan Jama,16198,16209,11
1879,"RAHMA ROSE IYO DALMAR YARE 2018 HEESTII CALANKA OFFICIAL VIDEO 4K (DIRECTED BY STUDIO LIIBAAN) by Liibaan Jama 4 years ago 5 minutes, 37 seconds 145,204 views",Liibaan Jama,145204,145229,25
1880,"BOQOR MATAAN FEAT HC THE CHEMIST 2018 SUMAYA OFFICIAL VIDEO 4K (DIRECTED BY STUDIO LIIBAAN) by Liibaan Jama 4 years ago 4 minutes, 22 seconds 1,206,951 views",Liibaan Jama,1206951,1207081,130
1881,"DALMAR YARE 2017 HEES AROOS OFFICIAL SONG (DIRECTED BY STUDIO LIIBAAN) by Liibaan Jama 4 years ago 4 minutes, 27 seconds 14,034 views",Liibaan Jama,14034,14043,9
1882,"CAAQIL YARE IYO HODAN ABDIRAHMAN 2017 BAL EEGA SOMALILAND OFFICIAL VIDEO  DIRECTED BY STUDIO LIIBAAN by Liibaan Jama 4 years ago 6 minutes, 52 seconds 334,858 views",Liibaan Jama,334858,335019,161
1883,"ABDIRISAK BLACKY 2017 SOMALAAY GURACAN OFFICIAL VIDEO (DIRECTED BY STUDIO LIIBAAN) by Liibaan Jama 4 years ago 5 minutes, 28 seconds 213,943 views",Liibaan Jama,213943,213944,1
1884,"ALI NAJIIB IYO ABDULLAHI BOQOL 2017 HEESTII HAYSDILINA OFFICIAL SONG (DIRECTED BY STUDIO LIIBAAN) by Liibaan Jama 4 years ago 6 minutes, 57 seconds 69,117 views",Liibaan Jama,69117,69124,7
1885,"DALMAR YARE 2017 DHALINYAROOY KACA OFFICIAL VIDEO 4K (DIRECTED BY STUDIO LIIBAAN) by Liibaan Jama 4 years ago 6 minutes, 37 seconds 2,038,265 views",Liibaan Jama,2038265,2043081,4816
1886,"ABWAAN MOHAMED AHMED ORSHE 2017 MAANSADII GOCASHO BAROORDIIQDII SOBE KADHACDAY OFFICIAL VIDEO DIRECT by Liibaan Jama 4 years ago 6 minutes, 10 seconds 144,278 views",Liibaan Jama,144278,144283,5
1887,"ABDINUR ADEN DALJIR 2017 HEESTII UBAH OFFICIAL SONG (DIRECTED BY STUDIO LIIBAAN) by Liibaan Jama 4 years ago 7 minutes, 2 seconds 125,814 views",Liibaan Jama,125814,125854,40
1888,"AHMED WADANI 2017 HA IGU DAYIN MAYEELEE OFFICIAL VIDEO 4K (DIRECTED BY STUDIO LIIBAAN) by Liibaan Jama 4 years ago 7 minutes, 11 seconds 124,738 views",Liibaan Jama,124738,124747,9
1889,"ABDULLAHI GOOF 2017 GEES UUN II DHAQAJI OFFICIAL VIDEO 4K (DIRECTED BY STUDIO LIIBAAN) by Liibaan Jama 4 years ago 5 minutes, 10 seconds 84,887 views",Liibaan Jama,84887,84961,74
1890,"ABDIRAHMAN DOWLO 2017 WAA AROOS OFFICIAL SONG (DIRECTED BY STUDIO LIIBAAN) by Liibaan Jama 4 years ago 8 minutes, 25 seconds 5,342 views",Liibaan Jama,5342,5342,0
1891,"NASTEEXO INDHO 2017 BAXNAANO OFFICIAL VIDEO (DIRECTED BY STUDIO LIIBAAN) by Liibaan Jama 4 years ago 5 minutes, 21 seconds 829,585 views",Liibaan Jama,829585,830841,1256
1892,"ZAKI YARE 2017 HANAANKA OFFICIAL VIDEO 4K (DIRECTED BY STUDIO LIIBAAN) by Liibaan Jama 4 years ago 5 minutes, 38 seconds 1,732,044 views",Liibaan Jama,1732044,1734569,2525
1893,"DALMAR YARE IYO AWALE ADAN 2017 HEESTII XAMAR OFFICIAL VIDEO (DIRECTED BY STUDIO LIIBAAN) by Liibaan Jama 4 years ago 6 minutes, 43 seconds 156,263 views",Liibaan Jama,156263,156370,107
1894,"HABAD OLAD 2017 DADAA UGU HOREE 4K OFFICIAL VIDEO (DIRECTED BY STUDIO LIIBAAN) by Liibaan Jama 4 years ago 7 minutes, 16 seconds 300,216 views",Liibaan Jama,300216,300698,482
1895,"MUSTAFE TT 2017 KU DOORTE OFFICIAL SONG (DIRECTED BY STUDIO LIIBAAN) by Liibaan Jama 4 years ago 4 minutes, 17 seconds 11,536 views",Liibaan Jama,11536,11548,12
1896,"SAMATAR YARE 2017 GUUR OFFICIAL SONG (DIRECTED BY STUDIO LIIBAAN) by Liibaan Jama 4 years ago 5 minutes, 44 seconds 9,340 views",Liibaan Jama,9340,9351,11
1897,"KHADAR KEYOW IYO ABDULLAHI BOQOL 2017 INDHODEERALEEY OFFICIAL SONG (DIRECTED BY STUDIO LIIBAAN) by Liibaan Jama 4 years ago 9 minutes, 19 seconds 218,472 views",Liibaan Jama,218472,218715,243
1898,"ABDIRAHMAN DOWLO 2017JOWHARA OFFICIAL VIDEO (DIRECTED BY STUDIO LIIBAAN) by Liibaan Jama 4 years ago 6 minutes, 46 seconds 8,969 views",Liibaan Jama,8969,8969,0
1899,"ABDULLAHI GOOF IYO NASTEEXO INDHO 2017 MURTI HADAL OFFICIAL VIDEO (DIRECTED BY STUDIO LIIBAAN) by Liibaan Jama 4 years ago 4 minutes, 15 seconds 207,593 views",Liibaan Jama,207593,207671,78
1900,"OOMAAR 2017 DIGDIGTA WADNAHA OFFICIAL VIDEO (DIRECTED BY STUDIO LIIBAAN) by Liibaan Jama 4 years ago 4 minutes, 15 seconds 587,907 views",Liibaan Jama,587907,589724,1817
1901,"ABDIRASHIID SALAL 2017 XIGTO PUNTLAND OFFICIAL VIDEO (DIRECTED BY STUDIO LIIBAAN) by Liibaan Jama 4 years ago 5 minutes, 57 seconds 26,332 views",Liibaan Jama,26332,26342,10
1902,"SIYAAD WANTED 2017 XAMAR OFFICIAL VIDEO (DIRECTED BY STUDIO LIIBAAN) by Liibaan Jama 4 years ago 6 minutes, 24 seconds 24,677 views",Liibaan Jama,24677,24694,17
1903,"ZAKI YARE 2017 INDHUHU MA ARKAAN QOF KALE 4K OFFICIAL VIDEO (DIRECTED BY STUDIO LIIBAAN) by Liibaan Jama 4 years ago 7 minutes, 22 seconds 364,184 views",Liibaan Jama,364184,364491,307
1904,"AHMED RASTA IYO NASTEEXO INDHO 2017 II FUR LAABTA OFFICIAL VIDEO (DIRECTED BY STUDIO LIIBAAN) by Liibaan Jama 4 years ago 8 minutes, 20 seconds 3,533,840 views",Liibaan Jama,3533840,3546716,12876
1905,"SAHRO CUMAR DHUULE 2017 NABSI OFFICIAL VIDEO (DIRECTED BY STUDIO LIIBAAN) by Liibaan Jama 4 years ago 6 minutes, 12 seconds 71,150 views",Liibaan Jama,71150,71187,37
1906,"OOMAAR 2017 iDHEH OFFICIAL VIDEO (DIRECTED BY STUDIO LIIBAAN) by Liibaan Jama 4 years ago 5 minutes, 28 seconds 3,970,422 views",Liibaan Jama,3970422,3996132,25710
1907,"SUPER SAALAX CARAB 2017 QADARIN OFFICIAL VIDEO (DIRECTED BY STUDIO LIIBAAN) by Liibaan Jama 4 years ago 6 minutes, 31 seconds 160,261 views",Liibaan Jama,160261,160315,54
1908,"DALMAR YARE 2017 GACALO OFFICIAL VIDEO (DIRECTED BY STUDIO LIIBAAN) by Liibaan Jama 4 years ago 5 minutes, 48 seconds 424,269 views",Liibaan Jama,424269,424473,204
1909,"AHMED GAASHAANLE 2017 DHALAAN OFFICIAL VIDEO (DIRECTED BY STUDIO LIIBAAN) by Liibaan Jama 4 years ago 5 minutes, 51 seconds 37,191 views",Liibaan Jama,37191,37316,125
1910,"DHEMAN ALI 2017 CAGA DHIBO BAL WILOOW OFFICIAL VIDEO (DIRECTED BY STUDIO LIIBAAN) by Liibaan Jama 4 years ago 4 minutes, 45 seconds 222,415 views",Liibaan Jama,222415,222484,69
1911,"IDLE YARE 2017 AYAAN OFFICIAL SONG (DIRECTED BY STUDIO LIIBAAN) by Liibaan Jama 4 years ago 6 minutes, 24 seconds 14,104 views",Liibaan Jama,14104,14116,12
1912,"SHACABKA FAREED 2017 HINDA OFFICIAL VIDEO (DIRECTED BY STUDIO LIIBAAN) by Liibaan Jama 4 years ago 6 minutes, 20 seconds 16,386 views",Liibaan Jama,16386,16394,8
1913,"CAAQIL YARE 2017 SUMAYA OFFICIAL VIDEO (DIRECTED BY STUDIO LIIBAAN) by Liibaan Jama 4 years ago 5 minutes, 24 seconds 423,160 views",Liibaan Jama,423160,423819,659
1914,"MUKTAR ADEERO FT FARHAN DHAMALA 2017 YAA DACHII OFFICIAL VIDEO (DIRECTED BY STUDIO LIIBAAN) by Liibaan Jama 4 years ago 4 minutes, 18 seconds 313,113 views",Liibaan Jama,313113,314259,1146
1915,"MUKHTAAR CANTAR 2017 OFFICIAL SONG (DIRECTED BY STUDIO LIIBAAN) by Liibaan Jama 4 years ago 6 minutes, 50 seconds 6,365 views",Liibaan Jama,6365,6365,0
1916,"ASAD YARE 2017 LA SOCO SOMALILAND OFFICIAL SONG (DIRECTED BY STUDIO LIIBAAN) by Liibaan Jama 4 years ago 6 minutes, 14 seconds 5,867 views",Liibaan Jama,5867,5867,0
1917,"FARHIYA KABAYARE 2017 DOWLADA SOMALILAND OFFICIAL SONG (DIRECTED BY STUDIO LIIBAAN) by Liibaan Jama 4 years ago 4 minutes, 14 seconds 88,103 views",Liibaan Jama,88103,88113,10
1918,"GULED SAMATAR 2017 WAQTI OFFICIAL VIDEO (DIRECTED BY STUDIO LIIBAAN) by Liibaan Jama 4 years ago 5 minutes, 28 seconds 6,368 views",Liibaan Jama,6368,6369,1
1919,"AFRIKAAN 2017 WAXBA KAMA TAQAANID OFFICIAL VIDEO (DIRECTED BY STUDIO LIIBAAN) by Liibaan Jama 4 years ago 6 minutes, 48 seconds 53,815 views",Liibaan Jama,53815,53870,55
1920,"ABDI HUBAI IYO SHUKRI SINDIKO 2017 BEESAANI OFFICIAL VIDEO (DIRECTED BY STUDIO LIIBAAN) by Liibaan Jama 4 years ago 5 minutes, 19 seconds 44,278 views",Liibaan Jama,44278,44307,29
1921,"ABDIRAZAK ASHUUKE 2017 QUREESHTA OFFICIAL VIDEO (DIRECTED BY STUDIO LIIBAAN) by Liibaan Jama 4 years ago 4 minutes, 46 seconds 61,588 views",Liibaan Jama,61588,61593,5
1922,"ZAKI YARE 2017 HABLAHEENA OFFICIAL VIDEO (DIRECTED BY STUDIO LIIBAAN) by Liibaan Jama 4 years ago 8 minutes, 5 seconds 184,070 views",Liibaan Jama,184070,184166,96
1923,"SAHAL KASKEEY 2017 NAJMA OFFICIAL VIDEO (DIRECTED BY STUDIO LIIBAAN) by Liibaan Jama 4 years ago 5 minutes, 38 seconds 36,208 views",Liibaan Jama,36208,36220,12
1924,"DEEQA AHMED 2017 HAMIGA OFFICIAL VIDEO (DIRECTED BY STUDIO LIIBAAN) by Liibaan Jama 4 years ago 4 minutes, 51 seconds 473,551 views",Liibaan Jama,473551,475110,1559
1925,"SAYID ABDIWAHAAB 2017 DHAANTO CUSUB TOOLMOON OFFICIAL VIDEO (DIRECTED BY STUDIO LIIBAAN) by Liibaan Jama 4 years ago 3 minutes, 23 seconds 29,436 views",Liibaan Jama,29436,29449,13
1926,"NAJIIB ALFA 2017 KUNJEER RAALI NOQO OFFICIAL  4K VIDEO (DIRECTED BY STUDIO LIIBAAN) by Liibaan Jama 4 years ago 6 minutes, 32 seconds 9,130,186 views",Liibaan Jama,9130186,9178594,48408
1927,"AWALE ADAN 2017 RAHA JAAR LANOQO OFFICIAL  4K VIDEO (DIRECTED BY STUDIO LIIBAAN) by Liibaan Jama 4 years ago 7 minutes, 12 seconds 1,007,786 views",Liibaan Jama,1007786,1011886,4100
1928,"ABDULLAHI BOQOL IYO ZAKI YARE 2017 IIGEEYA OFFICIAL VIDEO (DIRECTED BY STUDIO LIIBAAN) by Liibaan Jama 5 years ago 7 minutes, 18 seconds 77,425 views",Liibaan Jama,77425,77564,139
1929,"AIDARUS MALIBOI 2017 BILADA GEESIGA OFFICIAL VIDEO (DIRECTED BY STUDIO LIIBAAN) by Liibaan Jama 5 years ago 5 minutes, 33 seconds 11,869 views",Liibaan Jama,11869,11870,1
1930,"SHUKRI SINDIKO 2017 DIIDAY DIIDAY OFFICIAL VIDEO (DIRECTED BY STUDIO LIIBAAN) by Liibaan Jama 5 years ago 6 minutes, 20 seconds 79,108 views",Liibaan Jama,79108,79126,18
1931,"ABDULWAHAB CANTAR NAAJI 2017 HEESTII FARMAAJO OFFICIAL SONG (DIRECTED BY STUDIO LIIBAAN) by Liibaan Jama 5 years ago 7 minutes, 7 seconds 13,904 views",Liibaan Jama,13904,13907,3
1932,"AWALE ADAN 2017 HEESTII FARMAAJO OFFICIAL VIDEO (DIRECTED BY STUDIO LIIBAAN) by Liibaan Jama 5 years ago 6 minutes, 36 seconds 562,235 views",Liibaan Jama,562235,563520,1285
1933,"DALMAR YARE IYO AWALE ADAN 2017 HEESTII MADAXWEYNE FARMAAJO OFFICIAL SONG DIRECTED BY STUDIO LIIBAAN by Liibaan Jama 5 years ago 6 minutes, 17 seconds 73,315 views",Liibaan Jama,73315,73331,16
1934,"FANAANIINTA LONDON IYO HEESTII SAADAASHU WAA GUUL 2017 OFFICIAL SONG (DIRECTED BY STUDIO LIIBAAN) by Liibaan Jama 5 years ago 6 minutes, 26 seconds 28,430 views",Liibaan Jama,28430,28438,8
1935,"ABDULLAHI BOQOL 2017 GALBIS OFFICIAL VIDEO (DIRECTED BY STUDIO LIIBAAN) by Liibaan Jama 5 years ago 5 minutes, 13 seconds 15,275 views",Liibaan Jama,15275,15286,11
1936,"HIDAYO DHAQAN 2017 CALAFKAA SIDAA YIRI OFFICIAL VIDEO (DIRECTED BY STUDIO LIIBAAN) by Liibaan Jama 5 years ago 5 minutes, 34 seconds 335,088 views",Liibaan Jama,335088,335135,47
1937,"OMAR SHOOLI 2017 MAXAA KEENAY OFFICIAL VIDEO (DIRECTED BY STUDIO LIIBAAN) by Liibaan Jama 5 years ago 7 minutes, 16 seconds 189,657 views",Liibaan Jama,189657,190028,371
1938,"HANI UK 2017 LAHASHO OFFICIAL VIDEO (DIRECTED BY STUDIO LIIBAAN) by Liibaan Jama 5 years ago 4 minutes, 57 seconds 735,609 views",Liibaan Jama,735609,736592,983
1939,"SIYAAD WANTED 2017 HEESTII SIDII QARAN DHISNEE OFFICIAL SONG (DIRECTED BY STUDIO LIIBAAN) by Liibaan Jama 5 years ago 4 minutes, 56 seconds 11,923 views",Liibaan Jama,11923,11932,9
1940,"NAJIIB ALFA 2017  GO AAN LAGA GAARO OFFICIAL VIDEO (DIRECTED BY STUDIO LIIBAAN) by Liibaan Jama 5 years ago 5 minutes, 15 seconds 7,004,876 views",Liibaan Jama,7004876,7019992,15116
1941,"SHUKRI SHARAF 2017 AXDI OFFICIAL VIDEO (DIRECTED BY STUDIO LIIBAAN) by Liibaan Jama 5 years ago 8 minutes, 14 seconds 16,175 views",Liibaan Jama,16175,16180,5
1942,"GORGOR YUSUF 2017 NEW DHAANTO ARIDHABAN OFFICIAL VIDEO (DIRECTED BY STUDIO LIIBAAN) by Liibaan Jama 5 years ago 5 minutes, 2 seconds 26,251 views",Liibaan Jama,26251,26272,21
1943,"CAAQIL YARE 2017 SACDIYO OFFICIAL VIDEO (DIRECTED BY STUDIO LIIBAAN) by Liibaan Jama 5 years ago 5 minutes, 25 seconds 142,481 views",Liibaan Jama,142481,142595,114
1944,"MAHAD INDHO DEERO 2017 OGADENYA ANAA ISKA LEH OFFICIAL VIDEO (DIRECTED BY STUDIO LIIBAAN) by Liibaan Jama 5 years ago 6 minutes, 8 seconds 16,684 views",Liibaan Jama,16684,16704,20
1945,"OMAR SHOOLI 2017 SHIISHA OFFICIAL VIDEO (DIRECTED BY STUDIO LIIBAAN) by Liibaan Jama 5 years ago 4 minutes, 49 seconds 100,738 views",Liibaan Jama,100738,100820,82
1946,"RAHMA ROSE IYO OMAR SHOOLI 2017 MIIR MA LIHIYEE OFFICIAL VIDEO (DIRECTED BY STUDIO LIIBAAN) by Liibaan Jama 5 years ago 6 minutes, 46 seconds 321,943 views",Liibaan Jama,321943,322497,554
1947,"OMAR SHOOLI 2017 WARIS OFFICIAL VIDEO (DIRECTED BY STUDIO LIIBAAN) by Liibaan Jama 5 years ago 5 minutes, 36 seconds 66,420 views",Liibaan Jama,66420,66486,66
1948,"WAAYAHA CUSUB 2017 HUDO HOODO OFFICIAL VIDEO (DIRECTED BY STUDIO LIIBAAN) by Liibaan Jama 5 years ago 4 minutes, 34 seconds 1,120,737 views",Liibaan Jama,1120737,1123633,2896
1949,"DALMAR YARE IYO DEEQA AHMED 2017 QIIRO OFFICIAL VIDEO (DIRECTED BY STUDIO LIIBAAN) by Liibaan Jama 5 years ago 11 minutes, 16 seconds 2,293,192 views",Liibaan Jama,2293192,2301746,8554
1950,"SAHRUUJA IYO OMAR SHOOLI 2017 URKEYGA ARWAXISOY OFFICIAL VIDEO (DIRECTED BY STUDIO LIIBAAN) by Liibaan Jama 5 years ago 4 minutes, 12 seconds 481,523 views",Liibaan Jama,481523,482281,758
1951,"ABDULAHI BOQOL 2017 RIYAAQ OFFICIAL VIDEO (DIRECTED BY STUDIO LIIBAAN) by Liibaan Jama 5 years ago 7 minutes, 46 seconds 29,288 views",Liibaan Jama,29288,29293,5
1952,"ABDIRAHMAN DOWLO 2017 DHOOL OFFICIAL VIDEO (DIRECTED BY STUDIO LIIBAAN) by Liibaan Jama 5 years ago 5 minutes, 41 seconds 20,216 views",Liibaan Jama,20216,20224,8
1953,"SAMATAR YARE 2017 TASHO BABY OFFICIAL VIDEO (DIRECTED BY STUDIO LIIBAAN) by Liibaan Jama 5 years ago 3 minutes, 27 seconds 44,357 views",Liibaan Jama,44357,44365,8
1954,"ABSHIR ABAADIR 2017 XUBIN JACEEL OFFICIAL VIDEO (DIRECTED BY STUDIO LIIBAAN) by Liibaan Jama 5 years ago 6 minutes, 51 seconds 18,238 views",Liibaan Jama,18238,18249,11
1955,"MAHAD INDHO DEERO 2017 BANDAR BEELO OFFICIAL VIDEO (DIRECTED BY STUDIO LIIBAAN) by Liibaan Jama 5 years ago 6 minutes, 16 seconds 12,309 views",Liibaan Jama,12309,12319,10
1956,"MOHAMED ALTA 2017 DARTAA BAAN U LULAYAA OFFICIAL VIDEO (DIRECTED BY STUDIO LIIBAAN) by Liibaan Jama 5 years ago 7 minutes 74,713 views",Liibaan Jama,74713,74724,11
1957,"FARHAAN SHIINE FEAT FFK REMIX 2017 BARASHO OFFICIAL VIDEO (DIRECTED BY STUDIO LIIBAAN) by Liibaan Jama 5 years ago 7 minutes, 6 seconds 29,611 views",Liibaan Jama,29611,29620,9
1958,"ABDIRAHMAN DOWLO 2017 AMAL OFFICIAL SONG (DIRECTED BY STUDIO LIIBAAN by Liibaan Jama 5 years ago 7 minutes, 43 seconds 5,688 views",Liibaan Jama,5688,5688,0
1959,"LIBAN KIJELE 2016 KIJELE OFFICIAL VIDEO (DIRECTED BY STUDIO LIIBAAN) by Liibaan Jama 5 years ago 6 minutes, 44 seconds 1,043,729 views",Liibaan Jama,1043729,1047851,4122
1960,"ZAKI YARE 2017 SIDAAD DOONTABA KA YEEL OFFICIAL VIDEO (DIRECTED BY STUDIO LIIBAAN) by Liibaan Jama 5 years ago 7 minutes, 6 seconds 1,662,779 views",Liibaan Jama,1662779,1664327,1548
1961,"KEYSAR OMAR GACAL 2017 BORAMA OFFICIAL SONG (DIRECTED BY STUDIO LIIBAAN) by Liibaan Jama 5 years ago 6 minutes, 1 second 24,884 views",Liibaan Jama,24884,24889,5
1962,"AWALE ADAN 2017 ANEEY BADOWNIMO I QAADEY OFFICIAL VIDEO (DIRECTED BY STUDIO LIIBAAN) by Liibaan Jama 5 years ago 8 minutes, 35 seconds 7,911,432 views",Liibaan Jama,7911432,7975185,63753
1963,"LIBAN KIJELE 2016 JANAAY OFFICIAL VIDEO (DIRECTED BY STUDIO LIIBAAN) by Liibaan Jama 5 years ago 4 minutes, 16 seconds 790,874 views",Liibaan Jama,790874,793054,2180
1964,"FARAH KAAFI 2016 MARWO OFFICIAL VIDEO (DIRECTED BY STUDIO LIIBAAN) by Liibaan Jama 5 years ago 3 minutes, 54 seconds 20,063 views",Liibaan Jama,20063,20070,7
1965,"SANKA XAAJI 2016 JIGJIGA OFFICIAL SONG (DIRECTED BY STUDIO LIIBAAN) by Liibaan Jama 5 years ago 5 minutes, 52 seconds 3,371 views",Liibaan Jama,3371,3372,1
1966,"XAABSADE 2016 CEELASHA OFFICIAL SONG (DIRECTED BY STUDIO LIIBAAN) by Liibaan Jama 5 years ago 4 minutes, 33 seconds 7,200 views",Liibaan Jama,7200,7212,12
1967,"SAMATAR YARE 2016 XASUUSTII LONDON OFFICIAL VIDEO (DIRECTED BY STUDIO LIIBAAN) by Liibaan Jama 5 years ago 5 minutes, 20 seconds 70,492 views",Liibaan Jama,70492,70539,47
1968,"OMAR SHOOLI 2016 AROOS OFFICIAL VIDEO (DIRECTED BY STUDIO LIIBAAN) by Liibaan Jama 5 years ago 6 minutes, 4 seconds 19,134 views",Liibaan Jama,19134,19224,90
1969,"OMAR DHIBO 2016 ARAGSAN OFFICIAL VIDEO (DIRECTED BY STUDIO LIIBAAN) by Liibaan Jama 5 years ago 7 minutes, 34 seconds 5,177 views",Liibaan Jama,5177,5179,2
1970,"ABDULLAHI BOQOL 2016 HOBEEY GALMUDUG OFFICIAL VIDEO (DIRECTED BY STUDIO LIIBAAN) by Liibaan Jama 5 years ago 6 minutes, 28 seconds 923,918 views",Liibaan Jama,923918,929315,5397
1971,"SAMIR CADE 2016 BILAN OFFICIAL VIDEO (DIRECTED BY STUDIO LIIBAAN) by Liibaan Jama 5 years ago 6 minutes, 47 seconds 9,975 views",Liibaan Jama,9975,9978,3
1972,"RAHMA ROSE IYO ABDIRISAK BK 2016 TAAGEER GALMUDUG OFFICIAL VIDEO (DIRECTED BY STUDIO LIIBAAN) by Liibaan Jama 5 years ago 5 minutes, 44 seconds 77,721 views",Liibaan Jama,77721,77784,63
1973,"ASAD QARNI 2016 MILGO OFFICIAL VIDEO (DIRECTED BY STUDIO LIIBAAN) by Liibaan Jama 5 years ago 5 minutes, 51 seconds 27,641 views",Liibaan Jama,27641,27648,7
1974,"ABDIWALI SHACABKA 2016 XABAD OFFICIAL VIDEO (DIRECTED BY STUDIO LIIBAAN) by Liibaan Jama 5 years ago 5 minutes, 57 seconds 23,221 views",Liibaan Jama,23221,23230,9
1975,"SIYAAD WANTED 2016 LUUQ GANAANE OFFICIAL VIDEO (DIRECTED BY STUDIO LIIBAAN) by Liibaan Jama 5 years ago 4 minutes, 51 seconds 382,286 views",Liibaan Jama,382286,386230,3944
1976,"ABDIRAZAK ASHUUKE 2016 YARTA DABACSANE OFFICIAL VIDEO (DIRECTED BY STUDIO LIIBAAN) by Liibaan Jama 5 years ago 7 minutes, 1 second 25,973 views",Liibaan Jama,25973,25976,3
1977,"IDIL CADOW 2016 FILM OFFICIAL VIDEO (DIRECTED BY STUDIO LIIBAAN) by Liibaan Jama 5 years ago 6 minutes, 8 seconds 60,608 views",Liibaan Jama,60608,60689,81
1978,"AWALE ADAN 2016 UBAXA DOOLO OFFICIAL VIDEO (DIRECTED BY STUDIO LIIBAAN) by Liibaan Jama 5 years ago 5 minutes, 34 seconds 322,269 views",Liibaan Jama,322269,322969,700
1979,"OMAR SHOOLI 2016 DUMARKA OFFICIAL VIDEO (DIRECTED BY STUDIO LIIBAAN) by Liibaan Jama 5 years ago 5 minutes, 13 seconds 30,520 views",Liibaan Jama,30520,30533,13
1980,"AWALE ADAN 2016 HUBQAAD OFFICIAL VIDEO (DIRECTED BY STUDIO LIIBAAN) by Liibaan Jama 5 years ago 8 minutes, 28 seconds 963,628 views",Liibaan Jama,963628,974336,10708
1981,"MAXAMED JACEELOW 2016 HAWEENKA ADAA U MUDAN OFFICIAL VIDEO (DIRECTED BY STUDIO LIIBAAN) by Liibaan Jama 5 years ago 6 minutes, 1 second 16,027 views",Liibaan Jama,16027,16038,11
1982,"ABDIRAHMAN DOWLO 2016 NORWAY OFFICIAL VIDEO (DIRECTED BY STUDIO LIIBAAN) by Liibaan Jama 5 years ago 5 minutes, 51 seconds 23,046 views",Liibaan Jama,23046,23078,32
1983,"ABDULLAHI GOOF 2016 DABKA MAAN KU DHACAA OFFICIAL VIDEO (DIRECTED BY STUDIO LIIBAAN) by Liibaan Jama 5 years ago 3 minutes, 23 seconds 930,106 views",Liibaan Jama,930106,932041,1935
1984,"ABDULLAHI GOOF 2016 QABO LAANTA UBAXA OFFICIAL VIDEO (DIRECTED BY STUDIO LIIBAAN) by Liibaan Jama 5 years ago 6 minutes, 20 seconds 203,746 views",Liibaan Jama,203746,203879,133
1985,"NIMCAAN HILAAC 2016 MAANTANA OFFICIAL VIDEO (DIRECTED BY STUDIO LIIBAAN) by Liibaan Jama 5 years ago 8 minutes, 16 seconds 5,249,196 views",Liibaan Jama,5249196,5285929,36733
1986,"MOHAMED GALAYR 2016 GOBAAD OFFICIAL VIDEO (DIRECTED BY STUDIO LIIBAAN) by Liibaan Jama 5 years ago 6 minutes, 17 seconds 11,301 views",Liibaan Jama,11301,11305,4
1987,"HODAN AFRICA 2016 MISS AFRICA OFFICIAL VIDEO (DIRECTED BY STUDIO LIIBAAN) by Liibaan Jama 5 years ago 3 minutes, 54 seconds 170,129 views",Liibaan Jama,170129,170173,44
1988,"IQRA YAREY 2016 DHIB OFFICIAL VIDEO (DIRECTED BY STUDIO LIIBAAN) by Liibaan Jama 5 years ago 7 minutes, 35 seconds 2,475,106 views",Liibaan Jama,2475106,2480069,4963
1989,"SAHRUUJA 2016 LAYLA OFFICIAL VIDEO (DIRECTED BY STUDIO LIIBAAN) by Liibaan Jama 5 years ago 7 minutes, 16 seconds 53,232 views",Liibaan Jama,53232,53251,19
1990,"RAHMA ROSE 2016 DHEEF OFFICIAL VIDEO (DIRECTED BY STUDIO LIIBAAN) by Liibaan Jama 5 years ago 7 minutes, 20 seconds 556,569 views",Liibaan Jama,556569,557132,563
1991,"MUKTAR ADEERO 2016 HARGEYSA OFFICIAL VIDEO (DIRECTED BY STUDIO LIIBAAN) by Liibaan Jama 5 years ago 6 minutes, 56 seconds 120,620 views",Liibaan Jama,120620,121028,408
1992,"FARAH KAAFI 2016 QAMAR OFFICIAL VIDEO (DIRECTED BY STUDIO LIIBAAN) by Liibaan Jama 5 years ago 5 minutes, 20 seconds 13,016 views",Liibaan Jama,13016,13019,3
1993,"KALA SAA SAMIYO XUMO 2016 FANAANIINTA NORTH AMERICA OFFICIAL VIDEO (DIRECTED BY STUDIO LIIBAAN) by Liibaan Jama 5 years ago 4 minutes, 15 seconds 11,368 views",Liibaan Jama,11368,11371,3
1994,"FARHAAN SHIINE 2016 ASMAR OFFICIAL SONG (DIRECTED BY STUDIO LIIBAAN) by Liibaan Jama 5 years ago 6 minutes, 47 seconds 35,297 views",Liibaan Jama,35297,35307,10
1995,"OMAR JACEELOW 2016 CALMASHADA OFFICIAL VIDEO (DIRECTED BY STUDIO LIIBAAN) by Liibaan Jama 5 years ago 5 minutes, 45 seconds 6,939 views",Liibaan Jama,6939,6940,1
1996,"AHMED CEEGGAAG 2016 HAADAAN OFFICIAL SONG (DIRECTED BY STUDIO LIIBAAN) by Liibaan Jama 5 years ago 7 minutes, 26 seconds 7,104 views",Liibaan Jama,7104,7106,2
1997,"ABDIRISAK BK 2016 JAMASHO OFFICIAL VIDEO (DIRECTED BY STUDIO LIIBAAN) by Liibaan Jama 5 years ago 5 minutes, 25 seconds 28,941 views",Liibaan Jama,28941,28955,14
1998,"DALMAR YARE 2016 FAIZA OFFICIAL VIDEO (DIRECTED BY STUDIO LIIBAAN) by Liibaan Jama 5 years ago 6 minutes, 23 seconds 570,576 views",Liibaan Jama,570576,570720,144
1999,"GARASHO 2016 FANAANIINTA NORTH AMERICA OFFICIAL VIDEO (DIRECTED BY STUDIO LIIBAAN) by Liibaan Jama 5 years ago 5 minutes, 10 seconds 9,191 views",Liibaan Jama,9191,9194,3
2000,"GUULAHA XISBIGA XDSHI 2016 FANAANIINTA NORTH AMERICA OFFICIAL VIDEO (DIRECTED BY STUDIO LIIBAAN) by Liibaan Jama 5 years ago 3 minutes, 56 seconds 10,395 views",Liibaan Jama,10395,10395,0
2001,"AWALE ADAN 2016 DARMAAN OFFICIAL VIDEO (DIRECTED BY STUDIO LIIBAAN) by Liibaan Jama 5 years ago 5 minutes, 17 seconds 27,942 views",Liibaan Jama,27942,27947,5
2002,"FARAH YARE 2016 ALOOW YAA KUDOONA OFFICIAL VIDEO (DIRECTED BY STUDIO LIIBAAN) by Liibaan Jama 5 years ago 5 minutes, 49 seconds 9,813 views",Liibaan Jama,9813,9813,0
2003,"HANI UK 2016 TRUE LOVE STORY OFFICIAL VIDEO DIRECTED BY STUDIO LIIBAAN) by Liibaan Jama 6 years ago 5 minutes, 27 seconds 52,456 views",Liibaan Jama,52456,52511,55
2004,"SULEIMAN CAAQIL 2016 ADUUNYADA OFFICIAL VIDEO (DIRECTED BY STUDIO LIIBAAN) by Liibaan Jama 6 years ago 5 minutes, 57 seconds 10,248 views",Liibaan Jama,10248,10252,4
2005,"XAAWO KIIN 2016 SAHAL OFFICIAL VIDEO (DIRECTED BY STUDIO LIIBAAN) by Liibaan Jama 6 years ago 5 minutes, 10 seconds 29,122 views",Liibaan Jama,29122,29126,4
2006,"FARTUUN BIRIMO 2016 XAQ DHOWR OFFICIAL VIDEO (DIRECTED BY STUDIO LIIBAAN) by Liibaan Jama 6 years ago 7 minutes, 17 seconds 886,705 views",Liibaan Jama,886705,889502,2797
2007,"AL FANAN ABDILLAHI STAR 2016 DHOOLA CEDEYS OFFICIAL VIDEO (DIRECTED BY STUDIO LIIBAAN) by Liibaan Jama 6 years ago 5 minutes, 23 seconds 11,108 views",Liibaan Jama,11108,11115,7
2008,"OMAR JACEELOW 2016 NAFTEYDA WAAN MA WELIYAA OFFICIAL VIDEO (DIRECTED BY STUDIO LIIBAAN) by Liibaan Jama 6 years ago 3 minutes, 28 seconds 40,611 views",Liibaan Jama,40611,40763,152
2009,"CAAMIR ZAKI 2016 NORWAY OFFICIAL VIDEO (DIRECTED BY STUDIO LIIBAAN) by Liibaan Jama 6 years ago 5 minutes, 46 seconds 97,078 views",Liibaan Jama,97078,97111,33
2010,"OMAR JACEELOW 2016 DAREEN OFFICIAL VIDEO (DIRECTED BY STUDIO LIIBAAN) by Liibaan Jama 6 years ago 4 minutes, 54 seconds 4,639 views",Liibaan Jama,4639,4643,4
2011,"OMAR JACEELOW 2016 DARDARAN OFFICIAL VIDEO (DIRECTED BY STUDIO LIIBAAN) by Liibaan Jama 6 years ago 7 minutes, 5 seconds 8,478 views",Liibaan Jama,8478,8481,3
2012,"OMAR SHOOLI 2016 WARXUN TASHIIL WAA LAGA WEECDAA OFFICIAL VIDEO (DIRECTED BY STUDIO LIIBAAN) by Liibaan Jama 6 years ago 5 minutes, 47 seconds 69,854 views",Liibaan Jama,69854,69947,93
2013,"ABDULAHI BOQOL 2016 KOWSAR OFFICIAL SONG (DIRECTED BY STUDIO LIIBAAN) by Liibaan Jama 6 years ago 4 minutes, 57 seconds 18,845 views",Liibaan Jama,18845,18846,1
2014,"AROOSKII ANWAR IYO KHADRA 2016 SAHRO, ILKACASE, ISKALAAJI OFFICIAL VIDEO DIRECTED BY STUDIO LIIBAAN by Liibaan Jama 6 years ago 5 minutes, 6 seconds 43,799 views",Liibaan Jama,43799,43806,7
2015,"CAAQIL YARE 2016 XASILI OFFICIAL VIDEO (DIRECTED BY STUDIO LIIBAAN) by Liibaan Jama 6 years ago 4 minutes, 29 seconds 10,201,891 views",Liibaan Jama,10201891,10218450,16559
2016,"DAMAASHAADKA BAXAYA 2016 DALMAR,RAHMA,GEEDI,ALTA,A SHAQALE OFFICIAL VIDEO DIRECTED BY STUDIO LIIBAAN by Liibaan Jama 6 years ago 7 minutes, 16 seconds 57,469 views",Liibaan Jama,57469,57484,15
2017,"KHAATUMAA KA DABA TIMID 2016 ABDULAHI BOQOL OFFICIAL VIDEO (DIRECTED BY STUDIO LIIBAAN) by Liibaan Jama 6 years ago 4 minutes, 14 seconds 13,436 views",Liibaan Jama,13436,13440,4
2018,"KHAATUMAY U GAARTAHAY 2016 RAHMA/DALMAR/ALTA/M GUUN OFFICIAL VIDEO (DIRECTED BY STUDIO LIIBAAN) by Liibaan Jama 6 years ago 7 minutes, 12 seconds 63,502 views",Liibaan Jama,63502,63715,213
2019,"FARTUUN BIRIMO 2016 YAA LAGAA DARAYMIN OFFICIAL VIDEO (DIRECTED BY STUDIO LIIBAAN) by Liibaan Jama 6 years ago 6 minutes, 41 seconds 845,414 views",Liibaan Jama,845414,847379,1965
2020,"MARWAAN YARE  2016 KA NOOLI WIXII ISOO MARAY OFFICIAL VIDEO (DIRECTED BY STUDIO LIIBAAN) by Liibaan Jama 6 years ago 7 minutes, 12 seconds 65,215 views",Liibaan Jama,65215,65242,27
2021,"AWALE ADAN IYO HANI UK 2016 GUUR OFFICIAL VIDEO (DIRECTED BY STUDIO LIIBAAN) by Liibaan Jama 6 years ago 8 minutes, 31 seconds 8,123,232 views",Liibaan Jama,8123232,8150071,26839
2022,"IDIRIS TEMPO 2016 DEGMO OFFICIAL SONG (DIRECTED BY STUDIO LIIBAAN) by Liibaan Jama 6 years ago 4 minutes, 24 seconds 5,416 views",Liibaan Jama,5416,5416,0
2023,"NIMCO DAREEN 2016 IIDAA LUUYUU OFFICIAL SONG (DIRECTED BY STUDIO LIIBAAN) by Liibaan Jama 6 years ago 5 minutes, 18 seconds 98,857 views",Liibaan Jama,98857,98862,5
2024,"SAHRUUJA IYO XAAJI 2016 OFFICIAL VIDEO (DIRECTED BY STUDIO LIIBAAN) by Liibaan Jama 6 years ago 9 minutes 145,378 views",Liibaan Jama,145378,145472,94
2025,"CAAMIR ZAKI 2016 DEEQA OFFICIAL VIDEO (DIRECTED BY STUDIO LIIBAAN) by Liibaan Jama 6 years ago 3 minutes, 25 seconds 191,167 views",Liibaan Jama,191167,191276,109
2026,"AWALE ADAN 2016 GUJADA KALGACAYLKA OFFICIAL VIDEO (DIRECTED BY STUDIO LIIBAAN) by Liibaan Jama 6 years ago 6 minutes, 47 seconds 1,556,324 views",Liibaan Jama,1556324,1564313,7989
2027,"OMAR SHOOLI 2016 DUMARKA OFFICIAL VIDEO (DIRECTED BY STUDIO LIIBAAN) by Liibaan Jama 6 years ago 5 minutes, 5 seconds 496,703 views",Liibaan Jama,496703,497449,746
2028,"AWALE, DALMAR, ISKALAAJI 2016 TIIRSHA QARANKEENA OFFICIAL VIDEO (DIRECTED BY STUDIO LIIBAAN) by Liibaan Jama 6 years ago 8 minutes, 27 seconds 874,855 views",Liibaan Jama,874855,876149,1294
2029,"MOHAMED BOQOL 2016 MUNA OFFICIAL VIDEO (DIRECTED BY STUDIO LIIBAAN) by Liibaan Jama 6 years ago 5 minutes, 29 seconds 13,069 views",Liibaan Jama,13069,13075,6
2030,"ISKALAAJI IYO ILKACASE THEY EUROPEAN TOUR STARTS IN NEXT TWO DAYS DON'T MISS IT THANK YOU by Liibaan Jama 6 years ago 2 minutes, 7 seconds 12,336 views",Liibaan Jama,12336,12340,4
2031,"CAAQIL YARE 2016 MALYUUN OFFICIAL VIDEO (DIRECTED BY STUDIO LIIBAAN) by Liibaan Jama 6 years ago 5 minutes, 12 seconds 243,847 views",Liibaan Jama,243847,243920,73
2032,"SIYAAD WANTED 2016 JELBEEB OFFICIAL VIDEO (DIRECTED BY STUDIO LIIBAAN) by Liibaan Jama 6 years ago 5 minutes, 22 seconds 120,949 views",Liibaan Jama,120949,121128,179
2033,"SAHRUUJA 2015 WIILKA WIIL WAAYE OFFICIAL VIDEO (DIRECTED BY STUDIO LIIBAAN) by Liibaan Jama 6 years ago 6 minutes, 31 seconds 332,554 views",Liibaan Jama,332554,332824,270
2034,"CABDI ABIIB 2015 DEEQA OFFICIAL SONG (DIRECTED BY STUDIO LIIBAAN) by Liibaan Jama 6 years ago 6 minutes, 43 seconds 21,581 views",Liibaan Jama,21581,21603,22
2035,"DEEQA AHMED 2015 ALA JIIBI OFFICIAL SONG (DIRECTED BY STUDIO LIIBAAN) by Liibaan Jama 6 years ago 6 minutes, 6 seconds 13,065 views",Liibaan Jama,13065,13075,10
2036,"BILAN ADAN 2015 HIIRTAANYO OFFICIAL VIDEO (DIRECTED BY STUDIO LIIBAAN) by Liibaan Jama 6 years ago 4 minutes, 50 seconds 13,333 views",Liibaan Jama,13333,13336,3
2037,"WARDA KARAMA 2015 NABADA OFFICIAL VIDEO (DIRECTED BY STUDIO LIIBAAN) by Liibaan Jama 6 years ago 7 minutes, 51 seconds 67,793 views",Liibaan Jama,67793,67860,67
2038,"AWALE ADAN 2015 TAMASHLEYN OFFICIAL VIDEO (DIRECTED BY STUDIO LIIBAAN) by Liibaan Jama 6 years ago 5 minutes, 28 seconds 14,184,944 views",Liibaan Jama,14184944,14256976,72032
2039,"OSMAN MONTREAL 2015 KHADRA OFFICIAL VIDEO (DIRECTED BY STUDIO LIIBAAN) by Liibaan Jama 6 years ago 5 minutes, 37 seconds 10,305 views",Liibaan Jama,10305,10316,11
2040,"SAHRUUJA 2015 HILIMO OFFICIAL VIDEO (DIRECTED BY STUDIO LIIBAAN) by Liibaan Jama 6 years ago 4 minutes, 53 seconds 61,988 views",Liibaan Jama,61988,62045,57
2041,"HODAN ABDIRAHMAN 2015 SIYAR SIYAR OFFICIAL VIDEO (DIRECTED BY STUDIO LIIBAAN) by Liibaan Jama 6 years ago 5 minutes, 40 seconds 6,692 views",Liibaan Jama,6692,6703,11
2042,"HODAN ABDIRAHMAN 2015 DABIIB OFFICIAL VIDEO (DIRECTED BY STUDIO LIIBAAN) by Liibaan Jama 6 years ago 7 minutes, 56 seconds 630,819 views",Liibaan Jama,630819,634094,3275
2043,"DALMAR YARE 2015 BILIC OFFICIAL VIDEO (DIRECTED BY STUDIO LIIBAAN) by Liibaan Jama 6 years ago 9 minutes, 59 seconds 163,571 views",Liibaan Jama,163571,163706,135
2044,"AHZAAB OSMAN IYO OMAR SHOOLI 2015 WAX DHINTAA OFFICIAL SONG (DIRECTED BY STUDIO LIIBAAN) by Liibaan Jama 6 years ago 7 minutes, 8 seconds 113,705 views",Liibaan Jama,113705,113916,211
2045,"MOHAMED ALTA 2015 XILO OFFICIAL VIDEO (DIRECTED BY STUDIO LIIBAAN) by Liibaan Jama 6 years ago 8 minutes, 54 seconds 295,063 views",Liibaan Jama,295063,295252,189
2046,"HODAN ABDIRAHMAN 2015 JAALE OFFICIAL VIDEO (DIRECTED BY STUDIO LIIBAAN) by Liibaan Jama 6 years ago 9 minutes, 50 seconds 4,290,403 views",Liibaan Jama,4290403,4310358,19955
2047,"HODAN ABDIRAHMAN IYO MOHAMED ALTA 2015 MATAANO OFFICIAL VIDEO (DIRECTED BY STUDIO LIIBAAN) by Liibaan Jama 6 years ago 13 minutes, 17 seconds 3,872,504 views",Liibaan Jama,3872504,3883864,11360
2048,"DALMAR YARE 2015 HOOYO OFFICIAL VIDEO (DIRECTED BY STUDIO LIIBAAN) by Liibaan Jama 6 years ago 11 minutes, 28 seconds 570,444 views",Liibaan Jama,570444,571735,1291
2049,"BOQOL, HODAN, DALMAR, SAHRUUJA, ALTA 2015 GALMUDUG WAXEY OFFICIAL VIDEO (DIRECTED BY STUDIO LIIBAAN) by Liibaan Jama 6 years ago 8 minutes, 36 seconds 844,281 views",Liibaan Jama,844281,846887,2606
2050,"XAFLADII GALMUDUG STATE 2015 MAINE PORTLAND OFFICIAL VIDEO (DIRECTED BY STUDIO LIIBAAN) by Liibaan Jama 6 years ago 1 hour, 50 minutes 12,258 views",Liibaan Jama,12258,12263,5
2051,"ALTA, HODAN, BOQOL, DALMAR 2015 GALMUDUG CURATAYE OFFICIAL VIDEO (DIRECTED BY STUDIO LIIBAAN) by Liibaan Jama 6 years ago 6 minutes, 8 seconds 525,149 views",Liibaan Jama,525149,526086,937
2052,"ABDULLAHI BOQOL 2015 GALMUDUG OFFICIAL VIDEO (DIRECTED BY STUDIO LIIBAAN) by Liibaan Jama 6 years ago 6 minutes, 13 seconds 108,396 views",Liibaan Jama,108396,108562,166
2053,"OMAR SHOOLI 2015 AXDI OFFICIAL VIDEO (DIRECTED BY STUDIO LIIBAAN) by Liibaan Jama 6 years ago 4 minutes, 49 seconds 476,927 views",Liibaan Jama,476927,478127,1200
2054,"CAAMIR ZAKI IYO JAWHAR DARWISH 2015 AAWAY OFFICIAL VIDEO (DIRECTED BY STUDIO LIIBAAN) by Liibaan Jama 6 years ago 7 minutes, 40 seconds 593,313 views",Liibaan Jama,593313,594094,781
2055,"MOORKA YARE 2015 BILIC OFFICIAL SONG (BY STUDIO LIIBAAN) by Liibaan Jama 6 years ago 5 minutes, 49 seconds 3,770 views",Liibaan Jama,3770,3770,0
2056,"MOHAMED YOOCAALE 2015 GEERAAR SOMALIA OFFICIAL VIDEO (DIRECTED BY STUDIO LIIBAAN) by Liibaan Jama 6 years ago 4 minutes, 4 seconds 4,043 views",Liibaan Jama,4043,4044,1
2057,"YASMIIN DARAJO 2015 GACAL OFFICIAL VIDEO DIRECTED (BY STUDIO LIIBAAN) by Liibaan Jama 6 years ago 5 minutes, 34 seconds 30,270 views",Liibaan Jama,30270,30280,10
2058,"HEESTII DHIIRANE 2015 OYSU-MN OFFICIAL VIDEO (DIRECTED BY STUDIO LIIBAAN) by Liibaan Jama 6 years ago 4 minutes, 17 seconds 33,955 views",Liibaan Jama,33955,33974,19
2059,"SAALAX IYO RAXMA 2015 DHAANTO CUSUB OFFICIAL VIDEO (DIRECTED BY STUDIO LIIBAAN) by Liibaan Jama 6 years ago 5 minutes, 52 seconds 60,413 views",Liibaan Jama,60413,60424,11
2060,"QOOMAAL 2015 BAREEY OFFICIAL VIDEO (DIRECTED BY STUDIO LIIBAAN) by Liibaan Jama 6 years ago 4 minutes, 39 seconds 19,764 views",Liibaan Jama,19764,19782,18
2061,"OMAR SHOOLI 2015 INTASAAR OFFICIAL VIDEO (DIRECTED BY STUDIO LIIBAAN) by Liibaan Jama 6 years ago 7 minutes, 55 seconds 67,841 views",Liibaan Jama,67841,67962,121
2062,"ABDULLAHI BAAJIYO 2015 GABLEEY ANIGA KUTUMAA OFFICIAL VIDEO (DIRECTED BY STUDIO LIIBAAN) by Liibaan Jama 6 years ago 4 minutes, 17 seconds 10,479 views",Liibaan Jama,10479,10484,5
2063,"AWALE ADAN 2015 GALMUDUG OFFICIAL SONG (BY STUDIO LIIBAAN) by Liibaan Jama 6 years ago 6 minutes, 30 seconds 52,214 views",Liibaan Jama,52214,52271,57
2064,"NAJAX DEEQSI 2015 NAJMA OFFICIAL SONG (BY STUDIO LIIBAAN) by Liibaan Jama 6 years ago 7 minutes, 24 seconds 113,101 views",Liibaan Jama,113101,113270,169
2065,"OMAR SHOOLI 2015 FALANQO OFFICIAL VIDEO (DIRECTED BY STUDIO LIIBAAN) by Liibaan Jama 6 years ago 6 minutes, 18 seconds 237,149 views",Liibaan Jama,237149,237508,359
2066,"SAMATAR YARE 2015 KALSOONI OFFICIAL VIDEO (DIRECTED BY STUDIO LIIBAAN) by Liibaan Jama 6 years ago 6 minutes, 56 seconds 36,572 views",Liibaan Jama,36572,36628,56
2067,"DALMAR YARE 2015 CAWO OFFICIAL VIDEO (DIRECTED BY STUDIO LIIBAAN) by Liibaan Jama 6 years ago 7 minutes, 18 seconds 253,100 views",Liibaan Jama,253100,253198,98
2068,"ABDULLAHI GOOF 2015 DEQOW DARTAA OFFICIAL VIDEO (DIRECTED BY STUDIO LIIBAAN) by Liibaan Jama 6 years ago 5 minutes, 13 seconds 407,309 views",Liibaan Jama,407309,407571,262
2069,"DJ ICE REMIX 2015 DUMARKA OFFICIAL VIDEO (DIRECTED BY STUDIO LIIBAAN) by Liibaan Jama 6 years ago 3 minutes, 57 seconds 20,091 views",Liibaan Jama,20091,20254,163
2070,"GEEDI 2015 HUUBO IGA DHURO OFFICIAL SONG BY (STUDIO LIIBAAN) by Liibaan Jama 6 years ago 5 minutes, 49 seconds 6,803 views",Liibaan Jama,6803,6806,3
2071,"RIWAAYAD CUSUB 2015 DULMI AAN LAGA DOODIN OFFICIAL FILM (DIRECTED BY STUDIO LIIBAAN) by Liibaan Jama 6 years ago 20 minutes 28,935 views",Liibaan Jama,28935,28935,0
2072,"KHADIIJA YUUSUF IYO MIRE CILMI GURE 2015 WIXI DIL IYO BOOB DHACAY OFFICIAL SONG (BY STUDIO LIIBAAN) by Liibaan Jama 6 years ago 13 minutes, 11 seconds 2,998 views",Liibaan Jama,2998,2998,0
2073,"SIR MOHAMUD 2015 NAJAAD OFFICIAL VIDEO (DIRECTED BY STUDIO LIIBAAN) by Liibaan Jama 6 years ago 4 minutes, 10 seconds 80,704 views",Liibaan Jama,80704,80721,17
2074,"MOORKA YARE 2015 HANBAYADII MUSTAR IYO SUCDI OFFICIAL SONG (BY STUDIO LIIBAAN) by Liibaan Jama 6 years ago 5 minutes, 51 seconds 3,706 views",Liibaan Jama,3706,3706,0
2075,"HODAN ABDIRAHMAN IYO SIR MOHAMUD 2015 DHULKAYGA (DIRECTED BY STUDIO LIIBAAN) by Liibaan Jama 6 years ago 5 minutes, 48 seconds 509,264 views",Liibaan Jama,509264,509776,512
2076,"FARHIYA FISKA IYO C/ASIIS ISKALAAJI 2015 HAMBALYADII MUSTAF KARAMA IYO SUCDI ABDI  (STUDIO LIIBAAN) by Liibaan Jama 6 years ago 4 minutes, 38 seconds 23,434 views",Liibaan Jama,23434,23443,9
2077,"AWEES QALBI 2015 MALYUUN OFFICIAL VIDEO (DIRECTED BY STUDIO LIIBAAN) by Liibaan Jama 6 years ago 3 minutes, 30 seconds 7,765 views",Liibaan Jama,7765,7770,5
2078,"ISKALAAJI IYO LAKI HAJI 2015 HALYEEY OFFICIAL SONG (BY STUDIO LIIBAAN) by Liibaan Jama 6 years ago 8 minutes, 46 seconds 37,099 views",Liibaan Jama,37099,37117,18
2079,"C/RASHIID CALI XAMARI 2015 CALAF OFFICIAL SONG (BY LIIBAAN STUDIO) by Liibaan Jama 6 years ago 4 minutes, 40 seconds 12,416 views",Liibaan Jama,12416,12435,19
2080,"MIRE CILMI GURE IYO KOOXDII ONKOD 2015 MAXAA DHAXANSHEEN OFFICIAL VIDEO DIRECTED (BY STUDIO LIIBAAN) by Liibaan Jama 6 years ago 8 minutes, 50 seconds 4,424 views",Liibaan Jama,4424,4425,1
2081,"FARHAAN SHIINE 2015 SULEEQO OFFICIAL SONG (BY LIIBAAN STUDIO) by Liibaan Jama 6 years ago 5 minutes, 1 second 5,773 views",Liibaan Jama,5773,5774,1
2082,"SAMATAR YARE 2015 LAYLA OFFICIAL VIDEO (DIRECTED BY STUDIO LIIBAAN) by Liibaan Jama 6 years ago 3 minutes, 2 seconds 72,646 views",Liibaan Jama,72646,72666,20
2083,"MIRE CILMI GURE IYO SHUKRI SHEEKH CIISE 2015 CANABEEY OFFICIAL SONG (BY STUDIO LIIBAAN) by Liibaan Jama 6 years ago 10 minutes, 26 seconds 5,971 views",Liibaan Jama,5971,5978,7
2084,"ISKALAAJI 2015 IFRAAX OFFICIAL VIDEO (DIRECTED BY STUDIO LIIBAAN) by Liibaan Jama 6 years ago 5 minutes, 10 seconds 166,859 views",Liibaan Jama,166859,167162,303
2085,"SIYAAD INDHOBUUR 2015 HADANA INIGAA KUNACAY OFFICIAL VIDEO (DIRECTED BY STUDIO LIIBAAN) by Liibaan Jama 6 years ago 5 minutes, 36 seconds 26,362 views",Liibaan Jama,26362,26371,9
2086,"TAALIB 2015 CAASHAQA HA BAAYICI OFFICIAL VIDEO (DIRECTED BY STUDIO LIIBAAN) by Liibaan Jama 6 years ago 7 minutes, 6 seconds 9,540 views",Liibaan Jama,9540,9540,0
2087,"ADAN SHIMBIROLAYS 2015 HIDO OFFICIAL VIDEO (DIRECTED BY STUDIO LIIBAAN) by Liibaan Jama 6 years ago 7 minutes, 40 seconds 30,279 views",Liibaan Jama,30279,30361,82
2088,"OMAR DHIBO 2015 MARWO OFFICIAL VIDEO (DIRECTED BY STUDIO LIIBAAN) by Liibaan Jama 6 years ago 6 minutes, 56 seconds 126,578 views",Liibaan Jama,126578,126590,12
2089,"SAMATAR YARE 2015 JAWAABTII FARXIYA FISKA OFFICIAL VIDEO (DIRECTED BY STUDIO LIIBAAN) by Liibaan Jama 6 years ago 3 minutes, 48 seconds 1,006,211 views",Liibaan Jama,1006211,1006972,761
2090,"SAMATAR YARE & OMAR SHOOLI 2015 SABABTA OFFICIAL VIDEO (DIRECTED BY STUDIO LIIBAAN) by Liibaan Jama 7 years ago 5 minutes 91,618 views",Liibaan Jama,91618,91695,77
2091,"SAHRUUJA IYO XAAJI 2015 JIINBAAR OFFICIAL VIDEO (DIRECTED BY STUDIO LIIBAAN) by Liibaan Jama 7 years ago 7 minutes, 34 seconds 89,855 views",Liibaan Jama,89855,89890,35
2092,"AXMED NAAJI SACAD 2015 DALKEYGOOW OFFICIAL VIDEO (DIRECTED BY STUDIO LIIBAAN) by Liibaan Jama 7 years ago 4 minutes, 56 seconds 237,638 views",Liibaan Jama,237638,240148,2510
2093,"AXMED CALI CIGAAL 2015 GEEDAHA LIVE OFFICIAL VIDEO (DIRECTED BY STUDIO LIIBAAN) by Liibaan Jama 7 years ago 4 minutes, 59 seconds 105,223 views",Liibaan Jama,105223,105277,54
2094,"AXMED NAAJI SACAD IYO AXMED ALI CIGAAL 2015 HEESTA QURBA JOOGTA OFFICIAL VIDEO DIRECTED BY STUDIO LI by Liibaan Jama 7 years ago 10 minutes, 9 seconds 46,765 views",Liibaan Jama,46765,46859,94
2095,"DEEQA AHMED 2015 ALLEYLAHEE JACAYLKII  OFFICIAL VIDEO (DIRECTED BY STUDIO LIIBAAN) by Liibaan Jama 7 years ago 6 minutes, 10 seconds 1,027,092 views",Liibaan Jama,1027092,1029117,2025
2096,"WARDA KARAMA 2015 HAADA HUWA OFFICIAL VIDEO (DIRECTED BY STUDIO LIIBAAN) by Liibaan Jama 7 years ago 4 minutes, 17 seconds 300,894 views",Liibaan Jama,300894,301303,409
2097,"AWALE ADAN 2015 KABAN OFFICIAL SONG (DIRECTED BY STUDIO LIIBAAN) by Liibaan Jama 7 years ago 8 minutes, 9 seconds 58,828 views",Liibaan Jama,58828,58838,10
2098,"OMAR SHOOLI 2015 NIN JACEEL OFFICIAL VIDEO (DIRECTED BY STUDIO LIIBAAN) by Liibaan Jama 7 years ago 6 minutes, 53 seconds 2,806,290 views",Liibaan Jama,2806290,2833002,26712
2099,"ABDIRAHMAN DOWLO 2015 HOOYO OFFICIAL VIDEO (DIRECTED BY STUDIO LIIBAAN) by Liibaan Jama 7 years ago 6 minutes, 47 seconds 25,121 views",Liibaan Jama,25121,25127,6
2100,"KHADAR KAMBALA 2015 ZAMZAMEEY OFFICIAL SONG (DIRECTED BY STUDIO LIIBAAN) by Liibaan Jama 7 years ago 5 minutes, 19 seconds 9,818 views",Liibaan Jama,9818,9818,0
2101,"MUSTAF RASTO 2015 CAASHAQ OFFICIAL VIDEO (DIRECTED BY STUDIO LIIBAAN) by Liibaan Jama 7 years ago 3 minutes, 29 seconds 2,299,699 views",Liibaan Jama,2299699,2302495,2796
2102,"DALMAR YARE 2015 FARHIYA OFFICIAL SONG (DIRECTED BY STUDIO LIIBAAN) by Liibaan Jama 7 years ago 4 minutes, 56 seconds 24,848 views",Liibaan Jama,24848,24851,3
2103,"MUKTAR ADEERO & HODAN ABDIRAHMAN 2015 HIRRIYUMAAN OFFICIAL VIDEO (DIRECTED BY STUDIO LIIBAAN) by Liibaan Jama 7 years ago 6 minutes, 58 seconds 570,800 views",Liibaan Jama,570800,572509,1709
2104,"FARTUN OMAR 2015 HANAD OFFICIAL VIDEO (DIRECTED BY STUDIO LIIBAAN) by Liibaan Jama 7 years ago 6 minutes, 34 seconds 227,736 views",Liibaan Jama,227736,227987,251
2105,"DEEQA AHMED 2015 NASIIB OFFICIAL VIDEO (DIRECTED BY STUDIO LIIBAAN) by Liibaan Jama 7 years ago 5 minutes, 48 seconds 157,451 views",Liibaan Jama,157451,157564,113
2106,"FARTUN OMAR 2015 HOLLAND SHOW by Liibaan Jama 7 years ago 26 seconds 25,379 views",Liibaan Jama,25379,25389,10
2107,"KOOXDII DDSI 2015 WAXBARASHO OFFICIAL VIDEO DIRECTED BY STUDIO LIIBAAN by Liibaan Jama 7 years ago 4 minutes, 24 seconds 21,538 views",Liibaan Jama,21538,21543,5
2108,"AHZAAB OSMAN IYO ZAKI 2015 DHAANTO HUUNO OFFICIAL VIDEO (DIRECTED BY STUDIO LIIBAAN) by Liibaan Jama 7 years ago 5 minutes, 6 seconds 219,740 views",Liibaan Jama,219740,219847,107
2109,"ABDI NUUR DALJIR 2015 DAHABEY OFFICIAL VIDEO (DIRECTED BY STUDIO LIIBAAN) by Liibaan Jama 7 years ago 7 minutes, 43 seconds 26,055 views",Liibaan Jama,26055,26086,31
2110,"WARDA KARAMA 2015 SULDAAN QAABUS OFFICIAL VIDEO (DIRECTED BY STUDIO LIIBAAN) by Liibaan Jama 7 years ago 6 minutes, 6 seconds 70,652 views",Liibaan Jama,70652,70708,56
2111,"WARDA KARAMA 2015 RIIXAAN OFFICIAL VIDEO (DIRECTED BY STUDIO LIIBAAN) by Liibaan Jama 7 years ago 5 minutes, 59 seconds 290,995 views",Liibaan Jama,290995,291674,679
2112,"AHZAAB OSMAN UBAX 2015 OFFICIAL SONG (BY STUDIO LIIBAAN) by Liibaan Jama 7 years ago 5 minutes, 34 seconds 55,994 views",Liibaan Jama,55994,56013,19
2113,"DEEQA AXMED GEYDH 2015 ILA MUUDSO CAASHAQA OFFICIAL VIDEO (DIRECTED BY STUDIO LIIBAAN) by Liibaan Jama 7 years ago 4 minutes, 31 seconds 688,014 views",Liibaan Jama,688014,689676,1662
2114,"AWALE ADAN FEAT  KABAYARE 2015 KU OGOLIYAA OFFICIAL VIDEO (DIRECTED BY STUDIO LIIBAAN) by Liibaan Jama 7 years ago 5 minutes, 11 seconds 13,732,292 views",Liibaan Jama,13732292,13792326,60034
2115,"OMAR SHOOLI 2014 LARBAA OFFICIAL VIDEO (DIRECTED BY STUDIO LIIBAAN) by Liibaan Jama 7 years ago 5 minutes, 49 seconds 240,122 views",Liibaan Jama,240122,240781,659
2116,"SOUGEH CA/LLAHI BOQOREH 2014 NIMCO OFFICIAL VIDEO (DIRECTED BY STUDIO LIIBAAN) by Liibaan Jama 7 years ago 4 minutes, 36 seconds 10,259 views",Liibaan Jama,10259,10271,12
2117,"SAMATAR YARE 2014 DEEQA OFFICIAL VIDEO (DIRECTED BY STUDIO LIIBAAN) by Liibaan Jama 7 years ago 5 minutes, 1 second 41,499 views",Liibaan Jama,41499,41502,3
2118,"XAFLADII KHAATUMO STATE 2014 MPLS MN OFFICIAL VIDEO DIRECTED BY STUDIO LIIBAAN by Liibaan Jama 7 years ago 3 minutes, 42 seconds 9,404 views",Liibaan Jama,9404,9406,2
2119,"DAGAANADA GALMUDUG 2014 OFFICIAL VIDEO (DIRECTED BY STUDIO LIIBAAN) by Liibaan Jama 7 years ago 5 minutes, 50 seconds 241,445 views",Liibaan Jama,241445,241988,543
2120,"XAFLADII KHAATUMO STATE 2014 MINNEAPOLIS MN OFFICIAL VIDEO (DIRECTED BY STUDIO LIIBAAN) by Liibaan Jama 7 years ago 6 minutes, 37 seconds 11,595 views",Liibaan Jama,11595,11597,2
2121,"SALDHIGTAYE GALMUDUG 2014 OFFICIAL VIDEO (DIRECTED BY STUDIO LIIBAAN) by Liibaan Jama 7 years ago 11 minutes, 17 seconds 993,890 views",Liibaan Jama,993890,996720,2830
2122,"XAFLADII KHAATUMO STATE 2014 MINNEAPOLIS OFFICIAL VIDEO (DIRECTED BY STUDIO LIIBAAN) by Liibaan Jama 7 years ago 8 minutes, 42 seconds 55,085 views",Liibaan Jama,55085,55101,16
2123,"FARHIYA KABAYARE 2014 AROOSKII MAHAD IYO HABOON OFFICIAL VIDEO (DIRECTED BY STUDIO LIIBAAN) by Liibaan Jama 7 years ago 6 minutes, 19 seconds 1,039,444 views",Liibaan Jama,1039444,1040652,1208
2124,"AHZAAB OSMAN 2014 HILACA ROOBKA OFFICIAL VIDEO (DIRECTED BY STUDIO LIIBAAN) by Liibaan Jama 7 years ago 5 minutes, 59 seconds 3,514,863 views",Liibaan Jama,3514863,3525665,10802
2125,"SAMATAR YARE 2014 DAGAN OFFICIAL VIDEO (DIRECTED BY STUDIO LIIBAAN) by Liibaan Jama 7 years ago 4 minutes, 48 seconds 80,781 views",Liibaan Jama,80781,80844,63
2126,"SOO DHAWEEYN TII FARHIYA KABAYARE IYO PARTY IN EDMONTON CANADA FRIDAY AUGUST 1 2014 by Liibaan Jama 7 years ago 3 minutes, 48 seconds 200,623 views",Liibaan Jama,200623,200642,19
2127,"XAAJI 2014 SAAFI OFFICIAL VIDEO (DIRECTED BY STUDIO LIIBAAN) by Liibaan Jama 7 years ago 4 minutes, 39 seconds 9,651 views",Liibaan Jama,9651,9651,0
2128,"OMAR SHOOLI 2014 CILMI OFFICIAL VIDEO (DIRECTED BY STUDIO LIIBAAN) by Liibaan Jama 7 years ago 6 minutes, 6 seconds 50,353 views",Liibaan Jama,50353,50395,42
2129,"CUMAR DHIBO IYO ABWAAN KARLOS 2014 BAADIGOOB OFFICIAL VIDEO (DIRECTED BY STUDIO LIIBAAN) by Liibaan Jama 7 years ago 7 minutes, 13 seconds 10,537 views",Liibaan Jama,10537,10541,4
2130,"ABDI BAASID SH AXMED AWLIYO 2014 RIXLA TUSAAIQ OFFICIAL VIDEO DIRECTED BY STUDIO LIIBAAN by Liibaan Jama 7 years ago 8 minutes, 6 seconds 55,462 views",Liibaan Jama,55462,55614,152
2131,"MUKTAR ADEERO 2014 DAGAN OFFICIAL SONG (BY STUDIO LIIBAAN) by Liibaan Jama 7 years ago 6 minutes, 46 seconds 37,463 views",Liibaan Jama,37463,37546,83
2132,"MURSAL MUSE 2014 SAADAASHA OFFICIAL SONG (BY STUDIO LIIBAAN) by Liibaan Jama 7 years ago 5 minutes, 53 seconds 13,400 views",Liibaan Jama,13400,13407,7
2133,"AWALE ADAN 2014 PUTLAND OFFICIAL SONG BY STUDIO LIIBAAN by Liibaan Jama 7 years ago 5 minutes, 8 seconds 29,174 views",Liibaan Jama,29174,29182,8
2134,"AWALE ADAN 2014 XIJAAB OFFICIAL SONG (BY STUDIO LIIBAAN) by Liibaan Jama 7 years ago 5 minutes, 45 seconds 275,754 views",Liibaan Jama,275754,277075,1321
2135,"FARTUN OMAR 2014 WANAAG OFFICIAL VIDEO (DIRECTED BY STUDIO LIIBAAN) by Liibaan Jama 7 years ago 6 minutes, 23 seconds 246,642 views",Liibaan Jama,246642,246978,336
2136,"DEEQA BILAN 2014 CALANKEYGA OFFICIAL SONG BY STUDIO LIIBAAN by Liibaan Jama 7 years ago 5 minutes, 35 seconds 12,618 views",Liibaan Jama,12618,12620,2
2137,"MOHAMED ALTA 2014 HOOBAAN OFFICIAL VIDEO (DIRECTED BY STUDIO LIIBAAN) by Liibaan Jama 7 years ago 6 minutes, 19 seconds 170,341 views",Liibaan Jama,170341,170416,75
2138,"NASTEEXO CIISE INDHO 2014 DAREEN OFFICIAL VIDEO DIRECTED BY STUDIO LIIBAAN by Liibaan Jama 7 years ago 6 minutes, 17 seconds 437,358 views",Liibaan Jama,437358,437850,492
2139,"HODAN ABDIRAHMAN IYO ISKALAAJI 2014 HANASHO OFFICIAL VIDEO (DIRECTED BY STUDIO LIIBAAN) by Liibaan Jama 7 years ago 6 minutes, 43 seconds 4,880,877 views",Liibaan Jama,4880877,4895232,14355
2140,"MUKTAR ADEERO 2014 OROMIA SONG OFFICIAL SONG BY STUDIO LIIBAAN by Liibaan Jama 7 years ago 6 minutes, 36 seconds 36,052 views",Liibaan Jama,36052,36087,35
2141,"DEEQA AHMED 2014 ALA MUUDSO CAANSHANQA OFFICIAL SONG BY STUDIO LIIBAAN by Liibaan Jama 7 years ago 4 minutes, 28 seconds 36,533 views",Liibaan Jama,36533,36548,15
2142,"SIR MOHAMUD 2014 ZAYNAB OFFICIAL SONG (BY STUDIO LIIBAAN) by Liibaan Jama 7 years ago 4 minutes, 12 seconds 9,769 views",Liibaan Jama,9769,9770,1
2143,"FARHIYA FISKA IYO MUSTAFA KARAMA 2014 NABSI OFFICIAL SONG (DIRECTED BY STUDIO LIIBAAN) by Liibaan Jama 7 years ago 2 minutes, 5 seconds 60,197 views",Liibaan Jama,60197,60206,9
2144,"ZAHUUR AHMED 2014 DANQASHO OFFICIAL VIDEO (DIRECTED BY STUDIO LIIBAAN) by Liibaan Jama 7 years ago 3 minutes, 11 seconds 77,907 views",Liibaan Jama,77907,77915,8
2145,"FADUMIINA 2014 XABIIBI OFFICIAL SONG (DIRECTED BY STUDIO LIIBAAN) by Liibaan Jama 8 years ago 4 minutes, 24 seconds 20,420 views",Liibaan Jama,20420,20427,7
2146,"OMAR SHOOLI 2014 FARDOWSA OFFICIAL VIDEO (DIRECTED BY STUDIO LIIBAAN) by Liibaan Jama 8 years ago 4 minutes, 3 seconds 492,843 views",Liibaan Jama,492843,492871,28
2147,"DULUF 2014 DAL IYO DUUNYO OFFICIAL VIDEO (DIRECTED BY STUDIO LIIBAAN) by Liibaan Jama 8 years ago 5 minutes, 32 seconds 200,402 views",Liibaan Jama,200402,201303,901
2148,"HODAN ABDIRAHMAN 2014 HOTELADA OFFICIAL VIDEO (DIRECTED BY STUDIO LIIBAAN) by Liibaan Jama 8 years ago 7 minutes, 28 seconds 5,714,938 views",Liibaan Jama,5714938,5736024,21086
2149,"MOHAMED ALTA IYO DALMAR YARE 2014 BOSNIYA OFFICIAL VIDEO (DIRECTED BY STUDIO LIIBAAN) by Liibaan Jama 8 years ago 6 minutes, 19 seconds 3,270,452 views",Liibaan Jama,3270452,3279435,8983
2150,"AHZAAB OSMAN 2014 ADKEEYSO OFFICIAL VIDEO (DIRECTED BY STUDIO LIIBAAN) by Liibaan Jama 8 years ago 6 minutes, 15 seconds 6,466,758 views",Liibaan Jama,6466758,6481753,14995
2151,"SAMATAR YARE 2014 MUXIBO OFFICIAL SONG (BY STUDIO LIIBAAN) by Liibaan Jama 8 years ago 3 minutes, 9 seconds 14,887 views",Liibaan Jama,14887,14889,2
2152,"AWALE ADAN 2014 BAREEDDU OROMO OFFICIAL VIDEO (DIRECTED BY STUDIO LIIBAAN) by Liibaan Jama 8 years ago 4 minutes, 4 seconds 3,387,732 views",Liibaan Jama,3387732,3394202,6470
2153,"DEEQA BILAN IYO ABDIHAMIID ELMI 2014 SII CILAAMO OFFICIAL SONG (BY STUDIO LIIBAAN) by Liibaan Jama 8 years ago 9 minutes, 1 second 181,300 views",Liibaan Jama,181300,181348,48
2154,"ABDIWAHAB BOOSKA 2014 JIGJIGA OFFICIAL VIDEO (DIRECTED BY STUDIO LIIBAAN) by Liibaan Jama 8 years ago 6 minutes, 22 seconds 208,453 views",Liibaan Jama,208453,209227,774
2155,"GEEDI 2014 JAHEEYA OFFICIAL VIDEO (DIRECTED BY STUDIO LIIBAAN) by Liibaan Jama 8 years ago 4 minutes, 16 seconds 19,640 views",Liibaan Jama,19640,19641,1
2156,"SAMATAR YARE 2014 MUHASHO OFFICIAL VIDEO (DIRECTED BY STUDIO LIIBAAN) by Liibaan Jama 8 years ago 4 minutes, 54 seconds 191,586 views",Liibaan Jama,191586,191657,71
2157,"AWALE ADAN 2014 KU BAAFSHEY OFFICIAL VIDEO (DIRECTED BY STUDIO LIIBAAN) by Liibaan Jama 8 years ago 5 minutes, 6 seconds 4,954,481 views",Liibaan Jama,4954481,4980487,26006
2158,"NIMCO DAREEN 2013 NAFTEYDA OFFICIAL VIDEO (DIRECTED BY STUDIO LIIBAAN) by Liibaan Jama 8 years ago 4 minutes, 36 seconds 453,129 views",Liibaan Jama,453129,453367,238
2159,"MOHAMED ALTA 2013 TAAGDAREEYOO OFFICIAL VIDEO (DIRECTED BY STUDIO LIIBAAN) by Liibaan Jama 8 years ago 5 minutes, 51 seconds 322,829 views",Liibaan Jama,322829,322976,147
2160,"FARXAAN FIYOORE 2013 HAMDI OFFICIAL VIDEO (DIRECTED BY STUDIO LIIBAAN) by Liibaan Jama 8 years ago 6 minutes, 43 seconds 449,019 views",Liibaan Jama,449019,450335,1316
2161,"ALI BIRRA & MUKHTAR ADERRO 2013 OFFICIAL VIDEO DIRECTED BY (STUDIO LIIBAAN) by Liibaan Jama 8 years ago 5 minutes, 30 seconds 1,631,326 views",Liibaan Jama,1631326,1640880,9554
2162,"AWALE ADAN 2013 MAHDIA OFFICIAL VIDEO (DIRECTED BY STUDIO LIIBAAN) by Liibaan Jama 8 years ago 8 minutes, 41 seconds 1,224,357 views",Liibaan Jama,1224357,1232272,7915
2163,"QOOMAAL 2013 MARYANEEY OFFICIAL VEDIO (BY STUDIO LIIBAAN) by Liibaan Jama 8 years ago 4 minutes, 44 seconds 292,663 views",Liibaan Jama,292663,295459,2796
2164,"FARXIYO KABAYARE GOORMAAD II IMAN  OFFICIAL SONG BY (STUDIO LIIBAAN) by Liibaan Jama 8 years ago 2 minutes, 40 seconds 90,479 views",Liibaan Jama,90479,90488,9
2165,"FARXIYO KABAYARE HOOYO RUUN OFFICIAL SONG BY STUDIO LIIBAAN) by Liibaan Jama 8 years ago 3 minutes, 17 seconds 77,020 views",Liibaan Jama,77020,77025,5
2166,"AHZAAB OSMAN 2013 DEEQA LUULA OFFICIAL VIDEO DIRECTED BY (STUDIO LIIBAAN) by Liibaan Jama 8 years ago 7 minutes, 1 second 383,895 views",Liibaan Jama,383895,384346,451
2167,"AWALE ADAN 2013 TIRIIG OFFICIAL SONG BY (STUDIO LIIBAAN) by Liibaan Jama 8 years ago 6 minutes, 26 seconds 117,391 views",Liibaan Jama,117391,118037,646
2168,"DALMAR YARE 2013 WAAN IMANAYAA OFFICIAL VIDEO DIRECTED BY (STUDIO LIIBAAN) by Liibaan Jama 8 years ago 7 minutes, 55 seconds 783,005 views",Liibaan Jama,783005,786112,3107
2169,"NIMCO DAREEN FEAT BY LUUL JAYLAANI 2013 MACAANOW OFFICIAL VIDEO DIRECTED BY (STUDIO LIIBAAN) by Liibaan Jama 8 years ago 4 minutes, 21 seconds 1,982,911 views",Liibaan Jama,1982911,1990742,7831
2170,"MAHAD INDHO DEERO 2013 SAMIIRA OFFICIAL SONG (BY STUDIO LIIBAAN) by Liibaan Jama 8 years ago 2 minutes, 40 seconds 4,416 views",Liibaan Jama,4416,4419,3
2171,"AWALE ADAN 2013 DUMARKA OFFICIAL SONG (BY STUDIO LIIBAAN) by Liibaan Jama 8 years ago 6 minutes, 40 seconds 112,560 views",Liibaan Jama,112560,112648,88
2172,"HODAN ABDIRAHMAN 2013 EHANO OFFICIAL SONG BY (STUDIO LIIBAAN) by Liibaan Jama 8 years ago 3 minutes, 36 seconds 8,515 views",Liibaan Jama,8515,8518,3
2173,"ISTAAHIL DHEEMAN 2013 LIBTA CAASHAQA OFFICIAL VIDEO DIRECTED BY STUDIO LIIBAAN) by Liibaan Jama 8 years ago 4 minutes, 5 seconds 35,647 views",Liibaan Jama,35647,35700,53
2174,"AHZAAB OSMAN 2013 FILSAN OFFICIAL SONG (BY STUDIO LIIBAAN) by Liibaan Jama 8 years ago 6 minutes, 20 seconds 16,073 views",Liibaan Jama,16073,16074,1
2175,"HODAN ABDIRAHMAN CALAF LAMA SALUGEEY 2013 OFFICIAL SONG (EDITED BY STUDIO LIIBAAN) by Liibaan Jama 8 years ago 5 minutes, 52 seconds 30,076 views",Liibaan Jama,30076,30084,8
2176,"SAHRUUJA IYO OMAR SHOOLI DAADOY 2013 OFFICIAL VIDEO DIRECTED BY STUDIO LIIBAAN) by Liibaan Jama 8 years ago 7 minutes, 13 seconds 477,980 views",Liibaan Jama,477980,478690,710
2177,"JOOQLE HOOYO 2013 OFFICIAL VIDEO (DIRECTED BY STUDIO LIIBAAN) by Liibaan Jama 8 years ago 9 minutes, 23 seconds 176,422 views",Liibaan Jama,176422,176627,205
2178,"DULUF & SHOOLI 2013 HOBEEYA OFFICIAL VIDEO DIRECTED BY STUDIO LIIBAAN) by Liibaan Jama 8 years ago 4 minutes, 54 seconds 146,825 views",Liibaan Jama,146825,146896,71
2179,"FADUMA AHMED RAG IYO DUMAR 2013 OFFICIAL VIDEO (DIRECTED BY STUDIO LIIBAAN) by Liibaan Jama 8 years ago 5 minutes, 32 seconds 445,579 views",Liibaan Jama,445579,447932,2353
2180,"NIMCO YASIIN IYO ABDIJIBAR AL KHALIIJI GUUR ALLE 2013 OFFICIAL VIDEO (DIRECTED BY STUDIO LIIBAAN) by Liibaan Jama 8 years ago 5 minutes, 17 seconds 1,747,027 views",Liibaan Jama,1747027,1756948,9921
2181,"CIID JAMA DEEQA 2013 OFFICIAL VIDEO (DIRECTED BY STUDIO LIIBAAN) by Liibaan Jama 8 years ago 6 minutes, 17 seconds 27,890 views",Liibaan Jama,27890,28027,137
2182,"NASTEEXO INDHO 2013 XUJO JACEEL OFFICIAL VIDEO (DIRECTED BY STUDIO LIIBAAN) by Liibaan Jama 8 years ago 6 minutes, 20 seconds 858,689 views",Liibaan Jama,858689,859925,1236
2183,"QOOMAAL LAKEYEE 2013 OFFICIAL VIDEO (DIRECTED BY STUDIO LIIBAAN) by Liibaan Jama 8 years ago 5 minutes, 1 second 45,813 views",Liibaan Jama,45813,46198,385
2184,"JOOQLE IKRAAN 2013 OFFICIAL VIDEO (DIRECTED BY STUDIO LIIBAAN) by Liibaan Jama 8 years ago 6 minutes, 18 seconds 179,420 views",Liibaan Jama,179420,180338,918
2185,"ZAHUR 2013 DIB WAXAY KA NOQOTANA OFFICIAL VIDEO (DIRECTED BY STUDIO LIIBAAN) by Liibaan Jama 8 years ago 3 minutes, 31 seconds 223,993 views",Liibaan Jama,223993,224061,68
2186,"XAWO KIIN 2013 GOCASHO OFFICIAL VIDEO (DIRECTED BY STUDIO LIIBAAN) by Liibaan Jama 8 years ago 7 minutes, 37 seconds 164,881 views",Liibaan Jama,164881,164928,47
2187,"ZAHUR 2013 NASIIB OFFICIAL VIDEO (DIRECTED BY STUDIO LIIBAAN) by Liibaan Jama 8 years ago 5 minutes, 9 seconds 191,457 views",Liibaan Jama,191457,191490,33
2188,"AWALE ADAN 2013 CADAALAD OFFICIAL SONG (BY STUDIO LIIBAAN) by Liibaan Jama 8 years ago 5 minutes, 9 seconds 50,054 views",Liibaan Jama,50054,50090,36
2189,"CAWALE ADAN 2013 XAMAR OFFICIAL SONG (BY STUDIO LIIBAAN) by Liibaan Jama 8 years ago 5 minutes, 1 second 17,588 views",Liibaan Jama,17588,17589,1
2190,"XAAWO KIIN 2013 XAKAMAHA ADKEEY OFFICIAL VIDEO (DIRECTED BY STUDIO LIIBAAN) by Liibaan Jama 8 years ago 5 minutes, 47 seconds 322,730 views",Liibaan Jama,322730,322981,251
2191,"SHUKRI FARAH SINDIKO 2013 DUCEYSANOOW OFFICIAL SONG (BY STUDIO LIIBAAN) by Liibaan Jama 8 years ago 5 minutes, 21 seconds 20,435 views",Liibaan Jama,20435,20440,5
2192,"SAHRO CUMAR DHUULE IYO CABDI CASIIS ISKALAAJI 2013 KAAMILO OFFICIAL SONG (BY STUDIO LIIBAAN) by Liibaan Jama 9 years ago 8 minutes, 21 seconds 32,516 views",Liibaan Jama,32516,32529,13
2193,"XAAWO KIIN 2013 JIDBO OFFICIAL VIDEO (DIRECTED BY STUDIO LIIBAAN) by Liibaan Jama 9 years ago 6 minutes, 49 seconds 522,547 views",Liibaan Jama,522547,522984,437
2194,"XAAWO KIIN 2013 HA IGA ROORIN OFFICIAL VIDEO (DIRECTED BY STUDIO LIIBAAN) by Liibaan Jama 9 years ago 5 minutes, 28 seconds 2,398,494 views",Liibaan Jama,2398494,2413194,14700
2195,"OMAR SHOOLI FEAT MUKHTAR ADEERO 2013 LABO MIIRA OFFICIAL VIDEO (DIRECTED BY STUDIO LIIBAAN) by Liibaan Jama 9 years ago 4 minutes, 12 seconds 77,728 views",Liibaan Jama,77728,77903,175
2196,"HODAN ABDIRAHMAN IYO MUKHTAR ADEERO 2013 DACWO OFFICIAL SONG (BY STUDIO LIIBAAN) by Liibaan Jama 9 years ago 7 minutes, 15 seconds 1,138,790 views",Liibaan Jama,1138790,1140831,2041
2197,"MAHAD INDHODEERO 2013 SOOL IYO NUGAAL OFFICIAL SONG (BY STUDIO LIIBAAN) by Liibaan Jama 9 years ago 4 minutes, 30 seconds 9,326 views",Liibaan Jama,9326,9326,0
2198,"MAHAD JEESTO 2013 DOWLADNIMO OFFICIAL SONG (BY STUDIO LIIBAAN) by Liibaan Jama 9 years ago 5 minutes, 21 seconds 16,190 views",Liibaan Jama,16190,16190,0
2199,"OMAR SHOOLI 2013 UUR KUTAALADAYDII OFFICIAL VIDEO (DIRECTED BY STUDIO LIIBAAN) by Liibaan Jama 9 years ago 5 minutes, 15 seconds 202,087 views",Liibaan Jama,202087,202381,294
2200,"ISKALAAJI IYO FARTUUN OMAR 2013 HAB ISII OFFICIAL VIDEO (DIRECTED BY STUDIO LIIBAAN) by Liibaan Jama 9 years ago 8 minutes, 5 seconds 723,272 views",Liibaan Jama,723272,724259,987
2201,"AHMED GAASHAANLE 2013 MASAAFO OFFICIAL VIDEO DIRECTED BY (STUDIO LIIBAAN) by Liibaan Jama 9 years ago 7 minutes, 1 second 322,217 views",Liibaan Jama,322217,325698,3481
2202,"AWALE ADAN 2013 LAYAABAY OFFICIAL VIDEO (DIRECTED BY STUDIO LIIBAAN) by Liibaan Jama 9 years ago 4 minutes, 46 seconds 3,819,438 views",Liibaan Jama,3819438,3851358,31920
2203,"AHZAAB 2012 CASHA OFFICIAL SONG (STUDIO LIIBAAN) by Liibaan Jama 9 years ago 5 minutes, 36 seconds 31,415 views",Liibaan Jama,31415,31452,37
2204,"FARTUUN OMAR AND AHMED GAASHAANLE 2012 IIKAALAY OFFICIAL VIDEO (DIRECTED BY STUDIO LIIBAAN) by Liibaan Jama 9 years ago 5 minutes, 33 seconds 297,850 views",Liibaan Jama,297850,298077,227
2205,"AHMED GAASHAANLE 2012 DHOOF OFFICIAL VIDEO (DIRECTED BY STUDIO LIIBAAN) by Liibaan Jama 9 years ago 6 minutes, 16 seconds 95,540 views",Liibaan Jama,95540,95817,277
2206,"OMAR SHOOLI 2012  KUTAALADAYDII (STUDIO LIIBAAN) by Liibaan Jama 9 years ago 4 minutes, 35 seconds 6,463 views",Liibaan Jama,6463,6463,0
2207,"OMAR SHOOLI 2012 SIDA LABA WA LAALA OFFICIAL VIDEO (DIRECTED BY STUDIO LIIBAAN) by Liibaan Jama 9 years ago 6 minutes, 12 seconds 821,957 views",Liibaan Jama,821957,823883,1926
2208,"FARHIYA KABAYARE 2012 NABDI OFFICIAL VIDEO (DIRECTED BY STUDIO LIIBAAN) by Liibaan Jama 9 years ago 5 minutes, 4 seconds 968,199 views",Liibaan Jama,968199,969042,843
2209,"ISKALAAJI 2012 COSOB OFFICIAL VIDEO (DIRECTED BY STUDIO LIIBAAN) by Liibaan Jama 9 years ago 5 minutes, 48 seconds 94,624 views",Liibaan Jama,94624,94765,141
2210,"MAHAD INDHO DEERO 2012 SAHRO (STUDIO LIIBAAN) by Liibaan Jama 9 years ago 9 minutes 9,569 views",Liibaan Jama,9569,9571,2
2211,"BAAJIYO 2012 SHAB SHABLEE ILA CIYAAR OFFICIAL VIDEO (DIRECTED BY STUDIO LIIBAAN) by Liibaan Jama 9 years ago 5 minutes, 40 seconds 13,999 views",Liibaan Jama,13999,14002,3
2212,"FARHIYA KABAYARE 2012 ZAMZAM OFFICIAL VIDEO (DIRECTED BY STUDIO LIIBAAN) by Liibaan Jama 9 years ago 16 minutes 2,029,665 views",Liibaan Jama,2029665,2035861,6196
2213,"AWALE ADAN 2012 SOMALI OFFICIAL VIDEO (DIRECTED BY STUDIO LIIBAAN) by Liibaan Jama 9 years ago 4 minutes, 1 second 14,292 views",Liibaan Jama,14292,14300,8
2214,"AWALE ADAN 2012 IDIL OFFICIAL VIDEO (DIRECTED BY STUDIO LIIBAAN) by Liibaan Jama 9 years ago 3 minutes, 35 seconds 3,999,475 views",Liibaan Jama,3999475,4045894,46419
