,Posts,Channel,Views_03/03,Views_03/12,view_delta
0,"Tokichaw and Gikdo Kasa -Hole Hama | ሆሌ ሐማ -New Ethiopian Sidama Music 2022(official video) by Mafi ያ Tube 7 days ago 5 minutes, 13 seconds 244 views",Mafi ያ Tube,244,488,244
1,"Didi Gaga ft Sancho Gebre - Kim Kim |ኪም ኪም - New Ethiopian Music 2022(official music Video) by Mafi ያ Tube 11 days ago 3 minutes, 36 seconds 1,479 views",Mafi ያ Tube,1479,2744,1265
2,"Temesgen G/Egziabher - Kebad | ከባድ -New Ethiopian music lyrics 2022(official lyrics) by Mafi ያ Tube 2 weeks ago 4 minutes, 45 seconds 436 views",Mafi ያ Tube,436,554,118
3,"Yared Negu and Sancho Gebre - Kula Kulo | ኩላኩሎ - New Ethiopian Music 2022(official video) by Mafi ያ Tube 2 weeks ago 4 minutes, 23 seconds 4,259 views",Mafi ያ Tube,4259,6045,1786
4,"DIDI GAGA - Woze | ዎዜ - Ethiopian New Lyrical and Dance music Video 2022 by Mafi ያ Tube 3 weeks ago 4 minutes, 16 seconds 458 views",Mafi ያ Tube,458,594,136
5,"Eden G/selassie and Amanuel Yilma - Abeney | ኣበነይ -New Ethiopian Tigray Music 2022 by Mafi ያ Tube 3 weeks ago 8 minutes, 3 seconds 186 views",Mafi ያ Tube,186,207,21
6,Subscribe by Mafi ያ Tube 1 month ago 24 seconds 17 views,Mafi ያ Tube,17,23,6
7,"Neahom And Selamawit - Tebleni | ተብለኒ - New Ethio-Ertria Music 2022(official video) by Mafi ያ Tube 1 month ago 6 minutes, 43 seconds 277 views",Mafi ያ Tube,277,296,19
8,"Selamawit Yohanis - Habeney | ሓበነይ - New Ethiopian Music 2022 (official video) by Mafi ያ Tube 1 month ago 5 minutes, 44 seconds 339 views",Mafi ያ Tube,339,369,30
9,"Abebe Teka - Bementa Tutochua | በመንታ ጡቶቿ - Ethiopian Lyrical and instrumental music 2022 by Mafi ያ Tube 1 month ago 5 minutes, 44 seconds 259 views",Mafi ያ Tube,259,341,82
10,"Dagi Boy - Ayinama | አይናማ - New Ethiopian Afro pop Cover Music 2022 (official Music) by Mafi ያ Tube 1 month ago 3 minutes, 41 seconds 989 views",Mafi ያ Tube,989,1191,202
11,Dagi Boy  Interview on South TV Ten years movements on many type of Art-የዳጊ ቦይ ቃለ መጠይቅ በደቡብ ቲቪ by Mafi ያ Tube 1 month ago 21 minutes 74 views,Mafi ያ Tube,74,76,2
12,"Danny flavour_funny video by Mafi ያ Tube 1 month ago 1 minute, 41 seconds 16 views",Mafi ያ Tube,16,17,1
13,"Biruk Bekele - Enbut tsigereda | እንቡጥ ፅጌሬዳ - New Ethiopian music 2021(official video) by Mafi ያ Tube 2 months ago 5 minutes, 24 seconds 91 views",Mafi ያ Tube,91,105,14
14,"Yared Negu - Man Alat | ማን አላት - New Ethiopian Music 2021 (official video) by Mafi ያ Tube 2 months ago 3 minutes, 43 seconds 224 views",Mafi ያ Tube,224,434,210
15,nigeruat challenge by Mafi ያ Tube 2 months ago 31 seconds 22 views,Mafi ያ Tube,22,36,14
16,"ጉድ ሰራችኝ ድንቅ ኮሜዲ ፊልም ስቀው ማቆም ካቃቶት ተሸንፈዋል ማለት ነው by Mafi ያ Tube 2 months ago 10 minutes, 17 seconds 35 views",Mafi ያ Tube,35,37,2
17,"Mahlet Gashaw - Fikr Bene tsento 90'th Cover |90' ቹ ከቨር - New Ethiopian cover music by Mafi ያ Tube 2 months ago 3 minutes, 20 seconds 65 views",Mafi ያ Tube,65,69,4
18,"Biniyam Tesema ft Gildo Kasa - Ney Ney | ነይ ነይ - New Ethiopian music video 2021(official video) by Mafi ያ Tube 2 months ago 4 minutes, 33 seconds 7,195 views",Mafi ያ Tube,7195,10210,3015
19,"Teme Shanto_×_Gildo Kasa - Daamo | ዳኣሞ - New Ethiopian Music video 2021(official video) by Mafi ያ Tube 2 months ago 4 minutes, 42 seconds 326 views",Mafi ያ Tube,326,335,9
20,"Lalem Muluneh - shekila Seriwa /ሸክላ ሰሪዋ - New Ethiopian Music 202(official Video) by Mafi ያ Tube 2 months ago 5 minutes, 25 seconds 123 views",Mafi ያ Tube,123,124,1
21,"Best Ethiopian Non stop music 2017-2021Collection by Mafi ያ Tube 3 months ago 3 hours, 37 minutes 704 views",Mafi ያ Tube,704,1121,417
22,"Yidota - Eden - Dagi Boy -Balebzu Kelem |ባለብዙ ቀለም -New Ethiopian Music 2021(official video) by Mafi ያ Tube 3 months ago 5 minutes, 43 seconds 66 views",Mafi ያ Tube,66,68,2
23,"Dagi Boy - Egna Enkomalen|እኛ እንቆማለን - New Ethiopian Defense force army Music 2021(official video) by Mafi ያ Tube 3 months ago 5 minutes, 14 seconds 97 views",Mafi ያ Tube,97,104,7
24,"Dagi Boy - Banchima | New Ethiopian Afro pop Cover music (cover music) by Mafi ያ Tube 3 months ago 3 minutes, 5 seconds 729 views",Mafi ያ Tube,729,798,69
25,Dagi Boy - Nigeruat | ንገሯት - New Ethiopian Music Video 2021(official video) by Mafi ያ Tube 3 months ago 4 minutes 163 views,Mafi ያ Tube,163,168,5
26,"Tekalign Paulos - Neka Bel | ነቃ በል - New Ethiopian Music 2021 (Official Video) by Mafi ያ Tube 3 months ago 4 minutes, 40 seconds 22 views",Mafi ያ Tube,22,25,3
27,"Fiyori Beyene - Ageb Beluley |ፍዮሪ በየነ - New Tigray Music 2021 by Mafi ያ Tube 3 months ago 4 minutes, 9 seconds 114 views",Mafi ያ Tube,114,120,6
28,"Gedion Daniel (Lemen?) ጌድዮን ዳንኤል ( ለምን?) New Ethiopian Music 2021 (Official Video) by Mafi ያ Tube 3 months ago 5 minutes, 4 seconds 331 views",Mafi ያ Tube,331,340,9
29,"Selamawit Yohannis - Adey Tigray |አደይ ትግራይ - New Tigray Music 2021 by Mafi ያ Tube 3 months ago 5 minutes, 1 second 173 views",Mafi ያ Tube,173,175,2
30,"Selamawit Yohannis_Nahonm Yohanis-Goblel Segney |ጎብለል ሰግመይ -New Tigray Music 2021 by Mafi ያ Tube 3 months ago 8 minutes, 27 seconds 223 views",Mafi ያ Tube,223,233,10
31,"Asgegnew Ashko(asge) - Loes Instrument | ሎኤስ Ethiopian Instrumental music by Mafi ያ Tube 3 months ago 4 minutes, 21 seconds 126 views",Mafi ያ Tube,126,133,7
32,"Before TV show DAGI Dance Show Trains on stage by Mafi ያ Tube 3 months ago 4 minutes, 13 seconds 17 views",Mafi ያ Tube,17,18,1
33,"Jeli Gamo - Hanassa | ሀናሳ - New Best Ethiopian Gamo music 2021 by Mafi ያ Tube 3 months ago 4 minutes, 52 seconds 799 views",Mafi ያ Tube,799,870,71
34,"Biruk Samuel - Tiztash | ትዝታሽ-በግጥም- New Ethiopian music Lyrics Video(official lyrics) by Mafi ያ Tube 3 months ago 5 minutes, 3 seconds 79 views",Mafi ያ Tube,79,82,3
35,"Abenezer Assefa - Anasiweya | አናሲወያ - New Ethiopian Music 2021(official video) by Mafi ያ Tube 3 months ago 4 minutes, 57 seconds 165 views",Mafi ያ Tube,165,170,5
36,"YoYo - Abereregn|አበረረኝ - New Ethiopian Music video 2021(official video) by Mafi ያ Tube 3 months ago 3 minutes, 48 seconds 69 views",Mafi ያ Tube,69,69,0
37,"Dagi Boy - Fetahuat |ፈታኃት - New Ethiopian Music video 2021(official video) by Mafi ያ Tube 3 months ago 5 minutes, 9 seconds 1,179 views",Mafi ያ Tube,1179,1204,25
38,nigeruat dagi boy by Mafi ያ Tube 3 months ago 36 seconds 30 views,Mafi ያ Tube,30,32,2
39,"Yo Yo_ Hiphop |ሂፕሀፕ ሀገርኛ _ New Ethiopian hip hop music 2021 by Mafi ያ Tube 3 months ago 3 minutes, 49 seconds 99 views",Mafi ያ Tube,99,100,1
40,"Bishaw Birhanu - Gingilate | ጊንጊላቴ - New Ethiopian sidama Music Video 2021(official video) by Mafi ያ Tube 3 months ago 4 minutes, 36 seconds 903 views",Mafi ያ Tube,903,1012,109
41,"Aschalew_Tiringo new kenfersh | ትርንጎ ነው ከንፈርሽ-New Ethiopian Music 2021(official video) by Mafi ያ Tube 3 months ago 4 minutes, 30 seconds 110 views",Mafi ያ Tube,110,112,2
42,"Nahom Yohanis -ኣነ'ሕሽኪ | ኣነ'ሕሽኪ - New Tigray music 2021(official music) by Mafi ያ Tube 3 months ago 3 minutes, 59 seconds 172 views",Mafi ያ Tube,172,173,1
43,"Ephrem Amare And Nehom Mekuria-Meley | መለይ - Ethiopian New Music (official videi) 2021 by Mafi ያ Tube 3 months ago 4 minutes, 57 seconds 210 views",Mafi ያ Tube,210,224,14
44,"Kabir G.hageyo- Lelo | ሌሎ - New Ethiopian Oromo Music Video 2021(official Video) by Mafi ያ Tube 4 months ago 3 minutes, 17 seconds 554 views",Mafi ያ Tube,554,562,8
45,"እማማ_ትወጂኛለሽ ዎይ_ልዩ የልጆች መዝሙር ቁ2 |Emama_twejignalesh Woy_Best kids sing song #100 vol2 October 30, 2021 by Mafi ያ Tube 4 months ago 6 minutes, 5 seconds 182 views",Mafi ያ Tube,182,202,20
46,"ትውልድ እንቅረፅ የልጆች አስገራሚ መዝሙር _ቁጥር አንድ_Tiwld Enqirets _ Ethiopian New kids Song Vol One  #100 by Mafi ያ Tube 4 months ago 5 minutes, 18 seconds 27 views",Mafi ያ Tube,27,32,5
47,"Chena_Job - Mewdede | መውደዴ - New Ethiopian Afro pop Music 2021 (official video) by Mafi ያ Tube 4 months ago 3 minutes, 31 seconds 73 views",Mafi ያ Tube,73,82,9
48,"Werkaferahu Ft Gildo kasa -Kebera | ከቤራ - Ethiopian New music 2021 (official music Video) by Mafi ያ Tube 4 months ago 3 minutes, 20 seconds 321 views",Mafi ያ Tube,321,356,35
49,"Adissu Dagne - Kelib | ከልብ - New Ethiopian cover music 2021 (official video ( by Mafi ያ Tube 4 months ago 5 minutes, 17 seconds 198 views",Mafi ያ Tube,198,203,5
50,"Biruk Samuel - Lela Ken New | ሌላ ቀን ነው - New Ethiopian Music Video 2021 (official video) by Mafi ያ Tube 4 months ago 3 minutes, 32 seconds 270 views",Mafi ያ Tube,270,274,4
51,"Abenezer Assefa - Tsigereda | ጽገሬዳ - AB  New Best Ethiopian 90'th Cover Music 2021 (official video) by Mafi ያ Tube 4 months ago 3 minutes, 43 seconds 1,326 views",Mafi ያ Tube,1326,1398,72
52,እስኪመለስ አዲስ የአማርኛ አክሽን ፊልም_Eskimeles New Ethiopian Action Movie 2021 by Mafi ያ Tube 4 months ago 40 minutes 306 views,Mafi ያ Tube,306,334,28
53,"Eden G/silassie - Kinalfo Inna | ክንሀልፎ ዒና - New Tigray  Music Video 2021 (official  video) by Mafi ያ Tube 4 months ago 7 minutes, 20 seconds 287 views",Mafi ያ Tube,287,290,3
54,"Dagi Boy - DIMAM | ድማም - New Ethiopian  Music Video 2016 (official  video) by Mafi ያ Tube 6 months ago 5 minutes, 13 seconds 315 views",Mafi ያ Tube,315,317,2
55,"Alemayehu Zasa - Cheda kusha | ጨዳ ኩሻ - New Ethiopian  Music Video 2018 (official  video) by Mafi ያ Tube 9 months ago 5 minutes, 53 seconds 78 views",Mafi ያ Tube,78,86,8
56,"እንዲህም ይጨፈራል ለካ በሳቅ ነው ያደከመቻው ህዝቡን አስደመመ by Mafi ያ Tube 9 months ago 2 minutes, 8 seconds 69 views",Mafi ያ Tube,69,69,0
57,"Adbar Tilahun - Bodewa | ቦደዋ -New Ethiopian Yem Music Video 2021 (official  video) by Mafi ያ Tube 9 months ago 4 minutes, 32 seconds 944 views",Mafi ያ Tube,944,958,14
58,Banchima Challenge Best one by Mafi ያ Tube 9 months ago 49 seconds 56 views,Mafi ያ Tube,56,56,0
59,Dita_Challenge by Mafi ያ Tube 9 months ago 40 seconds 59 views,Mafi ያ Tube,59,65,6
60,ባለጋሪው በዲሽታ ጊና ሙዚቃ ፈታ አደረጋቸው_Ballgariw_Entertaining the people by new Ethiopian music Dishtagina by Mafi ያ Tube 9 months ago 4 minutes 132 views,Mafi ያ Tube,132,137,5
61,"Dagi Boy-Endeakme | እንዳቅሜ - New Ethiopian Music (official video) by Mafi ያ Tube 10 months ago 6 minutes, 6 seconds 217 views",Mafi ያ Tube,217,218,1
62,"#ethiopian Gosaye Bayu(ጎሳዬ ባዩ)_Abel Bemote(አቤል በሞቴ)_New Ethiopian official music Video 2020 by Mafi ያ Tube 10 months ago 4 minutes, 2 seconds 82 views",Mafi ያ Tube,82,82,0
63,"Dagi Boy ft Minte  - Corona | ኮሮና - New Ethiopian  Music Video 2021 (official  video) by Mafi ያ Tube 10 months ago 2 minutes, 4 seconds 796 views",Mafi ያ Tube,796,811,15
64,"Dagi Boy - Semayawi | ሰማያዊ ማጀቢያ - New Ethiopian movies score Music 2021 (official  video) by Mafi ያ Tube 10 months ago 5 minutes, 14 seconds 753 views",Mafi ያ Tube,753,771,18
65,"Best Kids dancer in gamo by Mafi ያ Tube 10 months ago 3 minutes, 11 seconds 47 views",Mafi ያ Tube,47,50,3
66,"Copy of አስገራሚ የልጆች ሰርከስ ትርዒት በዚህ እድሜ ይሄን መሞክር ይከብዳል by Mafi ያ Tube 10 months ago 5 minutes, 23 seconds 90 views",Mafi ያ Tube,90,95,5
67,"Dagi Boy ft Hermela - Limensh Wey | ልመንሽ ዎይ - New Ethiopian  Music Video 2019 (official  video) by Mafi ያ Tube 10 months ago 4 minutes, 46 seconds 433 views",Mafi ያ Tube,433,436,3
68,"Best sidama cultural Dance by Dagi Dance show Int_ምርጥ የሲዳማ ባህላዊ ጭፈራ by Mafi ያ Tube 11 months ago 4 minutes, 29 seconds 239 views",Mafi ያ Tube,239,241,2
69,Jerusalem challenge by Ethiopian Dancer_Dagi Dance Show international by Mafi ያ Tube 11 months ago 32 seconds 221 views,Mafi ያ Tube,221,221,0
70,ላንቃ በድጋሚ አስደንጋጭ _Cover Music ላለመሳቅ ይሞክሩ by Mafi ያ Tube 11 months ago 1 minute 52 views,Mafi ያ Tube,52,56,4
71,"በሀገራችን ለመጀመሪያ ግዜ በከፍተኛ ብቃት የተሰራ Cover music_ላንቃን ተዋወቁት እስቲ ላለመሳቅ ይሞክሩ እባካችሁ by Mafi ያ Tube 11 months ago 1 minute, 8 seconds 29 views",Mafi ያ Tube,29,29,0
72,"Abenezer Asefa - Yikr | ይቅር - New Ethiopian  Music Video 2020 (official  video) by Mafi ያ Tube 11 months ago 4 minutes, 17 seconds 596 views",Mafi ያ Tube,596,607,11
73,"Best Traditional Dance of gamo and wolayita...ቀወጡት እኮ ሴቶች በጣም ያምራሉ by Mafi ያ Tube 11 months ago 3 minutes, 13 seconds 59 views",Mafi ያ Tube,59,59,0
74,ባንቺማ_ቻለንጅ_በሶሊ_ዳጊ ቦይ_Banchima_challenge _soli_song by Dagi Boy by Mafi ያ Tube 1 year ago 33 seconds 500 views,Mafi ያ Tube,500,502,2
75,"Slow Music live performance By Dagi Reggae by Mafi ያ Tube 1 year ago 6 minutes, 23 seconds 88 views",Mafi ያ Tube,88,91,3
76,"ነብስ ይማር በማይካድራ 215 አስክሬን የቀብር ስነ ስርዓት እየተደረገ ይገኛል ነብስ ይማር ወገኔ by Mafi ያ Tube 1 year ago 3 minutes, 16 seconds 28 views",Mafi ያ Tube,28,28,0
77,"እኔስ የለኝ ጓደኛ Teddy afro  27/3/2020 by Mafi ያ Tube 1 year ago 1 minute, 4 seconds 48 views",Mafi ያ Tube,48,49,1
78,"የቲክቶኳን ቆንጆ ሀዩቲን አገናኙኝ የምነግራት አለኝ ይላል by Mafi ያ Tube 1 year ago 4 minutes, 42 seconds 72 views",Mafi ያ Tube,72,72,0
79,"በልቼ ተበላሁ አለ
ሙሰኛው ፖሊስ(ሙና እና እያሱ) ምርጥ አስቂኝ እና አዝናኝ የአጭር ግዜ ድራማ ፈታ ማለት ለሚፈልጉ by Mafi ያ Tube 1 year ago 12 minutes, 15 seconds 71 views",Mafi ያ Tube,71,72,1
80,"እዩ BoY ሞዴል ሳሮን አየልኝን መፀዳጃ ቤት ድረስ በመከተል ፍቅሩን ሊገልፅላት ሲል ያጋጠመው ያልታሰበ ክስተት by Mafi ያ Tube 1 year ago 1 minute, 12 seconds 371 views",Mafi ያ Tube,371,371,0
81,"የጩባው መችም የማይደገም በሳቅ ፍርስ የሚያደርግ አድክም ትወና ካለፈው ሳምንት የተቀነጨበ by Mafi ያ Tube 1 year ago 2 minutes, 46 seconds 84 views",Mafi ያ Tube,84,84,0
82,"Dagi_Boy_Matitegeb(ማትጠገብ)_Ethiopian New Music 2020_Official Video by Mafi ያ Tube 1 year ago 4 minutes, 49 seconds 204 views",Mafi ያ Tube,204,204,0
83,"Wolayita Cultural Dance_By #Dagi_Dance_Show_Hawassa by Mafi ያ Tube 1 year ago 5 minutes, 24 seconds 78 views",Mafi ያ Tube,78,81,3
84,"Enat Birhanu - Yaamucaa Reji |ያሙጫ ሬጂ -New Ethiopian Music Video 2021 (official video) by Mafi ያ Tube 1 year ago 4 minutes, 8 seconds 72 views",Mafi ያ Tube,72,72,0
85,"የእማማ ዝናሽ አስቂኝ ቀልዶች ከTikTok ላይ የተመረጡ October 11, 2020 by Mafi ያ Tube 1 year ago 5 minutes, 17 seconds 13 views",Mafi ያ Tube,13,14,1
86,"Dagi Boy - Habesha | ሀበሻ - Ethiopian New Amharic music Video 2021 (official video) by Mafi ያ Tube 1 year ago 5 minutes, 44 seconds 364 views",Mafi ያ Tube,364,365,1
87,"Dagi Reggae Semayawi(ሰማያዊ)New Ethiopian music for Film sound Track #Semayawi የሰማያዊ ፊልም ማጀቢያ ሙዚቃ 2020 by Mafi ያ Tube 1 year ago 1 minute, 47 seconds 484 views",Mafi ያ Tube,484,486,2
88,"Students graduation ceremony of 2012 In Hawssa main campus Hall by Mafi ያ Tube 1 year ago 1 minute, 5 seconds 21 views",Mafi ያ Tube,21,22,1
89,Best gurage Dance movement by DDSI by Mafi ያ Tube 1 year ago 18 seconds 280 views,Mafi ያ Tube,280,280,0
90,Amazing Afro dance movement by Dancer Dagi by Mafi ያ Tube 1 year ago 41 seconds 110 views,Mafi ያ Tube,110,111,1
91,"Sidama Kexala Movement By Dagi Dance Show int cermony of opening Hospital by Mafi ያ Tube 1 year ago 1 minute, 23 seconds 415 views",Mafi ያ Tube,415,418,3
92,"Holehama SIDAMA Dance movement By DDSI by Mafi ያ Tube 1 year ago 2 minutes, 14 seconds 370 views",Mafi ያ Tube,370,371,1
93,"ድምፃዊ አዲስአልም ሸምሱ 3ኛ ዙር የፋና ላምሮት የባለትሰጥዖ ድምፃውያን ተወዳዳሪ #ፋና ላምሮት by Mafi ያ Tube 1 year ago 11 minutes, 1 second 98 views",Mafi ያ Tube,98,98,0
94,"Corona Admasu Wana ft chenakid new music video 2012 አድማሱ ዋና እና ቼና ኪድ ኮረና አዲስ ሙዚቃ ቪዲዮ by Mafi ያ Tube 1 year ago 3 minutes, 7 seconds 362 views",Mafi ያ Tube,362,363,1
95,ቼና ኪድ ስለ ኮሮና የቀለዱት በጣም አስቂኝ ቀል ወይ ኮሮና እንዲህም ያደርጋል very funy video about corona covid 19 by chenakid by Mafi ያ Tube 1 year ago 47 seconds 48 views,Mafi ያ Tube,48,48,0
96,"Dagi Reggae_ft_Bunge _Burunje_-_Tera Tera_|_ቴራ ቴራ_-_New_Ethiopian_Music_2020_(Official_Video) by Mafi ያ Tube 1 year ago 4 minutes, 33 seconds 86 views",Mafi ያ Tube,86,86,0
97,"Dagi Boy - Fetahuat - lyrics |ፈታዋት-ግጥም - New Ethiopian Music_2020_(Official_lyrics Video by Mafi ያ Tube 1 year ago 5 minutes, 7 seconds 1,505 views",Mafi ያ Tube,1505,1545,40
98,"chenakid_music vine_Fetahuat_|_ፈታዋት__New_Ethiopian_Music_2020_(Official_Video) by Mafi ያ Tube 1 year ago 5 minutes, 9 seconds 100 views",Mafi ያ Tube,100,100,0
99,Twins dagi performing dagi D ሼሮሳ dance cover by Mafi ያ Tube 1 year ago 31 seconds 812 views,Mafi ያ Tube,812,813,1
100,very funny seasn magi comedy part two Bill Test by Mafi ያ Tube 2 years ago 1 minute 29 views,Mafi ያ Tube,29,29,0
101,"very funny seasn magi comedy part one Bill Test by Mafi ያ Tube 2 years ago 1 minute, 3 seconds 17 views",Mafi ያ Tube,17,17,0
102,waw dance from Ehio gamo crew amaizin colab wach and enjoy it 2019 by Mafi ያ Tube 2 years ago 31 seconds 176 views,Mafi ያ Tube,176,176,0
103,Dagi Dance Show International says that every body can dance by Mafi ያ Tube 2 years ago 47 seconds 60 views,Mafi ያ Tube,60,61,1
104,"mulualem takele new ethipian music  shururuye by Mafi ያ Tube 2 years ago 1 minute, 41 seconds 132 views",Mafi ያ Tube,132,134,2
105,lets fun 2 by  Dagi Dance Show International by Mafi ያ Tube 2 years ago 19 seconds 50 views,Mafi ያ Tube,50,51,1
106,"ethiopian gamo traditional dance by Dagi Dance Show International music asge dendasho 2019 by Mafi ያ Tube 2 years ago 6 minutes, 38 seconds 210 views",Mafi ያ Tube,210,210,0
107,lets fun 3 by Dagi Dance Show International by Mafi ያ Tube 2 years ago 11 seconds 25 views,Mafi ያ Tube,25,27,2
108,በቁም አፈር መልበስ ሳይሻል አይቀርም ግን ለመዝናናት lets fun by Dagi Dance Show International 2019 by Mafi ያ Tube 2 years ago 42 seconds 30 views,Mafi ያ Tube,30,31,1
109,"Dagi dance show performing sidama cultural dance on the program of ethiopis(ኢትያጲስ) 2019 by Mafi ያ Tube 2 years ago 1 minute, 45 seconds 212 views",Mafi ያ Tube,212,213,1
110,"Ethiopian Best Hareri(ሸጎዬ)traditional dance performance by Dagi Dance Show Hawassa 2019 by Mafi ያ Tube 2 years ago 4 minutes, 19 seconds 118 views",Mafi ያ Tube,118,118,0
111,"Ethiopian oromo traditional  dance performing by Dagi Dance Show 2019 by Mafi ያ Tube 2 years ago 1 minute, 2 seconds 117 views",Mafi ያ Tube,117,117,0
112,"Best Ethiopian kunama(ኩናማ)traditional dance by dagi dagi dance show 2019 by Mafi ያ Tube 2 years ago 3 minutes, 59 seconds 1,209 views",Mafi ያ Tube,1209,1211,2
113,"Best Ethiopian gambela(መዠንገር)traditional dance performing by Dagi Dance show Awassa by Mafi ያ Tube 2 years ago 2 minutes, 47 seconds 277 views",Mafi ያ Tube,277,283,6
114,"Ethiopian Sidama cultural Dance  Performing By Dagi Dance show hawassa by Mafi ያ Tube 3 years ago 1 minute, 15 seconds 42 views",Mafi ያ Tube,42,42,0
115,"Dagi Dance Show performing ARI  taditional dance 2017 by Mafi ያ Tube 4 years ago 2 minutes, 49 seconds 106 views",Mafi ያ Tube,106,106,0
116,"Dagi Dance Show making wolayita gerersa training T by Mafi ያ Tube 4 years ago 1 minute, 6 seconds 580 views",Mafi ያ Tube,580,583,3
117,"Dagi Dance Show Awassa performing sidama tra dance by Mafi ያ Tube 5 years ago 1 minute, 49 seconds 2,112 views",Mafi ያ Tube,2112,2120,8
118,"Dagi Dance show Awassa performing gamo traditional by Mafi ያ Tube 5 years ago 2 minutes, 48 seconds 641 views",Mafi ያ Tube,641,644,3
119,"Sami Dan - Qalen | ሳሚ ዳን - ቃሌን Officiall Music Video : New Ethiopian Music 2022 on Mela TV by MELA TV 1 month ago 3 minutes, 41 seconds 41,012 views",MELA TV,41012,41672,660
120,"Tenes - Henok Berhanu December 16, 2021 by MELA TV 2 months ago 16 seconds 419 views",MELA TV,419,434,15
121,"Ethiopia Tenes ተነስ Henok Berhanu ሄኖክ ብርሀኑ New Ethiopian Music 2021 by MELA TV 2 months ago 3 minutes, 10 seconds 5,318 views",MELA TV,5318,5362,44
122,"Kalatashiw Akal - Beatweded | Doncorleon Mix l New Ethiopian Music 2021 on Mela TV by MELA TV 6 months ago 3 minutes, 46 seconds 7,191 views",MELA TV,7191,7255,64
123,"የፌስቡክ አርበኞች Ye Facebook Arbegnoch Premiere Part 01 on Mela TV by MELA TV 1 year ago 52 minutes 26,070 views",MELA TV,26070,26103,33
124,"የፌስቡክ አርበኞች Ye Facebook Arbegnoch Premiere Part 02 on Mela TV by MELA TV 1 year ago 53 minutes 39,912 views",MELA TV,39912,39941,29
125,"Abatachn Hoy አባታችን ሆይ  - Tewodros Tadesse ቴዎርድሮስ ታደሰ on Mela TV by MELA TV 1 year ago 5 minutes, 53 seconds 3,550 views",MELA TV,3550,3567,17
126,"Abrham Maru Senselet's Gash Tassew - Ethiopia Aderah Nat on Mela TV by MELA TV 1 year ago 8 minutes, 57 seconds 9,332 views",MELA TV,9332,9335,3
127,"የፌስቡክ አርበኞች ክፍል 10 ሴራ - Ye Facebook Arbegnoch | Episode 10 - Sēra on MELA TV by MELA TV 1 year ago 38 minutes 39,185 views",MELA TV,39185,39195,10
128,"የፌስቡክ አርበኞች ክፍል 09 እንግዳ - Ye Facebook Arbegnoch | Episode 09 - Engida on MELA TV by MELA TV 1 year ago 37 minutes 32,295 views",MELA TV,32295,32300,5
129,"የፌስቡክ አርበኞች ክፍል 08 እቅድ - Ye Facebook Arbegnoch | Episode 08 - Ekid on MELA TV by MELA TV 1 year ago 33 minutes 42,589 views",MELA TV,42589,42594,5
130,"የፌስቡክ አርበኞች ክፍል 07 እርምጃ - Ye Facebook Arbegnoch | Episode 07 - Ermija on MELA TV by MELA TV 1 year ago 34 minutes 32,713 views",MELA TV,32713,32720,7
131,"የፌስቡክ አርበኞች ክፍል 06 ተስፋ - Ye Facebook Arbegnoch | Episode 06 - Tesfa by MELA TV 1 year ago 37 minutes 32,861 views",MELA TV,32861,32867,6
132,"የፌስቡክ አርበኞች ክፍል 05 ቅን ልቦች - Ye Facebook Arbegnoch | Episode 05 - Kin Liboch by MELA TV 1 year ago 35 minutes 50,164 views",MELA TV,50164,50181,17
133,"የፌስቡክ አርበኞች ክፍል 04  ትዝታ - Ye Facebook Arbegnoch | Episode 04 - Tizita by MELA TV 1 year ago 34 minutes 40,988 views",MELA TV,40988,41002,14
134,"የፌስቡክ አርበኞች ክፍል 03 ፍቅር - Ye Facebook Arbegnoch | Episode 03 - Fikir on Mela TV by MELA TV 1 year ago 35 minutes 47,442 views",MELA TV,47442,47462,20
135,"የፌስቡክ አርበኞች ክፍል 02 ግዜው የለውጥ ነው - Ye Facebook Arbegnoch | Episode 02 - Gizew Ye Lewit New on Mela TV by MELA TV 1 year ago 30 minutes 45,688 views",MELA TV,45688,45721,33
136,"Senselet Series Season 6 Starts this Coming Saturday | ሰንሰለት ምዕራፍ 6 የፊታችን ቅዳሜ March 7 ይጀምራል by MELA TV 1 year ago 1 minute, 16 seconds 30,144 views",MELA TV,30144,30162,18
137,"Ye Facebook Arbegnoch - Episode 01 | The Pilot - Beteseb ቤተሰብ on Mela TV by MELA TV 2 years ago 30 minutes 77,152 views",MELA TV,77152,77191,39
138,"YeFacebook Arbegnoch Triller የፌስቡክ አርበኞች የፊታችን እሁድ የካቲት 22 ይጀምራል on Mela TV by MELA TV 2 years ago 2 minutes, 19 seconds 5,602 views",MELA TV,5602,5603,1
139,"እግዚአብሔር አይወለድም አይወልድምን?  ምሥጢረ ሥላሴ - ክፍል 9/10 ሚጠት፦ ወደ ኦርቶዶክስ መመለስ /መምጣት by MELA TV 2 years ago 15 minutes 2,801 views",MELA TV,2801,2807,6
140,"I Never Knew - Episode 9 on Mela TV by MELA TV 2 years ago 5 minutes, 23 seconds 3,220 views",MELA TV,3220,3221,1
141,"Senselet Drama S05 Recap Part 2 ሰንሰለት ምዕራፍ 5 ትውስታ Part 2 by MELA TV 2 years ago 38 minutes 43,333 views",MELA TV,43333,43349,16
142,"መላእክት ፈጣሪ አይደሉም ምሥጢረ ሥላሴ - ክፍል 7/10 - በመምህር ዶ/ር ዘበነ ለማ by MELA TV 2 years ago 15 minutes 2,631 views",MELA TV,2631,2634,3
143,"Senselet Drama S05 Recap 1- ሰንሰለት ምዕራፍ 5 ትውስታ -1 by MELA TV 2 years ago 41 minutes 89,548 views",MELA TV,89548,89571,23
144,"ምሥጢረ ሥላሴ - ክፍል 7/10 - መጽሐፍ ቅዱስ ""እኛ"" የሚለው ሥላሴን አይደለም ለሚሉ on Mela TV by MELA TV 2 years ago 18 minutes 5,214 views",MELA TV,5214,5262,48
145,"I Never Knew - Episode 8 on Mela TV by MELA TV 2 years ago 8 minutes, 56 seconds 3,988 views",MELA TV,3988,3990,2
146,"Senselet Drama S05 EP 126 Part 2 ሰንሰለት ምዕራፍ 5 ክፍል 126 - Part 2 by MELA TV 2 years ago 20 minutes 347,000 views",MELA TV,347000,347174,174
147,"Senselet Drama S05 EP 126 Part 1 ሰንሰለት ምዕራፍ 5 ክፍል 126 - Part 1 by MELA TV 2 years ago 23 minutes 416,770 views",MELA TV,416770,416905,135
148,"Senselet Drama S05 EP 125 Part 1 ሰንሰለት ምዕራፍ 5 ክፍል 125 - Part 1 by MELA TV 2 years ago 25 minutes 365,551 views",MELA TV,365551,365718,167
149,"Senselet Drama S05 EP 125 Part 2 ሰንሰለት ምዕራፍ 5 ክፍል 125 - Part 2 by MELA TV 2 years ago 22 minutes 324,000 views",MELA TV,324000,324178,178
150,"ምሥጢረ ሥላሴ - ክፍል 6/10 በመምህር ዶ/ር ዘበነ ለማ - ሚጠት፦ ወደ ኦርቶዶክስ መመለስ/መምጣት on Mela TV by MELA TV 2 years ago 18 minutes 5,643 views",MELA TV,5643,5701,58
151,"Senselet Drama S05 EP 124 Part 1 ሰንሰለት ምዕራፍ 5 ክፍል 124 - Part 1 by MELA TV 2 years ago 22 minutes 349,505 views",MELA TV,349505,349651,146
152,"Senselet Drama S05 EP 124 Part 2 ሰንሰለት ምዕራፍ 5 ክፍል 124 - Part 2 by MELA TV 2 years ago 26 minutes 319,812 views",MELA TV,319812,319987,175
153,"ምሥጢረ ሥላሴ - ክፍል 5/10 ሚጠት፦ ወደ ኦርቶዶክስ መመለስ /መምጣት መሰረታዊ የኢትዮጵያ ኦርቶዶክስ ተዋህዶ ቤ.ክ. ትምህርት - ዘወትር ዓርብ by MELA TV 2 years ago 14 minutes 5,472 views",MELA TV,5472,5529,57
154,"Senselet Drama S05 EP 123 Part 2 ሰንሰለት ምዕራፍ 5 ክፍል 123 - Part 2 by MELA TV 2 years ago 31 minutes 326,253 views",MELA TV,326253,326405,152
155,"Senselet Drama S05 EP 1123 Part 1 ሰንሰለት ምዕራፍ 5 ክፍል 123 - Part 1 by MELA TV 2 years ago 23 minutes 305,700 views",MELA TV,305700,305834,134
156,"ምሥጢረ ሥላሴ - ክፍል 4/10 ሚጠት፦ ወደ ኦርቶዶክስ መመለስ /መምጣት  መሰረታዊ የኢትዮጵያ ኦርቶዶክስ ተዋህዶ ቤ.ክ. ትምህርት - ዘወትር ዓርብ by MELA TV 2 years ago 14 minutes, 55 seconds 7,605 views",MELA TV,7605,7705,100
157,"Senselet Drama S05 EP 122 Part 2 ሰንሰለት ምዕራፍ 5 ክፍል 122 - Part 2 by MELA TV 2 years ago 22 minutes 297,126 views",MELA TV,297126,297245,119
158,"Senselet Drama S05 EP 122 Part 1 ሰንሰለት ምዕራፍ 5 ክፍል 122 - Part 1 by MELA TV 2 years ago 24 minutes 355,043 views",MELA TV,355043,355191,148
159,"ምሥጢረ ሥላሴ - ክፍል 3/10 ሚጠት፦ ወደ ኦርቶዶክስ መመለስ /መምጣት  መሰረታዊ የኢትዮጵያ ኦርቶዶክስ ተዋህዶ ቤ.ክ. ትምህርት - ዘወትር ዓርብ by MELA TV 2 years ago 15 minutes 9,362 views",MELA TV,9362,9467,105
160,"እንኳን ለጌታችን ለአምላካችን ለመድኃኒታችን ኢየሱስ ክርስቶስ የልደት በዓል አደረሳችሁ - ከመምህር ዶ/ር ዘበነ ለማ on Mela TV by MELA TV 2 years ago 13 minutes, 47 seconds 15,953 views",MELA TV,15953,15953,0
161,"Senselet Drama S05 EP 121 Part 1 ሰንሰለት ምዕራፍ 5 ክፍል 121 - Part 1 by MELA TV 2 years ago 24 minutes 346,721 views",MELA TV,346721,346858,137
162,"Senselet Drama S05 EP 121 Part 2 ሰንሰለት ምዕራፍ 5 ክፍል 121 - Part 2 by MELA TV 2 years ago 26 minutes 311,318 views",MELA TV,311318,311453,135
163,"ምሥጢረ ሥላሴ - ክፍል 2/10 ሚጢት፦ ወደ ኦርቶዶክስ መመለስ /መምጣት  መሰረታዊ የኢትዮጵያ ኦርቶዶክስ ተዋህዶ ቤ.ክ. ትምህርት - by MELA TV 2 years ago 15 minutes 13,709 views",MELA TV,13709,13847,138
164,"Senselet Drama S05 EP 120 Part 2 ሰንሰለት ምዕራፍ 5 ክፍል 120 - Part 2 by MELA TV 2 years ago 26 minutes 316,066 views",MELA TV,316066,316239,173
165,"Senselet Drama S05 EP 120 Part 1 ሰንሰለት ምዕራፍ 5 ክፍል 120 - Part 1 by MELA TV 2 years ago 24 minutes 356,127 views",MELA TV,356127,356272,145
166,"ምሥጢረ ሥላሴ - ክፍል 1/10 ሚጢት፦ ወደ ኦርቶዶክስ መመለስ /መምጣት  መሰረታዊ የኢትዮጵያ ኦርቶዶክስ ተዋህዶ ቤ.ክ. ትምህርት - ዘወትር ዓርብ by MELA TV 2 years ago 20 minutes 18,585 views",MELA TV,18585,18930,345
167,"የምእመናን ደም ተገኝባት - በመምህር ዶ/ር ዘበነ ለማ on Mela TV by MELA TV 2 years ago 10 minutes, 6 seconds 4,153 views",MELA TV,4153,4154,1
168,"YeFacebook Arbegnoch Triller on Mela TV by MELA TV 2 years ago 2 minutes, 27 seconds 10,655 views",MELA TV,10655,10657,2
169,"Senselet Drama S05 EP 119 Part 1 ሰንሰለት ምዕራፍ 5 ክፍል 119 - Part 1 by MELA TV 2 years ago 24 minutes 351,179 views",MELA TV,351179,351294,115
170,"Senselet Drama S05 EP 119 Part 2 ሰንሰለት ምዕራፍ 5 ክፍል 119 - Part 2 by MELA TV 2 years ago 21 minutes 293,991 views",MELA TV,293991,294114,123
171,"The Golden Voice Gossaye Tesfaye Performing Live in Washington DC December 21 2019 by MELA TV 2 years ago 48 seconds 4,480 views",MELA TV,4480,4486,6
172,"Senselet Drama S05 EP 118 Part 2 ሰንሰለት ምዕራፍ 5 ክፍል 118 - Part 2 by MELA TV 2 years ago 21 minutes 317,617 views",MELA TV,317617,317751,134
173,"Senselet Drama S05 EP 118 Part 1 ሰንሰለት ምዕራፍ 5 ክፍል 118 - Part 1 by MELA TV 2 years ago 24 minutes 348,801 views",MELA TV,348801,348947,146
174,"Memiher Zebene Lema - Emebetachene Anasgebam Alwat እመቤታችንን አናስገባም አሉ  on Mela TV by MELA TV 2 years ago 26 minutes 4,873 views",MELA TV,4873,4881,8
175,"መምህር ዘበነ ለማ   OnMela TV by MELA TV 2 years ago 3 minutes, 13 seconds 3,291 views",MELA TV,3291,3297,6
176,"Senselet Drama S05 EP 117 Part 2 ሰንሰለት ምዕራፍ 5 ክፍል 117 - Part 2 by MELA TV 2 years ago 23 minutes 303,169 views",MELA TV,303169,303311,142
177,"Senselet Drama S05 EP 117 Part 1 ሰንሰለት ምዕራፍ 5 ክፍል 117 - Part 1 by MELA TV 2 years ago 24 minutes 335,867 views",MELA TV,335867,336032,165
178,"Senselet Drama S05 EP 116 Part 2 ሰንሰለት ምዕራፍ 5 ክፍል 116 - Part 2 by MELA TV 2 years ago 27 minutes 318,115 views",MELA TV,318115,318186,71
179,"Senselet Drama S05 EP 116 Part 1 ሰንሰለት ምዕራፍ 5 ክፍል 116 - Part 1 by MELA TV 2 years ago 22 minutes 345,904 views",MELA TV,345904,345988,84
180,"Tariku Shele 80 - Tew Fano - New Ethiopian Music 2019 (Official Video) by MELA TV 2 years ago 5 minutes, 10 seconds 32,465 views",MELA TV,32465,32480,15
181,"ከቀበሮ ጉድጓድ የመጣ እሪፓርት  በእስክንድር ነጋ  on Mela TV by MELA TV 2 years ago 45 minutes 14,606 views",MELA TV,14606,14609,3
182,"እስክንድር ነጋ እና የባልደራሱ ፈተና on Mela TV by MELA TV 2 years ago 18 minutes 3,267 views",MELA TV,3267,3267,0
183,"ታማኝ በየነ በባልደርሱ ስብሰባ ላይon Mela TV by MELA TV 2 years ago 1 minute, 11 seconds 9,599 views",MELA TV,9599,9600,1
184,"እስክንድር ነጋ ፓለቲካ ፓርቲ ሊመሰርት ነው by MELA TV 2 years ago 1 minute, 39 seconds 2,503 views",MELA TV,2503,2515,12
185,"Senselet Drama S05 EP 115 Part 1 ሰንሰለት ምዕራፍ 5 ክፍል 115 - Part 1 by MELA TV 2 years ago 24 minutes 369,306 views",MELA TV,369306,369541,235
186,"Senselet Drama S05 EP 115 Part 2 ሰንሰለት ምዕራፍ 5 ክፍል 115 - Part 2 by MELA TV 2 years ago 23 minutes 301,485 views",MELA TV,301485,301607,122
187,"November 22, 2019 by MELA TV 2 years ago 57 seconds 1,201 views",MELA TV,1201,1201,0
188,"አቤቱ፥ አንተን ታመንሁ፤ ለዘላለም አልፈር። የሚመጣው እሳት ያቃጥላችኋል፤ ስርም አያስቀርላችሁም!   on Mela TV by MELA TV 2 years ago 26 minutes 3,605 views",MELA TV,3605,3606,1
189,"YOTC - I Never Knew on Mela TV Episode 4 by MELA TV 2 years ago 6 minutes, 32 seconds 1,684 views",MELA TV,1684,1687,3
190,"YOTC - I Never Knew on Mela TV Episode 3 by MELA TV 2 years ago 5 minutes, 23 seconds 1,789 views",MELA TV,1789,1789,0
191,"SMART Learning Center | www.smartlearningctrs.com by MELA TV 2 years ago 43 seconds 2,570 views",MELA TV,2570,2572,2
192,"YOTC - I Never Knew on Mela TV Episode 02 by MELA TV 2 years ago 4 minutes, 32 seconds 2,168 views",MELA TV,2168,2168,0
193,"YOTC - I Never Knew on Mela TV Episode 1 by MELA TV 2 years ago 4 minutes, 58 seconds 2,595 views",MELA TV,2595,2597,2
194,"Ethiopian Prime Minister Dr. Abiy Ahmed Documentary - ከቢሮ እስከ ሀገር - የትዉልድ አሻራ on Mela TV by MELA TV 2 years ago 41 minutes 47,855 views",MELA TV,47855,47985,130
195,"Agere Show by Aziza Ahmed - Happy Ethiopian New Year | መልካም አዲስ ዓመት 2012 by MELA TV 2 years ago 1 minute, 31 seconds 1,881 views",MELA TV,1881,1881,0
196,"Senselet Drama Season 5 Trailer - Saturday August 10 2019 by MELA TV 2 years ago 1 minute, 21 seconds 37,512 views",MELA TV,37512,37513,1
197,"ከታኪዮን መፅሐፍ ላይ ተቀንጭቦ የተሰራ በአርቲስት ቴዎድሮስ ለገሰ by MELA TV 2 years ago 11 minutes, 52 seconds 17,803 views",MELA TV,17803,17803,0
198,"Hufaisa - ሁፋይሳ  Addis Misganaw | Addio New Ethiopian Music 2019 (Official Video) Ethio-Jazz Funk by MELA TV 2 years ago 6 minutes, 57 seconds 23,863 views",MELA TV,23863,23891,28
199,"Senselet Drama S04 EP 100 Part 2 ሰንሰለት ምዕራፍ 4 ክፍል 100 - Part 2 by MELA TV 2 years ago 24 minutes 409,088 views",MELA TV,409088,409217,129
200,"Senselet Drama S04 EP 100 Part 1 ሰንሰለት ምዕራፍ 4 ክፍል 100 - Part 1 by MELA TV 2 years ago 23 minutes 476,935 views",MELA TV,476935,477098,163
201,"Senselet Drama S04 EP 99 Part 2 ሰንሰለት ምዕራፍ 4 ክፍል 99 - Part 2 by MELA TV 2 years ago 18 minutes 347,790 views",MELA TV,347790,347924,134
202,"Senselet Drama S04 EP 99 Part 1 ሰንሰለት ምዕራፍ 4 ክፍል 99 - Part 1 by MELA TV 2 years ago 22 minutes 447,968 views",MELA TV,447968,448101,133
203,"Grand African Run in Washington DC ታላቁ ሩጫ በዲሲ by MELA TV 2 years ago 1 minute, 12 seconds 5,768 views",MELA TV,5768,5768,0
204,"Senselet Drama S04 EP 98 Part 1 ሰንሰለት ምዕራፍ 4 ክፍል 98 - Part 1 by MELA TV 2 years ago 21 minutes 373,955 views",MELA TV,373955,374073,118
205,"Senselet Drama S04 EP 98 Part 2 ሰንሰለት ምዕራፍ 4 ክፍል 98 - Part 2 by MELA TV 2 years ago 28 minutes 360,323 views",MELA TV,360323,360491,168
206,"Senselet Drama S04 EP 97 Part 2 ሰንሰለት ምዕራፍ 4 ክፍል 97 - Part 2 by MELA TV 2 years ago 22 minutes 327,665 views",MELA TV,327665,327784,119
207,"Senselet Drama S04 EP 97 Part 1 ሰንሰለት ምዕራፍ 4 ክፍል 97 - Part 1 by MELA TV 2 years ago 25 minutes 406,834 views",MELA TV,406834,406944,110
208,"Senselet Drama 2nd Year Anniversary at ESFNA 2019 Atlanta,GA by MELA TV 2 years ago 1 minute, 10 seconds 10,104 views",MELA TV,10104,10106,2
209,"Senselet Drama S04 EP 96 Part 2 ሰንሰለት ምዕራፍ 4 ክፍል 96 - Part 2 by MELA TV 2 years ago 25 minutes 348,866 views",MELA TV,348866,348968,102
210,"Senselet Drama S04 EP 96 Part 1 ሰንሰለት ምዕራፍ 4 ክፍል 96 - Part 1 by MELA TV 2 years ago 20 minutes 348,529 views",MELA TV,348529,348635,106
211,"Senselet Drama S04 EP 95 Part 2 ሰንሰለት ምዕራፍ 4 ክፍል 95 - Part 2 by MELA TV 2 years ago 19 minutes 322,556 views",MELA TV,322556,322663,107
212,"Senselet Drama S04 EP 95 Part 1 ሰንሰለት ምዕራፍ 4 ክፍል 95 - Part 1 by MELA TV 2 years ago 21 minutes 358,843 views",MELA TV,358843,358981,138
213,"Senselet Drama S04 EP 94 Part 2 ሰንሰለት ምዕራፍ 4 ክፍል 94 - Part 2 by MELA TV 2 years ago 30 minutes 286,858 views",MELA TV,286858,286944,86
214,"Senselet Drama S04 EP 94 Part 2 ሰንሰለት ምዕራፍ 4 ክፍል 94 - Part 2 by MELA TV 2 years ago 28 minutes 79,469 views",MELA TV,79469,79487,18
215,"Senselet Drama S04 EP 94 Part 1 ሰንሰለት ምዕራፍ 4 ክፍል 94 - Part 1 by MELA TV 2 years ago 22 minutes 367,115 views",MELA TV,367115,367216,101
216,"Senselet Drama S04 EP 93 Part 2 ሰንሰለት ምዕራፍ 4 ክፍል 93 - Part 2 by MELA TV 2 years ago 27 minutes 341,945 views",MELA TV,341945,342051,106
217,"Senselet Drama S04 EP 93 Part 1 ሰንሰለት ምዕራፍ 4 ክፍል 93 - Part 1 by MELA TV 2 years ago 19 minutes 400,035 views",MELA TV,400035,400151,116
218,"Senselet Drama S04 EP 92 Part 1 ሰንሰለት ምዕራፍ 4 ክፍል 92 - Part 1 by MELA TV 2 years ago 18 minutes 393,587 views",MELA TV,393587,393729,142
219,"Senselet Drama S04 EP 92 Part 2 ሰንሰለት ምዕራፍ 4 ክፍል 92 - Part 2 by MELA TV 2 years ago 23 minutes 320,750 views",MELA TV,320750,320853,103
220,"አርቲስት ታማኝ በየነ ከፊትህ እሳትና ውሀን አቅርቤልሀለሁ ወደፈቀድከው እጅህን ስደድ by MELA TV 2 years ago 13 minutes, 12 seconds 9,115 views",MELA TV,9115,9115,0
221,"የባለ መድሀኒት ፅሎትና የመቃብር ቆፋሪ ፅሎት በሙዓዘ ጥበባት ዳንኤል ክብረት by MELA TV 2 years ago 27 minutes 11,547 views",MELA TV,11547,11550,3
222,"Senselet Drama S04 EP 91 Part 2 ሰንሰለት ምዕራፍ 4 ክፍል 91 - Part 2 by MELA TV 2 years ago 23 minutes 343,639 views",MELA TV,343639,343729,90
223,"Senselet Drama S04 EP 91 Part 1 ሰንሰለት ምዕራፍ 4 ክፍል 91 - Part 1 by MELA TV 2 years ago 21 minutes 403,381 views",MELA TV,403381,403487,106
224,"Senselet Drama S04 EP 90 Part 1 ሰንሰለት ምዕራፍ 4 ክፍል 90 - Part 1 by MELA TV 2 years ago 24 minutes 384,628 views",MELA TV,384628,384742,114
225,"Senselet Drama S04 EP 90 Part 2 ሰንሰለት ምዕራፍ 4 ክፍል 90 - Part 2 by MELA TV 2 years ago 25 minutes 379,684 views",MELA TV,379684,379809,125
226,"Senselet Drama S04 EP 89 Part 2 ሰንሰለት ምዕራፍ 4 ክፍል 89 - Part 2 by MELA TV 2 years ago 23 minutes 342,667 views",MELA TV,342667,342775,108
227,"Senselet Drama S04 EP 89 Part 1 ሰንሰለት ምዕራፍ 4 ክፍል 89 - Part 1 by MELA TV 2 years ago 25 minutes 415,123 views",MELA TV,415123,415260,137
228,"Yosef Molla - Ekabod New Ethiopian Music 2019 Lyric Video by MELA TV 2 years ago 6 minutes, 7 seconds 5,999 views",MELA TV,5999,6003,4
229,"በበዓሉ ምክንያት ዛሬ ሰንሰለት የማይተላለፍ መሆኑን ከታላቅ ይቅርታ ጋር እናሳውቃለን ሳምንት በተመሳሳይ ሰዐት እንገናኝ by MELA TV 2 years ago 35 seconds 31,088 views",MELA TV,31088,31088,0
230,"Senselet Drama S04 EP 88 Part 2 ሰንሰለት ምዕራፍ 4 ክፍል 88 - Part 2 by MELA TV 2 years ago 24 minutes 373,238 views",MELA TV,373238,373346,108
231,"Senselet Drama S04 EP 88 Part 1 ሰንሰለት ምዕራፍ 4 ክፍል 88 - Part 1 by MELA TV 2 years ago 20 minutes 429,459 views",MELA TV,429459,429597,138
232,"Senselet Drama S04 EP 87 Part 2 ሰንሰለት ምዕራፍ 4 ክፍል 87 - Part 2 by MELA TV 2 years ago 21 minutes 336,774 views",MELA TV,336774,336893,119
233,"Senselet Drama S04 EP 87 Part 1 ሰንሰለት ምዕራፍ 4 ክፍል 87 - Part 1 by MELA TV 2 years ago 23 minutes 398,134 views",MELA TV,398134,398247,113
234,"YeFacebook Arbegoch - የፌስቡክ አርበኞች Official Teaser Trailer by MELA TV 2 years ago 6 minutes, 36 seconds 7,691 views",MELA TV,7691,7692,1
235,"ኡስታስ አቡበከር በብሔራዊቲያትር by MELA TV 2 years ago 19 minutes 3,274 views",MELA TV,3274,3282,8
236,"Senselet Drama S04 EP 84 Part 2 ሰንሰለት ምዕራፍ 4 ክፍል 84 - Part 2 by MELA TV 2 years ago 28 minutes 347,552 views",MELA TV,347552,347661,109
237,"Senselet Drama S04 EP 84 Part 1 ሰንሰለት ምዕራፍ 4 ክፍል 84 - Part 1 by MELA TV 2 years ago 22 minutes 376,247 views",MELA TV,376247,376356,109
238,"ከቤተ መንግስቱ ጀርባ by MELA TV 2 years ago 28 minutes 4,752 views",MELA TV,4752,4753,1
239,"ሰሞኑን ከታዘብካቸው ሦስት ነገሮች by MELA TV 2 years ago 22 minutes 10,263 views",MELA TV,10263,10263,0
240,"ሞያተኛ  አገሬ by MELA TV 2 years ago 9 minutes, 7 seconds 4,649 views",MELA TV,4649,4650,1
241,"Senselet Drama S04 EP 83 Part 1 ሰንሰለት ምዕራፍ 4 ክፍል 83 - Part 1 by MELA TV 2 years ago 22 minutes 360,738 views",MELA TV,360738,360856,118
242,"Senselet Drama S04 EP 83 Part 2 ሰንሰለት ምዕራፍ 4 ክፍል 83 - Part2 by MELA TV 2 years ago 27 minutes 348,557 views",MELA TV,348557,348669,112
243,"Senselet Drama S04 EP 82 Part 2 ሰንሰለት ምዕራፍ 4 ክፍል 82 - Part 2 by MELA TV 2 years ago 23 minutes 364,299 views",MELA TV,364299,364408,109
244,"Senselet Drama S04 EP 82 Part 1 ሰንሰለት ምዕራፍ 4 ክፍል 82 - Part 1 by MELA TV 2 years ago 20 minutes 363,329 views",MELA TV,363329,363425,96
245,"Emama | እማማ - Andy B. Andinet Birhanu and Dawit Bosco - New Ethiopian Music 2019 Official Video by MELA TV 2 years ago 7 minutes, 33 seconds 56,658 views",MELA TV,56658,56681,23
246,"Senselet Drama S04 EP 81 Part 2 ሰንሰለት ምዕራፍ 4 ክፍል 81 - Part 2 by MELA TV 2 years ago 27 minutes 392,533 views",MELA TV,392533,392652,119
247,"Senselet Drama S04 EP 81 Part 1 ሰንሰለት ምዕራፍ 4 ክፍል 81 - Part 1 by MELA TV 2 years ago 23 minutes 366,428 views",MELA TV,366428,366534,106
248,"Senselet Drama S04 EP 80 Part 2 ሰንሰለት ምዕራፍ 4 ክፍል 80 - Part 2 by MELA TV 3 years ago 26 minutes 353,225 views",MELA TV,353225,353346,121
249,"Senselet Drama S04 EP 80 Part 1 ሰንሰለት ምዕራፍ 4 ክፍል 80- Part 1 by MELA TV 3 years ago 19 minutes 376,435 views",MELA TV,376435,376577,142
250,"Senselet Drama S04 EP 79 Part 1 ሰንሰለት ምዕራፍ 4 ክፍል 79- Part 1 by MELA TV 3 years ago 21 minutes 427,184 views",MELA TV,427184,427334,150
251,"Senselet Drama S04 EP 79 Part 2 ሰንሰለት ምዕራፍ 4 ክፍል 79- Part 2 by MELA TV 3 years ago 25 minutes 251,675 views",MELA TV,251675,251770,95
252,"መነባነብ በአርቲስት ሰላማዊት ደስታ by MELA TV 3 years ago 12 minutes, 18 seconds 4,232 views",MELA TV,4232,4249,17
253,"ዶክተር ሰለሞን ተሾመ እኛ ስንዎደድ by MELA TV 3 years ago 25 minutes 1,912 views",MELA TV,1912,1913,1
254,"Senselet Drama S04 EP 78 Part 2 ሰንሰለት ምዕራፍ 4 ክፍል 78- Part 2 by MELA TV 3 years ago 22 minutes 348,968 views",MELA TV,348968,349076,108
255,"Senselet Drama S04 EP 78 Part 1 ሰንሰለት ምዕራፍ 4 ክፍል 78 - Part 1 by MELA TV 3 years ago 21 minutes 391,850 views",MELA TV,391850,391959,109
256,"Senselet Drama S04 EP 77 Part 2 ሰንሰለት ምዕራፍ 4 ክፍል 77 - Part 2 by MELA TV 3 years ago 25 minutes 354,470 views",MELA TV,354470,354595,125
257,"Senselet Drama S04 EP 77 Part 1 ሰንሰለት ምዕራፍ 4 ክፍል 77 - Part 1 by MELA TV 3 years ago 21 minutes 372,795 views",MELA TV,372795,372916,121
258,"ገጣሚ ምንተስኖት ማሞ ""ስንዎደድ"" by MELA TV 3 years ago 11 minutes, 44 seconds 1,832 views",MELA TV,1832,1832,0
259,"Andargachew Tsege - አቶ አንዳርጋቸው ፅጌ በብሔራዊ ቲያትር መድረክ Yeweg Mishit on MELA TV - የወግ ምሽት በመላ ቲቪ by MELA TV 3 years ago 18 minutes 5,127 views",MELA TV,5127,5127,0
260,"Senselet Drama - Ethiopiatrustfund.org by MELA TV 3 years ago 12 minutes, 21 seconds 186,415 views",MELA TV,186415,186424,9
261,"PM Dr Abiy Ahmed - ጠ/ሚ አብይ አህመድ Yeweg Mishit on MELA TV - የወግ ምሽት በመላ ቲቪ by MELA TV 3 years ago 24 minutes 51,950 views",MELA TV,51950,51957,7
262,"Senselet Drama S04 EP 76 Part 1 ሰንሰለት ምዕራፍ 4 ክፍል 76 - Part 1 by MELA TV 3 years ago 22 minutes 374,099 views",MELA TV,374099,374238,139
263,"Senselet Drama S04 EP 76 Part 2 ሰንሰለት ምዕራፍ 4 ክፍል 76 - Part 2 by MELA TV 3 years ago 22 minutes 361,373 views",MELA TV,361373,361484,111
264,"Senselet Drama S04 EP 75 Part 2 ሰንሰለት ምዕራፍ 4 ክፍል 75 - Part 2 by MELA TV 3 years ago 20 minutes 329,822 views",MELA TV,329822,329935,113
265,"Senselet Drama S04 EP 75 Part 1 ሰንሰለት ምዕራፍ 4 ክፍል 75 - Part 1 by MELA TV 3 years ago 21 minutes 367,135 views",MELA TV,367135,367273,138
266,"ፍራሽ አዳሽ  የፖለቲካ አሽሙር by MELA TV 3 years ago 15 minutes 13,591 views",MELA TV,13591,13619,28
267,"ማን እነማን ናቸው ተፈሪ አለሙ by MELA TV 3 years ago 4 minutes, 11 seconds 1,904 views",MELA TV,1904,1904,0
268,"ከአክሱም ጫፍ አቁፋዳ በአለማየሁ ታደሰ by MELA TV 3 years ago 10 minutes, 29 seconds 3,675 views",MELA TV,3675,3677,2
269,"Senselet Drama S04 EP 74 Part 2 ሰንሰለት ምዕራፍ 4 ክፍል 74 - Part 2 by MELA TV 3 years ago 22 minutes 346,507 views",MELA TV,346507,346639,132
270,"Senselet Drama S04 EP 74 Part 1 ሰንሰለት ምዕራፍ 4 ክፍል 74 - Part 1 by MELA TV 3 years ago 22 minutes 361,185 views",MELA TV,361185,361318,133
271,"Senselet Drama S04 EP 73 Part 2 ሰንሰለት ምዕራፍ 4 ክፍል 73 - Part 2 by MELA TV 3 years ago 20 minutes 335,200 views",MELA TV,335200,335336,136
272,"Senselet Drama S04 EP 73 Part 1 ሰንሰለት ምዕራፍ 4 ክፍል 73 - Part 1 by MELA TV 3 years ago 24 minutes 386,146 views",MELA TV,386146,386329,183
273,"Senselet Drama S04 EP 72 Part 1 ሰንሰለት ምዕራፍ 4 ክፍል 72 - Part 1 by MELA TV 3 years ago 22 minutes 375,701 views",MELA TV,375701,375821,120
274,"Senselet Drama S04 EP 72 Part 2 ሰንሰለት ምዕራፍ 4 ክፍል 72 - Part 2 by MELA TV 3 years ago 21 minutes 330,197 views",MELA TV,330197,330277,80
275,"Hilina Desalgne የገደል ላይ ዕንቁ by MELA TV 3 years ago 11 minutes 35,952 views",MELA TV,35952,35958,6
276,"ሀገሬ አትፈርስም by MELA TV 3 years ago 9 minutes, 23 seconds 1,535 views",MELA TV,1535,1535,0
277,"ድንቁርናን ማንቀጥቀጥ ተራራ ከማንቀጥቀጥ በላይ ነው Daneil Keberet by MELA TV 3 years ago 11 minutes, 51 seconds 50,348 views",MELA TV,50348,50348,0
278,"""ካልሞትክ አይገሉህም""  እኔ ውስጤን አዳምጭ ወደ ሀገሬ ተመልሻለሁ Tesfay Geberehanan by MELA TV 3 years ago 12 minutes, 17 seconds 4,464 views",MELA TV,4464,4464,0
279,"ኑ ሃገሬን እናዋልዳት shimelese Abera Joro by MELA TV 3 years ago 12 minutes, 53 seconds 5,511 views",MELA TV,5511,5515,4
280,"Senselet Drama S04 EP 72 Part 2 ሰንሰለት ምዕራፍ 4 ክፍል 72 - Part 2 by MELA TV 3 years ago 20 minutes 347,656 views",MELA TV,347656,347813,157
281,"Senselet Drama S04 EP 71 Part 1 ሰንሰለት ምዕራፍ 4 ክፍል 71 - Part 1 by MELA TV 3 years ago 21 minutes 360,771 views",MELA TV,360771,360932,161
282,"Adera Birhanu Tezera New Music - አደራ  ብርሀኑ ተዘራ አዲስ ነጠላ ዜማ በቅርብ ቀን by MELA TV 3 years ago 1 minute, 4 seconds 4,523 views",MELA TV,4523,4525,2
283,"Ge'ez Poietic Jazz Part 02 - ግጥም በጃዝ ክፍል 02 on MELA TV December 2018 by MELA TV 3 years ago 27 minutes 6,200 views",MELA TV,6200,6201,1
284,"Fikadu Girma - Arada ፍቃዱ ግርማ - አራዳ እንዲህ ነው - New Ethiopian Music 2018 by MELA TV 3 years ago 8 minutes, 12 seconds 22,677 views",MELA TV,22677,23294,617
285,"Ge'ez Poietic Jazz Part 01 - ግጥም በጃዝ ክፍል 01 on MELA TV  December 2018 by MELA TV 3 years ago 23 minutes 7,835 views",MELA TV,7835,7835,0
286,"Senselet Drama S04 EP 70 Part 2 ሰንሰለት ምዕራፍ 4 ክፍል 70 - Part 2 by MELA TV 3 years ago 19 minutes 334,874 views",MELA TV,334874,335026,152
287,"Senselet Drama S04 EP 70 Part 1 ሰንሰለት ምዕራፍ 4 ክፍል 70 - Part 1 by MELA TV 3 years ago 20 minutes 400,051 views",MELA TV,400051,400197,146
288,"""በሰጠነው መጠን ነው የሚሰጠን ""ሙዓዘ ጥበባት ዳንኤል ክብረት | Yeweg Mishit on MELA TV - የወግ ምሽት በመላ ቲቪ by MELA TV 3 years ago 27 minutes 2,240 views",MELA TV,2240,2240,0
289,"ጌትነት እንየው by MELA TV 3 years ago 15 minutes 1,424 views",MELA TV,1424,1430,6
290,"Senselet Drama S04 EP 69 Part 1 ሰንሰለት ምዕራፍ 4 ክፍል 69 - Part 1 by MELA TV 3 years ago 19 minutes 353,438 views",MELA TV,353438,353577,139
291,"Senselet Drama S04 EP 69 Part 2 ሰንሰለት ምዕራፍ 4 ክፍል 69 - Part 2 by MELA TV 3 years ago 24 minutes 380,049 views",MELA TV,380049,380216,167
292,"And Enat And Hager - Abel Assefa 2018 New Ethiopian Music by MELA TV 3 years ago 5 minutes, 55 seconds 2,583 views",MELA TV,2583,2589,6
293,"የተደማሪው የፍቅር ደብዳቤ አርቲስት ደበበ እሸቱ by MELA TV 3 years ago 5 minutes, 44 seconds 1,647 views",MELA TV,1647,1648,1
294,"መፅናኛ ለሰካራሞች ጌትነት እንየው by MELA TV 3 years ago 4 minutes, 9 seconds 3,135 views",MELA TV,3135,3138,3
295,"ኢትዮጵያዊነት ከዘር በላይ ነው ኢትዮጵያዊነት ከዘር በላይ ነው by MELA TV 3 years ago 34 minutes 1,749 views",MELA TV,1749,1750,1
296,"ሼሁ የተፈቱ ቀን Yeweg Mishit on MELA TV - የወግ ምሽት በመላ ቲቪ by MELA TV 3 years ago 3 minutes, 56 seconds 3,166 views",MELA TV,3166,3166,0
297,"የድሮ ዘፈን እና የአሁን ዘፈን አስቂኝ ወግ ከአርቲስት ፍቃዱ ከበደ Yeweg Mishit on MELA TV - የወግ ምሽት በመላ ቲቪ by MELA TV 3 years ago 10 minutes, 24 seconds 10,283 views",MELA TV,10283,10291,8
298,"""ይህን ትንቢት ቴዲ ቀድሞ ከማን ሰማ ""ለቴዲ አፍሮ የተፃፈ Yeweg Mishit on MELA TV - የወግ ምሽት በመላ ቲቪ by MELA TV 3 years ago 1 minute, 46 seconds 1,254 views",MELA TV,1254,1254,0
299,"Senselet Drama S04 EP 68 Part 2 ሰንሰለት ምዕራፍ 4 ክፍል 68 - Part 2 by MELA TV 3 years ago 24 minutes 340,666 views",MELA TV,340666,340826,160
300,"Senselet Drama S04 EP 68 Part 1 ሰንሰለት ምዕራፍ 4 ክፍል 68 - Part 1 by MELA TV 3 years ago 22 minutes 359,048 views",MELA TV,359048,359179,131
301,"Dr. Dagnachew Assefa - ዶ/ር ዳኛቸው አሰፋ በወቅታዊ ጉዳይ ላይ አስገራሚ ንግግር Yeweg Mishit on MELA TV - የወግ ምሽት በመላ ቲቪ by MELA TV 3 years ago 27 minutes 11,013 views",MELA TV,11013,11016,3
302,"Endale Geta Kebede -ደራሲ እንዳለ ጌታ ከበደ ከጅብ አፍ ያስጣሉንን እናመስግን  | Yeweg Mishit on MELA TV - የወግ ምሽት በመላ ቲቪ by MELA TV 3 years ago 19 minutes 4,324 views",MELA TV,4324,4365,41
303,"Megabi Hadis Eshetu Alemayehu - ሰኳር መብራት ውሃ የሌላት ኢትዮጵያ | Yeweg Mishit on MELA TV - የወግ ምሽት በመላ ቲቪ by MELA TV 3 years ago 18 minutes 20,429 views",MELA TV,20429,20446,17
304,"Daniel Kibret - እስኪ አብረን እናውጋ  እስኪ አብረን እንብላ ""ትግራይ እና አማራ "" Yeweg Mishit on MELA TV - የወግ ምሽት በመላ ቲቪ by MELA TV 3 years ago 14 minutes, 14 seconds 2,137 views",MELA TV,2137,2138,1
305,"Daniel Kibret - አይነጋም ይነጋል - ሙዓዘ ጥበባት ዳንኤል ክብረት | Yeweg Mishit on MELA TV - የወግ ምሽት በመላ ቲቪ by MELA TV 3 years ago 24 minutes 18,293 views",MELA TV,18293,18308,15
306,"Comedian Dereje Haile - ኮሜዲያን ደረጄ ኃይሌ በወቅታዊ ጉዳይ የቀለደው አስቂኝ ቀልድ. by MELA TV 3 years ago 15 minutes 36,711 views",MELA TV,36711,36736,25
307,"Senselet Drama S04 EP 67 Part 2 ሰንሰለት ምዕራፍ 4 ክፍል 67 - Part 2 by MELA TV 3 years ago 25 minutes 358,677 views",MELA TV,358677,358819,142
308,"Senselet Drama S04 EP 67 Part 1 ሰንሰለት ምዕራፍ 4 ክፍል 67 - Part 1 by MELA TV 3 years ago 21 minutes 360,933 views",MELA TV,360933,361074,141
309,"The Great Run of Ethiopia 2018 - ታላቁ ሩጫ እና አሰቂኝ ትዕይንቶች by MELA TV 3 years ago 10 minutes, 49 seconds 5,265 views",MELA TV,5265,5267,2
310,"Senselet Drama S04 EP 66 Part 2 ሰንሰለት ምዕራፍ 4 ክፍል 66 - Part 2 by MELA TV 3 years ago 21 minutes 363,864 views",MELA TV,363864,364018,154
311,"Senselet Drama S04 EP 66 Part 1 ሰንሰለት ምዕራፍ 4 ክፍል 66 - Part 1 by MELA TV 3 years ago 17 minutes 346,787 views",MELA TV,346787,346945,158
312,"Hiwot Emishawe - ሕይወት እምሻው ቲርኪ ሚርኪ ያልሆነው የተማሩ ስዎች ጨዋታ | Yeweg Mishit on MELA TV - የወግ ምሽት በመላ ቲቪ by MELA TV 3 years ago 11 minutes, 2 seconds 16,157 views",MELA TV,16157,16182,25
313,"Zenebe Wela ደራሲ ዘነበ ወላ ስለ መገለፅ እና ስለ ሴት ለወጣቶች ያስተላለፍው መልዕክት Yeweg Mishit on MELA TV - የወግ ምሽት በመላ ቲቪ by MELA TV 3 years ago 18 minutes 25,515 views",MELA TV,25515,25561,46
314,"Loret Yetnebersh Neguse - ሎሬት የትነበርሽ ንጉሴ ስለ ፕሬዝዳንት ሳህለ ወርቅ ዘውዴ አዲሱ ሹመት Yeweg Mishit on MELA TV by MELA TV 3 years ago 16 minutes 235,296 views",MELA TV,235296,235383,87
315,"Senselet Drama S04 EP 65 Part 2 ሰንሰለት ምዕራፍ 4 ክፍል 65 - Part 2 by MELA TV 3 years ago 22 minutes 351,144 views",MELA TV,351144,351298,154
316,"Senselet Drama S04 EP 65 Part 1 ሰንሰለት ምዕራፍ 4 ክፍል 65 - Part 1 by MELA TV 3 years ago 20 minutes 360,258 views",MELA TV,360258,360417,159
317,"Senselet Drama S04 EP 65 Part 1 ሰንሰለት ምዕራፍ 4 ክፍል 65 - Part 1 by MELA TV 3 years ago 20 minutes 21,084 views",MELA TV,21084,21091,7
318,"Senselet Drama S04 EP 64 Part 2 ሰንሰለት ምዕራፍ 4 ክፍል 64 - Part 2 by MELA TV 3 years ago 21 minutes 369,353 views",MELA TV,369353,369512,159
319,"Senselet Drama S04 EP 64 Part 1 ሰንሰለት ምዕራፍ 4 ክፍል 64 - Part 1 by MELA TV 3 years ago 20 minutes 404,027 views",MELA TV,404027,404199,172
320,"Senselet Drama Season 4 Trailer - Saturday November 3 by MELA TV 3 years ago 1 minute, 33 seconds 23,813 views",MELA TV,23813,23814,1
321,"Senselet Drama Season 03  Recap 3 - ሰንሰለት ድራማ ምዕራፍ 3 ትውስታ 3 by MELA TV 3 years ago 51 minutes 10,325 views",MELA TV,10325,10332,7
322,"Tamagnen Geba Belew - Mehari Degefaw New Ethiopian Music 2018 by MELA TV 3 years ago 4 minutes, 49 seconds 46,227 views",MELA TV,46227,46327,100
323,"ESAT Discussion with Tamagne Beyene on his trip to Ethiopia - ታማኝ በየነ እና የኢትዮጵያ ጉዞው ከሲሳይ አጌና ጋር by MELA TV 3 years ago 3 minutes, 55 seconds 141,162 views",MELA TV,141162,141331,169
324,"Neway Debebe Apology to Ethiopians Interview with Tamagne Beyene | MELA TV 2018 by MELA TV 3 years ago 23 minutes 50,623 views",MELA TV,50623,50678,55
325,"Dr. Menber Aklilu - ዶክተር መንበር አክሊሉ በአሲድ የተቃጠለችው የአንድ ልጅ እናት ወደ አሜሪካ ወስዳ ልታሳክማት ነው | MELA TV 2018 by MELA TV 3 years ago 41 minutes 25,251 views",MELA TV,25251,25493,242
326,"Guzo Adwa Part 2 | MELA TV 2018 by MELA TV 3 years ago 14 minutes, 32 seconds 632 views",MELA TV,632,634,2
327,"Guzo Adwa Part 1 | MELA TV 2018 by MELA TV 3 years ago 6 minutes, 54 seconds 981 views",MELA TV,981,987,6
328,"Senselet Drama Season 03 Ep 64 Recap 2 - ሰንሰለት ድራማ  ምዕራፍ 3 ትውስታ 2 by MELA TV 3 years ago 51 minutes 25,573 views",MELA TV,25573,25576,3
329,Ustaze Abdselam - ኡስታዝ አብድሰላም ሰይድ ማነህና እጄን ልስጥህ 2018 | Yeweg Mishit on MELA TV - የወግ ምሽት በመላ ቲቪ by MELA TV 3 years ago 23 minutes 459 views,MELA TV,459,459,0
330,"Daniel Kibret ዳንኤል ክብረት | Yeweg Mishit on MELA TV - የወግ ምሽት በመላ ቲቪ by MELA TV 3 years ago 19 minutes 7,224 views",MELA TV,7224,7231,7
331,"Fikadu Kebede 40 Minutes on Air ፈቃዱ ከበደ አርባ ደቂቃ አየር ላይ | Yeweg Mishit on MELA TV - የወግ ምሽት በመላ ቲቪ by MELA TV 3 years ago 19 minutes 15,233 views",MELA TV,15233,15304,71
332,"Kidist Arsema Semaet Gedam Guzo Advert by MELA TV 3 years ago 4 minutes, 46 seconds 2,230 views",MELA TV,2230,2231,1
333,"Tamagne Beyene on Burayou September 2018 by MELA TV 3 years ago 33 minutes 1,621 views",MELA TV,1621,1621,0
334,"Tamagne Beyene speech In Diredawa Septemeber 2018 by MELA TV 3 years ago 21 minutes 4,901 views",MELA TV,4901,4923,22
335,"Tamagne Beyene speech in Adama Nazret 2018 by MELA TV 3 years ago 15 minutes 8,600 views",MELA TV,8600,8681,81
336,The Mystery of Ethiopian Calandar - የኢትዮጵያ የዘመን አቆጣጠር ሚስጥር by MELA TV 3 years ago 51 minutes 753 views,MELA TV,753,757,4
337,"Ethiopira - Henok Berhanu New Ethiopian Music 2018 by MELA TV 3 years ago 6 minutes, 59 seconds 4,912 views",MELA TV,4912,4917,5
338,"Fisum T - Bandira | ባንዲራ New Ethiopian Music Dedicated to Dr Abiy Ahmed 2018 by MELA TV 3 years ago 5 minutes, 13 seconds 5,196 views",MELA TV,5196,5219,23
339,"Henock Ekubamichael - ቀናሽ ወይ | Kenash Wey with Lyrics  - New Ethiopian Music 2018 by MELA TV 3 years ago 4 minutes, 22 seconds 37,551 views",MELA TV,37551,37881,330
340,"Leule and Tirhas Wedding Aug 05 2017 Highlight 1 by MELA TV 3 years ago 2 minutes, 50 seconds 1,959 views",MELA TV,1959,1960,1
341,"Senselet crew and Ethiopian artists in North America fundraising call for Fikadu and Mahlet by MELA TV 3 years ago 4 minutes, 33 seconds 1,017 views",MELA TV,1017,1017,0
342,"Neway Debebe - Yefikir Emebet - Reggae cover by Andinet Birhanu | Andy B. Studio Jam 2018 by MELA TV 4 years ago 4 minutes, 53 seconds 19,707 views",MELA TV,19707,19746,39
343,"The Return Drum Cover - Addis Misganaw (Adio) & Habtamu Negash by MELA TV 4 years ago 3 minutes, 55 seconds 2,313 views",MELA TV,2313,2317,4
344,"Getish Mamo - Yamegnal | Tekebel Vol. 3 Comming Soon by MELA TV 4 years ago 1 minute, 6 seconds 161,354 views",MELA TV,161354,161489,135
345,"Gizachew Teklemaryam - Ligabaw Beyene New Ethiopian Music 2018 by MELA TV 4 years ago 8 minutes, 23 seconds 12,730 views",MELA TV,12730,12737,7
346,"Senselet Drama Season 2 | ሰንሰለት ድራማ Official Trailer 2018 by MELA TV 4 years ago 2 minutes, 54 seconds 4,261 views",MELA TV,4261,4263,2
347,"Senselet Drama Actor Maru Abebe /Asmamaw/ Interview with Admas Radio by MELA TV 4 years ago 21 minutes 14,786 views",MELA TV,14786,14788,2
348,"Tsegazeab Gebreslasie - Emenini (እመንኒ) - New Ethiopian Music 2017 (Official Video) by MELA TV 4 years ago 4 minutes, 3 seconds 12,938 views",MELA TV,12938,12940,2
349,"Saba & Miki Wedding Highlight by MELA TV 4 years ago 4 minutes, 54 seconds 4,745 views",MELA TV,4745,4746,1
350,"Abrham Maru - Lwazo New Ethiopian Music 2017 by MELA TV 4 years ago 5 minutes, 39 seconds 6,510 views",MELA TV,6510,6510,0
351,"And Nen - አንድ ነን - New Ethiopian Music 2018 አዲሱ የኢትዮጵያ ብሄራዊ መዝሙር by MELA TV 4 years ago 7 minutes, 2 seconds 36,526 views",MELA TV,36526,36642,116
352,"Senselet Drama Episode 3 - ሰንሰለት ድራማ ክፍል 3 by MELA TV 4 years ago 34 minutes 615,075 views",MELA TV,615075,615524,449
353,"Henok Berhanu - Yibel Bered by MELA TV 4 years ago 5 minutes, 48 seconds 4,819 views",MELA TV,4819,4821,2
354,"Senselet Drama Episode 2 - ሰንሰለት ድራማ ክፍል 2 by MELA TV 4 years ago 42 minutes 502,874 views",MELA TV,502874,503323,449
355,"Senselet Drama | ሰንሰለት ድራማ by MELA TV 4 years ago 2 minutes, 59 seconds 46,167 views",MELA TV,46167,46171,4
356,"Senselet Drama Episode 1 - ሰንሰለት ድራማ ክፍል 1 by MELA TV 4 years ago 42 minutes 973,567 views",MELA TV,973567,974250,683
357,"Dawit Melese - Alchalkum 2017 with Ras Band Live by MELA TV 4 years ago 6 minutes, 2 seconds 1,098 views",MELA TV,1098,1123,25
358,"Teddy Afro  SEED Award Ceremony May 2017 Washington D.C. by MELA TV 4 years ago 13 minutes, 36 seconds 875,188 views",MELA TV,875188,875686,498
359,"Teddy Afro - ቴዲ አፍሮ New Dedicated Music for Tewodros Kassahun by MELA TV 4 years ago 4 minutes, 46 seconds 21,852 views",MELA TV,21852,21862,10
360,"Lafontain 20th years Anniversary/Reunion Concert Advert by MELA TV 4 years ago 5 minutes, 44 seconds 2,183 views",MELA TV,2183,2183,0
361,"Teddy Afro Latest full Interview about his new Album Ethiopia on VOA by MELA TV 4 years ago 35 minutes 60,064 views",MELA TV,60064,60066,2
362,"Teddy Afro Latest Interview about his new Album Ethiopia on VOA by MELA TV 4 years ago 8 minutes, 28 seconds 3,429 views",MELA TV,3429,3429,0
363,"Semegne and shewangezaw by MELA TV 4 years ago 12 minutes, 32 seconds 6,653 views",MELA TV,6653,6653,0
364,"Zrefe እውን ቤተክርስቲያን እንዲህ ነው አስተምሮዋ? by MELA TV 4 years ago 30 minutes 2,826 views",MELA TV,2826,2827,1
365,"በደብረ ሰላም ቅድስት ማርያም የገና በዓል by MELA TV 4 years ago 52 minutes 1,459 views",MELA TV,1459,1459,0
366,"Genet Abate - Man Lilekih | ማን ሊለቅህ - New Ethiopian Music 2017 (Official Music Video) by MELA TV 5 years ago 5 minutes, 47 seconds 11,853 views",MELA TV,11853,11881,28
367,"Hibist Tiruneh - Tagesegn | ህብስት ጥሩነህ - ታገሰኝ New Official Music Video 2017 by MELA TV 5 years ago 6 minutes, 12 seconds 96,623 views",MELA TV,96623,97124,501
368,"Shambel Belayneh Performing Live -Tarik Yifreden 2015 ECO STAGE by MELA TV 5 years ago 4 minutes, 26 seconds 1,568 views",MELA TV,1568,1569,1
369,"Girma Beyene - Enken Yelelebish by MELA TV 5 years ago 4 minutes, 25 seconds 3,537 views",MELA TV,3537,3565,28
370,"New Ethiopian Music 2017 - Yemareshet Damtew - Biyyyaako Sinlalla Oromigna by MELA TV 5 years ago 5 minutes, 33 seconds 16,081 views",MELA TV,16081,16119,38
371,"Moges Ababu - Konjiye New Ethiopian Official Music Video 2017 by MELA TV 5 years ago 6 minutes, 22 seconds 5,503 views",MELA TV,5503,5507,4
372,"Sentayehu - Yemareshet Damtew New Ethiopian Music Video 2017 by MELA TV 5 years ago 5 minutes, 6 seconds 9,191 views",MELA TV,9191,9209,18
373,"Senselet Drama | ሰንሰለት ድራማ Official Trailer 2017 by MELA TV 5 years ago 1 minute, 24 seconds 18,160 views",MELA TV,18160,18163,3
374,"Abrham - Salem Welday  ኣብርሃም New Eritrean  music 2017(official music vedio) by MELA TV 5 years ago 7 minutes, 13 seconds 19,555 views",MELA TV,19555,19573,18
375,"Eyob Mekonen Tew Yalshign Tewkut | ተው ያልሽኝን New Ethiopian Music 2017 New Album by MELA TV 5 years ago 5 minutes, 24 seconds 9,343 views",MELA TV,9343,9402,59
376,"Eyob Mekonen - Libe Tenestwal | ልቤ ተነስቷል  New Ethiopian Music 2017 | እሮጣለሁ Erotalehu New Album by MELA TV 5 years ago 5 minutes, 1 second 131,210 views",MELA TV,131210,131289,79
377,"Moges Ababu - Konjiye - ቆንጅዬ New Ethiopian Music 2017 (Official Music Video) by MELA TV 5 years ago 6 minutes, 22 seconds 1,933 views",MELA TV,1933,1944,11
378,"Dr.Zebene Lema Ethiopian Gena Christmas Celebration at Debreselam Medhanialem WDC 2016 by MELA TV 5 years ago 9 minutes, 31 seconds 14,457 views",MELA TV,14457,14462,5
379,"Gela - Kalkidan Meshesha New Ethiopian Music 2017 by MELA TV 5 years ago 6 minutes, 16 seconds 171,942 views",MELA TV,171942,172292,350
380,"Ethiopian Wedding Highlight - Jara and Weyni 2016 by MELA TV 5 years ago 15 minutes 12,565 views",MELA TV,12565,12565,0
381,"የፋሲል ደሞዝ ሲዲ ርሊዝ እንዲህ ነበር 2015 by MELA TV 5 years ago 21 minutes 9,468 views",MELA TV,9468,9468,0
382,"Andy B - Anchin Ato Menor Kebedegne  Ethiopian Music 2016 by MELA TV 5 years ago 4 minutes, 22 seconds 2,390 views",MELA TV,2390,2391,1
383,"Eyayu Funges in Washington Dc Nov 2016 by MELA TV 5 years ago 5 minutes, 31 seconds 50,222 views",MELA TV,50222,50242,20
384,"Fantish Bekele - Addis Tewled (አዲስ ትውልድ) - New Ethiopian Music 2016 by MELA TV 5 years ago 8 minutes, 10 seconds 354,307 views",MELA TV,354307,354352,45
385,"Yirakilin Yehe Esat | ይራቅልን ይህ እሳት - Ethiopian Unity Song Official Video 2016 by MELA TV 5 years ago 6 minutes, 50 seconds 108,473 views",MELA TV,108473,108483,10
386,"Mesfin Bekele - Selam Le Ethiopia New Ethiopian Music 2016 by MELA TV 5 years ago 4 minutes, 57 seconds 316,052 views",MELA TV,316052,316067,15
387,"Fasil Demoz 25 Amet New Ethiopian Music 2016 by MELA TV 5 years ago 6 minutes, 8 seconds 784,544 views",MELA TV,784544,785296,752
388,"Dani - Yikeweti  Official Ethiopian Music Video 2016 by MELA TV 5 years ago 4 minutes, 50 seconds 116,119 views",MELA TV,116119,117953,1834
389,"Helen Girma - Salmotibih by MELA TV 5 years ago 7 minutes, 8 seconds 12,388 views",MELA TV,12388,12443,55
390,"Rello - Ras Biruk(Barkey) and Ras Band New Ethiopian Official Music Video May 2016 by MELA TV 5 years ago 5 minutes, 41 seconds 11,561 views",MELA TV,11561,11568,7
391,"Ras Biruk Barky - Zemen? New Offical Music Video 2016 by MELA TV 5 years ago 5 minutes, 53 seconds 11,760 views",MELA TV,11760,11762,2
392,"Mela Productions by MELA TV 5 years ago 18 seconds 3,884 views",MELA TV,3884,3889,5
393,"Dina Antenh Dagnachew - BADE - በዴ New Single  Ethiopian Music 2016 Official Video by MELA TV 5 years ago 5 minutes 69,837 views",MELA TV,69837,70094,257
394,"STAND UP FOR SOMALIA by MELA TV 5 years ago 52 minutes 3,728 views",MELA TV,3728,3729,1
395,"Fundraising For Fekadu Hailegebrail by MELA TV 6 years ago 9 minutes, 48 seconds 393 views",MELA TV,393,393,0
396,"Fiker and Abel Wedding July 26th 2015 by MELA TV 6 years ago 8 minutes, 39 seconds 117,549 views",MELA TV,117549,117550,1
397,"Fiker and Abel Wedding July 26th 2015 by MELA TV 6 years ago 9 minutes, 12 seconds 691 views",MELA TV,691,691,0
398,"Kalkidan Meshesha - Ema - (Official Music Video) - New Ethiopian Music 2015 by MELA TV 6 years ago 5 minutes, 55 seconds 678,598 views",MELA TV,678598,681696,3098
399,"Endayfera - Ethio-Man ትንሹ ቴዲ አፍሮ New Official Ethiopian Music by MELA TV 6 years ago 6 minutes, 15 seconds 5,223,157 views",MELA TV,5223157,5225247,2090
400,"የጋዜጠኛ ሰይፉ ፋንታሁንንና የቬሮኒካ ኑረዲን ጋብቻ by MELA TV 6 years ago 9 minutes, 58 seconds 93,616 views",MELA TV,93616,93622,6
401,"Hailu Fereja - Zikishatamin [New Official Ethiopian Guragegna Music Video] by MELA TV 6 years ago 7 minutes, 17 seconds 1,359,028 views",MELA TV,1359028,1362492,3464
402,"malqese new lerase by MELA TV 6 years ago 10 minutes, 1 second 5,156 views",MELA TV,5156,5156,0
403,"Kesis Tizitaw Samuel Mezmur - Yemeskelu Serawit by MELA TV 6 years ago 9 minutes, 24 seconds 93,343 views",MELA TV,93343,93419,76
404,"Ethiopian Adera - New Official Music Video April 2015 by MELA TV 6 years ago 5 minutes, 27 seconds 290,408 views",MELA TV,290408,290431,23
405,"Tamagne Beyene Speech infront of South African Embassy by MELA TV 6 years ago 4 minutes, 42 seconds 54,160 views",MELA TV,54160,54164,4
406,"Timket Celebration at Debre Mehret Saint Michael Ethiopian Orthodox Tewahedo Church Jan 19 2015 by MELA TV 7 years ago 26 minutes 68,812 views",MELA TV,68812,68818,6
407,"Aster Bedane Interview with Hulie Addis Esat Radio by MELA TV 7 years ago 12 minutes, 29 seconds 19,584 views",MELA TV,19584,19586,2
408,"Meskel Demera Celebration at Virginia Maryland DC hagere sibket 2014 by MELA TV 7 years ago 46 minutes 17,503 views",MELA TV,17503,17505,2
409,"Meskel Demera Celebration at DSK Mariam Washington, DC 2014 by MELA TV 7 years ago 34 minutes 8,026 views",MELA TV,8026,8027,1
410,"Endale Admike Fikir Nen by MELA TV 7 years ago 4 minutes, 52 seconds 29,226 views",MELA TV,29226,29375,149
411,"Hanna Gizaw & Dn Temesgen Asfaw - Kimsha Highlight Video by MELA TV 7 years ago 9 minutes, 59 seconds 24,119 views",MELA TV,24119,24121,2
412,"ESAT Hulie Addis Radio with Hirut Bekele by MELA TV 8 years ago 9 minutes, 11 seconds 3,450 views",MELA TV,3450,3453,3
413,"Mengedu Rezeme - Behilue Kassahune by MELA TV 8 years ago 3 minutes, 54 seconds 1,858 views",MELA TV,1858,1864,6
414,"ESAT Semaywi Demo Sep 22, 2013 Addis Ababa, Ethiopia by MELA TV 8 years ago 30 minutes 1,819 views",MELA TV,1819,1819,0
415,"Protest at Saudi Arabia Embassy - Tamagne Beyene by MELA TV 8 years ago 9 minutes, 3 seconds 48,967 views",MELA TV,48967,48968,1
