,Posts,Channel,Views_03/03,Views_03/12,view_delta
0,"Ethiopian Music : Gammachuu Nagarii (Ee Sayyoo) - New Ethiopian Music 2022(Official Video) by Minew Shewa Tube 37 minutes ago 6 minutes, 52 seconds 499 views",Minew Shewa Entertainment,499,7290,6791
1,"Ethiopian Music : Amanuel Mengiste አማኑኤል መንግስቴ (ማን ጎደለኝ) - New Ethiopian Music 2022(Official Video) by Minew Shewa Tube 1 day ago 7 minutes, 16 seconds 6,149 views",Minew Shewa Entertainment,6149,11283,5134
2,"Ethiopian Music : Anteneh Mengistu አንተነህ መንግስቱ (አይገርመኝም)  - New Ethiopian Music 2022(Official Video) by Minew Shewa Tube 3 days ago 5 minutes, 7 seconds 11,647 views",Minew Shewa Entertainment,11647,15651,4004
3,"Ethiopian Music : Tesfaye Chane ተስፋዬ ጫኔ (ተናገር አራዳ) - New Ethiopian Music 2022(Official Video) by Minew Shewa Tube 3 days ago 5 minutes, 36 seconds 5,225 views",Minew Shewa Entertainment,5225,6307,1082
4,"Ethiopian Music : Neway Debebe (Gondar) ነዋይ ደበበ (ጎንደር)  - New Ethiopian Music 2022(Official Video) by Minew Shewa Tube 5 days ago 8 minutes, 9 seconds 372,813 views",Minew Shewa Entertainment,372813,595346,222533
5,"Ethiopian Music : Lij Abe (Dummy) ልጅ ኤብ (ዳሚ) - New Ethiopian Music 2022(Official Video) by Minew Shewa Tube 5 days ago 1 minute, 34 seconds 6,695 views",Minew Shewa Entertainment,6695,8202,1507
6,"Ethiopian Music : Seble Sebsibe (Zebibo) ሰብለ ሰብስቤ (ዘቢቦ) - New Ethiopian Music 2022(Official Video) by Minew Shewa Tube 8 days ago 4 minutes, 30 seconds 37,858 views",Minew Shewa Entertainment,37858,42617,4759
7,"Ethiopian Music : Lataa Tolaa (Misirro Ko) - New Ethiopian Music 2022(Official Video) by Minew Shewa Tube 9 days ago 5 minutes, 53 seconds 12,256 views",Minew Shewa Entertainment,12256,13357,1101
8,"Muluken Nigusse ሙሉቀን ንጉሴ (ኢትዮጵያ ለዘለዓለም ትኑር) - New Ethiopian Music 2022(Official Video) by Minew Shewa Tube 9 days ago 5 minutes, 13 seconds 6,942 views",Minew Shewa Entertainment,6942,7506,564
9,"ዮሴፍ ደነቀ ፣ ግርማ ዮሃንስ ፣ ወንድሙ ታደሰ ፣ ቦሻ ቦዳ (ሆዴ ባባ) - New Ethiopian Music 2022(Official Video) by Minew Shewa Tube 11 days ago 4 minutes, 49 seconds 8,379 views",Minew Shewa Entertainment,8379,9107,728
10,"Ethiopian Music : Burik (Ayewa) ቡሪክ (አይዋ) - New Ethiopian Music 2022(Official Video) by Minew Shewa Tube 12 days ago 3 minutes, 51 seconds 362,766 views",Minew Shewa Entertainment,362766,504107,141341
11,"Behailu Delelegn በሃይሉ ደለለኝ (ተሰናበቺኝ)  - New Ethiopian Music 2022(Official Video) by Minew Shewa Tube 13 days ago 4 minutes, 50 seconds 52,361 views",Minew Shewa Entertainment,52361,64095,11734
12,"Ethiopian Music : Papa ft Hune (Konjo)  - New Ethiopian Music 2022(Official Video) by Minew Shewa Tube 2 weeks ago 4 minutes 24,568 views",Minew Shewa Entertainment,24568,27941,3373
13,"Ethiopian Music : Akliilu Bareedaa (Namaqabdaa) - New Ethiopian Music 2022(Official Video) by Minew Shewa Tube 2 weeks ago 5 minutes, 20 seconds 8,691 views",Minew Shewa Entertainment,8691,8990,299
14,"Ethiopian Music : Mulualem Takele (Wude) ሙሉአለም ታከለ (ውዴ) - New Ethiopian Music 2022(Official Video) by Minew Shewa Tube 2 weeks ago 4 minutes, 36 seconds 702,517 views",Minew Shewa Entertainment,702517,888334,185817
15,"Ethiopian Music : Israel Belete እስራኤል በለጠ (ሱስ ሆነሺብኛል) - New Ethiopian Music 2022(Official Video) by Minew Shewa Tube 2 weeks ago 4 minutes, 2 seconds 20,389 views",Minew Shewa Entertainment,20389,21701,1312
16,"Ethiopian Music : Manaye Maja ማናዬ ማጃ (ቶጵያይ የለሲ) - New Ethiopian Music 2022(Official Video) by Minew Shewa Tube 3 weeks ago 7 minutes, 31 seconds 7,399 views",Minew Shewa Entertainment,7399,7708,309
17,"Ethiopian Music : Bayu Amore ባዩ አሞሬ (ሃገሬ) - New Ethiopian Music 2022(Official Video) by Minew Shewa Tube 3 weeks ago 6 minutes, 22 seconds 9,161 views",Minew Shewa Entertainment,9161,9447,286
18,"Ethiopian Music : Getu Belete (Wede) ጌቱ በለጠ (ውዴ) - New Ethiopian Music 2022(Official Video) by Minew Shewa Tube 3 weeks ago 7 minutes, 15 seconds 37,305 views",Minew Shewa Entertainment,37305,40021,2716
19,"Ethiopian Music : Melat Kelemwork ሜላት ቀለመወርቅ (ከአፌ ላይ) - New Ethiopian Music 2022(Official Video) by Minew Shewa Tube 3 weeks ago 4 minutes 433,390 views",Minew Shewa Entertainment,433390,545745,112355
20,"Ethiopian Music : Abel Getu (Korash) አቤል ጌቱ (ኮራሽ) - New Ethiopian Music 2022(Official Video) by Minew Shewa Tube 3 weeks ago 3 minutes, 12 seconds 17,763 views",Minew Shewa Entertainment,17763,18353,590
21,"Ethiopian Music : Minale Tadesse ምናለ ታደሰ (ኢትዮጵያ ከፍ በይ) - New Ethiopian Music 2021(Official Video) by Minew Shewa Tube 1 month ago 5 minutes, 27 seconds 7,309 views",Minew Shewa Entertainment,7309,7480,171
22,"Oromo Music : Hayiluu Kitaabaa (Fooliin Gootaa) - New Oromo Music 2022(Official Video) by Minew Shewa Tube 1 month ago 7 minutes, 16 seconds 32,232 views",Minew Shewa Entertainment,32232,34038,1806
23,"Ethiopian Music : Zebader Alemu ዘብአደር አለሙ (ልገስግስ) - New Ethiopian Music 2022(Official Video) by Minew Shewa Tube 1 month ago 6 minutes, 42 seconds 14,208 views",Minew Shewa Entertainment,14208,14481,273
24,"Ethiopian Music : Ashenafi kebede (Hellwa) አሸናፊ ከበደ (ሄልዋ) - New Ethiopian Music 2022(Official Video) by Minew Shewa Tube 1 month ago 3 minutes, 53 seconds 18,837 views",Minew Shewa Entertainment,18837,19247,410
25,"Rediate Adinew (Hager Selam) ረድኤት አድነው (ሃገር ሰላም) - New Ethiopian Music 2022(Official Video) by Minew Shewa Tube 1 month ago 7 minutes, 13 seconds 6,011 views",Minew Shewa Entertainment,6011,6180,169
26,"Ethiopian Music : Solomon James Browne (Heart Beat) - New Ethiopian Music 2022(Official Video) by Minew Shewa Tube 1 month ago 3 minutes, 10 seconds 4,003 views",Minew Shewa Entertainment,4003,4079,76
27,"Ethiopian Music : Bewketu Sewmehon በእውቀቱ ሰውመሆን (ሳም ጉንጯን) - New Ethiopian Music 2022(Official Video) by Minew Shewa Tube 1 month ago 5 minutes, 39 seconds 97,461 views",Minew Shewa Entertainment,97461,104098,6637
28,"Ethiopian Music፡ Aychew Kindayehu (Lilita) አይቸው ክንዳየሁ (ሊሊታ) New Ethiopian Music 2022(Official Video) by Minew Shewa Tube 1 month ago 3 minutes, 53 seconds 14,733 views",Minew Shewa Entertainment,14733,15250,517
29,"Ethiopian Music : Abebe Tsige (Awdamet) አበበ ፅጌ (አውዳመት) - New Ethiopian Music 2022(Official Video) by Minew Shewa Tube 1 month ago 5 minutes, 24 seconds 6,684 views",Minew Shewa Entertainment,6684,6777,93
30,"Ethiopian Music : Yordanos Tadele ዮርዳኖስ ታደለ (ምን ይል ሚኒሊክ) - New Ethiopian Music 2022(Official Video) by Minew Shewa Tube 1 month ago 5 minutes, 51 seconds 8,523 views",Minew Shewa Entertainment,8523,8695,172
31,"Ethiopian Music : Temesgen Zigale ተመስገን ዝጋለ (እርቄም አልደላኝ) - New Ethiopian Music 2022(Official Video) by Minew Shewa Tube 1 month ago 6 minutes, 9 seconds 16,996 views",Minew Shewa Entertainment,16996,17468,472
32,"Ethiopian Music : Sabaa'if Umar (Odaa Murtii) - New Ethiopian Music 2022(Official Video) by Minew Shewa Tube 1 month ago 5 minutes, 8 seconds 5,897 views",Minew Shewa Entertainment,5897,6061,164
33,"Ethiopian Music : Teddy AB (Hands of Ethiopia) - New Ethiopian Music 2022(Official Video) by Minew Shewa Tube 1 month ago 4 minutes, 13 seconds 13,947 views",Minew Shewa Entertainment,13947,14191,244
34,"Estegenet Hailemariam እፀገነት ሃይለማርያም (የአፍሪካ እናት) - New Ethiopian Music 2022(Official Video) by Minew Shewa Tube 1 month ago 5 minutes, 21 seconds 23,842 views",Minew Shewa Entertainment,23842,24308,466
35,"Ethiopian Music : Solomon Kassa ሰለሞን ካሳ (ወይን አበባ) - New Ethiopian Music 2022(Official Video) by Minew Shewa Tube 1 month ago 6 minutes, 8 seconds 9,368 views",Minew Shewa Entertainment,9368,9487,119
36,"Ethiopian Music : Diinoo Amad (Beekkadhu si Beekee) - New Ethiopian Music 2021(Official Video) by Minew Shewa Tube 1 month ago 5 minutes, 28 seconds 7,980 views",Minew Shewa Entertainment,7980,8046,66
37,"Ethiopian Music : G Mesay Kebede ጂ መሳይ ከበደ (መጣሁልሽ ... ሃገሬ) New Ethiopian Music 2022(Official Video) by Minew Shewa Tube 1 month ago 3 minutes, 37 seconds 46,739 views",Minew Shewa Entertainment,46739,47634,895
38,"Halima Abdurahman ሃሊማ አብዱራህማን (የመንታ እናት) - New Ethiopian Music 2021(Official Video) by Minew Shewa Tube 1 month ago 5 minutes, 30 seconds 73,482 views",Minew Shewa Entertainment,73482,74841,1359
39,"Ethiopian Music : Atse Tinsu አፄ ትንሱ (ወዲህ ባይ) - New Ethiopian Music 2021(Official Video) by Minew Shewa Tube 1 month ago 4 minutes, 2 seconds 195,191 views",Minew Shewa Entertainment,195191,232361,37170
40,"Ethiopian Music : Tesfaye Bedasso ተስፋዬ በዳሶ (ኢትዮጵያ ሀገሬ) - New Ethiopian Music 2021(Official Video) by Minew Shewa Tube 1 month ago 7 minutes, 17 seconds 8,564 views",Minew Shewa Entertainment,8564,8635,71
41,"Siymregn Teshome (Yene Konjo) ሲያምረኝ ተሾመ (የኔ ቆንጆ) - New Ethiopian Music 2021(Official Video) by Minew Shewa Tube 1 month ago 4 minutes, 2 seconds 19,612 views",Minew Shewa Entertainment,19612,20055,443
42,"Ethiopian Music : Mike Los Afros (ከ ዓመት እስከ ዓመት) - New Ethiopian Music 2021(Official Video) by Minew Shewa Tube 1 month ago 4 minutes, 36 seconds 9,166 views",Minew Shewa Entertainment,9166,9284,118
43,"Ethiopian Music : Daniel Bele ዳንኤል በሌ (ተው በሉት) - New Ethiopian Music 2021(Official Video) by Minew Shewa Tube 1 month ago 4 minutes, 20 seconds 6,384 views",Minew Shewa Entertainment,6384,6488,104
44,"Ethiopian Music : Eshetu Legese እሸቱ ለገሰ (ኮናቲታና አች ኮኔ?) - New Ethiopian Music 2021(Official Video) by Minew Shewa Tube 2 months ago 6 minutes, 22 seconds 7,171 views",Minew Shewa Entertainment,7171,7250,79
45,"Ethiopian Music : Frew Gebeyew ፍሬው ገበየሁ (ዱማ ዱማ) - New Ethiopian Music 2021(Official Video) by Minew Shewa Tube 2 months ago 3 minutes, 29 seconds 13,018 views",Minew Shewa Entertainment,13018,13132,114
46,"Ethiopian Music : Mahmud Misbah (Ya Obbolessa koo) - New Ethiopian Music 2021(Official Video) by Minew Shewa Tube 2 months ago 4 minutes, 57 seconds 8,735 views",Minew Shewa Entertainment,8735,8866,131
47,"Biruk Shibabew x Alem Tibebu ብሩክ ሽባባው እና አለም ጥበቡ (አለኝ) - New Ethiopian Music 2021(Official Video) by Minew Shewa Tube 2 months ago 5 minutes, 29 seconds 8,134 views",Minew Shewa Entertainment,8134,8237,103
48,"Ethiopian Music : Genet Masresha ገነት ማስረሻ (ዘራፌዋ) - New Ethiopian Music 2021(Official Video) by Minew Shewa Tube 2 months ago 7 minutes 36,865 views",Minew Shewa Entertainment,36865,37574,709
49,"Ethiopian Music : Benyam Tesfa ቢንያም ተስፋ (ቸር ያሰማን) - New Ethiopian Music 2021(Official Video) by Minew Shewa Tube 2 months ago 4 minutes, 40 seconds 23,823 views",Minew Shewa Entertainment,23823,24004,181
50,"Ethiopian Music : Eneyew Terefe እንየው ተረፈ (አፋጀሺኝ) - New Ethiopian Music 2021(Official Video) by Minew Shewa Tube 2 months ago 6 minutes, 40 seconds 9,766 views",Minew Shewa Entertainment,9766,9852,86
51,"Ethiopian Music : Tibebe Adefres ጥበበ አደፍርስ (የኔ ቆንጆ) - New Ethiopian Music 2021(Official Video) by Minew Shewa Tube 2 months ago 5 minutes, 3 seconds 12,137 views",Minew Shewa Entertainment,12137,12318,181
52,"Yohannes Feleke  - INs and OUTs (Coming Soon New Movie Trailer) by Minew Shewa Tube 2 months ago 1 minute, 26 seconds 2,243 views",Minew Shewa Entertainment,2243,2265,22
53,"Maskaram Gaashaaw (Joollee biyya teenyaa) by Minew Shewa Tube 2 months ago 5 minutes, 30 seconds 5,360 views",Minew Shewa Entertainment,5360,5395,35
54,"Ethiopian Music : Hirut Franko ሂሩት ፍራንኮ (አይዞሽ ኢትዮጵያ) - New Ethiopian Music 2021(Official Video) by Minew Shewa Tube 2 months ago 4 minutes, 12 seconds 8,897 views",Minew Shewa Entertainment,8897,8936,39
55,"Ethiopian Music : ሙሉጌታ ሽቴ ፣ ፌኔት ምትኩ ፣ ሳሙኤል ጋይቶ (ሞት ፅድቅ ነው) -New Ethiopian Music 2021(Official Video) by Minew Shewa Tube 2 months ago 5 minutes, 20 seconds 19,874 views",Minew Shewa Entertainment,19874,19992,118
56,"Ethiopian Music : Henok Berhanu (Amen) ሄኖክ ብርሃኑ (አሜን) - New Ethiopian Music 2021(Official Video) by Minew Shewa Tube 2 months ago 3 minutes, 23 seconds 10,330 views",Minew Shewa Entertainment,10330,10379,49
57,"Ethiopian Music : Hiwi Asaye ሂዊ አሳዬ (ናፍቀኸኛል) - New Ethiopian Music 2021(Official Video) by Minew Shewa Tube 2 months ago 3 minutes, 49 seconds 14,172 views",Minew Shewa Entertainment,14172,14355,183
58,"Ethiopian Music : Azeb H/Gebriel አዜብ ኃ/ገብርኤል (አይዞሽ ኢትዮጵያ) - New Ethiopian Music 2021(Official Video) by Minew Shewa Tube 2 months ago 6 minutes, 2 seconds 23,562 views",Minew Shewa Entertainment,23562,23818,256
59,"Ethiopian Music : Jawaar Huseen (Muramte) - New Ethiopian Music 2021(Official Video) by Minew Shewa Tube 2 months ago 5 minutes, 31 seconds 6,199 views",Minew Shewa Entertainment,6199,6248,49
60,"Ethiopian Music : Aweke Abebe አወቀ አበበ (ሃገሬ ምን አደረኩልሽ) - New Ethiopian Music 2021(Official Video) by Minew Shewa Tube 2 months ago 5 minutes, 11 seconds 12,884 views",Minew Shewa Entertainment,12884,13167,283
61,"Ethiopian Music: ደመላሽ ንጉሴ | ማስተዋል እያዪ | ሙሉጌታ እሸቴ (ጠባቂ ነኝ) - New Ethiopian Music 2021(Official Video) by Minew Shewa Tube 2 months ago 3 minutes, 4 seconds 15,720 views",Minew Shewa Entertainment,15720,15802,82
62,"Ethiopian Music : Fasil Tilahun ፋሲል ጥላሁን (ያማርሽበት ሸማ) - New Ethiopian Music 2021(Official Video) by Minew Shewa Tube 2 months ago 5 minutes, 51 seconds 7,842 views",Minew Shewa Entertainment,7842,7895,53
63,"Alazar Teklie . NatiEL . King Soul | Berta | በርታ  - New Ethiopian Music 2021(Official Video) by Minew Shewa Tube 2 months ago 4 minutes, 40 seconds 66,707 views",Minew Shewa Entertainment,66707,67519,812
64,"Ethiopian Music : Alem Kebede አለም ከበደ (ቼበለው) - New Ethiopian Music 2021(Official Video) by Minew Shewa Tube 2 months ago 6 minutes, 14 seconds 28,139 views",Minew Shewa Entertainment,28139,28228,89
65,"Ethiopian Music : Daniel Edme ዳኒኤል እድሜ (ትንሳኤሽን ያሳየን) - New Ethiopian Music 2021(Official Video) by Minew Shewa Tube 2 months ago 3 minutes, 54 seconds 10,224 views",Minew Shewa Entertainment,10224,10281,57
66,"Ethiopian Music : Ashenafi Molla አሸናፊ ሞላ (ሃቅ ነው) - New Ethiopian Music 2021(Official Video) by Minew Shewa Tube 2 months ago 4 minutes, 58 seconds 175,597 views",Minew Shewa Entertainment,175597,179773,4176
67,"Ethiopian Music : Kedir Seid ከድር ሰኢድ (ክተት) - New Ethiopian Music 2021(Official Video) by Minew Shewa Tube 2 months ago 4 minutes, 53 seconds 10,574 views",Minew Shewa Entertainment,10574,10633,59
68,"Ethiopian Music : Habtu Girma ሃብቱ ግርማ (በቃ በላት) - New Ethiopian Music 2021(Official Video) by Minew Shewa Tube 2 months ago 4 minutes, 35 seconds 8,690 views",Minew Shewa Entertainment,8690,8706,16
69,"Ethiopian Music : Habtemariam Tsega ሃብተማርያም ፀጋ (ክተት) - New Ethiopian Music 2021(Official Video) by Minew Shewa Tube 2 months ago 6 minutes, 28 seconds 14,393 views",Minew Shewa Entertainment,14393,14479,86
70,"Ethiopian Music : Sisay Fantahun ሲሳይ ፋንታሁን (ወታደር ነኝ) - New Ethiopian Music 2021(Official Video) by Minew Shewa Tube 3 months ago 6 minutes, 3 seconds 23,555 views",Minew Shewa Entertainment,23555,23785,230
71,"Ethiopian Music : Girmaa Olaanaa (Waamuu Waamuu)  - New Ethiopian Music 2021(Official Video) by Minew Shewa Tube 3 months ago 5 minutes, 43 seconds 17,795 views",Minew Shewa Entertainment,17795,17867,72
72,"Ethiopian Music : መርዕድ ወ/ሰማያት እና ጌታቸው ጋዲሳ (ቦንቾይ ኢትዮጵያው) - New Ethiopian Music 2021(Official Video) by Minew Shewa Tube 3 months ago 5 minutes, 26 seconds 8,751 views",Minew Shewa Entertainment,8751,8787,36
73,"Ethiopian Music : Mengistu Demelash መንግስቱ ደምመላሽ (ሃገሬ) - New Ethiopian Music 2021(Official Video) by Minew Shewa Tube 3 months ago 5 minutes, 56 seconds 29,932 views",Minew Shewa Entertainment,29932,30050,118
74,"ዘማሪት አቦነሽ አድነው እና ዘማሪት ማርታ አሻጋሪ  (ኢትዮጵያን ቀኝህ አውል) - New Ethiopian Music 2021(Official Video) by Minew Shewa Tube 3 months ago 7 minutes, 23 seconds 84,834 views",Minew Shewa Entertainment,84834,85191,357
75,"Ethiopian Music : Moaget Getu (Ya Goota Koo) - New Ethiopian Music 2021(Official Video) by Minew Shewa Tube 3 months ago 5 minutes, 37 seconds 10,426 views",Minew Shewa Entertainment,10426,10523,97
76,"Ethiopian Music : Amaha Kasegn አማሃ ካሰኝ (ለዚህ) - New Ethiopian Music 2021(Official Video) by Minew Shewa Tube 3 months ago 3 minutes, 56 seconds 13,820 views",Minew Shewa Entertainment,13820,13962,142
77,"Ethiopian Music : Ganna Goobee (Dandiin Sobaa) - New Ethiopian Music 2021(Official Video) by Minew Shewa Tube 3 months ago 6 minutes, 25 seconds 7,965 views",Minew Shewa Entertainment,7965,8059,94
78,"Ethiopian Music : Chala Guta ጫላ ጉታ (እወድሻለው) - New Ethiopian Music 2021(Official Video) by Minew Shewa Tube 3 months ago 4 minutes, 27 seconds 13,872 views",Minew Shewa Entertainment,13872,13995,123
79,"Ethiopian Music : Sitota Megersa ስጦታ መገርሳ (ትዝ አትበለኝ) - New Ethiopian Music 2021(Official Video) by Minew Shewa Tube 3 months ago 3 minutes, 28 seconds 13,083 views",Minew Shewa Entertainment,13083,13183,100
80,"Ethiopian Music : Aychew Zerihun አይቸው ዘሪሁን (አትነካኩን) - New Ethiopian Music 2021(Official Video) by Minew Shewa Tube 3 months ago 5 minutes, 46 seconds 17,665 views",Minew Shewa Entertainment,17665,17802,137
81,"Ethiopian Music : Semachew Kasa ስማቸው ካሳ (ጎጃም ከፋው) - New Ethiopian Music 2021(Official Video) by Minew Shewa Tube 3 months ago 7 minutes 12,053 views",Minew Shewa Entertainment,12053,12130,77
82,"Ethiopian Music : Jireenyaa Shiferraw (Meeitti Buusi) - New Ethiopian Music 2021(Official Video) by Minew Shewa Tube 3 months ago 4 minutes, 18 seconds 308,349 views",Minew Shewa Entertainment,308349,318087,9738
83,"Ethiopian Music : Neway Debebe ነዋይ ደበበ (የታሪክ መዝገብ) - New Ethiopian Music 2021(Official Video) by Minew Shewa Tube 3 months ago 5 minutes, 15 seconds 905,662 views",Minew Shewa Entertainment,905662,916985,11323
84,"Natnael Samson (Neyma Lene) ናትናኤል ሳምሶን (ነይማ ለኔ) - New Ethiopian Music 2021(Official Video) by Minew Shewa Tube 3 months ago 4 minutes, 31 seconds 10,850 views",Minew Shewa Entertainment,10850,10947,97
85,"Ethiopian Music : Taaddasaa Fiixee (Jiituu Malkaa) - New Ethiopian Music 2021(Official Video) by Minew Shewa Tube 3 months ago 4 minutes, 59 seconds 8,182 views",Minew Shewa Entertainment,8182,8362,180
86,"Ethiopian Music : Abyot Zewge አብዮት ዘውገ (ኢትዮጱያ) - New Ethiopian Music 2021(Official Video) by Minew Shewa Tube 3 months ago 5 minutes, 2 seconds 7,220 views",Minew Shewa Entertainment,7220,7242,22
87,"Ethiopian Music : Eyerus Melese እየሩስ መለሰ (ብርቱ ጎንደሬ) - New Ethiopian Music 2021(Official Video) by Minew Shewa Tube 3 months ago 4 minutes, 43 seconds 32,913 views",Minew Shewa Entertainment,32913,33911,998
88,"Tigist Takele X Hirut Takele ሂሩት ታከለ X ትግስት ታከለ (በሴትነቴ) - New Ethiopian Music 2021(Official Video) by Minew Shewa Tube 3 months ago 5 minutes, 8 seconds 21,678 views",Minew Shewa Entertainment,21678,21790,112
89,"Ethiopian Music : Tame G x Gildo Kassa (አይኗን ነው) - New Ethiopian Music 2021(Official Video) by Minew Shewa Tube 3 months ago 4 minutes, 43 seconds 174,233 views",Minew Shewa Entertainment,174233,176930,2697
90,"African Music : Jino Ewolo (Mutura) - New African Music 2021(Official Video) by Minew Shewa Tube 3 months ago 3 minutes, 57 seconds 11,822 views",Minew Shewa Entertainment,11822,12028,206
91,"Kaleb Alaho ft Bereket Zewdu ካሌብ አላሆ ft በረከት ዘውዱ (ሰላሟ ይብዛ)- New Ethiopian Music 2021(Official Video) by Minew Shewa Tube 3 months ago 6 minutes, 13 seconds 18,253 views",Minew Shewa Entertainment,18253,18294,41
92,"Ethiopian Music : Gashaaw Mulgeetaa (Abbaa Yaadaa) - New Ethiopian Music 2021(Official Video) by Minew Shewa Tube 3 months ago 5 minutes, 35 seconds 9,522 views",Minew Shewa Entertainment,9522,9604,82
93,"Ethiopian Music : Berket Kasaye (Ney Ney) - New Ethiopian Music 2021(Official Video) by Minew Shewa Tube 3 months ago 3 minutes, 20 seconds 23,128 views",Minew Shewa Entertainment,23128,23253,125
94,"Ethiopian Music : Johnny Simba (Ney Wedene) ነይ ወደ እኔ - New Ethiopian Music 2021(Official Video) by Minew Shewa Tube 3 months ago 4 minutes, 11 seconds 42,076 views",Minew Shewa Entertainment,42076,42438,362
95,"Ethiopian Music : Ashenafi Legesse አሸናፊ ለገሰ (በዓይናችን) - New Ethiopian Music 2021(Official Video) by Minew Shewa Tube 3 months ago 5 minutes, 29 seconds 66,661 views",Minew Shewa Entertainment,66661,71472,4811
96,"Ethiopian Music : Girum Wudu ግሩም ውዱ (ጥቁር ደም) - New Ethiopian Music 2021(Official Video) by Minew Shewa Tube 3 months ago 6 minutes, 21 seconds 168,494 views",Minew Shewa Entertainment,168494,170086,1592
97,"Ethiopian Music : Bekalu Tafer በቃሉ ታፈር (ያባቶቹ ልጅ) - New Ethiopian Music 2021(Official Video) by Minew Shewa Tube 3 months ago 6 minutes, 9 seconds 11,560 views",Minew Shewa Entertainment,11560,11585,25
98,"Ethiopian Music : Guddisaa Beeggii (Bara Kirri) - New Ethiopian Music 2021(Official Video) by Minew Shewa Tube 4 months ago 4 minutes, 59 seconds 7,530 views",Minew Shewa Entertainment,7530,7545,15
99,"Ethiopian Music : Daniel Eshetu ዳንኤል እሸቱ (እመኝልኝ) - New Ethiopian Music 2021(Official Video) by Minew Shewa Tube 4 months ago 5 minutes, 56 seconds 6,474 views",Minew Shewa Entertainment,6474,6527,53
100,"Ethiopian Music : Applish Men (Geday Nat) - New Ethiopian Music 2021(Official Video) by Minew Shewa Tube 4 months ago 3 minutes, 31 seconds 8,798 views",Minew Shewa Entertainment,8798,8829,31
101,"Ethiopian Music : Denekew Dejene ደነቀው ደጀኔ (ዝናዬ) - New Ethiopian Music 2021(Official Video) by Minew Shewa Tube 4 months ago 6 minutes, 7 seconds 9,282 views",Minew Shewa Entertainment,9282,9350,68
102,"Ethiopian Music : Yirgalem Ayele (Yibka) ይርጋለም አየለ (ይብቃ) - New Ethiopian Music 2021(Official Video) by Minew Shewa Tube 4 months ago 5 minutes, 10 seconds 16,860 views",Minew Shewa Entertainment,16860,16934,74
103,"Ethiopian Music : Zinash Wube ዝንሽ ውቤ (ቃል አጣሁ) - New Ethiopian Music 2021(Official Video) by Minew Shewa Tube 4 months ago 5 minutes, 16 seconds 1,786,224 views",Minew Shewa Entertainment,1786224,1833468,47244
104,"Ethiopian Music : Nathnael Dereje ናትናኤል ደረጄ (ወደድኩሽ በጣም) - New Ethiopian Music 2021(Official Video) by Minew Shewa Tube 4 months ago 3 minutes, 55 seconds 79,616 views",Minew Shewa Entertainment,79616,80253,637
105,"Ethiopian Music : Daani'eel Abarraa (Eenyuuttan Himadha) - New Ethiopian Music 2021(Official Video) by Minew Shewa Tube 4 months ago 5 minutes, 20 seconds 26,545 views",Minew Shewa Entertainment,26545,26626,81
106,"Ethiopian Music : Tafarra Xaasoo (Bareduu Showaa) - New Ethiopian Music 2021(Official Video) by Minew Shewa Tube 4 months ago 5 minutes, 3 seconds 7,011 views",Minew Shewa Entertainment,7011,7034,23
107,"Ethiopian Music : Bekalu Tade በቃሉ ታዴ (የታል አሁን) - New Ethiopian Music 2021(Official Video) by Minew Shewa Tube 4 months ago 6 minutes, 44 seconds 12,848 views",Minew Shewa Entertainment,12848,12930,82
108,"Ethiopian Music : Selina Fantish ሰሊና ፋንትሽ (አዲስ ፍቅር) - New Ethiopian Music 2021(Official Video) by Minew Shewa Tube 4 months ago 4 minutes, 15 seconds 28,300 views",Minew Shewa Entertainment,28300,28455,155
109,"Abdu Kiar x Frankie Dee (Addis Ababa) አዲስ አበባ - New Ethiopian Music 2021(Official Video) by Minew Shewa Tube 4 months ago 4 minutes, 6 seconds 366,642 views",Minew Shewa Entertainment,366642,370750,4108
110,"Ethiopian Music : Tsega Muchie ፀጋ ሙጬ (ባመነው ሲከዳ) - New Ethiopian Music 2021(Official Video) by Minew Shewa Tube 4 months ago 5 minutes, 43 seconds 30,513 views",Minew Shewa Entertainment,30513,30659,146
111,"Ethiopian Music : Guutamaa Mahammad (Yaada Jaalalaa) - New Ethiopian Music 2021(Official Video) by Minew Shewa Tube 4 months ago 4 minutes, 31 seconds 50,056 views",Minew Shewa Entertainment,50056,52549,2493
112,"Bereket x Senait (Tutuye) በረከት ገ/መስቀል እና ሰናይት እሸቱ (ቱቱዬ) - New Ethiopian Music 2021(Official Video) by Minew Shewa Tube 4 months ago 5 minutes, 30 seconds 31,524 views",Minew Shewa Entertainment,31524,31622,98
113,"Ethiopian Music : Mulugeta Birhanu ሙሉጌታ ብርሃኑ (ፊርማታዬ) - New Ethiopian Music 2021(Official Video) by Minew Shewa Tube 4 months ago 5 minutes, 59 seconds 17,617 views",Minew Shewa Entertainment,17617,17697,80
114,"Ethiopian Music : Endeshaw Abera እንደሻው አበራ (አቤት ውሸቷ) - New Ethiopian Music 2021(Official Video) by Minew Shewa Tube 4 months ago 6 minutes, 3 seconds 27,377 views",Minew Shewa Entertainment,27377,27567,190
115,"Ethiopian Music : Biruk Samuel ብሩክ ሳሙኤል (ሌላ ቀን) - New Ethiopian Music 2021(Official Video) by Minew Shewa Tube 4 months ago 3 minutes, 40 seconds 8,893 views",Minew Shewa Entertainment,8893,8934,41
116,"Ethiopian Music : Tewodros Mosisa ቴዎድሮስ ሞሲሳ (አበደ ይሉኛል) - New Ethiopian Music 2021(Official Video) by Minew Shewa Tube 4 months ago 4 minutes, 31 seconds 137,242 views",Minew Shewa Entertainment,137242,137913,671
117,"Ethiopian Music : Alamaw Chekol አላማው ቸኮል (ፍረዱኛ) - New Ethiopian Music 2021(Official Video) by Minew Shewa Tube 4 months ago 4 minutes, 33 seconds 16,192 views",Minew Shewa Entertainment,16192,16258,66
118,"Ethiopian Music : EyuStar (Molkakaye) ሞልቃቃዬ  - New Ethiopian Music 2021(Official Video) by Minew Shewa Tube 4 months ago 3 minutes, 36 seconds 11,318 views",Minew Shewa Entertainment,11318,11378,60
119,"Ethiopian Music : Kaasuu Katamaa (Yaasiddisee) - New Ethiopian Music 2021(Official Video) by Minew Shewa Tube 4 months ago 5 minutes, 52 seconds 15,117 views",Minew Shewa Entertainment,15117,15175,58
120,"Mulugeta Mengistu ሙሉጌታ መንግስቱ (ኢትዮጵያ ነሽ ክብሬ) - New Ethiopian Music 2021(Official Video) by Minew Shewa Tube 4 months ago 4 minutes, 42 seconds 9,213 views",Minew Shewa Entertainment,9213,9250,37
121,"Ethiopian Music : Jan Fani X Vex (Gomlaleye) ጎምላልዬ - New Ethiopian Music 2021(Official Video) by Minew Shewa Tube 4 months ago 3 minutes, 58 seconds 38,572 views",Minew Shewa Entertainment,38572,38759,187
122,"Ethiopian Music : Betty G ቤቲ ጂ (አዲስ ሰማይ) - New Ethiopian Music 2021(Official Video) by Minew Shewa Tube 4 months ago 4 minutes, 2 seconds 740,125 views",Minew Shewa Entertainment,740125,746871,6746
123,"Ethiopian Music : Nathan Alemayehu ናታን አለማየሁ (እስኪ እንዴ) - New Ethiopian Music 2021(Official Video) by Minew Shewa Tube 4 months ago 3 minutes, 53 seconds 31,761 views",Minew Shewa Entertainment,31761,31970,209
124,"Ethiopian Music : Biruk Drek ብሩክ ድሬክ (ድቅን ይልብኛል) - New Ethiopian Music 2021(Official Video) by Minew Shewa Tube 4 months ago 4 minutes, 42 seconds 17,485 views",Minew Shewa Entertainment,17485,17618,133
125,"Ethiopian Music : Tena Zemelak ጠና ዘመላክ (ዓለም ነሽ ኢትዮጵያ)  - New Ethiopian Music 2021(Official Video) by Minew Shewa Tube 4 months ago 6 minutes, 18 seconds 12,710 views",Minew Shewa Entertainment,12710,12753,43
126,"Ethiopian Music : Aschalew Lema አስቻለው ለማ (ኢትዮጵያን ከደሜ) - New Ethiopian Music 2021(Official Video) by Minew Shewa Tube 4 months ago 4 minutes, 29 seconds 40,763 views",Minew Shewa Entertainment,40763,40849,86
127,"Ethiopian Music : Temesgen Belete ተመስገን በለጠ (ወይ አልጠረጥራት) - New Ethiopian Music 2021(Official Video) by Minew Shewa Tube 4 months ago 4 minutes, 6 seconds 24,011 views",Minew Shewa Entertainment,24011,24071,60
128,"Ethiopian Music : Saba Kebede ሳባ ከበደ (ቋንቋዬ) - New Ethiopian Music 2021(Official Video) by Minew Shewa Tube 4 months ago 6 minutes, 12 seconds 14,791 views",Minew Shewa Entertainment,14791,14841,50
129,"Ethiopian Music : Haimanot Mengesha ሃይማኖት መንገሻ (አይዋሽም) - New Ethiopian Music 2021(Official Video) by Minew Shewa Tube 4 months ago 5 minutes, 16 seconds 29,929 views",Minew Shewa Entertainment,29929,30090,161
130,"Ethiopian Music : Seefuu Dhaaqaabaa (Oromiyaa) - New Ethiopian Music 2021(Official Video) by Minew Shewa Tube 5 months ago 6 minutes, 3 seconds 8,400 views",Minew Shewa Entertainment,8400,8687,287
131,"Ethiopian Music : Haileyesus Feyissa ሃይለየሱስ ፈይሳ (የፍቅር ንቅሳት) New Ethiopian Music 2021(Official Video) by Minew Shewa Tube 5 months ago 5 minutes, 23 seconds 466,655 views",Minew Shewa Entertainment,466655,469102,2447
132,"Ethiopian Music : Hikma Getachew ሂክማ ጌታቸው (እድለኛ ነኝ) - New Ethiopian Music 2021(Official Video) by Minew Shewa Tube 5 months ago 4 minutes, 15 seconds 25,133 views",Minew Shewa Entertainment,25133,25219,86
133,"Ethiopian Music : Masfiin Caalaa (Angammadeera) - New Ethiopian Music 2021(Official Video) by Minew Shewa Tube 5 months ago 5 minutes, 15 seconds 8,325 views",Minew Shewa Entertainment,8325,8344,19
134,"Tsehayu Abera (Lega Chereka) ፀሐዩ አበራ (ለጋ ጨረቃ) - New Ethiopian Music 2021(Official Video) by Minew Shewa Tube 5 months ago 5 minutes, 29 seconds 7,648 views",Minew Shewa Entertainment,7648,7672,24
135,"Ethiopian Music : Nadia Ali ናድያ አሊ (መች አለሁ) - New Ethiopian Music 2021(Official Video) by Minew Shewa Tube 5 months ago 4 minutes, 23 seconds 233,532 views",Minew Shewa Entertainment,233532,234594,1062
136,"Ethiopian Music : Burik (Nafkeshignal) ቡሪክ (ናፍቀሽኛል) - New Ethiopian Music 2021(Official Video) by Minew Shewa Tube 5 months ago 4 minutes, 56 seconds 738,064 views",Minew Shewa Entertainment,738064,754180,16116
137,"Ethiopian Music : Mehari Degefaw መሃሪ ደገፋው (ሸለመኝ) - New Ethiopian Music 2021(Official Video) by Minew Shewa Tube 5 months ago 7 minutes, 42 seconds 4,419,392 views",Minew Shewa Entertainment,4419392,4568048,148656
138,"Tasfayyee Dajanee (Maalan Si Godhee) - New Ethiopian Music 2021(Official Video) by Minew Shewa Tube 5 months ago 6 minutes, 1 second 13,849 views",Minew Shewa Entertainment,13849,13983,134
139,"Yewendwosen W/Mariam የወንደሰን ወ/ማርያም (እሜቴ ባፈና) - New Ethiopian Music 2021(Official Video) by Minew Shewa Tube 5 months ago 6 minutes, 36 seconds 27,304 views",Minew Shewa Entertainment,27304,27560,256
140,"Wasihun Teshome (Ney Selesh) ዋሲሁን ተሾመ (ነይ ስልሽ) - New Ethiopian Music 2021(Official Video) by Minew Shewa Tube 5 months ago 4 minutes, 19 seconds 22,598 views",Minew Shewa Entertainment,22598,22667,69
141,"Ethiopian Music : Sheekoo Amaan (Kana Beektuu) - New Ethiopian Music 2021(Official Video) by Minew Shewa Tube 5 months ago 5 minutes, 1 second 8,503 views",Minew Shewa Entertainment,8503,8541,38
142,"Ethiopian Music : Teddy Yo (Almetam) ቴዲ ዮ (አልመጣም) - New Ethiopian Music 2021(Official Video) by Minew Shewa Tube 5 months ago 4 minutes, 18 seconds 3,507,798 views",Minew Shewa Entertainment,3507798,3594135,86337
143,"Ethiopian Music : Casiopia (Alehu) ካስዮፕያ (አለሁ) - New Ethiopian Music 2021(Official Video) by Minew Shewa Tube 5 months ago 3 minutes, 29 seconds 12,971 views",Minew Shewa Entertainment,12971,13035,64
144,"Ethiopian Music : Isheetuu Bagashaw (Jiddaa) - New Ethiopian Music 2021(Official Video) by Minew Shewa Tube 5 months ago 7 minutes, 56 seconds 15,120 views",Minew Shewa Entertainment,15120,15290,170
145,"Ethiopian Music : Amsaaluu Tammenee (Sii Dhabnaani) - New Ethiopian Music 2021(Official Video) by Minew Shewa Tube 5 months ago 6 minutes, 10 seconds 8,858 views",Minew Shewa Entertainment,8858,8891,33
146,"Ethiopian Music : Getachew Terefe ጌታቸው ተረፈ (ምን ይሻላል) - New Ethiopian Music 2021(Official Video) by Minew Shewa Tube 5 months ago 6 minutes, 27 seconds 23,991 views",Minew Shewa Entertainment,23991,24055,64
147,"Ethiopian Music : Feleke Kassa ፈለቀ ካሳ (ክፉሽ በእኔ ይለፍ) - New Ethiopian Music 2021(Official Video) by Minew Shewa Tube 5 months ago 6 minutes, 32 seconds 25,138 views",Minew Shewa Entertainment,25138,25210,72
148,"Ethiopian Music : Adino Ferede አድኖ ፈረደ (አውድ ዓመት አሸብርቆ) - New Ethiopian Music 2021(Official Video) by Minew Shewa Tube 5 months ago 4 minutes, 23 seconds 8,140 views",Minew Shewa Entertainment,8140,8164,24
149,"Ethiopian Music : Gebreshet Bitew ገብርሸት ቢተው (ዳረንጎቴ) - New Ethiopian Music 2021(Official Video) by Minew Shewa Tube 5 months ago 5 minutes, 5 seconds 16,971 views",Minew Shewa Entertainment,16971,17000,29
150,"Ethiopian Music : Belay Melesie በላይ መልሴ (ያንጎለላ ናት) - New Ethiopian Music 2021(Official Video) by Minew Shewa Tube 5 months ago 6 minutes, 48 seconds 9,920 views",Minew Shewa Entertainment,9920,9929,9
151,"Ethiopian Music : Elsa Nigussie (Galanni Keetuma) - New Ethiopian Music 2021(Official Video) by Minew Shewa Tube 5 months ago 6 minutes, 1 second 61,906 views",Minew Shewa Entertainment,61906,62280,374
152,"Ethiopian Music : Qananiisaa Tulluu (Intala Biyyaa) - New Ethiopian Music 2021(Official Video) by Minew Shewa Tube 5 months ago 5 minutes, 20 seconds 6,089 views",Minew Shewa Entertainment,6089,6097,8
153,"Ethiopian Music : Chresty Abebe (Na Lalli) - New Ethiopian Music 2021(Official Video) by Minew Shewa Tube 5 months ago 5 minutes, 16 seconds 13,832 views",Minew Shewa Entertainment,13832,13868,36
154,"Estifanos x Amroneal (Helina) እስጢፋኖስ እና አምሮንኤል (ህሊና) - New Ethiopian Music 2021(Official Video) by Minew Shewa Tube 5 months ago 4 minutes, 25 seconds 5,651 views",Minew Shewa Entertainment,5651,5673,22
155,"Ethiopian Music : Hab G (Awdamet) አውዳመት - New Ethiopian Music 2021(Official Video) by Minew Shewa Tube 5 months ago 4 minutes, 49 seconds 26,949 views",Minew Shewa Entertainment,26949,26980,31
156,"Ethiopian Music : Bisrat Abay ብስራት አባይ (የፍቅር እንግዳ) - New Ethiopian Music 2021(Official Video) by Minew Shewa Tube 5 months ago 4 minutes, 46 seconds 123,341 views",Minew Shewa Entertainment,123341,127260,3919
157,"Ethiopian Music : Henook Kidaannee (Shamarran) - New Ethiopian Music 2021(Official Video) by Minew Shewa Tube 5 months ago 5 minutes, 59 seconds 10,028 views",Minew Shewa Entertainment,10028,10068,40
158,"Ethiopian Music : Simon Fekadu ሲሞን ፍቃዱ (እንደልቧ) - New Ethiopian Music 2021(Official Video) by Minew Shewa Tube 5 months ago 4 minutes, 58 seconds 19,702 views",Minew Shewa Entertainment,19702,19726,24
159,"Ethiopian Music : Maritu Legese (Salmot) ማሪቱ ለገሰ (ሳልሞት) - New Ethiopian Music 2021(Official Video) by Minew Shewa Tube 5 months ago 5 minutes, 51 seconds 663,697 views",Minew Shewa Entertainment,663697,669120,5423
160,"Ethiopian Music : Seble Tesfaye (Na' Tew) ሰብለ ተስፋዬ (ና ተው) - New Ethiopian Music 2021(Official Video) by Minew Shewa Tube 6 months ago 5 minutes, 11 seconds 120,044 views",Minew Shewa Entertainment,120044,120318,274
161,"Ethiopian Music : Sima (Tega) ሲማ (ጠጋ) - New Ethiopian Music 2021(Official Video) by Minew Shewa Tube 6 months ago 4 minutes, 26 seconds 29,590 views",Minew Shewa Entertainment,29590,29849,259
162,"Ethiopian Music : አረንጓዴ ዓለም  - New Ethiopian Music 2021(Official Video) by Minew Shewa Tube 6 months ago 5 minutes, 38 seconds 18,861 views",Minew Shewa Entertainment,18861,18876,15
163,"Ethiopian Music : Yakob Ferede ያዕቆብ ፈረደ (አንድ እንሁን) - New Ethiopian Music 2021(Official Video) by Minew Shewa Tube 6 months ago 4 minutes, 27 seconds 9,111 views",Minew Shewa Entertainment,9111,9116,5
164,"Frehiwot Seyoum (Ajeb New) ፍሬህይወት ስዩም (አጀብ ነው) - New Ethiopian Music 2021(Official Video) by Minew Shewa Tube 6 months ago 5 minutes, 17 seconds 22,073 views",Minew Shewa Entertainment,22073,22152,79
165,"Etsubdink Tibebu (Endet Yihon) እጽብድንቅ ጥበቡ (እንዴት ይሆን) - New Ethiopian Music 2021(Official Video) by Minew Shewa Tube 6 months ago 3 minutes, 50 seconds 52,786 views",Minew Shewa Entertainment,52786,52892,106
166,"Ethiopian Music : Kuku Sebsibe (Dimama) ኩኩ ሰብስቤ (ድማማ) - New Ethiopian Music 2021(Official Video) by Minew Shewa Tube 6 months ago 5 minutes, 45 seconds 1,012,886 views",Minew Shewa Entertainment,1012886,1018241,5355
167,"Ethiopia Bekelech (Higoma) ኢትዮጵያ በቀለች (ሂጎማ) - New Ethiopian Music 2021(Official Video) by Minew Shewa Tube 6 months ago 4 minutes, 9 seconds 26,852 views",Minew Shewa Entertainment,26852,28925,2073
168,"Ethiopian Music : Solomon Demele ሰለሞን ደምሌ (እምቢ ዘራፍ) - New Ethiopian Music 2021(Official Video) by Minew Shewa Tube 6 months ago 6 minutes, 52 seconds 310,963 views",Minew Shewa Entertainment,310963,312984,2021
169,"Ethiopian Music : Fikir Admas (Alfetam) ፍቅር አድማስ (አልፈታም) - New Ethiopian Music 2021(Official Video) by Minew Shewa Tube 6 months ago 6 minutes, 19 seconds 63,026 views",Minew Shewa Entertainment,63026,63229,203
170,"Ethiopian Music : Roba Junior  X Nuhi (በሰላም ነው ወይ)  - New Ethiopian Music 2021(Official Remix) by Minew Shewa Tube 6 months ago 3 minutes, 30 seconds 21,371 views",Minew Shewa Entertainment,21371,21423,52
171,"Ethiopian Music : Abinet Dereje (Wude) አብነት ደረጀ (ውዴ) - New Ethiopian Music 2021(Official Video) by Minew Shewa Tube 6 months ago 3 minutes, 18 seconds 15,394 views",Minew Shewa Entertainment,15394,15439,45
172,"Blata ft Merry & Jossy ብላታ ሜሪ እና ጆሲ (አንድ ደም) New Ethiopian Music 2021(Official Video) by Minew Shewa Tube 6 months ago 5 minutes, 4 seconds 16,815 views",Minew Shewa Entertainment,16815,16833,18
173,"Ethiopian Music : Papio Belete (Batege) ፓፒዮ በለጠ (ባትጌ) - New Ethiopian Music 2021(Official Video) by Minew Shewa Tube 6 months ago 5 minutes, 34 seconds 25,271 views",Minew Shewa Entertainment,25271,25401,130
174,"Ethiopian Music : Kal Kin (Hoya Hoye) ቃል ኪን (ሆያ ሆዬ) - New Ethiopian Music 2021(Official Video) by Minew Shewa Tube 6 months ago 3 minutes, 24 seconds 106,314 views",Minew Shewa Entertainment,106314,106766,452
175,"Ethiopian Music : Darajje Galan (Eammolee) - New Ethiopian Music 2021(Official Video) by Minew Shewa Tube 6 months ago 4 minutes, 54 seconds 22,858 views",Minew Shewa Entertainment,22858,22912,54
176,"Ethiopian Music :Yeshalem Adamu የሻለም አዳሙ (ክብሬ ሲመለስ) - New Ethiopian Music 2021(Official Video) by Minew Shewa Tube 6 months ago 5 minutes, 52 seconds 11,766 views",Minew Shewa Entertainment,11766,11791,25
177,"Ethiopian Music : Fikre Tesfaye ፍቅሬ ተስፋዬ (የሆንሽውን ልሁን) - New Ethiopian Music 2021(Official Video) by Minew Shewa Tube 6 months ago 5 minutes, 40 seconds 39,011 views",Minew Shewa Entertainment,39011,39128,117
178,"Ethiopian Music : JC3 (Bale Bicha Kamiswa) ባለ ቢጫ ቀሚሷ - New Ethiopian Music 2021(Official Video) by Minew Shewa Tube 6 months ago 3 minutes, 50 seconds 10,604 views",Minew Shewa Entertainment,10604,10639,35
179,"Ethiopian Music : Mimi Genetu (Bel Ayal) ሚሚ ገነቱ (በል አያል) - New Ethiopian Music 2021(Official Video) by Minew Shewa Tube 6 months ago 5 minutes, 36 seconds 176,902 views",Minew Shewa Entertainment,176902,177740,838
180,"Ethiopian Music : Kalkidan Dejen ቃልኪዳን ደጀን (አንዷለም) - New Ethiopian Music 2021(Official Video) by Minew Shewa Tube 6 months ago 5 minutes, 23 seconds 32,164 views",Minew Shewa Entertainment,32164,32252,88
181,"Ethiopian Music :  Almaaz Xasso (Sin Qaba) - New Ethiopian Music 2021(Official Video) by Minew Shewa Tube 6 months ago 4 minutes, 47 seconds 9,056 views",Minew Shewa Entertainment,9056,9074,18
182,"Ethiopian Music : Kidist Birhanu (Tsina) ቅድስት ብርሃኑ (ጽና) - New Ethiopian Music 2021(Official Video) by Minew Shewa Tube 6 months ago 6 minutes, 44 seconds 11,274 views",Minew Shewa Entertainment,11274,11300,26
183,"Ethiopian Music : Terefe Assefa (Yene New) ተረፈ አሰፋ (የኔ ነው) New Ethiopian Music 2021(Official Video) by Minew Shewa Tube 6 months ago 5 minutes, 1 second 9,311 views",Minew Shewa Entertainment,9311,9338,27
184,"Ethiopian Music : Mola Setarge ሞላ ሰጥአርጌ (እናቴን ያላችሁ) - New Ethiopian Music 2021(Official Video) by Minew Shewa Tube 6 months ago 7 minutes, 22 seconds 1,071,263 views",Minew Shewa Entertainment,1071263,1082087,10824
185,"Ethiopian Music : Senait Abera ሰናይት አበራ (መታደል ነው)  - New Ethiopian Music 2021(Official Video) by Minew Shewa Tube 6 months ago 4 minutes, 57 seconds 63,195 views",Minew Shewa Entertainment,63195,63357,162
186,"Ethiopian Music : KG MAN (ወደ ኋላ) - New Ethiopian Music 2021(Official Video) by Minew Shewa Tube 6 months ago 3 minutes, 30 seconds 13,990 views",Minew Shewa Entertainment,13990,14018,28
187,"Ethiopian Music : Tizazu Betru ትዛዙ በትሩ (አማራ ነኝ) - New Ethiopian Music 2021(Official Video) by Minew Shewa Tube 6 months ago 6 minutes, 18 seconds 412,515 views",Minew Shewa Entertainment,412515,414295,1780
188,"Ethiopian Music : Berhanu Taye (Neka) ብርሃኑ ታዬ (ንቃ) - New Ethiopian Music 2021(Official Video) by Minew Shewa Tube 6 months ago 4 minutes, 37 seconds 141,052 views",Minew Shewa Entertainment,141052,141662,610
189,"Ethiopian Music : Awwalee Ciroo  (Cayaa Too) - New Ethiopian Music 2021(Official Video) by Minew Shewa Tube 7 months ago 5 minutes, 10 seconds 137,046 views",Minew Shewa Entertainment,137046,142580,5534
190,"Ethiopian Music : Debas Wassie ደባስ ዋሴ (እንድያው ደመና ነው) - New Ethiopian Music 2021(Official Video) by Minew Shewa Tube 7 months ago 5 minutes, 12 seconds 8,858 views",Minew Shewa Entertainment,8858,8890,32
191,"Ethiopian Music : Aman Ahmed (Mamaye) አማን አህመድ (ማማዬ)  - New Ethiopian Music 2021(Official Video) by Minew Shewa Tube 7 months ago 4 minutes, 4 seconds 53,170 views",Minew Shewa Entertainment,53170,53212,42
192,"Ethiopian Music : Abdu Kiar & Melat Kelemework (Weye Weye) New Ethiopian Music 2021(Official Video) by Minew Shewa Tube 7 months ago 6 minutes, 13 seconds 11,248,448 views",Minew Shewa Entertainment,11248448,11431133,182685
193,"Ethiopian Music : Zimam Ayalew ዝማም አያሌው (ሙሃባዬ) - New Ethiopian Music 2021(Official Video) by Minew Shewa Tube 7 months ago 6 minutes, 36 seconds 34,152 views",Minew Shewa Entertainment,34152,34281,129
194,"Ethiopian Music : Marsawi Kifle (Ethiopia) ማርሳዊ ክፍሌ (ኢትዮጵያ) New Ethiopian Music 2021(Official Video) by Minew Shewa Tube 7 months ago 4 minutes, 57 seconds 12,688 views",Minew Shewa Entertainment,12688,12704,16
195,"Ethiopian Music : Eyayu Tegegn እያዩ ትገኝ (መላ በይ እንቺ ሃገር) - New Ethiopian Music 2021(Official Video) by Minew Shewa Tube 7 months ago 13 minutes, 8 seconds 13,658 views",Minew Shewa Entertainment,13658,13674,16
196,"Oromo Music : Abbuu Ganammoo (Harmee) - New Ethiopian Music 2021(Official Video) by Minew Shewa Tube 7 months ago 5 minutes, 44 seconds 13,604 views",Minew Shewa Entertainment,13604,13650,46
197,"Ethiopian Music : Saadam Hajjii (Soba Kee) - New Ethiopian Music 2021(Official Video) by Minew Shewa Tube 7 months ago 4 minutes, 54 seconds 19,894 views",Minew Shewa Entertainment,19894,19985,91
198,"Daniel Mislework (Tolo Tolo) ዳንኤል ምስለወርቅ (ቶሎ ቶሎ) - New Ethiopian Music 2021(Official Video) by Minew Shewa Tube 7 months ago 5 minutes, 37 seconds 142,293 views",Minew Shewa Entertainment,142293,142715,422
199,"Ethiopian Music: Genet Seyoum (Iza Koyana) ገነት ስዩም (ኢዛ ኮያና) New Ethiopian Music 2021(Official Video) by Minew Shewa Tube 7 months ago 5 minutes, 15 seconds 15,139 views",Minew Shewa Entertainment,15139,15163,24
200,"Ethiopian Music : Habtamu Tedla ሃብታሙ ተድላ (ይድላው ልቤን) - New Ethiopian Music 2021(Official Video) by Minew Shewa Tube 7 months ago 5 minutes, 59 seconds 28,579 views",Minew Shewa Entertainment,28579,28703,124
201,"Ethiopian Music : Burik Dirk (Beredu) - New Ethiopian Music 2021(Official Video) by Minew Shewa Tube 7 months ago 4 minutes, 24 seconds 14,981 views",Minew Shewa Entertainment,14981,15049,68
202,"Ethiopian Music : Hana Getu ሃና ጌቱ (ባይቀናውም) - New Ethiopian Music 2021(Official Video) by Minew Shewa Tube 7 months ago 5 minutes, 8 seconds 26,386 views",Minew Shewa Entertainment,26386,26426,40
203,"Sara Takele | Sirtana (Shedeney) ሳራ ታከለ | ሲርታና (ሸደነይ) New Tigrigna Music 2021(Official Video) by Minew Shewa Tube 7 months ago 4 minutes, 32 seconds 67,446 views",Minew Shewa Entertainment,67446,67602,156
204,"Filler | Diego | Zerubabel  (And kir | አንድ ክር) - New Ethiopian Music 2021(Official Video) by Minew Shewa Tube 7 months ago 3 minutes, 25 seconds 27,002 views",Minew Shewa Entertainment,27002,27063,61
205,"Ethiopian Music : Tigist Yirga ትግስት ይርጋ (ሸብ አድርጌ) - New Ethiopian Music 2021(Official Video) by Minew Shewa Tube 7 months ago 6 minutes, 18 seconds 14,322 views",Minew Shewa Entertainment,14322,14380,58
206,"Habtu Girma (Shashe Agape) ሃብቱ ግርማ (ሻሼ አጋፔ) - New Ethiopian Music 2021(Official Video) by Minew Shewa Tube 7 months ago 3 minutes, 41 seconds 7,973 views",Minew Shewa Entertainment,7973,7991,18
207,"Ethiopian Music : Tizita (Yeneta) ትዝታ (የኔታ) - New Ethiopian Music 2021(Official Video) by Minew Shewa Tube 7 months ago 5 minutes, 34 seconds 30,283 views",Minew Shewa Entertainment,30283,30420,137
208,"Ethiopian Music : Wedere Tadese ወደሬ ታደሰ (የቆጨው) - New Ethiopian Music 2021(Official Video) by Minew Shewa Tube 7 months ago 6 minutes, 40 seconds 14,582 views",Minew Shewa Entertainment,14582,14610,28
209,"Kaleab Kinfe | Kal Kin ቃልአብ ክንፈ (እቴ አምሳል) - New Ethiopian Music 2021(Official Video) by Minew Shewa Tube 7 months ago 5 minutes, 12 seconds 1,502,538 views",Minew Shewa Entertainment,1502538,1520473,17935
210,"Ethiopian Music : Tewachew Adane ተዋቸው አዳነ (የደኑ በሬ) - New Ethiopian Music 2021(Official Video) by Minew Shewa Tube 7 months ago 6 minutes, 48 seconds 397,717 views",Minew Shewa Entertainment,397717,399766,2049
211,"Ethiopian Music : Neway Tesema (Nanaye) ነዋይ ተሰማ (ናናዬ) - New Ethiopian Music 2021(Official Video) by Minew Shewa Tube 7 months ago 4 minutes, 3 seconds 35,038 views",Minew Shewa Entertainment,35038,35093,55
212,"Ethiopian Music : Zola Bape (Afity) ዞላ ባፔ (አፊቲ) - New Ethiopian Music 2021(Official Video) by Minew Shewa Tube 7 months ago 4 minutes, 19 seconds 14,307 views",Minew Shewa Entertainment,14307,14337,30
213,"Ethiopian Music : Feteh Tesfa (Hegeme) ፍትህ ተስፋ (ህገሜ) - New Ethiopian Music 2021(Official Video) by Minew Shewa Tube 7 months ago 4 minutes, 32 seconds 14,398 views",Minew Shewa Entertainment,14398,14441,43
214,"Ethiopian Music : Dawi Tolesa (Tisole) - New Ethiopian Music 2021(Official Video) by Minew Shewa Tube 7 months ago 6 minutes, 1 second 9,997 views",Minew Shewa Entertainment,9997,10024,27
215,"Ethiopian Music : Binyam Assefa ቢኒያም አሰፋ (የተረጋጋሁት) - New Ethiopian Music 2021(Official Video) by Minew Shewa Tube 8 months ago 4 minutes, 18 seconds 27,799 views",Minew Shewa Entertainment,27799,27875,76
216,"Yizez Melaku ሃምሳ አለቃ ይዘዝ መላኩ (ኢምቢ ለሃገሬ) - New Ethiopian Music 2021(Official Video) by Minew Shewa Tube 8 months ago 7 minutes, 47 seconds 78,111 views",Minew Shewa Entertainment,78111,78223,112
217,"Ethiopian Music : Birhan GebreKidan ብርሃነ ገ/ኪዳን (ፈለማ አይነይ) - New Tigrigna Music 2021(Official Video) by Minew Shewa Tube 8 months ago 5 minutes, 40 seconds 9,212 views",Minew Shewa Entertainment,9212,9229,17
218,"Ethiopian Music : Waariyoo Diidaa (Kuulakoo) - New Ethiopian Music 2021(Official Video) by Minew Shewa Tube 8 months ago 5 minutes, 32 seconds 13,338 views",Minew Shewa Entertainment,13338,13386,48
219,"Sami Zerihun ሳሚ ዘሪሁን (Happy Birthday) New Ethiopian Eriterian Music 2021(Official Video) by Minew Shewa Tube 8 months ago 2 minutes, 35 seconds 26,910 views",Minew Shewa Entertainment,26910,27054,144
220,"Ethiopian Music : Endalk Fantu | Grazme እንዳልክ ፋንቱ (ልኬነሽ) - New Ethiopian Music 2021(Official Video) by Minew Shewa Tube 8 months ago 4 minutes, 18 seconds 13,794 views",Minew Shewa Entertainment,13794,13811,17
221,"Ethiopian Music : Gezahegn W/Michael (Malo Malo)  - New Ethiopian Music 2021(Official Video) by Minew Shewa Tube 8 months ago 4 minutes, 12 seconds 23,384 views",Minew Shewa Entertainment,23384,23420,36
222,"Zerihun Alemayehu ዘሪሁን አለማየሁ (እኔ ኢትዮጵያዊ ነኝ)  - New Ethiopian Music 2021(Official Video) by Minew Shewa Tube 8 months ago 5 minutes, 39 seconds 10,442 views",Minew Shewa Entertainment,10442,10452,10
223,"Ethiopian Music : Alamaw Chekol ልዘይራት (አላማው ቸኮል) - New Ethiopian Music 2021(Official Video) by Minew Shewa Tube 8 months ago 5 minutes, 3 seconds 20,051 views",Minew Shewa Entertainment,20051,20096,45
224,"Ethiopian Music : Helen Getachew (Abat) ሄለን ጌታቸው (አባት) - New Ethiopian Music 2021(Official Video) by Minew Shewa Tube 8 months ago 6 minutes, 11 seconds 28,141 views",Minew Shewa Entertainment,28141,28260,119
225,"Ethiopian Music : Bayou Amore (Amore) ባዩ አሞሬ (አሞሬ) - New Ethiopian Music 2021(Official Video) by Minew Shewa Tube 8 months ago 3 minutes, 51 seconds 58,441 views",Minew Shewa Entertainment,58441,58547,106
226,"Ethiopian Music : Fraol Seifu (Bayesh) ፍርኦል ሰይፉ (ባየሽ) - New Ethiopian Music 2021(Official Video) by Minew Shewa Tube 8 months ago 3 minutes, 54 seconds 11,807 views",Minew Shewa Entertainment,11807,11830,23
227,"Anteneh Tesfaye (Ashaferegn) አንተነህ ተስፋዬ (አሻፈረኝ) - New Ethiopian Music 2021(Official Video) by Minew Shewa Tube 8 months ago 7 minutes, 4 seconds 852,851 views",Minew Shewa Entertainment,852851,864471,11620
228,"Ethiopian Music : Yizez Melaku (Tiz Alegn) ይዘዝ መላኩ (ትዝ አለኝ) New Ethiopian Music 2021(Official Video) by Minew Shewa Tube 8 months ago 6 minutes, 21 seconds 34,432 views",Minew Shewa Entertainment,34432,34544,112
229,"Ethiopian Music : Edelawit Beyene (Manew) እድላዊት በየነ (ማነው) - New Ethiopian Music 2021(Official Video) by Minew Shewa Tube 8 months ago 5 minutes, 28 seconds 8,257 views",Minew Shewa Entertainment,8257,8261,4
230,"Zerihun Asrat (konjo nat) ዘሪሁን አስራት (ቆንጆ ናት) - New Ethiopian Music 2021(Official Video) by Minew Shewa Tube 8 months ago 3 minutes, 39 seconds 13,191 views",Minew Shewa Entertainment,13191,13234,43
231,"Ethiopian Music : Abraham Chiksa አብርሃም ጭቅሳ (ንማጃ) - New Ethiopian Music 2021(Official Video) by Minew Shewa Tube 8 months ago 5 minutes, 13 seconds 10,997 views",Minew Shewa Entertainment,10997,11002,5
232,"Ethiopian Music : Jonny Arega ጆኒ አረጋ (ተው ስማ ስራ) - New Ethiopian Music 2021(Official Video) by Minew Shewa Tube 8 months ago 6 minutes, 34 seconds 18,128 views",Minew Shewa Entertainment,18128,18223,95
233,"Ethiopian Music : Helen Getachew ሄለን ጌታቸው (ተረዳኝ) - New Ethiopian Music 2021(Official Video) by Minew Shewa Tube 8 months ago 4 minutes, 36 seconds 15,461 views",Minew Shewa Entertainment,15461,15505,44
234,"Ethiopian Music : Genetu Mengist ገነቱ መንግስት (አማምቷ) - New Ethiopian Music 2021(Official Video) by Minew Shewa Tube 8 months ago 6 minutes, 23 seconds 14,042 views",Minew Shewa Entertainment,14042,14080,38
235,"Alemtsehay Tamrat አለምፀሀይ ታምራት (አንተን ሲሉኝ) - New Ethiopian Music 2021(Official Video) by Minew Shewa Tube 8 months ago 4 minutes, 3 seconds 29,494 views",Minew Shewa Entertainment,29494,29540,46
236,"Ethiopian Music : Negussie Bogale (Bandaff) ንጉሴ ቦጋለ (ባንዳፍ)  New Ethiopian Music 2021(Official Video) by Minew Shewa Tube 8 months ago 5 minutes, 30 seconds 19,551 views",Minew Shewa Entertainment,19551,19593,42
237,"Afework G/Medhin (Ethiopia) አፈወርቅ ገ/መድህን (ኢትዮጵያ) - New Ethiopian Music 2021(Official Video) by Minew Shewa Tube 8 months ago 5 minutes, 2 seconds 9,497 views",Minew Shewa Entertainment,9497,9510,13
238,"Ethiopian Music : Nishan Belay ኒሻን በላይ (ህድ እንዲህ) - New Ethiopian Music 2021(Official Video) by Minew Shewa Tube 8 months ago 4 minutes, 50 seconds 12,692 views",Minew Shewa Entertainment,12692,12721,29
239,"Ethiopian Music : Ashraq Hassen አሽራቅ ሀሰን (ለኔም ስምዓለኝ) - New Ethiopian Music 2021(Official Video) by Minew Shewa Tube 8 months ago 3 minutes, 38 seconds 7,657 views",Minew Shewa Entertainment,7657,7659,2
240,"Ethiopian Music : Birhanu Taye (Yewub Dar) ብርሃኑ ታዬ (የውብ ዳር) New Ethiopian Music 2021(Official Video) by Minew Shewa Tube 8 months ago 5 minutes, 36 seconds 30,191 views",Minew Shewa Entertainment,30191,30276,85
241,"Ethiopian Music : Ha-Geez (Sew) ሃ-ግእዝ (ሰው) - New Ethiopian Music 2021(Official Video) by Minew Shewa Tube 8 months ago 5 minutes, 36 seconds 13,396 views",Minew Shewa Entertainment,13396,13431,35
242,"Habtemariam Tsega ሃብተማርያም ፀጋ (የነበላይ ሃገር - New Ethiopian Music 2021(Official Video) by Minew Shewa Tube 8 months ago 5 minutes, 55 seconds 12,382 views",Minew Shewa Entertainment,12382,12403,21
243,"Alazar Yekelem (Teshetsh) አላዛር የቀለም - ዜድ (ተሸጥሽ)  - New Ethiopian Music 2021(Official Video) by Minew Shewa Tube 8 months ago 5 minutes, 26 seconds 15,483 views",Minew Shewa Entertainment,15483,15536,53
244,"Ethiopian Music : Abinet Girma (Zina) አብነት ግርማ (ዝና) - New Ethiopian Music 2021(Official Video) by Minew Shewa Tube 8 months ago 5 minutes, 15 seconds 379,916 views",Minew Shewa Entertainment,379916,381479,1563
245,"Ethiopian Music : Ethio Man (Teferi) ኢትዮ ማን (ተፈሪ) - New Ethiopian Music 2021(Official Video) by Minew Shewa Tube 8 months ago 5 minutes, 31 seconds 253,298 views",Minew Shewa Entertainment,253298,254304,1006
246,"Ethiopian Music Wasihun Mesfin (Ahohada) ዋስይሁን መስፍን (አኾኻዳ) New Ethiopian Music 2021(Official Video) by Minew Shewa Tube 8 months ago 4 minutes, 15 seconds 15,636 views",Minew Shewa Entertainment,15636,15860,224
247,"Ethiopian Music : Baalchaa Bajigaa (Mariin Fala Hin Ta'u) - New Ethiopian Music 2021(Official Video) by Minew Shewa Tube 9 months ago 5 minutes, 55 seconds 6,554 views",Minew Shewa Entertainment,6554,6560,6
248,"Ethiopian Music : Eleni Tigabe እለኒ ጥጋቤ (ዝም አልልም) - New Ethiopian Music 2021(Official Video) by Minew Shewa Tube 9 months ago 4 minutes, 14 seconds 18,736 views",Minew Shewa Entertainment,18736,18770,34
249,"Ethiopian Music : Habtamu Tagesse ሃብታሙ ታገሰ (ዉጣ ውረድ) - New Ethiopian Music 2021(Official Video) by Minew Shewa Tube 9 months ago 4 minutes, 26 seconds 32,751 views",Minew Shewa Entertainment,32751,32802,51
250,"Ethiopian Music : Bisrat Surafel ብስራት ሱራፌል (ትሆን ወይ) - New Ethiopian Music 2021(Official Video) by Minew Shewa Tube 9 months ago 4 minutes, 16 seconds 7,532,622 views",Minew Shewa Entertainment,7532622,7643016,110394
251,"Ethiopian Music : Zinash Wube ዝናሽ ውቤ (እውነታ) - New Ethiopian Music 2021(Official Video) by Minew Shewa Tube 9 months ago 7 minutes, 40 seconds 666,952 views",Minew Shewa Entertainment,666952,669344,2392
252,"Ethiopian Music : Mekdes Birhanu መቅደስ ብርሃኑ (መርካማ) - New Ethiopian Music 2021(Official Video) by Minew Shewa Tube 9 months ago 4 minutes, 31 seconds 25,482 views",Minew Shewa Entertainment,25482,25530,48
253,"Ethiopian Music : Binyam Mohammed ቢንያም መሃመድ (መጣሁ በይኝና) - New Ethiopian Music 2021(Official Video) by Minew Shewa Tube 9 months ago 4 minutes, 43 seconds 20,696 views",Minew Shewa Entertainment,20696,20706,10
254,"Ethiopian Music : Dagi Fish ዳጊ ፊሽ (መልእክት) - New Ethiopian Music 2021(Official Video) by Minew Shewa Tube 9 months ago 3 minutes, 16 seconds 13,180 views",Minew Shewa Entertainment,13180,13214,34
255,"Ethiopian Music : Miliyanss Gamx | Yihuda (ይሁዳ)  - New Ethiopian Music 2021(Official Video) by Minew Shewa Tube 9 months ago 4 minutes, 14 seconds 12,050 views",Minew Shewa Entertainment,12050,12064,14
256,"Ethiopian Music : Wendu Weyesa ወንዱ ወዬሣ (እሶይሶ ደንዳ) - New Ethiopian Music 2021(Official Video) by Minew Shewa Tube 9 months ago 5 minutes, 4 seconds 13,140 views",Minew Shewa Entertainment,13140,13151,11
257,"Ethiopian Music : Alemayehu Ireecha አለማየሁ እሬቻ (ምርጫዬ) - New Ethiopian Music 2021(Official Video) by Minew Shewa Tube 9 months ago 4 minutes, 48 seconds 17,089 views",Minew Shewa Entertainment,17089,17101,12
258,"Ethiopian Music : Kaleab Getaneh ቃልአብ ጌታነህ (በይ ነይ)  - New Tigrigna Music 2021(Official Video) by Minew Shewa Tube 9 months ago 5 minutes, 8 seconds 26,322 views",Minew Shewa Entertainment,26322,26367,45
259,"Ethiopian Music : Kalkidan Tesfaye (Ayaa Godagnoha) - New Ethiopian Music 2021(Official Video) by Minew Shewa Tube 9 months ago 3 minutes, 53 seconds 12,579 views",Minew Shewa Entertainment,12579,12598,19
260,"Ethiopian Music : Miliyon Tolosa (Wan Ofi Tiya) - New Ethiopian Music 2021(Official Video) by Minew Shewa Tube 9 months ago 4 minutes, 50 seconds 8,310 views",Minew Shewa Entertainment,8310,8332,22
261,"Yared Sisay (Meqemtel) ያሬድ ሲሳይ - ቺቻ (መቀምጠል)  - New Ethiopian Music 2021(Official Video) by Minew Shewa Tube 9 months ago 5 minutes, 45 seconds 20,043 views",Minew Shewa Entertainment,20043,20117,74
262,"Bewketu Sewmehon (Zemenay) በእውቀቱ ሰውመሆን (ዘመናይ) - New Ethiopian Music 2021(Official Video) by Minew Shewa Tube 9 months ago 6 minutes, 12 seconds 134,861 views",Minew Shewa Entertainment,134861,138300,3439
263,"Ethiopian Music: Frehiwot Yemem (Malilign) ፍሬህይወት ይማም (ማልልኝ)New Ethiopian Music 2021(Official Video) by Minew Shewa Tube 9 months ago 5 minutes, 7 seconds 84,863 views",Minew Shewa Entertainment,84863,85086,223
264,"Ethiopian Music : Yechale Dessie የቻለ ደሴ (እርም) - New Ethiopian Music 2021(Official Video) by Minew Shewa Tube 9 months ago 7 minutes, 17 seconds 20,810 views",Minew Shewa Entertainment,20810,20862,52
265,"Ethiopian Music: Nahome Mekuriya (Wude Liyu) ናሆም መኩርያ(ውዴ ልዩ)New Ethiopian Music 2021(Official Video) by Minew Shewa Tube 9 months ago 3 minutes, 58 seconds 2,562,584 views",Minew Shewa Entertainment,2562584,2608325,45741
266,"Ethiopian Music : Meron Gizachew ሜሮን ግዛቸው (ጉድ አያልቅበት) - New Ethiopian Music 2021(Official Video) by Minew Shewa Tube 9 months ago 4 minutes, 33 seconds 14,879 views",Minew Shewa Entertainment,14879,14912,33
267,"Ethiopian Music : - Mykey Flash x Dj Milla (Wedde) ውዴ - New Ethiopian Music 2021(Official Video) by Minew Shewa Tube 9 months ago 3 minutes, 35 seconds 101,915 views",Minew Shewa Entertainment,101915,102207,292
268,"Zenawi hailemariam(ዛኒ) Semia Werkum  “ሰሚዐ ወረኹም” New Tigrigna Music 2021(Official Video) by Minew Shewa Tube 9 months ago 5 minutes, 40 seconds 383,293 views",Minew Shewa Entertainment,383293,387371,4078
269,"Ethiopian Music : Daniel Shawul ዳንኤል ሻውል (አድርሺኝ) - New Ethiopian Music 2021(Official Video) by Minew Shewa Tube 9 months ago 6 minutes, 17 seconds 76,393 views",Minew Shewa Entertainment,76393,76560,167
270,"Ethiopian Music : Black ሀበሻ ft Tsega Berhe (Signorita) - New Ethiopian Music 2021(Official Video) by Minew Shewa Tube 9 months ago 4 minutes, 41 seconds 11,688 views",Minew Shewa Entertainment,11688,11710,22
271,"Kalkidan Demelachew (Beqa Beqa) ቃልኪዳን ደምላቸው (በቃ በቃ) - New Ethiopian Music 2021(Official Video) by Minew Shewa Tube 9 months ago 4 minutes, 56 seconds 16,037 views",Minew Shewa Entertainment,16037,16063,26
272,"Ethiopian Music : Chalachew G/Tsadik (Yaberedu Wollo) - New Ethiopian Music 2021(Official Video) by Minew Shewa Tube 9 months ago 4 minutes, 14 seconds 19,297 views",Minew Shewa Entertainment,19297,19438,141
273,"Ethiopian Music : Tinantwan ትናንቷን (ሀገሬ) - New Ethiopian Music 2021(Official Video) by Minew Shewa Tube 9 months ago 3 minutes, 16 seconds 8,954 views",Minew Shewa Entertainment,8954,8968,14
274,"Ethiopian Music : Aynalem Tafese አይናለም ታፈሰ (ያየብቴ ባስኬቶ) - New Ethiopian Music 2021(Official Video) by Minew Shewa Tube 9 months ago 6 minutes, 13 seconds 7,530 views",Minew Shewa Entertainment,7530,7550,20
275,"Ethiopian Music : Kehali - Kef Wede Lay || ከሓሊ - ከፍ ወደ ላይ - New Ethiopian Music 2021(Official Video) by Minew Shewa Tube 9 months ago 5 minutes, 30 seconds 28,892 views",Minew Shewa Entertainment,28892,28923,31
276,"Ethiopian Music : Natnael Leta ናትናኤል ለታ (አትጠገብ) - New Ethiopian Music 2021(Official Video) by Minew Shewa Tube 9 months ago 4 minutes, 23 seconds 27,638 views",Minew Shewa Entertainment,27638,27734,96
277,"Ethiopian Music : Addis Misganaw /Addio ""Meharene መሐረነ"" New Ethiopian Music 2021(Official Video) by Minew Shewa Tube 9 months ago 8 minutes, 5 seconds 19,738 views",Minew Shewa Entertainment,19738,19815,77
278,"Ethiopian Music : Haylemariam Almaw ሃይለማርያም አልማው (ሰው ሃገሩ) - New Ethiopian Music 2021(Official Video) by Minew Shewa Tube 9 months ago 4 minutes, 49 seconds 10,542 views",Minew Shewa Entertainment,10542,10561,19
279,"Ethiopian music : Tizta Demeke ""Yene Neh"" ትዝታ ደመቀ (የኔ ነህ) New Ethiopian Music 2021(Official Video) by Minew Shewa Tube 9 months ago 4 minutes, 29 seconds 17,338 views",Minew Shewa Entertainment,17338,17371,33
280,"Ethiopian Music : Meek1One ""Abet Abet"" (አቤት አቤት) New Ethiopian Music 2021(Official Video) by Minew Shewa Tube 9 months ago 4 minutes, 52 seconds 2,111,689 views",Minew Shewa Entertainment,2111689,2132075,20386
281,"Alemayehu Eshete (Teqeyersh) አለማየሁ እሸቴ (ተቀየርሽ) - New Ethiopian Music 2021(Official Video) by Minew Shewa Tube 9 months ago 3 minutes, 34 seconds 222,550 views",Minew Shewa Entertainment,222550,223183,633
282,"Ethiopian Music : Elias Yemane ኤልያስ የማነ (በማንም አትፈርስም) - New Ethiopian Music 2021(Official Video) by Minew Shewa Tube 9 months ago 7 minutes, 44 seconds 14,430 views",Minew Shewa Entertainment,14430,14462,32
283,"Gizework Tesfaye (Abet Tizita) ጊዜወርቅ ተስፋዬ (አቤት ትዝታ) - New Ethiopian Music 2021(Official Video) by Minew Shewa Tube 9 months ago 3 minutes, 46 seconds 20,330 views",Minew Shewa Entertainment,20330,20348,18
284,"Ethiopian Music : Habtamu Kebede ሃብታሙ ከበደ (ማን አየሽ) - New Ethiopian Music 2021(Official Video) by Minew Shewa Tube 9 months ago 4 minutes, 32 seconds 29,708 views",Minew Shewa Entertainment,29708,29752,44
285,"Ethiopian Music : Abushenka (Malif)  - New Ethiopian Music 2021(Official Video) by Minew Shewa Tube 9 months ago 3 minutes, 48 seconds 9,779 views",Minew Shewa Entertainment,9779,9790,11
286,"Ethiopian Music : Ethio Man ኢትዮ ማን (ደስታ ቀን) - New Ethiopian Music 2021(Official Video) by Minew Shewa Tube 9 months ago 3 minutes, 43 seconds 174,279 views",Minew Shewa Entertainment,174279,176792,2513
287,"Ethiopian Music : Abyssiniya Vine (Des Yilal) ደስ ይላል  - New Ethiopian Music 2021(Official Video) by Minew Shewa Tube 10 months ago 5 minutes, 5 seconds 4,137,161 views",Minew Shewa Entertainment,4137161,4174548,37387
288,"Ethiopian Music : Adonai Derebe (Mahtebe) አዶናይ ደርቤ (ማህተቤ) - New Ethiopian Music 2021(Official Video) by Minew Shewa Tube 10 months ago 4 minutes, 56 seconds 16,648 views",Minew Shewa Entertainment,16648,16666,18
289,"Ethiopian Music : Tammirat Yeshitilaa (Intala Collee) - New Ethiopian Music 2021(Official Video) by Minew Shewa Tube 10 months ago 5 minutes, 12 seconds 10,088 views",Minew Shewa Entertainment,10088,10108,20
290,"Ethiopian Music : Fetene Ababu ፈጠነ አባቡ (አትንኳት) - New Ethiopian Music 2021(Official Video) by Minew Shewa Tube 10 months ago 5 minutes, 51 seconds 8,053 views",Minew Shewa Entertainment,8053,8061,8
291,"Ethiopian Music : Biim Stephen (Ci Cuen) - New Ethiopian Music 2021(Official Video) by Minew Shewa Tube 10 months ago 4 minutes, 19 seconds 11,278 views",Minew Shewa Entertainment,11278,11288,10
292,"Ethiopian Music : Addisu Oche (Nena Nena)  - New Ethiopian Music 2021(Official Video) by Minew Shewa Tube 10 months ago 3 minutes, 41 seconds 7,341 views",Minew Shewa Entertainment,7341,7356,15
293,"Ethiopian Music : Yohannes Ambachew ዮሃንስ አምባቸው (እንዳላይ) - New Ethiopian Music 2021(Official Video) by Minew Shewa Tube 10 months ago 5 minutes, 27 seconds 8,311 views",Minew Shewa Entertainment,8311,8320,9
294,"Ethiopian Music : Helen Tsegaw (Sakita) ሄለን ፀጋው (ሳቂታ) - New Ethiopian Music 2021(Official Video) by Minew Shewa Tube 10 months ago 3 minutes, 54 seconds 65,460 views",Minew Shewa Entertainment,65460,66145,685
295,"Ethiopian Music : Mastewal Eyayu ማስተዋል እያዩ (ሠው አጣሽ ወይ) - New Ethiopian Music 2021(Official Video) by Minew Shewa Tube 10 months ago 6 minutes, 23 seconds 3,253,836 views",Minew Shewa Entertainment,3253836,3290826,36990
296,"Ethiopian Music : Roba Junior (በሰላም ነው ወይ) - New Ethiopian Music 2021(Official Video) by Minew Shewa Tube 10 months ago 4 minutes, 37 seconds 1,480,522 views",Minew Shewa Entertainment,1480522,1495393,14871
297,"Ethiopian Music : Dereje Dejene ደረጀ ደጀኔ (ዳግማዊ ትንሳኤ) - New Ethiopian Music 2021(Official Video) by Minew Shewa Tube 10 months ago 6 minutes, 45 seconds 18,459 views",Minew Shewa Entertainment,18459,18473,14
298,"Ethiopian Music : Abeje Abinet አበጀ አብነት (የሁለት ሃገር ፍቅር) - New Ethiopian Music 2021(Official Video) by Minew Shewa Tube 10 months ago 7 minutes, 26 seconds 16,890 views",Minew Shewa Entertainment,16890,16944,54
299,"Ethiopian Music : Amen አሜን የህፃናት ህብረት (አባይ ተገደበ) - New Ethiopian Music 2021(Official Video) by Minew Shewa Tube 10 months ago 6 minutes, 49 seconds 12,876 views",Minew Shewa Entertainment,12876,12897,21
300,"Ethiopian Music : Birbirsaa Mokonnin (Awaash ga'een dhufaa) New Ethiopian Music 2021(Official Video) by Minew Shewa Tube 10 months ago 4 minutes, 28 seconds 8,215 views",Minew Shewa Entertainment,8215,8241,26
301,"Ethiopian Music : Dawit Haileslase (Smret) ዳዊት ሃ/ስላሴ (ስምረት) New Ethiopian Music 2021(Official Video) by Minew Shewa Tube 10 months ago 5 minutes, 22 seconds 88,718 views",Minew Shewa Entertainment,88718,89283,565
302,"Ethiopian Music : Binny Lastta ቢኒ ላስታ (አምጣት ትዝታዬ) - New Ethiopian Music 2021(Official Video) by Minew Shewa Tube 10 months ago 4 minutes, 37 seconds 148,290 views",Minew Shewa Entertainment,148290,148625,335
303,"Ethiopian Music : Gebreshet Bitew ገብርሸት ቢተው (ዳረንጎቴ) - New Ethiopian Music 2021(Official Video) by Minew Shewa Tube 10 months ago 5 minutes, 5 seconds 99,949 views",Minew Shewa Entertainment,99949,100342,393
304,"Ethiopian Music : Tokichaw (Hinberbadu)  - New Ethiopian Music 2021(Official Video) by Minew Shewa Tube 10 months ago 6 minutes, 32 seconds 366,580 views",Minew Shewa Entertainment,366580,367897,1317
305,"Ethiopian Music : Kefale Molla (Zeb Yeder) ከፋለ ሞላ (ዘብ ይደር)  New Ethiopian Music 2021(Official Video) by Minew Shewa Tube 10 months ago 6 minutes, 16 seconds 89,819 views",Minew Shewa Entertainment,89819,90014,195
306,"Ethiopian Music : Yimam Asefa ይማም አሰፋ (ፍቅር ቂመኛ ነው) - New Ethiopian Music 2021(Official Video) by Minew Shewa Tube 10 months ago 5 minutes, 54 seconds 19,532 views",Minew Shewa Entertainment,19532,19565,33
307,"Ethiopian Music : Tomas x Ahadu (Arada) ቶማስ x አሃዱ (አራዳ)  - New Ethiopian Music 2021(Official Video) by Minew Shewa Tube 10 months ago 3 minutes, 36 seconds 915,411 views",Minew Shewa Entertainment,915411,918163,2752
308,"Ethiopian Music : Alula Yohannes (Gubo) አሉላ ዮሃንስ (ጉቦ) - New Ethiopian Music 2021(Official Video) by Minew Shewa Tube 10 months ago 4 minutes, 48 seconds 7,298 views",Minew Shewa Entertainment,7298,7304,6
309,"Tewodros Walelign (Che beye) ቴዎድሮስ ዋለልኝ (ቼ ብዬ) - New Ethiopian Music 2021(Official Video) by Minew Shewa Tube 10 months ago 4 minutes, 36 seconds 12,748 views",Minew Shewa Entertainment,12748,12771,23
310,"Ethiopian Music : Temesgen Getaneh ተመስገን ጌታነህ (ጎጃም ላይ ነው) - New Ethiopian Music 2021(Official Video) by Minew Shewa Tube 10 months ago 5 minutes, 30 seconds 12,465 views",Minew Shewa Entertainment,12465,12483,18
311,"Ethiopian Music : Kiya Tesfaye (Abate) ኪያ ተስፋዬ (አባቴ) - New Ethiopian Music 2021(Official Video) by Minew Shewa Tube 10 months ago 6 minutes, 45 seconds 127,515 views",Minew Shewa Entertainment,127515,129660,2145
312,"Ethiopian Music : Mykey Shewa (Kiki) ማይኪ ሸዋ (ኪኪ) - New Ethiopian Music 2021(Official Video) by Minew Shewa Tube 10 months ago 4 minutes, 19 seconds 2,445,407 views",Minew Shewa Entertainment,2445407,2462945,17538
313,"Bethelhem H/Mariam ቤተልሄም ሃይለማርያም (ያፍህ ይቅር) - New Ethiopian Music 2021(Official Video) by Minew Shewa Tube 10 months ago 5 minutes, 11 seconds 13,816 views",Minew Shewa Entertainment,13816,13832,16
314,"Ethiopian Music : Molalign Shete (Marewa) ሞላልኝ ሽቴ (ማሬዋ) - New Ethiopian Music 2021(Official Video) by Minew Shewa Tube 10 months ago 7 minutes, 45 seconds 8,987 views",Minew Shewa Entertainment,8987,9019,32
315,"Ethiopian Music : Kenaw Zewdu ቀናው ዘውዱ (አትንኳት) - New Ethiopian Music 2021(Official Video) by Minew Shewa Tube 10 months ago 5 minutes, 15 seconds 17,960 views",Minew Shewa Entertainment,17960,17989,29
316,"Belachew Simegn መ/አ በላቸው ስመኝ (ብሄር የለኝ እኔ) - New Ethiopian Music 2021(Official Video) by Minew Shewa Tube 10 months ago 4 minutes, 14 seconds 32,798 views",Minew Shewa Entertainment,32798,32842,44
317,"Sinishaw Kifle (Freellion Love) ስንሻው ክፍሌ New Ethiopian Music 2021(Official Video) by Minew Shewa Tube 10 months ago 3 minutes, 56 seconds 12,071 views",Minew Shewa Entertainment,12071,12097,26
318,"Tewabech Mekonin (Wegenye) ተዋበች መኮንን (ወገንዬ) - New Ethiopian Music 2021(Official Video) by Minew Shewa Tube 10 months ago 5 minutes, 8 seconds 12,780 views",Minew Shewa Entertainment,12780,12791,11
319,"Ethiopian Music : Alamaw Chekole አላማው ቸኮለ (እንደዋለለ) - New Ethiopian Music 2021(Official Video) by Minew Shewa Tube 10 months ago 5 minutes, 14 seconds 34,365 views",Minew Shewa Entertainment,34365,34437,72
320,"Ethiopian Music : Matyas Zemede ማትያስ ዘመዴ (የሌመኗ ቆንጆ) New Ethiopian Music 2021(Official Video) by Minew Shewa Tube 11 months ago 4 minutes, 31 seconds 30,201 views",Minew Shewa Entertainment,30201,30272,71
321,"Ethiopian Music : Beza Tadesse (Feta) ቤዛ ታደሰ (ፈታ) - New Ethiopian Music 2021(Official Video) by Minew Shewa Tube 11 months ago 6 minutes, 53 seconds 28,378 views",Minew Shewa Entertainment,28378,28436,58
322,"Ethiopian Music : Demelash Alem ደመላሽ አለም (ሸጋ ጄራ) - New Ethiopian Music 2021(Official Video) by Minew Shewa Tube 11 months ago 5 minutes, 7 seconds 13,390 views",Minew Shewa Entertainment,13390,13477,87
323,"Ethiopian Music : Miki Fine ሚኪ ፋይን (አንቺን ማፍቀር) - New Ethiopian Twist Music 2021(Official Video) by Minew Shewa Tube 11 months ago 3 minutes, 52 seconds 17,391 views",Minew Shewa Entertainment,17391,17410,19
324,"Fetleworke Tesfaye ፈትለወርቅ ተስፋዬ (እውነት ቀርቶ ውሸት) - New Ethiopian Music 2021(Official Video) by Minew Shewa Tube 11 months ago 4 minutes, 31 seconds 7,311 views",Minew Shewa Entertainment,7311,7318,7
325,"Ethiopian Music : Metalem Degu መጣለም ደጉ (አምጣልኝ በፍቅር) - New Ethiopian Music 2021(Official Video) by Minew Shewa Tube 11 months ago 5 minutes, 22 seconds 10,782 views",Minew Shewa Entertainment,10782,10801,19
326,"Ethiopian Music : Zemenu Belay (Anchiye) ዘመኑ በላይ (አንቺዬ) - New Ethiopian Music 2021(Official Video) by Minew Shewa Tube 11 months ago 5 minutes, 55 seconds 19,378 views",Minew Shewa Entertainment,19378,19392,14
327,"Ethiopian Music : Abraham x Dagiopia (Laygebash) ላይገባሽ - New Ethiopian Music 2021(Official Video) by Minew Shewa Tube 11 months ago 4 minutes, 45 seconds 153,647 views",Minew Shewa Entertainment,153647,154437,790
328,"Maycosavage ft Centyo (Yeswa Lij Negn) የሷ ልጅ ነኝ - New Ethiopian Music 2021(Official Video) by Minew Shewa Tube 11 months ago 4 minutes, 2 seconds 9,132 views",Minew Shewa Entertainment,9132,9141,9
329,"Ethiopian Music : Demeke Mulugeta (Sakilegn) ደመቀ ሙሉጌታ(ሳቂልኝ) New Ethiopian Music 2021(Official Video) by Minew Shewa Tube 11 months ago 4 minutes, 54 seconds 17,058 views",Minew Shewa Entertainment,17058,17090,32
330,"Ethiopian Music : Sintayehu Bekele ስንታየሁ በቀለ (ታምራለች) - New Ethiopian Music 2021(Official Video) by Minew Shewa Tube 11 months ago 3 minutes, 57 seconds 16,672 views",Minew Shewa Entertainment,16672,16680,8
331,"Ethiopian Music : Becky Tad ቤኪ ታድ (ምን እሆን ነበር)  - New Ethiopian Music 2021(Official Video) by Minew Shewa Tube 11 months ago 3 minutes, 34 seconds 10,270 views",Minew Shewa Entertainment,10270,10318,48
332,"Ethiopian Music : AB Man (Eswan) እሷን  - New Ethiopian Music 2021(Official Video) by Minew Shewa Tube 11 months ago 4 minutes, 54 seconds 19,017 views",Minew Shewa Entertainment,19017,19052,35
333,"Haftom G/Michael (Hakim hamimu) ሃፍቶም ገ/ሚካኤል (ሓኪም ሓሚሙ) - New Tigrigna Music 2021(Official Video) by Minew Shewa Tube 11 months ago 4 minutes, 37 seconds 286,035 views",Minew Shewa Entertainment,286035,287470,1435
334,"Ethiopian Music : Kirubel Tilahun ኪሩቤል ጥላሁን (አሻኝ ቡጊ ቡጊ) - New Ethiopian Music 2021(Official Video) by Minew Shewa Tube 11 months ago 4 minutes, 13 seconds 18,596 views",Minew Shewa Entertainment,18596,20090,1494
335,"Ethiopian Music : Alex (Yene Tsehay) አሌክስ (የኔ ፀሃይ) - New Ethiopian Music 2021(Official Video) by Minew Shewa Tube 11 months ago 5 minutes, 11 seconds 17,468 views",Minew Shewa Entertainment,17468,17501,33
336,"Mickeyas Bekele (Addis Ababa) ሚክያስ በቀለ (አዲስ አበባ) - New Ethiopian Music 2021(Official Video) by Minew Shewa Tube 11 months ago 4 minutes, 32 seconds 22,307 views",Minew Shewa Entertainment,22307,22326,19
337,"Ethiopian Music: Mafi Leul (Shewit Mearey) ማፊ ልኡል (ሸዊት መዓረይ)New Ethiopian Music 2021(Official Video) by Minew Shewa Tube 11 months ago 5 minutes, 21 seconds 512,914 views",Minew Shewa Entertainment,512914,515977,3063
338,"Ethiopian Music : Tamerat Kebede ታምራት ከበደ (አመመኝ እማ)  - New Ethiopian Music 2021(Official Video) by Minew Shewa Tube 11 months ago 5 minutes, 51 seconds 22,638 views",Minew Shewa Entertainment,22638,22661,23
339,"Ethiopian Music : Haimanot Zeleke (Chila) ሃይማኖት ዘለቀ (ችላ) - New Ethiopian Music 2021(Official Video) by Minew Shewa Tube 11 months ago 5 minutes, 24 seconds 17,606 views",Minew Shewa Entertainment,17606,17641,35
340,"Ethiopian Music: Habtamu Demere (Ethiopia) ሓብታሙ ደመረ (ኢትዮጵያ) New Ethiopian Music 2021(Official Video) by Minew Shewa Tube 11 months ago 5 minutes, 24 seconds 8,696 views",Minew Shewa Entertainment,8696,8707,11
341,"Mekdelawit Barega (Haleta) መቅደላዊት ባረጋ (ሃሌታ) - New Ethiopian Music 2021(Official Video) by Minew Shewa Tube 11 months ago 3 minutes, 47 seconds 32,454 views",Minew Shewa Entertainment,32454,32483,29
342,"Ethiopian Music : Kalkidan Serkalem ቃልኪዳን ሰርካለም (የሴት ልጅ) - New Ethiopian Music 2021(Official Video) by Minew Shewa Tube 11 months ago 4 minutes, 24 seconds 16,594 views",Minew Shewa Entertainment,16594,16608,14
343,"Natnael Samson (Banchi New) ናትናኤል ሳምሶን (ባንቺ ነው) - New Ethiopian Music 2021(Official Video) by Minew Shewa Tube 11 months ago 4 minutes, 34 seconds 20,990 views",Minew Shewa Entertainment,20990,21025,35
344,"Ethiopian Music : Bizuneh Girma ብዙነህ ግርማ (ህራይ በሊ) - New Tigrigna Music 2021(Official Video) by Minew Shewa Tube 11 months ago 3 minutes, 52 seconds 8,432 views",Minew Shewa Entertainment,8432,8440,8
345,"Ethiopian Music : Dagim Belay ዳግም በላይ (ልቤ ቢረጋ) - New Ethiopian Music 2021(Official Video) by Minew Shewa Tube 11 months ago 3 minutes, 46 seconds 18,388 views",Minew Shewa Entertainment,18388,18423,35
346,"Kasahun Tadesse (Webete Nesh) ካሳሁን ታደሰ (ውበቴ ነሽ) - New Ethiopian Music 2021(Official Video) by Minew Shewa Tube 11 months ago 6 minutes, 16 seconds 16,114 views",Minew Shewa Entertainment,16114,16135,21
347,"Eritrean Music : Issey Afewerki(Nksoon) ""Halalye"" New Eritrean Music 2021(Official Video) by Minew Shewa Tube 11 months ago 5 minutes, 49 seconds 42,303 views",Minew Shewa Entertainment,42303,42468,165
348,"Ethiopian Music : Tasfayee Alamuu (Seenaa) - New Ethiopian Music 2021(Official Video) by Minew Shewa Tube 11 months ago 5 minutes, 39 seconds 10,305 views",Minew Shewa Entertainment,10305,10320,15
349,"Ethiopian Music : Binyam Zewdie (Eywat) ቢንያም ዘውዴ (እይዋት)  - New Ethiopian Music 2021(Official Video) by Minew Shewa Tube 11 months ago 4 minutes, 7 seconds 25,207 views",Minew Shewa Entertainment,25207,25224,17
350,"Nuhi X Alpha Boyz ft Abol (Eberalehu) እበራለሁ New Ethiopian Music 2021(Official Video) by Minew Shewa Tube 11 months ago 5 minutes, 21 seconds 15,934 views",Minew Shewa Entertainment,15934,15985,51
351,"Ethiopian Music : Adefris G/Kirstos አደፍርስ ገ/ክርስቶስ (ላነሳሳው) New Ethiopian Music 2021(Official Video) by Minew Shewa Tube 11 months ago 5 minutes, 22 seconds 23,800 views",Minew Shewa Entertainment,23800,23825,25
352,"Ethiopian Music : Abinet Asefa አብነት አሰፋ (አግባት አለኝ) - New Ethiopian Music 2021(Official Video) by Minew Shewa Tube 11 months ago 7 minutes, 24 seconds 40,318 views",Minew Shewa Entertainment,40318,40380,62
353,"Ethiopian Music : Patrick G X Keyroll (Newada) ነዋዳ | New Ethiopian Music 2021(Official Video) by Minew Shewa Tube 11 months ago 3 minutes, 45 seconds 28,142 views",Minew Shewa Entertainment,28142,28204,62
354,"Ethiopian Music : Mulugeta Hailu ሙሉጌታ ሃይሉ (መንዜው ወኔ አለው) - New Ethiopian Music 2021(Official Video) by Minew Shewa Tube 11 months ago 7 minutes, 40 seconds 27,078 views",Minew Shewa Entertainment,27078,27107,29
355,"Ethiopian Music : lil Sancho (kakanu abeh) - New Ethiopian Music 2021(Official Video) by Minew Shewa Tube 11 months ago 5 minutes, 29 seconds 8,599 views",Minew Shewa Entertainment,8599,8624,25
356,"Temesgen Meles X Helen Tesfaye ተመስገን መለስ ና ሄለን ተስፋዬ(አማን ይሁን)New Ethiopian Music 2021(Official Video) by Minew Shewa Tube 11 months ago 6 minutes, 27 seconds 63,553 views",Minew Shewa Entertainment,63553,63638,85
357,"Nuradis Seid X Yoni Gonderigna ኑራዲስ ሰይድ እና ዮኒ ጎንደርኛ (ሳዱላዬ)  New Ethiopian Music 2021(Official Video) by Minew Shewa Tube 11 months ago 5 minutes, 46 seconds 1,255,730 views",Minew Shewa Entertainment,1255730,1269037,13307
358,"Endeshaw Mengistu (Kome Birra) እንደሻው መንግስቱ (ኮሜ ብራ ብራ) - New Ethiopian Music 2021(Official Video) by Minew Shewa Tube 11 months ago 5 minutes, 3 seconds 13,438 views",Minew Shewa Entertainment,13438,13445,7
359,"Ethiopian Music: Haleluya Tekletsadik x Henok Kibru(በአንድ ጎጆ)New Ethiopian Music 2021(Official Video) by Minew Shewa Tube 11 months ago 5 minutes, 44 seconds 674,958 views",Minew Shewa Entertainment,674958,677110,2152
360,"Ethiopian Music : Yaf-Ruf x TGOD (ሀበሻን MEME) WOW - New Ethiopian Roast Track 2021(Official Video) by Minew Shewa Tube 11 months ago 5 minutes, 2 seconds 1,908,334 views",Minew Shewa Entertainment,1908334,1927695,19361
361,"Ethiopian Music : Amanuel Ali (Ewnet) አማኑኤል አሊ (እውነት) - New Ethiopian Music 2021(Official Video) by Minew Shewa Tube 11 months ago 5 minutes, 22 seconds 23,794 views",Minew Shewa Entertainment,23794,23811,17
362,"Tewodros Abayneh (Karamara) ቴዎድሮስ አባይነህ (ካራማራ) - New Ethiopian Music 2021(Official Video) by Minew Shewa Tube 11 months ago 3 minutes, 58 seconds 28,144 views",Minew Shewa Entertainment,28144,28371,227
363,"Ethiopian Music : Jirenya Shiferaw (Terjini)  - New Ethiopian Music 2021(Official Video) by Minew Shewa Tube 1 year ago 5 minutes, 18 seconds 162,356 views",Minew Shewa Entertainment,162356,163067,711
364,"Ethiopian Music : Melkam Yirsaw መልካም ይርሳው (የእናቴን ውለታ) - New Ethiopian Music 2021(Official Video) by Minew Shewa Tube 1 year ago 4 minutes, 56 seconds 18,520 views",Minew Shewa Entertainment,18520,18547,27
365,"Ethiopian Music : Lishan Ayalew (Yazaya) ሊሻን አያሌው (ያዛያ)  - New Ethiopian Music 2021(Official Video) by Minew Shewa Tube 1 year ago 5 minutes, 3 seconds 71,967 views",Minew Shewa Entertainment,71967,72065,98
366,"Ethiopian Music : Daniel Demoz ዳንኤል ደሞዝ (ኸረ አማን) - New Ethiopian Music 2021(Official Video) by Minew Shewa Tube 1 year ago 6 minutes, 40 seconds 75,834 views",Minew Shewa Entertainment,75834,76197,363
367,"Ethiopian Music : Dagne Walle ዳኜ ዋለ (የደም ፀሐይ)  - New Ethiopian Music 2021(Official Video) by Minew Shewa Tube 1 year ago 6 minutes, 36 seconds 1,405,312 views",Minew Shewa Entertainment,1405312,1439981,34669
368,"Ethiopian Music : Seble Ayele ሰብለ አየለ (ልምጣ ወይ) - New Ethiopian Music 2021(Official Video) by Minew Shewa Tube 1 year ago 4 minutes, 33 seconds 46,919 views",Minew Shewa Entertainment,46919,46956,37
369,"Emawayesh Tsehaye (Kalkidan) እማዋይሽ ፀሃዬ (ቃልኪዳን) - New Ethiopian Music 2021(Official Video) by Minew Shewa Tube 1 year ago 4 minutes, 30 seconds 26,337 views",Minew Shewa Entertainment,26337,26359,22
370,"Ethiopian Music: Tariku 80 Shele ""Yenadal"" ታሪኩ 80 ሸሌ(ይናዳል) New Ethiopian Music 2021(Official Video) by Minew Shewa Tube 1 year ago 4 minutes, 49 seconds 66,530 views",Minew Shewa Entertainment,66530,66568,38
371,"Ethiopian Music : Mizz Jimi (Blene) ብሌኔ  - New Ethiopian Music 2021(Official Video) by Minew Shewa Tube 1 year ago 4 minutes, 17 seconds 35,938 views",Minew Shewa Entertainment,35938,35985,47
372,"Zebiba Girma x Mesay Tefera ዘቢባ ግርማ እና መሳይ ተፈራ (አዲስ ፍቅር) - New Ethiopian Music 2021(Official Video) by Minew Shewa Tube 1 year ago 5 minutes, 4 seconds 7,252,313 views",Minew Shewa Entertainment,7252313,7312656,60343
373,"Ethiopian Music : Mikyas Cherinet ሚክያስ ቸርነት (ቀረ ድሮ) - New Ethiopian Music 2021(Official Video) by Minew Shewa Tube 1 year ago 6 minutes, 59 seconds 542,433 views",Minew Shewa Entertainment,542433,544402,1969
374,"Ethiopian Music : Natemacc X Robbie2k (Zufanu) ዙፋኑ - New Ethiopian Music 2021(Official Video) by Minew Shewa Tube 1 year ago 3 minutes, 40 seconds 56,079 views",Minew Shewa Entertainment,56079,56199,120
375,"Tewodros Hailemichael (Jegna) ቴዎድሮስ ሃይለሚካኤል (ጀግና) - New Ethiopian Music 2021(Official Video) by Minew Shewa Tube 1 year ago 3 minutes, 43 seconds 15,241 views",Minew Shewa Entertainment,15241,15254,13
376,"Ethiopian Music : Ezu (Tew) ኢዙ (ተው)  - New Ethiopian Music 2021(Official Video) by Minew Shewa Tube 1 year ago 4 minutes, 4 seconds 19,472 views",Minew Shewa Entertainment,19472,19497,25
377,"Ethiopian Music : Tsion Girma (Helme New) ፂዮን ግርማ (ህልሜ ነው) New Ethiopian Music 2021(Official Video) by Minew Shewa Tube 1 year ago 4 minutes, 26 seconds 28,932 views",Minew Shewa Entertainment,28932,28948,16
378,"Ethiopian Music : Berhane G/Silassie ብርሃኔ ገ/ስላሴ (ምንትዋብ) - New Ethiopian Music 2021(Official Video) by Minew Shewa Tube 1 year ago 5 minutes, 48 seconds 15,980 views",Minew Shewa Entertainment,15980,16130,150
379,"Solomon Demeke (Mekelakeya) ሰለሞን ደመቀ (መከላከያ) - New Ethiopian Music 2021(Official Video) by Minew Shewa Tube 1 year ago 5 minutes, 37 seconds 12,611 views",Minew Shewa Entertainment,12611,12621,10
380,"Ethiopian Music Shambel Belayneh(Embi Ale)ሻምበል በላይነህ(እምቢ አለ)New Ethiopian Music 2021(Official Video) by Minew Shewa Tube 1 year ago 8 minutes, 28 seconds 833,129 views",Minew Shewa Entertainment,833129,840842,7713
381,"Ethiopian Music : Amsal Mitike (Wude Wude) አምሳል ምትኬ (ውዴ ውዴ) New Ethiopian Music 2021(Official Video) by Minew Shewa Tube 1 year ago 6 minutes, 1 second 2,496,030 views",Minew Shewa Entertainment,2496030,2527590,31560
382,"Ethiopian Music: Wendi Maru(Mech Yemechshal)ወንዲ ማሩ(መቼ ይመችሻል)New Ethiopian Music 2021(Official Video) by Minew Shewa Tube 1 year ago 4 minutes, 11 seconds 88,181 views",Minew Shewa Entertainment,88181,88468,287
383,"Ethiopian Music :Dawit Teku ዳዊት ትኩ (ዝኸበርኺ ፍቅረይ)   - New Ethiopian Music 2021(Official Video) by Minew Shewa Tube 1 year ago 5 minutes, 14 seconds 15,530 views",Minew Shewa Entertainment,15530,15556,26
384,"Ethiopian Music : Tadese Mengiste ታደሰ መንግስቴ (ልሂድ ልፈልጋት)  - New Ethiopian Music 2021(Official Video) by Minew Shewa Tube 1 year ago 5 minutes, 32 seconds 21,773 views",Minew Shewa Entertainment,21773,21797,24
385,"Ethiopian Music : Muluken Mesfin ሙሉቀን መስፍን (ሀበሻ ነኝ) - New Ethiopian Music 2021(Official Video) by Minew Shewa Tube 1 year ago 6 minutes, 8 seconds 23,237 views",Minew Shewa Entertainment,23237,23265,28
386,"Yabu Tesfaye (Abet Emebet) ያቡ ተስፋዬ (አቤት እመቤት) New Ethiopian Music 2021(Official Video) by Minew Shewa Tube 1 year ago 4 minutes, 16 seconds 22,434 views",Minew Shewa Entertainment,22434,22450,16
387,"Ethiopian Music : Mamila Lukas ማሚላ ሉቃስ (ምርጡን ላንቺ) - New Ethiopian Music 2021(Official Video) by Minew Shewa Tube 1 year ago 5 minutes, 27 seconds 1,578,975 views",Minew Shewa Entertainment,1578975,1592206,13231
388,"Ethiopian Music : Teamir Gizaw (Minewa) ተዓምር ግዛው (ምነዋ) - New Ethiopian Music 2021(Official Video) by Minew Shewa Tube 1 year ago 5 minutes, 41 seconds 16,134,529 views",Minew Shewa Entertainment,16134529,16310125,175596
389,"Ethiopian Music : Mehari Degefaw (Kegne) መሃሪ ደገፋው (ቀኜ)  - New Ethiopian Music 2021(Official Video) by Minew Shewa Tube 1 year ago 7 minutes, 27 seconds 3,573,718 views",Minew Shewa Entertainment,3573718,3596952,23234
390,"Ethiopian Music :Eshetu Mersha(Selam Awred)እሸቱ መርሻ(ሰላም አውርድ)New Ethiopian Music 2021(Official Video) by Minew Shewa Tube 1 year ago 5 minutes, 29 seconds 139,546 views",Minew Shewa Entertainment,139546,139948,402
391,"Alemeye Getachew (Aschegersh) አለምዬ ጌታቸው (አስቸገርሽ) - New Ethiopian Music 2021(Official Video) by Minew Shewa Tube 1 year ago 5 minutes, 17 seconds 692,215 views",Minew Shewa Entertainment,692215,695637,3422
392,"Ethiopian Music : Abera Belay (Yikerta) አበራ በላይ (ይቅርታ) - New Ethiopian Music 2021(Official Video) by Minew Shewa Tube 1 year ago 5 minutes, 46 seconds 22,609 views",Minew Shewa Entertainment,22609,22672,63
393,"Ethiopian Music : Teshale Endere ተሻለ እንድሬ (ፍቅር ነሽ ገነቴ) - New Ethiopian Music 2021(Official Video) by Minew Shewa Tube 1 year ago 6 minutes, 40 seconds 17,725 views",Minew Shewa Entertainment,17725,17813,88
394,"Ethiopian Music : Jimmy AK (Think About It) - New Ethiopian Music 2021(Official Video) by Minew Shewa Tube 1 year ago 4 minutes, 1 second 11,020 views",Minew Shewa Entertainment,11020,11057,37
395,"Ethiopian Music : Fisum T (Aye Mognu) ፍፁም ቲ (አዬ ሞኙ)  - New Ethiopian Music 2021(Official Video) by Minew Shewa Tube 1 year ago 5 minutes, 4 seconds 206,613 views",Minew Shewa Entertainment,206613,207118,505
396,"Adis Mulat & Abdu Kiar(Yewub Dar) ኢዲስ ሙላት & አብዱ ኪያር(የውብ ዳር)New Ethiopian Music 2021(Official Video) by Minew Shewa Tube 1 year ago 4 minutes, 55 seconds 3,697,690 views",Minew Shewa Entertainment,3697690,3732356,34666
397,"Ethiopian Music : Ephrem Amare (Hezbey) ኤፍሬም አማረ (ህዝበይ) - New Ethiopian Music 2021(Official Video) by Minew Shewa Tube 1 year ago 3 minutes, 58 seconds 990,767 views",Minew Shewa Entertainment,990767,993880,3113
398,"Ethiopian Music : Eyob Belay (Alehu) እዮብ በላይ (አለሁ) - New Ethiopian Music 2021(Official Video) by Minew Shewa Tube 1 year ago 4 minutes, 35 seconds 41,137 views",Minew Shewa Entertainment,41137,41285,148
399,"Ethiopian Music Birhanu Goshu(Aba Alemayehu)ብርሃኑ ጎሹ(አባ አለማየሁ)New Ethiopian Music2021(Official Video) by Minew Shewa Tube 1 year ago 6 minutes, 17 seconds 23,952 views",Minew Shewa Entertainment,23952,23970,18
400,"Ethiopian Music : Azaria Alemu አዛርያ አለሙ (እንደኔስ)  - New Ethiopian Music 2021(Official Video) by Minew Shewa Tube 1 year ago 4 minutes, 51 seconds 33,392 views",Minew Shewa Entertainment,33392,33444,52
401,"Nahom Asnake  ናሆም አስናቀ (ፍቅር ሰላም ለኢትዮጵያ) - New Ethiopian Music 2021(Official Video) by Minew Shewa Tube 1 year ago 4 minutes, 36 seconds 10,517 views",Minew Shewa Entertainment,10517,10531,14
402,"Lee Admassie (Ethiopia Forever) ሊ አድማሴ (ኢትዮጵያ ለዘላለም) - New Ethiopian Music 2021(Official Video) by Minew Shewa Tube 1 year ago 5 minutes, 5 seconds 10,184 views",Minew Shewa Entertainment,10184,10193,9
403,"Solomon | Aweke | Abraham ሰለሞን | አወቀ | አብራሃም (እንችላለን) - New Ethiopian Music 2021(Official Video) by Minew Shewa Tube 1 year ago 7 minutes, 19 seconds 10,458 views",Minew Shewa Entertainment,10458,10464,6
404,"Haftom G/Michael (Neusey) ሃፍቶም ገ/ሚካኤል (ንኡሰይ)  - New Tigrigna Music 2021(Official Video) by Minew Shewa Tube 1 year ago 4 minutes, 30 seconds 261,786 views",Minew Shewa Entertainment,261786,262639,853
405,"Ethiopian Music : Ami/AB3 (Tefetari) ተፈጣሪ - New Ethiopian Music 2021(Official Video) by Minew Shewa Tube 1 year ago 3 minutes, 47 seconds 6,294 views",Minew Shewa Entertainment,6294,6305,11
406,"Beshewa Zemed (Yayine Abeba) በሸዋ ዘመድ (ያይኔ አበባ) - New Ethiopian Music 2021(Official Video) by Minew Shewa Tube 1 year ago 7 minutes, 48 seconds 12,956 views",Minew Shewa Entertainment,12956,12972,16
407,"Ethiopian Music : Mulualem Takele ሙሉአለም ታከለ (አመሰግናለው) - New Ethiopian Music 2021(Official Video) by Minew Shewa Tube 1 year ago 4 minutes, 46 seconds 887,843 views",Minew Shewa Entertainment,887843,896985,9142
408,"Ethiopian Music: Shime Mesh (Yearada Lij) ሽሜ ሜሽ (የአራዳ ልጅ) - New Ethiopian Music 2021(Official Video) by Minew Shewa Tube 1 year ago 4 minutes, 38 seconds 42,200 views",Minew Shewa Entertainment,42200,42390,190
409,"Blacky Best ft Ras Selass (Yegna Sheger) (የኛ ሸገር) - New Ethiopian Music 2021(Official Video) by Minew Shewa Tube 1 year ago 5 minutes, 2 seconds 19,739 views",Minew Shewa Entertainment,19739,19779,40
410,"Ethiopian Music : Negese Ayanu ነገሰ አያኑ (የጫካው ነብር) - New Ethiopian Music 2021(Official Video) by Minew Shewa Tube 1 year ago 5 minutes, 33 seconds 9,644 views",Minew Shewa Entertainment,9644,9647,3
411,"Ethiopian Music : Aregahegn Lemma አረጋኸኝ ለማ (የኔ አማላይ) - New Ethiopian Music 2021(Official Video) by Minew Shewa Tube 1 year ago 4 minutes, 54 seconds 16,246 views",Minew Shewa Entertainment,16246,16281,35
412,"Abera Belay (Hulum Sidet Geba) አበራ በላይ (ሁሉም ስደት ገባ) - New Ethiopian Music 2021(Official Video) by Minew Shewa Tube 1 year ago 6 minutes, 55 seconds 6,207 views",Minew Shewa Entertainment,6207,6228,21
413,"Ethiopian Music : Fasika Milyard ፋሲካ ሚልያርድ (ዉለታህ) - New Ethiopian Music 2021(Official Video) by Minew Shewa Tube 1 year ago 5 minutes, 28 seconds 10,854 views",Minew Shewa Entertainment,10854,10859,5
414,"Ethiopian Music : Gudi Man (Tey) ተይ - New Ethiopian Music 2021(Official Video) by Minew Shewa Tube 1 year ago 4 minutes, 12 seconds 4,516 views",Minew Shewa Entertainment,4516,4522,6
415,"Ethiopian Music : Henok Niguse (Tesfa) ሄኖክ ንጉሴ (ተስፋ) - New Ethiopian Music 2021(Official Video) by Minew Shewa Tube 1 year ago 3 minutes, 28 seconds 9,752 views",Minew Shewa Entertainment,9752,9789,37
416,"Ethiopian Music : Mahamed Qancora (Qaca'ee Koblaa) - New Ethiopian Music 2021(Official Video) by Minew Shewa Tube 1 year ago 5 minutes 20,307 views",Minew Shewa Entertainment,20307,20388,81
417,"Ethiopian Music : Solomon Metaw (Zor Bel) ሰለሞን ምታው (ዞር በል) New Ethiopian Music 2021(Official Video) by Minew Shewa Tube 1 year ago 7 minutes, 15 seconds 20,888 views",Minew Shewa Entertainment,20888,20899,11
418,"Binyam Assefa (Lali Habesha) ቢንያም አሰፋ (ላሊ ሃበሻ)- New Ethiopian Cover Music 2021(Official Video) by Minew Shewa Tube 1 year ago 6 minutes, 21 seconds 14,532 views",Minew Shewa Entertainment,14532,14614,82
419,"Ethiopian Music : Bewketu Sewmehon በእውቀቱ ሰውመሆን (ወሎ ራያ) - New Ethiopian Music 2021(Official Video) by Minew Shewa Tube 1 year ago 4 minutes, 18 seconds 454,400 views",Minew Shewa Entertainment,454400,457198,2798
420,"Ethiopian Music :Kaleab Kinfe(Kal Kin)Wesnual ቃልአብ ክንፈ(ወስኗል)New Ethiopian Music 2021(Official Video) by Minew Shewa Tube 1 year ago 6 minutes, 3 seconds 2,595,681 views",Minew Shewa Entertainment,2595681,2611896,16215
421,"Dawit Desalegn (Ney Ney) ዳዊት ደሳለኝ (ነይ ነይ) New Ethiopian Music 2021(Official Video) by Minew Shewa Tube 1 year ago 3 minutes, 53 seconds 9,818 views",Minew Shewa Entertainment,9818,9830,12
422,"Tarekegn Muleta (Maria Maria) ታሬ ማሪያ (ማሪያ ማሪያ) - New Ethiopian Music 2021(Official Video) by Minew Shewa Tube 1 year ago 5 minutes, 29 seconds 8,879 views",Minew Shewa Entertainment,8879,8884,5
423,"Gedion Daniel (Techelshalew) ጌድዮን ዳንኤል (ትቼልሻለው) - New Ethiopian Music 2021(Official Video) by Minew Shewa Tube 1 year ago 6 minutes, 4 seconds 408,286 views",Minew Shewa Entertainment,408286,410782,2496
424,"Fasil Nigussie (Yene Alem) ፋሲል ንጉሴ (የኔ አለም) - New Ethiopian Music 2021(Official Video) by Minew Shewa Tube 1 year ago 4 minutes, 45 seconds 14,290 views",Minew Shewa Entertainment,14290,14320,30
425,"Euphorize ft Biniyam (Yegena Chewata) (የገና ጨዋታ)  - New Ethiopian Music 2021(Official Video) by Minew Shewa Tube 1 year ago 3 minutes, 58 seconds 4,539 views",Minew Shewa Entertainment,4539,4548,9
426,"Ethiopian Music : Admachew Ayele አድማቸው አየለ (አሰከረኝ ፍቅሯ) - New Ethiopian Music 2021(Official Video) by Minew Shewa Tube 1 year ago 4 minutes, 59 seconds 7,153 views",Minew Shewa Entertainment,7153,7165,12
427,"Ethiopian Music : Amanuel Sinshaw አማኑኤል ስንሻው (እንቢ በላቸው) - New Ethiopian Music 2021(Official Video) by Minew Shewa Tube 1 year ago 5 minutes, 40 seconds 6,851 views",Minew Shewa Entertainment,6851,6860,9
428,"Ethiopian Music : Getahun Tadesse ጌታሁን ታደሰ (አንድ አልነበረም ወይ) New Ethiopian Music 2021(Official Video) by Minew Shewa Tube 1 year ago 6 minutes, 33 seconds 11,861 views",Minew Shewa Entertainment,11861,11873,12
429,"Ethiopian Music : Habtamu Chaklie (Enatew) ሃብታሙ ጫቅሌ (እናቴው) New Ethiopian Music 2021(Official Video) by Minew Shewa Tube 1 year ago 5 minutes, 49 seconds 10,420 views",Minew Shewa Entertainment,10420,10422,2
430,"Ethiopian Music : Mekdes Girma መቅደስ ግርማ (ተላምጄህ ነው) - New Ethiopian Music 2021(Official Video) by Minew Shewa Tube 1 year ago 5 minutes, 14 seconds 1,362,880 views",Minew Shewa Entertainment,1362880,1367944,5064
431,"Ethiopian Music : Bereket Endrias (Garesro) - New Ethiopian Music 2021(Official Video) by Minew Shewa Tube 1 year ago 3 minutes, 46 seconds 12,728 views",Minew Shewa Entertainment,12728,12743,15
432,"Ethiopian Music : Muler Mesfin ሙለር መስፍን (ባይ ዞሬ ዞሬ) - New Ethiopian Music 2021(Official Video) by Minew Shewa Tube 1 year ago 3 minutes, 56 seconds 44,874 views",Minew Shewa Entertainment,44874,44993,119
433,"Ethiopian Music : Kasahun Demisse ካሳሁን ደምሴ (ደምቀሽ መድረኩላይ) - New Ethiopian Music 2021(Official Video) by Minew Shewa Tube 1 year ago 6 minutes, 43 seconds 9,589 views",Minew Shewa Entertainment,9589,9597,8
434,"Getahun Chaklu (Yene Shega) ጌታሁን ጫቅሉ (የኔ ሸጋ) New Ethiopian Music 2021(Official Video) by Minew Shewa Tube 1 year ago 5 minutes, 41 seconds 9,642 views",Minew Shewa Entertainment,9642,9650,8
435,"Selam Gonderewa (Gondere Negn) ሰላም ጎንደሬዋ (ጎንደሬ ነኝ) - New Ethiopian Music 2021(Official Video) by Minew Shewa Tube 1 year ago 4 minutes, 50 seconds 36,086 views",Minew Shewa Entertainment,36086,36175,89
436,"Ethiopian Music : Eyu Angaw (Sinegresh) እዩ አንጋው (ስነግርሽ) - New Ethiopian Music 2021(Official Video) by Minew Shewa Tube 1 year ago 3 minutes, 26 seconds 12,256 views",Minew Shewa Entertainment,12256,12454,198
437,"Fitsum Zebasil (Amhara Ayeferam) ፍጹም ዘባሲል (አማራ አይፈራም) - New Ethiopian Music 2021(Official Video) by Minew Shewa Tube 1 year ago 5 minutes, 44 seconds 23,728 views",Minew Shewa Entertainment,23728,23746,18
438,"Yidnekachew Mengistu (Enat) ይድነቃቸው መንግስቱ (እናት) - New Ethiopian Music 2021(Official Video) by Minew Shewa Tube 1 year ago 4 minutes, 36 seconds 7,024 views",Minew Shewa Entertainment,7024,7046,22
439,"Ethiopian Music : Helen Gabir ሄለን ጋብር (አመሉ ነው) - New Ethiopian Music 2021(Official Video) by Minew Shewa Tube 1 year ago 5 minutes, 3 seconds 11,054 views",Minew Shewa Entertainment,11054,11057,3
440,"Ethiopian Music : Tariku Wolde (Merkamo) ታሪኩ ወልዴ (መርካሞ) - New Ethiopian Music 2021(Official Video) by Minew Shewa Tube 1 year ago 5 minutes, 20 seconds 7,179 views",Minew Shewa Entertainment,7179,7194,15
441,"Ethiopian Music : Eden Abebe ኤደን አበበ (ጫን ያለው)  - New Ethiopian Music 2020(Official Video) by Minew Shewa Tube 1 year ago 5 minutes, 30 seconds 26,400 views",Minew Shewa Entertainment,26400,26434,34
442,"Ethiopian Music : B Weyn (Kinin) Asmera  - New Ethiopian Music 2020(Official Video) by Minew Shewa Tube 1 year ago 4 minutes, 14 seconds 8,876 views",Minew Shewa Entertainment,8876,8882,6
443,"Ethiopian Music : KUM3RA (Heartless) - New Ethiopian Music 2020(Official Video) by Minew Shewa Tube 1 year ago 3 minutes, 11 seconds 4,772 views",Minew Shewa Entertainment,4772,4776,4
444,"Ethiopian Music : Habiibaa Huseen (Lafee Goota) - New Ethiopian Music 2021(Official Video) by Minew Shewa Tube 1 year ago 4 minutes, 29 seconds 4,738 views",Minew Shewa Entertainment,4738,4744,6
445,"Ethiopian Mezmur: Helen Berhe (Horonaym) ሄለን በርሔ (ሖሮናይም) -New Ethiopian Mezmur 2021(Official Video) by Minew Shewa Tube 1 year ago 5 minutes, 17 seconds 711,252 views",Minew Shewa Entertainment,711252,713955,2703
446,"Solomon James Browne (Hold up your banner) - New Ethiopian Music 2021(Official Video) by Minew Shewa Tube 1 year ago 4 minutes, 4 seconds 6,164 views",Minew Shewa Entertainment,6164,6183,19
447,"M Star (Mahadi) - ITF TAEKWONDO - New Ethiopian Music 2020(Official Video) by Minew Shewa Tube 1 year ago 4 minutes, 31 seconds 5,985 views",Minew Shewa Entertainment,5985,6040,55
448,"Ali Birra & Abreham Belayneh አሊ ቢራ እና አብርሃም በላይነህ (ዳርም የለው) New Ethiopian Music 2021(Official Video) by Minew Shewa Tube 1 year ago 6 minutes, 9 seconds 5,733,961 views",Minew Shewa Entertainment,5733961,5772326,38365
449,"Ethiopian Music: Solomon Demele ሰሎሞን ደምሌ (ክንደ ነበልባል ) New Ethiopian Music 2021(Official Video) by Minew Shewa Tube 1 year ago 6 minutes, 21 seconds 176,446 views",Minew Shewa Entertainment,176446,177278,832
450,"Ethiopian Music : Ashenafi T/Haimanot አሸናፊ ተ/ሃይማኖት (ወዘናሽ) - New Ethiopian Music 2020(Official Video) by Minew Shewa Tube 1 year ago 4 minutes, 59 seconds 11,642 views",Minew Shewa Entertainment,11642,11651,9
451,"Temesgen Mulualem ተመስገን ሙሉዓለም (እንኳን ደስ አላችሁ) - New Ethiopian Music 2020(Official Video) by Minew Shewa Tube 1 year ago 3 minutes, 44 seconds 4,570 views",Minew Shewa Entertainment,4570,4578,8
452,"Ethiopian Music :Ayenew Arega (Zim Alelim) አየነው አረጋ(ዝም አልልም)New Ethiopian Music 2020(Official Video) by Minew Shewa Tube 1 year ago 8 minutes, 39 seconds 219,215 views",Minew Shewa Entertainment,219215,219570,355
453,"Ethiopian Music : Wegayehu Daya ወጋየሁ ዳያ (ህግ ይሁን የበላይ) - New Ethiopian Music 2020(Official Video) by Minew Shewa Tube 1 year ago 6 minutes, 17 seconds 8,518 views",Minew Shewa Entertainment,8518,8521,3
454,"Ethiopian Music : Yared Wubalem ያሬድ ውብአለም (ጎ ትነግስ ብዬ) - New Ethiopian Music 2020(Official Video) by Minew Shewa Tube 1 year ago 5 minutes, 10 seconds 12,004 views",Minew Shewa Entertainment,12004,12013,9
455,"Ethiopian Music : Enyew Amdisa (Semign) እንየው አምዲሳ (ስሚኝ) - New Ethiopian Music 2020(Official Video) by Minew Shewa Tube 1 year ago 4 minutes, 47 seconds 4,915 views",Minew Shewa Entertainment,4915,4921,6
456,"Alemtsehay Berhe  (Shewit Mishela) አለምፀሐይ በርሔ (ሸዊት ሚሸላ) - New Ethiopian Music 2020(Official Video) by Minew Shewa Tube 1 year ago 3 minutes, 20 seconds 5,768 views",Minew Shewa Entertainment,5768,5777,9
457,"Ethiopian Music : Geetaahun Cirfaa (Qaroo Ijaa)  - New Ethiopian Music 2020(Official Video) by Minew Shewa Tube 1 year ago 4 minutes, 49 seconds 8,585 views",Minew Shewa Entertainment,8585,8591,6
458,"Ethiopian Music : Yilkal Belsti ይልቃል በልስቲ (እኔ እየወደድኳት)  - New Ethiopian Music 2020(Official Video) by Minew Shewa Tube 1 year ago 7 minutes, 15 seconds 13,900 views",Minew Shewa Entertainment,13900,13961,61
459,"Ethiopian Music : Sitiyana Teni (Weleba) ሲትያና ቴኒ (ወለባ) - New Ethiopian Music 2020(Official Video) by Minew Shewa Tube 1 year ago 4 minutes, 27 seconds 110,007 views",Minew Shewa Entertainment,110007,110256,249
460,"ወንድሙ ከበደ አስናቀ ሎታ ሽመልስ ክፍሌ ጥሩ ብር ግዛው (ዳንጋርሳ ዳውሮ)- New Ethiopian Music 2020(Official Video) by Minew Shewa Tube 1 year ago 7 minutes, 33 seconds 11,467 views",Minew Shewa Entertainment,11467,11553,86
461,"Wegayehu Seyoum (Achitti Lalle) ወጋየሁ ስዩም (አቺቲ ላሌ) - New Ethiopian Music 2020(Official Video) by Minew Shewa Tube 1 year ago 5 minutes, 4 seconds 10,925 views",Minew Shewa Entertainment,10925,10930,5
462,"Ethiopian Music : Mastewal Destaw (Abay) ማስተዋል ደስታው (አባይ) - New Ethiopian Music 2020(Official Video) by Minew Shewa Tube 1 year ago 5 minutes, 45 seconds 17,048 views",Minew Shewa Entertainment,17048,17065,17
463,"Ethiopian Music : Emu Teshome (Demo Na) እሙ ተሾመ (ደሞ ና) - New Ethiopian Music 2020(Official Video) by Minew Shewa Tube 1 year ago 4 minutes, 50 seconds 36,475 views",Minew Shewa Entertainment,36475,36508,33
464,"Ethiopian Music: Tirubir Gizaw (Toki Bea) ጥሩብር ግዛው (ቶኪ ቤአ) New Ethiopian Music 2020(Official Video) by Minew Shewa Tube 1 year ago 4 minutes, 59 seconds 10,534 views",Minew Shewa Entertainment,10534,10542,8
465,"Tariku Kassahun (Asmerina) ታሪኩ ካሳሁን (አስመሪና) - New Ethiopian Music 2020(Official Video) by Minew Shewa Tube 1 year ago 5 minutes, 33 seconds 6,314 views",Minew Shewa Entertainment,6314,6316,2
466,"Mesay ft Mintesnot መሳይ ብርሃኑ ft ምንተስኖት ታምሩ (ማሪ ጎባንኬ) - New Ethiopian Music 2020(Official Video) by Minew Shewa Tube 1 year ago 3 minutes, 20 seconds 4,639 views",Minew Shewa Entertainment,4639,4645,6
467,"Ethiopian Music : Bitew Dawit (Hagere) ቢተው ዳዊት (ሀገሬ) - New Ethiopian Music 2020(Official Video) by Minew Shewa Tube 1 year ago 6 minutes, 14 seconds 8,952 views",Minew Shewa Entertainment,8952,8958,6
468,"Ethiopian Music : Helen Yosef (Bonna Bonna)  - New Ethiopian Music 2020(Official Video) by Minew Shewa Tube 1 year ago 4 minutes, 56 seconds 9,527 views",Minew Shewa Entertainment,9527,9538,11
469,"Ethiopian Music : Mente Dana (Agare) ምንቴ ዳና (አጋሬ) - New Ethiopian Music 2020(Official Video) by Minew Shewa Tube 1 year ago 4 minutes, 2 seconds 6,971 views",Minew Shewa Entertainment,6971,6974,3
470,"Ethiopian Music : Samson Mekonnen ሳምሶን መኮንን (ብስምሽ) - New Ethiopian Music 2020(Official Video) by Minew Shewa Tube 1 year ago 5 minutes, 36 seconds 47,597 views",Minew Shewa Entertainment,47597,47679,82
471,"Ethiopian Music : Yezina Negash የዝና ነጋሽ (መሄጃ ሲያሳጣኝ) - New Ethiopian Music 2020(Official Video) by Minew Shewa Tube 1 year ago 7 minutes, 50 seconds 427,418 views",Minew Shewa Entertainment,427418,428658,1240
472,"Ethiopian Music : Meseret Ebabu (Kebedegn) መሰረት እባቡ (ከበደኝ) New Ethiopian Music 2020(Official Video) by Minew Shewa Tube 1 year ago 4 minutes, 14 seconds 14,412 views",Minew Shewa Entertainment,14412,14443,31
473,"Ethiopian Music: Semme Hola (Melkam Lidet) ሰሜ ሆላ (መልካም ልደት) New Ethiopian Music 2020(Official Video) by Minew Shewa Tube 1 year ago 4 minutes, 30 seconds 25,751 views",Minew Shewa Entertainment,25751,26139,388
474,"Ethiopian Music : Betelhem, Lidiya, Tsion, Tigist(ሴት ነኝ)- New Ethiopian Music 2020(Official Video) by Minew Shewa Tube 1 year ago 4 minutes, 11 seconds 10,456 views",Minew Shewa Entertainment,10456,10489,33
475,"Dawit Mengesha (Ethiopia) ዳዊት መንገሻ (ኢትዮጵያ) - New Ethiopian Music 2020(Official Video) by Minew Shewa Tube 1 year ago 5 minutes, 42 seconds 71,247 views",Minew Shewa Entertainment,71247,71266,19
476,"Seble Mesfin (Nesh Gibebena) ሰብለ መስፍን (ኔሽ ጊበበና) - New Ethiopian Music 2020(Official Video) by Minew Shewa Tube 1 year ago 4 minutes, 15 seconds 8,942 views",Minew Shewa Entertainment,8942,8948,6
477,"Ethiopian Music : Megistu Demelash መንግስቱ ደመላሽ (ወሃበል) - New Ethiopian Music 2020(Official Video) by Minew Shewa Tube 1 year ago 7 minutes, 4 seconds 39,055 views",Minew Shewa Entertainment,39055,39089,34
478,"Israel Tadesse (Ethiopia) እስራኤል ታደሰ (ኢትዮጵያ) - New Ethiopian Music 2020(Official Video) by Minew Shewa Tube 1 year ago 4 minutes, 24 seconds 4,704 views",Minew Shewa Entertainment,4704,4709,5
479,"Netsanet zekarias (Gubil) ነጻነት ዘካርያስ (ጉብል) - New Ethiopian Music 2020(Official Video) by Minew Shewa Tube 1 year ago 5 minutes, 19 seconds 9,201 views",Minew Shewa Entertainment,9201,9202,1
480,"Ethiopian Music : Tadi Y T Quta (ቁጣ) - New Ethiopian Music 2020(Official Video) by Minew Shewa Tube 1 year ago 4 minutes, 19 seconds 2,722 views",Minew Shewa Entertainment,2722,2740,18
481,"Zerf x Zerihun ዘርፍ ዘነበ ና ዘሪሁን ደምሴ (ጋይሌስ ዋጋይ ባዋ) - New Ethiopian Music 2020(Official Video) by Minew Shewa Tube 1 year ago 5 minutes, 31 seconds 6,404 views",Minew Shewa Entertainment,6404,6427,23
482,"Ak mehari & LiL Kebek ኤኬ መሃሪ እና ሊል ኬቤክ (ወጣት) - New Ethiopian Music 2020(Official Video) by Minew Shewa Tube 1 year ago 3 minutes, 9 seconds 4,831 views",Minew Shewa Entertainment,4831,4836,5
483,"Ethiopian Music : Abbu Qajeelchaa (Jijjirattee Maqaa) - New Ethiopian Music 2020(Official Video) by Minew Shewa Tube 1 year ago 7 minutes, 13 seconds 6,331 views",Minew Shewa Entertainment,6331,6350,19
484,"Ethiopian Music : Muday Trio (Yegna Qelem) ሙዳይ ትሪዮ (የኛ ቀለም) New Ethiopian Music 2020(Official Video) by Minew Shewa Tube 1 year ago 5 minutes, 58 seconds 18,368 views",Minew Shewa Entertainment,18368,18376,8
485,"Ethiopian Music : Solomon Tigabe (Zinaren) ሰለሞን ጥጋቤ (ዝናሬን) New Ethiopian Music 2020(Official Video) by Minew Shewa Tube 1 year ago 5 minutes, 44 seconds 1,325,588 views",Minew Shewa Entertainment,1325588,1329218,3630
486,"Ethiopian Music : Kidus (Liramedew) ቅዱስ (ልራመደው) - New Ethiopian Music 2020(Official Video) by Minew Shewa Tube 1 year ago 3 minutes, 26 seconds 4,500 views",Minew Shewa Entertainment,4500,4508,8
487,"Ethiopian Music: Habte Abraham (Merognal) ሀብቴ አብርሃም (መሮኛል) New Ethiopian Music 2020(Official Video) by Minew Shewa Tube 1 year ago 6 minutes, 6 seconds 351,592 views",Minew Shewa Entertainment,351592,351977,385
488,"Ethiopian Music : Lemlem Temesgen ለምለም ተመስገን - New Ethiopian Cover Music 2020 (Official Video) by Minew Shewa Tube 1 year ago 3 minutes, 44 seconds 8,824 views",Minew Shewa Entertainment,8824,8842,18
489,"Ethiopian Music : Gudaataa Magarsaa (Qeerroo Oromoo) - New Ethiopian Music 2020(Official Video) by Minew Shewa Tube 1 year ago 6 minutes, 50 seconds 5,007 views",Minew Shewa Entertainment,5007,5025,18
490,"Ethiopian Music : Naggaa Furaa (Itti Cabsi) - New Ethiopian Music 2020(Official Video) by Minew Shewa Tube 1 year ago 6 minutes, 19 seconds 7,097 views",Minew Shewa Entertainment,7097,7103,6
491,"Qilxuu Caakkisoo fi Waaritee Burqaa (Hoo Sokoree)  - New Ethiopian Music 2020(Official Video) by Minew Shewa Tube 1 year ago 4 minutes 4,647 views",Minew Shewa Entertainment,4647,4651,4
492,"Ethiopian Music : Serkalem Bogale ሰርካለም ቦጋለ (አባይ ቤትሕ እደር) New Ethiopian Music 2020(Official Video) by Minew Shewa Tube 1 year ago 6 minutes, 56 seconds 13,208 views",Minew Shewa Entertainment,13208,13220,12
493,"Ethiopian Music : Alemu Aysa (Ashame) አለሙ አይሳ (አሻሜ)  - New Ethiopian Music 2020(Official Video) by Minew Shewa Tube 1 year ago 5 minutes, 11 seconds 4,996 views",Minew Shewa Entertainment,4996,5003,7
494,"Ethiopian Music : Bitew ቢተው (የአርበኛው ስም አለ) - New Ethiopian Music 2020(Official Video) by Minew Shewa Tube 1 year ago 7 minutes, 41 seconds 3,790 views",Minew Shewa Entertainment,3790,3794,4
495,"Ethiopian Music : Kebede Bekele (Amma Jabaadhu) - New Ethiopian Music 2020(Official Video) by Minew Shewa Tube 1 year ago 5 minutes, 34 seconds 5,764 views",Minew Shewa Entertainment,5764,5780,16
496,"Ethiopian Music : Piipili Huseen (Hadhaa Dhiiraa) - New Ethiopian Music 2020(Official Video) by Minew Shewa Tube 1 year ago 4 minutes, 18 seconds 3,989 views",Minew Shewa Entertainment,3989,3993,4
497,"Ethiopian Music : Demissie Mulugeta (Hin Ciitu)  - New Ethiopian Music 2020(Official Video) by Minew Shewa Tube 1 year ago 5 minutes, 24 seconds 5,654 views",Minew Shewa Entertainment,5654,5663,9
498,"Ethiopian Music : Mengistu Geta (Bereda Ko) - New Ethiopian Music 2020(Official Video) by Minew Shewa Tube 1 year ago 3 minutes, 35 seconds 14,210 views",Minew Shewa Entertainment,14210,14219,9
499,"Abdulmalik Yusuf (Simanama) አብዱልማሊክ ዩሱፍ (ስማናማ) - New Ethiopian Music 2020(Official Video) by Minew Shewa Tube 1 year ago 3 minutes, 21 seconds 5,780 views",Minew Shewa Entertainment,5780,5782,2
500,"Ethiopian Music : Ziggy Zaga ዚጊ ዛጋ (ምሳሌ ፩) - New Ethiopian Music 2020(Official Video) by Minew Shewa Tube 1 year ago 4 minutes, 22 seconds 41,351 views",Minew Shewa Entertainment,41351,41384,33
501,"Ethiopian Music: Eyob Asebe (Yekibir Libs)እዮብ አሰበ (የክብር ልብስ)New Ethiopian Music 2020(Official Video) by Minew Shewa Tube 1 year ago 4 minutes, 28 seconds 101,512 views",Minew Shewa Entertainment,101512,101882,370
502,"Sintayehu Zenebe (Mimi) ስንታየሁ ዘነበ | ሚሚ (እነከሌ)  - New Ethiopian Music 2020(Official Video) by Minew Shewa Tube 1 year ago 5 minutes, 58 seconds 88,107 views",Minew Shewa Entertainment,88107,88241,134
503,"Ethiopian Music : Sima (Ene Esuan) ሲማ (እኔ እሷን) - New Ethiopian Music 2020(Official Video) by Minew Shewa Tube 1 year ago 5 minutes, 33 seconds 16,891 views",Minew Shewa Entertainment,16891,16929,38
504,"Ethiopian Music : Kasa (Sew Bicheger) ካሳ (ሰው ቢቸግር) - New Ethiopian Music 2020(Official Video) by Minew Shewa Tube 1 year ago 4 minutes, 9 seconds 10,655 views",Minew Shewa Entertainment,10655,10668,13
505,"Ethiopian Music : Eliyas Yemata ኤልያስ የማታ (አጃኢብ ነው ወሎስ) - New Ethiopian Music 2020(Official Video) by Minew Shewa Tube 1 year ago 4 minutes, 39 seconds 15,805 views",Minew Shewa Entertainment,15805,15812,7
506,"Ethiopian music : Ilias Kazali ""Abelshee"" New Ethiopian Harari Music 2020(Official Video) by Minew Shewa Tube 1 year ago 5 minutes, 10 seconds 14,581 views",Minew Shewa Entertainment,14581,14636,55
507,"Adane Gezahegn (Semash Wey) አዳነ ገዛኸኝ (ሰማሽ ወይ)  - New Ethiopian Music 2020(Official Video) by Minew Shewa Tube 1 year ago 4 minutes, 21 seconds 17,541 views",Minew Shewa Entertainment,17541,17569,28
508,"Ethiopian Music : Sisay Deneke (Hagere) ሲሳይ ደነቀ (ሀገሬ) - New Ethiopian Music 2020(Official Video) by Minew Shewa Tube 1 year ago 6 minutes, 4 seconds 12,659 views",Minew Shewa Entertainment,12659,12683,24
509,"Ethiopian Music : Anteye Mandefro አንትዬ ማንደፍሮ (መሽቷል እደሪ) - New Ethiopian Music 2020(Official Video) by Minew Shewa Tube 1 year ago 4 minutes, 17 seconds 7,773 views",Minew Shewa Entertainment,7773,7792,19
510,"Ethiopian Music : Zewde Tekalign (Emitdi) ዘውዴ ተካልኝ (እሚትዲ) - New Ethiopian Music 2020(Official Video) by Minew Shewa Tube 1 year ago 5 minutes, 10 seconds 8,313 views",Minew Shewa Entertainment,8313,8318,5
511,"Ethiopian Music : Debass Wassie (Shilela) ደባስ ዋሴ (ሽለላ) - New Ethiopian Music 2020(Official Video) by Minew Shewa Tube 1 year ago 6 minutes, 49 seconds 234,221 views",Minew Shewa Entertainment,234221,236767,2546
512,"Ethiopian Music : G junior ft. King (Erut) - New Ethiopian Music 2020(Official Video) by Minew Shewa Tube 1 year ago 3 minutes, 26 seconds 8,433 views",Minew Shewa Entertainment,8433,8455,22
513,"Ethiopian Music : Fasika Mileard ፋሲካ ሚልያርድ (ዘረኝነት) - New Ethiopian Music 2020(Official Video) by Minew Shewa Tube 1 year ago 6 minutes, 3 seconds 8,266 views",Minew Shewa Entertainment,8266,8270,4
514,"Fila Bella ft Eyerusalem (Salayesh) ፊላ ቤላ ft እየሩሳሌም (ሳላይሽ) New Ethiopian Music 2020(Official Video) by Minew Shewa Tube 1 year ago 4 minutes, 35 seconds 12,925 views",Minew Shewa Entertainment,12925,12932,7
515,"Melaku Aschale (Lib Liben) መላኩ አስቻለ (ልብ ልቤን) - New Ethiopian Music 2020(Official Video) by Minew Shewa Tube 1 year ago 6 minutes, 2 seconds 8,840 views",Minew Shewa Entertainment,8840,8859,19
516,"Ethiopian Music : Tsedey Ketema (Siinfaarsaa) - New Ethiopian Music 2020(Official Video) by Minew Shewa Tube 1 year ago 4 minutes, 27 seconds 5,329 views",Minew Shewa Entertainment,5329,5341,12
517,"Ethiopian Music : Elias Wonde ኤልያስ ወንዴ (አትንኩት) - New Ethiopian Music 2020(Official Video) by Minew Shewa Tube 1 year ago 6 minutes, 10 seconds 16,336 views",Minew Shewa Entertainment,16336,16341,5
518,"Ethiopian Music : Senait Feleke (Negeregn) ሰናይት ፈለቀ (ንገረኝ) New Ethiopian Music 2020(Official Video) by Minew Shewa Tube 1 year ago 4 minutes, 40 seconds 19,390 views",Minew Shewa Entertainment,19390,19421,31
519,"Ethiopian Music: Yared Sahele Abebe ያሬድ ሳህሌ አበበ (ፍቅር ይበልጣል) New Ethiopian Music 2020(Official Video) by Minew Shewa Tube 1 year ago 5 minutes, 43 seconds 15,737 views",Minew Shewa Entertainment,15737,15750,13
520,"Ethiopian Music : Rodas Workeye ሮዳስ ወርቅዬ (እንደአዲስ) - New Ethiopian Music 2020(Official Video) by Minew Shewa Tube 1 year ago 4 minutes, 37 seconds 33,044 views",Minew Shewa Entertainment,33044,33054,10
521,"Ethiopian Music : Dagy (Yet Hedesh New) ዳጊ (የት ሄደሽ ነው)  - New Ethiopian Music 2020(Official Video) by Minew Shewa Tube 1 year ago 2 minutes, 59 seconds 26,783 views",Minew Shewa Entertainment,26783,26888,105
522,"Ethiopian Music : Kaleab Teshome (Kemado) ቃልአብ ተሾመ (ከማዶ) - New Ethiopian Music 2020(Official Video) by Minew Shewa Tube 1 year ago 3 minutes, 51 seconds 15,074 views",Minew Shewa Entertainment,15074,15090,16
523,"Ethiopian Music : Tedy Getch (Helinaye) ቴዲ ጌች (ህሊናዬ) - New Ethiopian Music 2020(Official Video) by Minew Shewa Tube 1 year ago 4 minutes, 8 seconds 10,562 views",Minew Shewa Entertainment,10562,10579,17
524,"Ethiopian Music : Feseha Imagnew ፍስሃ እማኘው (ማን ይሆን) - New Ethiopian Music 2020(Official Video) by Minew Shewa Tube 1 year ago 6 minutes, 18 seconds 21,933 views",Minew Shewa Entertainment,21933,21957,24
525,"Ethiopian Music : Dagne Walle (Leblebew) ዳኜ ዋለ (ለብልበው) - New Ethiopian Music 2020(Official Video) by Minew Shewa Tube 1 year ago 6 minutes, 46 seconds 3,907,502 views",Minew Shewa Entertainment,3907502,3921161,13659
526,"Ethiopian Music : ፍሬው ገበየው (ሃያ ገላ) Frew Gebeyew (Haya Gela) New Ethiopian Music 2020(Official Video by Minew Shewa Tube 1 year ago 3 minutes, 39 seconds 6,183 views",Minew Shewa Entertainment,6183,6194,11
527,"Redeat Markos |Sewalem Zewdu ረድኤት ማርቆስ | ሰውአየው ዘውዱ (ታደገን) - New Ethiopian Music 2020(Official Video) by Minew Shewa Tube 1 year ago 4 minutes, 52 seconds 6,075 views",Minew Shewa Entertainment,6075,6084,9
528,"Sam Brown X Haymi Alex | ሳም ብራውን x ሃይሚ አሌክስ (ልቤ ለፍቅር) - New Ethiopian Music 2020(Official Video) by Minew Shewa Tube 1 year ago 4 minutes, 11 seconds 5,422 views",Minew Shewa Entertainment,5422,5438,16
529,"Ethiopian Music : Abebe Semeneh አበበ ስሜነህ (ሰናድሬ) - New Ethiopian Music 2020(Official Video) by Minew Shewa Tube 1 year ago 6 minutes, 14 seconds 174,370 views",Minew Shewa Entertainment,174370,174462,92
530,"Redeat Lake ረድኤት ላከ (ጉማ በለው) - New Ethiopian Music 2020(Official Video) by Minew Shewa Tube 1 year ago 6 minutes, 42 seconds 28,940 views",Minew Shewa Entertainment,28940,28988,48
531,"Ethiopian Music : Real OC ft Jay Walk (Sinorita)  - New Ethiopian Music 2020(Official Video) by Minew Shewa Tube 1 year ago 3 minutes, 26 seconds 17,095 views",Minew Shewa Entertainment,17095,17364,269
532,"Habtamu Tebeje ሀብታሙ ተበጀ - New Ethiopian Cover Music 2020(Official Video) by Minew Shewa Tube 1 year ago 4 minutes, 24 seconds 12,286 views",Minew Shewa Entertainment,12286,12370,84
533,"Mezin Berihun (Qulich Qulich) መዝን በርይሁን (ቁልጭ ቁልጭ) - New Ethiopian Music 2020(Official Video) by Minew Shewa Tube 1 year ago 6 minutes, 10 seconds 9,979 views",Minew Shewa Entertainment,9979,9986,7
534,"Ethiopian Music : Debassu Wassie (Hay Loga) ደባሱ ዋሴ (ሃይ ሎጋ) New Ethiopian Music 2020(Official Video) by Minew Shewa Tube 1 year ago 7 minutes, 18 seconds 9,724 views",Minew Shewa Entertainment,9724,9780,56
535,"Samon H/Mariam (Azmach) ሳምኦን ሃ/ማርያም (አዝማች) - New Ethiopian Music 2020(Official Video) by Minew Shewa Tube 1 year ago 4 minutes, 34 seconds 3,133 views",Minew Shewa Entertainment,3133,3137,4
536,"Ethiopian Music : Solomon James Browne (Jamming for Africa) New Ethiopian Music 2020(Official Video) by Minew Shewa Tube 1 year ago 4 minutes, 14 seconds 5,314 views",Minew Shewa Entertainment,5314,5328,14
537,"Ethiopian Music : Abinet Girma አብነት ግርማ (መኖር በሰላም ነው) - New Ethiopian Music 2020(Official Video) by Minew Shewa Tube 1 year ago 5 minutes, 54 seconds 160,421 views",Minew Shewa Entertainment,160421,161558,1137
538,"Menbere T/Selassie መንበረ ተ/ስላሴ (ከአዋሽ ምከር አባይ) - New Ethiopian Music 2020(Official Video) by Minew Shewa Tube 1 year ago 5 minutes, 2 seconds 8,060 views",Minew Shewa Entertainment,8060,8065,5
539,"Frew Gebeyew (Selam Selam) ፍሬው ገበየው (ሰላም ሰላም) - New Ethiopian Music 2020(Official Video) by Minew Shewa Tube 1 year ago 6 minutes, 19 seconds 4,555 views",Minew Shewa Entertainment,4555,4568,13
540,"Ethiopian Music: Wiz Natan ft Ras - Afro (Zora Zora) (ዞራ ዞራ)New Ethiopian Music 2020(Official Video) by Minew Shewa Tube 1 year ago 4 minutes, 16 seconds 67,982 views",Minew Shewa Entertainment,67982,68145,163
541,"Serkalem Belayneh (Goblalaye) ሰርካለም በላይነህ (ጎብላላዬ) - New Ethiopian Music 2020(Official Video) by Minew Shewa Tube 1 year ago 7 minutes, 45 seconds 10,894 views",Minew Shewa Entertainment,10894,10910,16
542,"Wendimagegn Alemu & Dani Mulat ወንድማገኝ አለሙ & ዳኒ ሙላት(ብዬ እሹሩሩ) New Ethiopian Music 2020(Official Video) by Minew Shewa Tube 1 year ago 3 minutes, 35 seconds 12,400 views",Minew Shewa Entertainment,12400,12403,3
543,"Ethiopian Music : Netsanet Adamu ነፃነት አዳሙ (እንክት) - New Ethiopian Music 2020(Official Video) by Minew Shewa Tube 1 year ago 5 minutes, 49 seconds 10,015 views",Minew Shewa Entertainment,10015,10021,6
544,"Haimanot Sisay (Ante Gobez) ሃይማኖት ሲሳይ (አንተ ጎበዝ) - New Ethiopian Music 2020(Official Video) by Minew Shewa Tube 1 year ago 4 minutes, 45 seconds 19,493 views",Minew Shewa Entertainment,19493,19579,86
545,"Ethiopian Music : Amanuel Sineshaw አማኑኤል ስንሻው (ጎበዝ ተነጋገር) - New Ethiopian Music 2020(Official Video) by Minew Shewa Tube 1 year ago 4 minutes, 57 seconds 11,574 views",Minew Shewa Entertainment,11574,11580,6
546,"Ethiopian Music: Chali G/Yohanes (Tesaron) ቻሊ ገ/ዮሓንስ (ተሳሮን) New Ethiopian Music 2020(Official Video) by Minew Shewa Tube 1 year ago 5 minutes, 40 seconds 6,107 views",Minew Shewa Entertainment,6107,6123,16
547,"Yohannes Hamelmal (Yohan)  ዮሐንስ ሐመልማል (ዮሐን) New Ethiopian Music 2020(Official Cover Song) by Minew Shewa Tube 1 year ago 7 minutes, 3 seconds 12,067 views",Minew Shewa Entertainment,12067,12099,32
548,"Ethiopian Music : Mesfin Olma መስፍን ኦልማ (ይበቃል) - New Ethiopian Music 2020(Official Video) by Minew Shewa Tube 1 year ago 4 minutes, 47 seconds 9,859 views",Minew Shewa Entertainment,9859,9867,8
549,"ደባስ ዋሴ (ዙማየን ወሎ) Debas Wassie (Zumayen Wello) - New Ethiopian Music 2020(Official Video) by Minew Shewa Tube 1 year ago 5 minutes, 27 seconds 8,496 views",Minew Shewa Entertainment,8496,8532,36
550,"Kira Last & Dagi Dane (Asakalew ) ኪራ & ዳጊ (አሳካለው) - New Ethiopian Music 2020(Official Video) by Minew Shewa Tube 1 year ago 3 minutes, 41 seconds 6,429 views",Minew Shewa Entertainment,6429,6452,23
551,"Ethiopian Music : Getish Mamo ጌትሽ ማሞ (ስምሽ ነው የተረፈኝ) - New Ethiopian Music 2020(Official Video) by Minew Shewa Tube 1 year ago 3 minutes, 56 seconds 272,787 views",Minew Shewa Entertainment,272787,273106,319
552,"Bereket Darik (Zare Alkugn) በረከት ዳሪክ (ዛሬ አልኩኝ) New Ethiopian Music 2020(Official Video) by Minew Shewa Tube 1 year ago 4 minutes, 4 seconds 7,511 views",Minew Shewa Entertainment,7511,7527,16
553,"Ethiopian Music : Yared Mekonen (Ethiopia) ያሬድ መኮንን (ኢትዮጵያ) New Ethiopian Music 2020(Official Video) by Minew Shewa Tube 1 year ago 5 minutes, 6 seconds 8,613 views",Minew Shewa Entertainment,8613,8617,4
554,"Ethiopian Music : Ayenew Negash አየነው ነጋሽ (የሀበሻ ብሌኑ) - New Ethiopian Music 2020(Official Video) by Minew Shewa Tube 1 year ago 4 minutes, 39 seconds 7,401 views",Minew Shewa Entertainment,7401,7408,7
555,"Ethiopian Music : Solomon Nigussie ሰለሞን ንጉሴ (እንቢ ካለ)  - New Ethiopian Music 2020(Official Video) by Minew Shewa Tube 1 year ago 6 minutes, 18 seconds 443,251 views",Minew Shewa Entertainment,443251,444739,1488
556,"Serkalem Bogale (Ethiopia Serawit) ሰርካለም ቦጋለ (የኢትዮጵያ ሰራዊት) New Ethiopian Music 2020(Official Video) by Minew Shewa Tube 1 year ago 6 minutes, 8 seconds 17,149 views",Minew Shewa Entertainment,17149,17177,28
557,"Ethiopian Music : Anteneh Asfaw አንተነህ አስፋው (በትብብር)  - New Ethiopian Music 2020(Official Video) by Minew Shewa Tube 1 year ago 5 minutes, 10 seconds 6,659 views",Minew Shewa Entertainment,6659,6667,8
558,"Ethiopian Music: Workneh Assefa ወርቅነህ አሰፋ (ተው ቂም አይዘራ በምድሬ) New Ethiopian Music 2020(Official Video) by Minew Shewa Tube 1 year ago 6 minutes, 26 seconds 6,886 views",Minew Shewa Entertainment,6886,6896,10
559,"Ethiopian Music : Abay yale Tana (አባይ ያለ ጣና)- New Ethiopian Music 2020(Official Video) by Minew Shewa Tube 1 year ago 7 minutes, 4 seconds 10,263 views",Minew Shewa Entertainment,10263,10276,13
560,"Ethiopian Music: Tewodros Mengesha ቴዎድሮስ መንገሻ (ድርድር አናውቅም) New Ethiopian Music 2020(Official Video) by Minew Shewa Tube 1 year ago 4 minutes, 45 seconds 50,911 views",Minew Shewa Entertainment,50911,50922,11
561,"Ethiopian Music : Abinet Girma አብነት ግርማ (መኖር በሰላም ነው) - New Ethiopian Music 2020(Official Video) by Minew Shewa Tube 1 year ago 6 minutes, 8 seconds 87,424 views",Minew Shewa Entertainment,87424,87528,104
562,"Yohanes Fenta (Gonder Hagere) ዮሐንስ ፈንታ (ጎንደር ሀገሬ)  - New Ethiopian Music 2020(Official Video) by Minew Shewa Tube 1 year ago 5 minutes, 16 seconds 8,633 views",Minew Shewa Entertainment,8633,8654,21
563,"Ethiopian Music : Abebe Tadele (Neyilign) አበበ ታደለ (ነይልኝ) - New Ethiopian Music 2020(Official Video) by Minew Shewa Tube 1 year ago 5 minutes, 58 seconds 11,973 views",Minew Shewa Entertainment,11973,11980,7
564,"Ethiopian Music : Dabalee Girmaa (Yaa Kololee Koo)  - New Ethiopian Music 2020(Official Video) by Minew Shewa Tube 1 year ago 8 minutes, 23 seconds 12,797 views",Minew Shewa Entertainment,12797,12821,24
565,"Ethiopian Music : Wujira Musa (Negerign) ዉጅራ ሙሳ (ንገሪኝ) - New Ethiopian Music 2020(Official Video) by Minew Shewa Tube 1 year ago 5 minutes, 15 seconds 6,452 views",Minew Shewa Entertainment,6452,6462,10
566,"Ethiopian Music : Saron Damte (Zayaday) ሳሮን ዳምጤ (ዛያዳይ) - New Ethiopian Music 2020(Official Video) by Minew Shewa Tube 1 year ago 4 minutes, 6 seconds 11,697 views",Minew Shewa Entertainment,11697,11716,19
567,"Ethiopian Music : Getawun Chirfa (Alaattii) - New Ethiopian Music 2020(Official Video) by Minew Shewa Tube 1 year ago 4 minutes, 47 seconds 11,321 views",Minew Shewa Entertainment,11321,11323,2
568,"Ethiopian Music : Sahlu Wolde (Gura) ሳህሉ ወልዴ (ጉራ) - New Ethiopian Music 2020(Official Video) by Minew Shewa Tube 1 year ago 4 minutes, 25 seconds 7,675 views",Minew Shewa Entertainment,7675,7679,4
569,"Ethiopian Music :  - Mesfin Bekele መስፍን በቀለ ""ሚስጥር ነው"" New Ethiopian Music 2020(Official Video) by Minew Shewa Tube 1 year ago 6 minutes, 33 seconds 1,246,669 views",Minew Shewa Entertainment,1246669,1248425,1756
570,"Ethiopian Music : Fraol Tesfaye (Leki) ፍራኦል ተስፋዬ (ለኪ) - New Ethiopian Music 2020(Official Video) by Minew Shewa Tube 1 year ago 5 minutes, 29 seconds 13,177 views",Minew Shewa Entertainment,13177,13187,10
571,"Ethiopian Music : Gelila Tesfaye ገሊላ ተስፋዬ (ሳወራው ውስጤን) - New Ethiopian Music 2020(Official Video) by Minew Shewa Tube 1 year ago 4 minutes, 58 seconds 13,658 views",Minew Shewa Entertainment,13658,13668,10
572,"Ethiopian Music : Habtamu Tebeje ሀብታሙ ተበጀ (ዉጣ በለው)  - New Ethiopian Music 2020(Official Video) by Minew Shewa Tube 1 year ago 6 minutes, 44 seconds 41,899 views",Minew Shewa Entertainment,41899,42037,138
573,"Ethiopian Music : Betty Ejig (Yenen Yahel) ቤቲ እጅግ (የኔን ያህል) New Ethiopian Music 2020(Official Video) by Minew Shewa Tube 1 year ago 5 minutes, 10 seconds 989,941 views",Minew Shewa Entertainment,989941,996192,6251
574,"Ethiopian Music : Kifle Eshetu (Africa) ክፍሌ እሸቱ (አፍሪካ) - New Ethiopian Music 2020(Official Video) by Minew Shewa Tube 1 year ago 5 minutes, 14 seconds 4,508 views",Minew Shewa Entertainment,4508,4516,8
575,"Emebet Getinet (Yehulum Hager) እመቤት ጌትነት (የሁሉም ሀገር) - New Ethiopian Music 2020(Official Video) by Minew Shewa Tube 1 year ago 5 minutes, 56 seconds 24,277 views",Minew Shewa Entertainment,24277,24302,25
576,"Comedian Markos ኮሜድያን ማርቆስ (በሀገር ቀልድ አይነፋም) - New Ethiopian Music 2020(Official Video) by Minew Shewa Tube 1 year ago 6 minutes, 59 seconds 917,578 views",Minew Shewa Entertainment,917578,921060,3482
577,"Bethelhem Ashenafi (Kalkenagn) ቤተልሄም አሸናፊ (ካልቀናኝ) - New Ethiopian Music 2020(Official Video) by Minew Shewa Tube 1 year ago 5 minutes, 27 seconds 130,306 views",Minew Shewa Entertainment,130306,130657,351
578,"Ethiopian Music : Abyot Dagnachew አብዮት ዳኛቸው (ህልም አየሁ) - New Ethiopian Music 2020(Official Video) by Minew Shewa Tube 1 year ago 5 minutes, 47 seconds 9,211 views",Minew Shewa Entertainment,9211,9219,8
579,"Ethiopian Music: ሆ ሄ Big E x Kirrra x Burrra (Yakob) New Ethiopian Music 2020(Official Video) by Minew Shewa Tube 1 year ago 3 minutes, 30 seconds 5,761 views",Minew Shewa Entertainment,5761,5768,7
580,"Daniel | Arsama | Yared | Semon | Meron (Abay)  - New Ethiopian Music 2020(Official Video) by Minew Shewa Tube 1 year ago 5 minutes, 22 seconds 7,971 views",Minew Shewa Entertainment,7971,7982,11
581,"Ethiopian Music : Debas Wassie ደባስ ዋሴ (የዘንድሮ ፍቅር)  - New Ethiopian Music 2020(Official Video) by Minew Shewa Tube 1 year ago 4 minutes, 24 seconds 6,833 views",Minew Shewa Entertainment,6833,6854,21
582,"Ethiopian Music : Daribee Girmaa (Gadhiissaa) - New Ethiopian Music 2020(Official Video) by Minew Shewa Tube 1 year ago 5 minutes, 31 seconds 6,826 views",Minew Shewa Entertainment,6826,6846,20
583,"Ethiopian Music : Birhanu Werqe (Lihidma) ብርሃኑ ወርቄ (ልሂድም) - New Ethiopian Music 2020(Official Video) by Minew Shewa Tube 1 year ago 6 minutes, 37 seconds 11,683 views",Minew Shewa Entertainment,11683,11741,58
584,"Ethiopian Music : Ake Mulatu (Yitamenal) አኬ ሙላቱ (ይታመናል) - New Ethiopian Music 2020(Official Video) by Minew Shewa Tube 1 year ago 6 minutes, 26 seconds 5,613 views",Minew Shewa Entertainment,5613,5619,6
585,"Ethiopian Music : Tamrat Tolosa (Abay Eshururu) - New Ethiopian Music 2020(Official Video) by Minew Shewa Tube 1 year ago 4 minutes, 47 seconds 4,533 views",Minew Shewa Entertainment,4533,4554,21
586,"Ethiopian Music : Gosa Wasanu (Zinaara Too) - New Ethiopian Music 2020(Official Video) by Minew Shewa Tube 1 year ago 5 minutes, 29 seconds 6,530 views",Minew Shewa Entertainment,6530,6543,13
587,"Ethiopian Music :Mastewal Admasu (Nekakagn) ማስተዋል አድማሱ(ነካካኝ)New Ethiopian Music 2020(Official Video) by Minew Shewa Tube 1 year ago 6 minutes, 13 seconds 62,093 views",Minew Shewa Entertainment,62093,62216,123
588,"Tamirat Girma (Wetete Nesh)  ታምራት ግርማ (ወተቴ ነሽ) - New Ethiopian Music 2020(Official Video) by Minew Shewa Tube 1 year ago 5 minutes, 7 seconds 6,236 views",Minew Shewa Entertainment,6236,6247,11
589,"Tewudros Kebede (Selam Selam)  ቴዎድሮስ ከበደ (ሰላም ሰላም)  - New Ethiopian Music 2020(Official Video) by Minew Shewa Tube 1 year ago 5 minutes, 6 seconds 2,351 views",Minew Shewa Entertainment,2351,2358,7
590,"Ethiopian Music : Beza Kulu (Tibeb) ቤዛ ኩሉ (ጥበብ) - New Ethiopian Music 2020(Official Video) by Minew Shewa Tube 1 year ago 5 minutes, 53 seconds 4,626 views",Minew Shewa Entertainment,4626,4628,2
591,"Ethiopian Music : Aman | Metaferya | Shumete (Simboo Kiyya) New Ethiopian Music 2020(Official Video) by Minew Shewa Tube 1 year ago 5 minutes, 16 seconds 6,516 views",Minew Shewa Entertainment,6516,6526,10
592,"Ethiopian Music : Bazu Man (Ye Dejen Lej) ባዙ ማን ""የእንጂባራ""  - New Ethiopian Music 2020(Official Video) by Minew Shewa Tube 1 year ago 4 minutes, 40 seconds 40,881 views",Minew Shewa Entertainment,40881,40920,39
593,"Ethiopian Music : Mateb (Zalit) ማተብ (ዛሊት) - New Ethiopian Music 2020(Official Video) by Minew Shewa Tube 1 year ago 4 minutes, 4 seconds 255,503 views",Minew Shewa Entertainment,255503,256120,617
594,"Ethiopian Music : Million Abebe (Arada) ሚልዮን አበበ (አራዳ) - New Ethiopian Music 2020(Official Video) by Minew Shewa Tube 1 year ago 4 minutes, 27 seconds 21,225 views",Minew Shewa Entertainment,21225,21252,27
595,"Ethiopian Music : Ayu Girma (Shebelalem) አዩ ግርማ (ሸበላለም) - New Ethiopian Music 2020(Official Video) by Minew Shewa Tube 1 year ago 4 minutes, 47 seconds 1,982,026 views",Minew Shewa Entertainment,1982026,1989315,7289
596,"Simachew Bedlu (Afalgugn) ስማቸው በድሉ (አፋልጉኝ) - New Ethiopian Music 2020(Official Video) by Minew Shewa Tube 1 year ago 5 minutes, 52 seconds 10,903 views",Minew Shewa Entertainment,10903,10906,3
597,"Yosef | Mekdes | Samuel ዮሴፍ | መቅደስ | ሳሙኤል (እጅህን ዘርጋ)- New Ethiopian Music 2020(Official Video) by Minew Shewa Tube 1 year ago 4 minutes, 35 seconds 2,774 views",Minew Shewa Entertainment,2774,2775,1
598,"Ethiopian Music : Negussie Bogale (Emeye) ንጉሤ ቦጋለ (እምዬ) - New Ethiopian Music 2020(Official Video) by Minew Shewa Tube 1 year ago 5 minutes, 8 seconds 19,374 views",Minew Shewa Entertainment,19374,19381,7
599,"Ethiopian Music : Hana Derebe (Jalo) ሃና ደረበ (ጃሎ) - New Ethiopian Music 2020(Official Video) by Minew Shewa Tube 1 year ago 5 minutes, 18 seconds 11,964 views",Minew Shewa Entertainment,11964,11981,17
600,"Ethiopian Music : Sintayhu Kifle (Abay) ስንታየሁ ክፍሌ (አባይ) - New Ethiopian Music 2020(Official Video) by Minew Shewa Tube 1 year ago 1 minute, 40 seconds 4,881 views",Minew Shewa Entertainment,4881,4890,9
601,"Ethiopian Music : Habiiba Huseen (Hinjiru Hinjedhin) - New Ethiopian Music 2020(Official Video) by Minew Shewa Tube 1 year ago 6 minutes, 25 seconds 1,963 views",Minew Shewa Entertainment,1963,1963,0
602,"Alamuu Gaaddisaa (Gar Gar Nun Baasan)  - New Ethiopian Music 2020(Official Video) by Minew Shewa Tube 1 year ago 7 minutes, 9 seconds 6,181 views",Minew Shewa Entertainment,6181,6184,3
603,"Ethiopian Music : Yared Afework ያሬድ አፈወርቅ New Ethiopian Cover Music 2020(Official Video) by Minew Shewa Tube 1 year ago 5 minutes, 47 seconds 428,264 views",Minew Shewa Entertainment,428264,428868,604
604,"Anhedonic - Gatmanda (Jules mugisha) - New Ethiopian Music 2020(Official Video) by Minew Shewa Tube 1 year ago 3 minutes, 43 seconds 3,224 views",Minew Shewa Entertainment,3224,3224,0
605,"Adane Tesfaye (Yene Mar) አዳነ ተስፋዬ (የኔ ማር) - New Ethiopian Music 2020(Official Video) by Minew Shewa Tube 1 year ago 4 minutes, 13 seconds 6,032 views",Minew Shewa Entertainment,6032,6043,11
606,"Seltanu Kassie (Scenario) ስልጣኑ ካሴ (ሴናሪዮ) - New Ethiopian Music 2020(Official Video) by Minew Shewa Tube 1 year ago 7 minutes, 40 seconds 5,450 views",Minew Shewa Entertainment,5450,5478,28
607,"Nardos Astawesegne (Balgame) ናርዶስ አስታወሰኝ (ባለጋሜ) - New Ethiopian Music 2020(Official Video) by Minew Shewa Tube 1 year ago 4 minutes, 22 seconds 5,049 views",Minew Shewa Entertainment,5049,5055,6
608,"Yohannes Diriba (Yene Alem) ዮሐንስ ድሪባ (የኔ ዓለም) - New Ethiopian Music 2020(Official Video) by Minew Shewa Tube 1 year ago 4 minutes, 47 seconds 11,412 views",Minew Shewa Entertainment,11412,11437,25
609,"Debas Wase (Libe Wede Gonder) ደባስ ዋሴ (ልቤ ወደ ጎንደር) - New Ethiopian Music 2020(Official Video) by Minew Shewa Tube 1 year ago 5 minutes 4,952 views",Minew Shewa Entertainment,4952,4972,20
610,"Ethiopian Music : Subeda Halid (Ododo) ሱቤዳ ኻሊድ (ኦዶዶ)  - New Ethiopian Music 2020(Official Video) by Minew Shewa Tube 1 year ago 6 minutes, 18 seconds 6,438 views",Minew Shewa Entertainment,6438,6439,1
611,"Yohannes Tafese (Ewekilign) ዮሐንስ ታፈሰ (እወቂልኝ) - New Ethiopian Music 2020(Official Video) by Minew Shewa Tube 1 year ago 4 minutes, 46 seconds 3,282 views",Minew Shewa Entertainment,3282,3290,8
612,"Yohannes Tafese (Mihertu) ዮሐንስ ታፈሰ (ምሕረቱ) - New Ethiopian Music 2020(Official Video) by Minew Shewa Tube 1 year ago 4 minutes, 40 seconds 3,209 views",Minew Shewa Entertainment,3209,3210,1
613,"Ethiopian Music : Misganaw Andarge ምስጋናው አንዳርጌ (ስሚኝ እማ) - New Ethiopian Music 2020(Official Video) by Minew Shewa Tube 1 year ago 6 minutes, 21 seconds 29,321 views",Minew Shewa Entertainment,29321,29366,45
614,"Elshaday Aynalem ft HBK ኤልሻዳይ አይናለም ft HBK (እኔ አልቻልኩም) - New Ethiopian Music 2020(Official Video) by Minew Shewa Tube 1 year ago 4 minutes, 38 seconds 5,937 views",Minew Shewa Entertainment,5937,5957,20
615,"Ethiopian Music : Yohannes Feleke Neberkugn (ነበርኩኝ) - New Ethiopian Music 2020(Official Video) by Minew Shewa Tube 1 year ago 5 minutes, 2 seconds 7,621 views",Minew Shewa Entertainment,7621,7627,6
616,"Ethiopian Music : Shegye Shegitu ሸግዬ ሸጊቱ Meek1One New Ethiopian Music 2020(Official Video) by Minew Shewa Tube 1 year ago 6 minutes, 12 seconds 8,359,157 views",Minew Shewa Entertainment,8359157,8419230,60073
617,"Ethiopian Music : Ze Da (Boom)  - New Ethiopian Music 2020(Official Video) by Minew Shewa Tube 1 year ago 4 minutes, 15 seconds 8,452 views",Minew Shewa Entertainment,8452,8467,15
618,"Ethiopian Music : Esubalew Ayane (Hayarki) እሱባለው አያኔ (ሃያርኪ) New Ethiopian Music 2020(Official Video) by Minew Shewa Tube 1 year ago 4 minutes 7,799 views",Minew Shewa Entertainment,7799,7813,14
619,"Ethiopian Music: Yohannes Tafese (Nurilign) ዮሐንስ ታፈሰ (ኑሪልኝ) New Ethiopian Music 2020(Official Video) by Minew Shewa Tube 1 year ago 5 minutes, 38 seconds 2,605 views",Minew Shewa Entertainment,2605,2613,8
620,"Yohannes Tafesse (Bereket) ዮሐንስ ታፈሰ (በረከት) - New Ethiopian Music 2020(Official Video) by Minew Shewa Tube 1 year ago 5 minutes, 23 seconds 1,965 views",Minew Shewa Entertainment,1965,1968,3
621,"Ethiopian Music : AK The Afrikan Kid ft. Lily Siya (ሲያ) - New Ethiopian Music 2020(Official Video) by Minew Shewa Tube 1 year ago 4 minutes, 52 seconds 35,646 views",Minew Shewa Entertainment,35646,35694,48
622,"Ethiopian Music: Tilahun | Eshetu | Sisay | Feben (ችላ አንበል) New Ethiopian Music 2020(Official Video) by Minew Shewa Tube 1 year ago 4 minutes, 23 seconds 7,752 views",Minew Shewa Entertainment,7752,7756,4
623,"Ethiopian Music: Yohannes Kidane (Sitotaye) ዮሐንስ ኪዳኔ (ስጦታዬ) New Ethiopian Music 2020(Official Video) by Minew Shewa Tube 1 year ago 4 minutes, 18 seconds 8,787 views",Minew Shewa Entertainment,8787,8799,12
624,"Ethiopian Music : Metadel Abebaw መታደል አበባው (እስኪ በል) - New Ethiopian Music 2020(Official Video) by Minew Shewa Tube 1 year ago 6 minutes, 18 seconds 13,835 views",Minew Shewa Entertainment,13835,13878,43
625,"Ethiopian Music : Abraham Ayele አብርሃም አየለ (ያበጠው ይፈንዳ) - New Ethiopian Music 2020(Official Video) by Minew Shewa Tube 1 year ago 5 minutes, 57 seconds 13,280 views",Minew Shewa Entertainment,13280,13304,24
626,"Ethiopian Music : Hana Mistre (Atyebign) ሃና ሚስጥረ (አትይብኝ)  - New Ethiopian Music 2020(Official Video) by Minew Shewa Tube 1 year ago 5 minutes, 12 seconds 19,839 views",Minew Shewa Entertainment,19839,19857,18
627,"Hana Damte ሃና ዳምጤ (Cover Songs)  - New Ethiopian Music 2020(Official Video) by Minew Shewa Tube 1 year ago 4 minutes, 39 seconds 66,791 views",Minew Shewa Entertainment,66791,67222,431
628,"Ethiopian Music : Addis Walelegn አዲስ ዋለልኝ (እቅፍ ድግፍ) - New Ethiopian Music 2020(Official Video) by Minew Shewa Tube 1 year ago 5 minutes, 20 seconds 20,019 views",Minew Shewa Entertainment,20019,20149,130
629,"Tariku Sisay (Addis Ababa) ታሪኩ ሲሣይ (አዲስ አበባ) - New Ethiopian Music 2020(Official Video) by Minew Shewa Tube 1 year ago 4 minutes, 51 seconds 6,042 views",Minew Shewa Entertainment,6042,6043,1
630,"Ethiopian Music : Ayele Teka (Agaz Abo) አየለ ተካ (አጋዝ አቦ) - New Ethiopian Music 2020(Official Video) by Minew Shewa Tube 1 year ago 5 minutes, 49 seconds 7,226 views",Minew Shewa Entertainment,7226,7281,55
631,"Geyo-Mar (Tanan Entadeg) ግዮ-ማር (ጣናን እንታደግ) - New Ethiopian Music 2020(Official Video) by Minew Shewa Tube 1 year ago 6 minutes, 16 seconds 9,607 views",Minew Shewa Entertainment,9607,9607,0
632,"Ethiopian Music : Ashenafi Tesfaw አሸናፊ ተስፋው (የማይበገር) - New Ethiopian Music 2020(Official Video) by Minew Shewa Tube 1 year ago 5 minutes, 29 seconds 30,300 views",Minew Shewa Entertainment,30300,30334,34
633,"Amanuel Sineshaw  ""melegna negn""  አማኑኤል ስንሻው (መለኛ ነኝ) New Ethiopian Music 2020(Official Video) by Minew Shewa Tube 1 year ago 4 minutes, 14 seconds 13,397 views",Minew Shewa Entertainment,13397,13404,7
634,"Ethiopian Music : Abebe Alemu አበበ አለሙ (እማጵያ) - New Ethiopian Music 2020(Official Video) by Minew Shewa Tube 1 year ago 4 minutes, 48 seconds 8,981 views",Minew Shewa Entertainment,8981,9002,21
635,"Ethiopian Music : Zinash Wube (Manen New) ዝናሽ ውቤ (ማንን ነው) - New Ethiopian Music 2020(Official Video) by Minew Shewa Tube 1 year ago 6 minutes, 23 seconds 7,400,617 views",Minew Shewa Entertainment,7400617,7447757,47140
636,"Ethiopian Music: Genet | Abich | German | Ayele (ደግሞ እንኖራለን)New Ethiopian Music 2020(Official Video) by Minew Shewa Tube 1 year ago 4 minutes, 59 seconds 4,932 views",Minew Shewa Entertainment,4932,4933,1
637,"TEDDY AFRO (Demo Be Abay) ደሞ በአባይ ቼ በለው X STAR Remix EDM- New Ethiopian Music 2020(Official Video) by Minew Shewa Tube 1 year ago 3 minutes, 34 seconds 13,550 views",Minew Shewa Entertainment,13550,13557,7
638,"Ethiopian Music : Woyyeessaa Dhaqqabaa (Oromiyaa Tiyya) - New Ethiopian Music 2020(Official Video) by Minew Shewa Tube 1 year ago 5 minutes, 41 seconds 4,191 views",Minew Shewa Entertainment,4191,4198,7
639,"Ethiopian Music : Mr Kaza (Blatenaw) ካዛ (ብላቴናው)  - New Ethiopian Music 2020(Official Video) by Minew Shewa Tube 1 year ago 4 minutes, 15 seconds 3,960 views",Minew Shewa Entertainment,3960,4024,64
640,"Habtamu Kasayu | Sintayehu Kifle ሀብታሙ ካሳዩ | ስንታየሁ ክፍሌ (ምስጋና)New Ethiopian Music 2020(Official Video) by Minew Shewa Tube 1 year ago 4 minutes, 38 seconds 5,810 views",Minew Shewa Entertainment,5810,5817,7
641,"Abraham Ayalew (Weyn Alem) አብርሃም አያሌው (ወይን ዓለም) New Ethiopian Music 2020(Official Video) by Minew Shewa Tube 1 year ago 4 minutes, 50 seconds 14,835 views",Minew Shewa Entertainment,14835,14890,55
642,"Ethiopian music : Fikadu Girma ፍቃዱግርማ (አራዳ እንዲህ ነው) Live performance with Belema Band 2020. by Minew Shewa Tube 1 year ago 5 minutes, 28 seconds 6,416 views",Minew Shewa Entertainment,6416,6419,3
643,"Sintayehu Teklu (Abay Belu) ስንታየሁ ተክሉ (አባይ በሉ) - New Ethiopian Music 2020(Official Video) by Minew Shewa Tube 1 year ago 5 minutes, 27 seconds 5,557 views",Minew Shewa Entertainment,5557,5560,3
644,"Senayit Engda ሰናይት እንግዳ (ምስጋና ይድረስው) - New Ethiopian Music 2020(Official Video) by Minew Shewa Tube 1 year ago 8 minutes, 5 seconds 15,085 views",Minew Shewa Entertainment,15085,15157,72
645,"Ethiopian Music : Pap Kane (Atagachign) አታጋጪኝ - New Ethiopian Music 2020(Official Video) by Minew Shewa Tube 1 year ago 3 minutes, 51 seconds 9,852 views",Minew Shewa Entertainment,9852,9892,40
646,"Ashenafi Abraham Atsedemariam Mulugeta Mahder  ሁሉም ያልፋል  - New Ethiopian Music 2020(Official Video) by Minew Shewa Tube 1 year ago 5 minutes, 14 seconds 7,292 views",Minew Shewa Entertainment,7292,7298,6
647,"Ethiopian Music : Kedir Seid ከድር ሰኢድ (አባይ ለወገኔ)  - New Ethiopian Music 2020(Official Video) by Minew Shewa Tube 1 year ago 6 minutes, 54 seconds 5,621 views",Minew Shewa Entertainment,5621,5630,9
648,"Ethiopian Music : Mekonen Siyamregn መኮንን ሲያምረኝ (ቋንቋ) - New Ethiopian Music 2020(Official Video) by Minew Shewa Tube 1 year ago 6 minutes, 22 seconds 4,769 views",Minew Shewa Entertainment,4769,4769,0
649,"Ethiopian Music :Getish Mamo (Zufanu New)ጌትሽ ማሞ (ዙፋኑ ነው መሰል)New Ethiopian Music 2020(Official Video) by Minew Shewa Tube 1 year ago 7 minutes, 31 seconds 1,736,929 views",Minew Shewa Entertainment,1736929,1739329,2400
650,"Ethiopian Music : Munit Seid (Gize) ሙኒት ሰኢድ (ጊዜ)  - New Ethiopian Music 2020(Official Video) by Minew Shewa Tube 1 year ago 3 minutes, 47 seconds 20,216 views",Minew Shewa Entertainment,20216,20273,57
651,"Leul Tug ft. Gildo Kassa (Diro) ልኡል ከጊልዶ ጋር ""ድሮ"" New Ethiopian Music 2020(Official Video) by Minew Shewa Tube 1 year ago 4 minutes, 4 seconds 900,075 views",Minew Shewa Entertainment,900075,903960,3885
652,"Zekariyas Mekonen (Anchi Yene) ዘካርያስ መኮንን (አንቺ የኔ) - New Ethiopian Music 2020(Official Video) by Minew Shewa Tube 1 year ago 4 minutes, 23 seconds 12,036 views",Minew Shewa Entertainment,12036,12048,12
653,"Ethiopian Music : Tsehay Amare (Lebenu) ጸሀይ አማረ (ለበኑ) - New Ethiopian Music 2020(Official Video) by Minew Shewa Tube 1 year ago 5 minutes, 39 seconds 12,243 views",Minew Shewa Entertainment,12243,12273,30
654,"Serkalem Belayneh ሰርካለም በላይነህ (እምዬ ሀገሬ) - New Ethiopian Music 2020(Official Video) by Minew Shewa Tube 1 year ago 3 minutes, 5 seconds 9,037 views",Minew Shewa Entertainment,9037,9044,7
655,"Surafel Melkamu (Bicha Menor) ሱራፈል መልካሙ (ብቻ መኖር) - New Ethiopian Music 2020(Official Video) by Minew Shewa Tube 1 year ago 6 minutes, 4 seconds 5,734 views",Minew Shewa Entertainment,5734,5738,4
656,"Ethiopian Music : Workneh Hailu ወርቅነህ ሀይሉ (ድም'ማት) - New Ethiopian Music 2020(Official Video) by Minew Shewa Tube 1 year ago 3 minutes, 27 seconds 5,130 views",Minew Shewa Entertainment,5130,5140,10
657,"Eyerusalem Daniel (Na Shegeye) እየሩሳሌም ዳንኤል (ና ሸግዬ) - New Ethiopian Music 2020(Official Video) by Minew Shewa Tube 1 year ago 5 minutes, 1 second 9,901 views",Minew Shewa Entertainment,9901,9914,13
658,"Ethiopian Music: Andy Amare ""ኢትዮጵያ  ትቀጥላለች"" New Ethiopian Music 2020(Official Video) by Minew Shewa Tube 1 year ago 5 minutes, 36 seconds 15,542 views",Minew Shewa Entertainment,15542,15557,15
659,"Ethiopian Music : Yohanes Gutema ዮሐንስ ጉተማ (ፈራሁሽ) - New Ethiopian Music 2020(Official Video) by Minew Shewa Tube 1 year ago 5 minutes, 5 seconds 10,750 views",Minew Shewa Entertainment,10750,10764,14
660,"Ethiopian Music : Madaanit Qorichoo (Birroolee) - New Ethiopian Music 2020(Official Video) by Minew Shewa Tube 1 year ago 5 minutes, 4 seconds 4,150 views",Minew Shewa Entertainment,4150,4152,2
661,"Ethiopian Music : Million Hailu ሚልዮን ኃይሉ (ግጥምካ) - New Ethiopian Music 2020(Official Video) by Minew Shewa Tube 1 year ago 3 minutes, 22 seconds 1,185 views",Minew Shewa Entertainment,1185,1188,3
662,"ልዩ የመስቀል በዓል አከባበር በዋሽንግተን ዲሲ | Meskel Special Program in Washington DC 2020. by Minew Shewa Tube 1 year ago 8 minutes, 17 seconds 2,395 views",Minew Shewa Entertainment,2395,2396,1
663,"Abraham Maru ልዩ የመስቀል በዓል አከባበር በዋሽንግተን ዲሲ | Meskel Special Program in Washington DC 2020. by Minew Shewa Tube 1 year ago 5 minutes, 51 seconds 7,688 views",Minew Shewa Entertainment,7688,7695,7
664,"Fikadu Girma Yaz Yaz ልዩ የመስቀል በዓል አከባበር በዋሽንግተን ዲሲ | Meskel Special Program from Washington DC 2020. by Minew Shewa Tube 1 year ago 7 minutes, 32 seconds 4,907 views",Minew Shewa Entertainment,4907,4922,15
665,"Tsehay Amare ልዩ የመስቀል በዓል አከባበር በዋሽንግተን ዲሲ | Meskel Special Program in Washington DC 2020. by Minew Shewa Tube 1 year ago 9 minutes, 49 seconds 17,927 views",Minew Shewa Entertainment,17927,17934,7
666,"Nigusu Tamirat ልዩ የመስቀል በዓል አከባበር በዋሽንግተን ዲሲ | Meskel Special Program in Washington DC 2020. by Minew Shewa Tube 1 year ago 5 minutes, 40 seconds 12,351 views",Minew Shewa Entertainment,12351,12386,35
667,"Aragaw Alemu ልዩ የመስቀል በዓል አከባበር በዋሽንግተን ዲሲ | Meskel Special Program in Washington DC 2020. by Minew Shewa Tube 1 year ago 6 minutes, 59 seconds 4,981 views",Minew Shewa Entertainment,4981,4988,7
668,"Fikadu Girma ፍቃዱ ግርማ ልዩ የመስቀል በዓል አከባበር በዋሽንግተን ዲሲ | Meskel Special Program from Washington DC 2020. by Minew Shewa Tube 1 year ago 5 minutes, 40 seconds 5,399 views",Minew Shewa Entertainment,5399,5412,13
669,"Ethiopian Music: Abrham Ante ""Giffatana""  New Ethiopian Music 2020(Official Video) by Minew Shewa Tube 1 year ago 4 minutes, 47 seconds 8,246 views",Minew Shewa Entertainment,8246,8279,33
670,"Ethiopian Music : Kiyyaa Ashabbir (Fardatu Caala) - New Ethiopian Music 2020(Official Video) by Minew Shewa Tube 1 year ago 6 minutes, 5 seconds 1,728 views",Minew Shewa Entertainment,1728,1731,3
671,"Ethiopian Music : Yohannes Tafesse ዮሐንስ ታፈሰ (እስከመቼ) - New Ethiopian Music 2020(Official Video) by Minew Shewa Tube 1 year ago 4 minutes, 34 seconds 1,814 views",Minew Shewa Entertainment,1814,1819,5
672,"Yohannes Tafesse (Ewedshalew) ዮሐንስ ታፈሰ (እወድሻለው) - New Ethiopian Music 2020(Official Video) by Minew Shewa Tube 1 year ago 5 minutes, 19 seconds 2,659 views",Minew Shewa Entertainment,2659,2664,5
673,"Yohannes Tafesse (Eneshenef) ዮሐንስ ታፈሰ (እንሸነፍ)  - New Ethiopian Music 2020(Official Video) by Minew Shewa Tube 1 year ago 4 minutes, 54 seconds 2,205 views",Minew Shewa Entertainment,2205,2209,4
674,"Yohannes Tafesse (Dashen Lay) ዮሐንስ ታፈሰ (ዳሸን ላይ) - New Ethiopian Music 2020(Official Video) by Minew Shewa Tube 1 year ago 5 minutes, 39 seconds 3,293 views",Minew Shewa Entertainment,3293,3300,7
675,"Ethiopian Music :Mikyas Chernet (Ziyoze) ሚክያስ ቸርነት (ዚዮዜ) - New Ethiopian Music 2020(Official Video) by Minew Shewa Tube 1 year ago 5 minutes, 27 seconds 2,976,770 views",Minew Shewa Entertainment,2976770,3000075,23305
676,"Ethiopian Music: Solomon Demele (Amaraye) ሰሎሞን ደምሌ (አማራዬ) New Ethiopian Music 2020(Official Video) by Minew Shewa Tube 1 year ago 6 minutes, 58 seconds 311,686 views",Minew Shewa Entertainment,311686,313885,2199
677,"Ethiopian Music: Belay Melesse በላይ መልሴ (ቅበጪልኝ) - New Ethiopian Music 2020(Official Video) by Minew Shewa Tube 1 year ago 5 minutes, 42 seconds 7,949 views",Minew Shewa Entertainment,7949,7954,5
678,"Ethiopian Music :  - Liya Solomon ሊያ ሰለሞን (አናምንም በነገር) New Ethiopian Music 2020(Official Video) by Minew Shewa Tube 1 year ago 5 minutes, 6 seconds 13,995 views",Minew Shewa Entertainment,13995,14006,11
679,"Ethiopian Music : Kaleab Mulugeta ቃልአብ ሙሉጌታ (ምንም ሳይኖር) - New Ethiopian Music 2020(Official Video) by Minew Shewa Tube 1 year ago 4 minutes, 8 seconds 3,548,993 views",Minew Shewa Entertainment,3548993,3574759,25766
680,"Ethiopian Music : Ablex (Enanu) አብሌክስ (እናኑ) - New Ethiopian Music 2020(Official Video) by Minew Shewa Tube 1 year ago 4 minutes, 46 seconds 3,028,719 views",Minew Shewa Entertainment,3028719,3038153,9434
681,"Abebe Mekwanint (Anchi Enate) አበበ መኳንንት (አንቺ እናቴ)  - New Ethiopian Music 2020(Official Video) by Minew Shewa Tube 1 year ago 4 minutes, 30 seconds 5,190 views",Minew Shewa Entertainment,5190,5202,12
682,"Resom Teka ርዕሶም ተካ (እኔ አባይ ነኝ) - New Ethiopian Music 2020(Official Video) by Minew Shewa Tube 1 year ago 6 minutes, 16 seconds 7,684 views",Minew Shewa Entertainment,7684,7694,10
683,"Ethiopian Music : Jaalaleee Daadhii (Bilillee Oromo)  - New Ethiopian Music 2020(Official Video) by Minew Shewa Tube 1 year ago 5 minutes, 33 seconds 6,246 views",Minew Shewa Entertainment,6246,6255,9
684,"Temesgen Meketaw ተመስገን መከታው (ተይ በልዋት) - New Ethiopian Music 2020(Official Video) by Minew Shewa Tube 1 year ago 5 minutes, 8 seconds 4,584 views",Minew Shewa Entertainment,4584,4594,10
685,"Tariku Kassahun (Selame Nesh) ታሪኩ ካሳሁን (ሰላሜ ነሽ) - New Ethiopian Music 2020(Official Video) by Minew Shewa Tube 1 year ago 5 minutes, 6 seconds 5,991 views",Minew Shewa Entertainment,5991,5992,1
686,"Ethiopian Music : Yohhanes Sisye (Matebua) ዬሃንስ ሲሳይ ""ማተቧ"" New Ethiopian Music 2020(Official Video) by Minew Shewa Tube 1 year ago 5 minutes, 41 seconds 14,601 views",Minew Shewa Entertainment,14601,14624,23
687,"Ethiopian Music : Memhru Chamo መምህሩ ጫሞ (ዮ ማስቃላ) - New Ethiopian Music 2020(Official Video) by Minew Shewa Tube 1 year ago 5 minutes, 27 seconds 4,485 views",Minew Shewa Entertainment,4485,4517,32
688,"Ethiopian Music : Yakob Ferede (Nuribet) ያቆብ ፈረደ (ኑሪበት) - New Ethiopian Music 2020(Official Video) by Minew Shewa Tube 1 year ago 4 minutes, 18 seconds 5,249 views",Minew Shewa Entertainment,5249,5250,1
689,"Ethiopian Music : Yabu JC Adera Aleben (አደራ አለብን)  - New Ethiopian Music 2020(Official Video) by Minew Shewa Tube 1 year ago 5 minutes, 32 seconds 9,560 views",Minew Shewa Entertainment,9560,9569,9
690,"Ethiopian Music : Tsadiku Wetera ፃዲቁ ወተራ (ታረቀን) - New Ethiopian Music 2020(Official Video) by Minew Shewa Tube 1 year ago 5 minutes, 11 seconds 2,811 views",Minew Shewa Entertainment,2811,2815,4
691,"Abeje T/Hawariat (endet keremachu) አበጀ ተ/ሐዋርያት (እንዴት ከረማችሁ) New Ethiopian Music 2020(Official Video by Minew Shewa Tube 1 year ago 4 minutes, 27 seconds 11,964 views",Minew Shewa Entertainment,11964,11993,29
692,"Tesfu Delta (Tasfelegignalesh) ተስፉ ዴልታ ""ታስፈልጊኛለስሽ"" New Ethiopian Music 2020(Official Video) by Minew Shewa Tube 1 year ago 5 minutes, 52 seconds 38,090 views",Minew Shewa Entertainment,38090,38154,64
693,"Kinfe Gebru (Maregena) ክንፈ ገብሩ (ማረገና) - New Ethiopian Music 2020(Official Video) by Minew Shewa Tube 1 year ago 6 minutes, 18 seconds 45,653 views",Minew Shewa Entertainment,45653,46467,814
694,"Amare Andwalem አማረ አንዱዓለም (አውዳመት)  - New Ethiopian Music 2020(Official Video) by Minew Shewa Tube 1 year ago 5 minutes, 31 seconds 5,061 views",Minew Shewa Entertainment,5061,5069,8
695,"Ethiopian Music : Syco David (Ere Tey) ሳይኮ ዴቪድ (ኧረ ተይ) - New Ethiopian Music 2020(Official Video) by Minew Shewa Tube 1 year ago 4 minutes, 32 seconds 65,444 views",Minew Shewa Entertainment,65444,65666,222
696,"Ethiopian music: Kidist Habtamu ቅድስት ሀብታሙ (በባዶ እግር)  - New Ethiopian Music 2020(Official Video) by Minew Shewa Tube 1 year ago 4 minutes, 56 seconds 6,593 views",Minew Shewa Entertainment,6593,6598,5
697,"Binyam Getaye ቢንያም ጌትዬ (ተጽሰፈሻል)  - New Ethiopian Music 2020(Official Video) by Minew Shewa Tube 1 year ago 4 minutes, 14 seconds 7,261 views",Minew Shewa Entertainment,7261,7271,10
698,"ComedianTomas x Ahadu (Banana) ኮሜድያን ቶማስ x አሃዱ (ባናና)  - New Ethiopian Music 2020(Official Video) by Minew Shewa Tube 1 year ago 4 minutes, 4 seconds 1,524,957 views",Minew Shewa Entertainment,1524957,1527737,2780
699,"Ethiopian Music : Habtamu Abebe (Nieba) ሀብታሙ አበበ (ንእባ) - New Ethiopian Music 2020(Official Video) by Minew Shewa Tube 1 year ago 5 minutes, 42 seconds 8,196 views",Minew Shewa Entertainment,8196,8200,4
700,"Ethiopian Music : Yohanes Tafesse (Maleda) ዮሐንስ ታፈሰ (ማለዳ) - New Ethiopian Music 2020(Official Video) by Minew Shewa Tube 1 year ago 3 minutes, 51 seconds 3,137 views",Minew Shewa Entertainment,3137,3138,1
701,"Ethiopian Music : Yohanes Tafesse (Filega) ዮሐንስ ታፈሰ (ፍለጋ) - New Ethiopian Music 2020(Official Video) by Minew Shewa Tube 1 year ago 5 minutes, 28 seconds 3,401 views",Minew Shewa Entertainment,3401,3408,7
702,"Ethiopian Music : Banchiamlak Getnet ባንቺአምላክ ጌትነት (ወላንሳዬ) New Ethiopian Music 2020(Official Video) by Minew Shewa Tube 1 year ago 6 minutes, 59 seconds 1,683,145 views",Minew Shewa Entertainment,1683145,1702032,18887
703,"Ethiopian Music : Zebenay Mareye ዘበናይ ማርዬ (ገላግለኝ) - New Ethiopian Music 2020(Official Video) by Minew Shewa Tube 1 year ago 3 minutes, 48 seconds 5,586 views",Minew Shewa Entertainment,5586,5592,6
704,"Yohanes Tafesse ዮሐንስ ታፈሰ (የሰመመን ፍቅር) - New Ethiopian Music 2020(Official Video) by Minew Shewa Tube 1 year ago 4 minutes, 20 seconds 2,727 views",Minew Shewa Entertainment,2727,2729,2
705,"Ethiopian Music: Yohanes Tafesse (Yinegal) ዮሐንስ ታፈሰ (ይነጋል) New Ethiopian Music 2020(Official Video) by Minew Shewa Tube 1 year ago 4 minutes, 53 seconds 3,278 views",Minew Shewa Entertainment,3278,3282,4
706,"Ethiopian Music : Gedion Daniel (Rasen) ጌድዮን ዳንኤል (ራሴን) New Ethiopian Music 2020(Official Video) by Minew Shewa Tube 1 year ago 5 minutes, 51 seconds 301,571 views",Minew Shewa Entertainment,301571,301956,385
707,"Ethiopian Music : Beki B (Mewded) ቤኪ ቢ (መውደድ) - New Ethiopian Music 2020(Official Video) by Minew Shewa Tube 1 year ago 4 minutes, 14 seconds 15,248 views",Minew Shewa Entertainment,15248,15333,85
708,"Habtamu Asferaw ሀብታሙ አስፈራው (ነይ በሏት) - New Ethiopian Music 2020(Official Video) by Minew Shewa Tube 1 year ago 5 minutes, 32 seconds 4,401 views",Minew Shewa Entertainment,4401,4418,17
709,"Ethiopian Music : Michael Tesfaye ሚካኤል ተስፋዬ (ምነው ባደረገኝ)  - New Ethiopian Music 2020(Official Video) by Minew Shewa Tube 1 year ago 4 minutes, 20 seconds 6,087 views",Minew Shewa Entertainment,6087,6097,10
710,"Brook Shibabaw (Lanchi Honwal) ብሩክ ሽባባው (ላንቺ ሆኗል) - New Ethiopian Music 2020(Official Video) by Minew Shewa Tube 1 year ago 4 minutes, 51 seconds 6,784 views",Minew Shewa Entertainment,6784,6799,15
711,"Yidersal Emyamrew ይደርሳል እምያምረው (የኢትዮጵያ ሞሰብ)  - New Ethiopian Music 2020(Official Video) by Minew Shewa Tube 1 year ago 5 minutes, 39 seconds 4,560 views",Minew Shewa Entertainment,4560,4564,4
712,"Ethiopian Music : Tigabu Nigus ጥጋቡ ንጉስ (ምን ልግዛልሽ)  - New Ethiopian Music 2020(Official Video) by Minew Shewa Tube 1 year ago 5 minutes, 23 seconds 12,474 views",Minew Shewa Entertainment,12474,12487,13
713,"Yotoreal (Ethiopia Yehulum) ዮቶርኤል (ኢትዮጵያ  የሁሉም) by Minew Shewa Tube 1 year ago 6 minutes, 56 seconds 4,906 views",Minew Shewa Entertainment,4906,4914,8
714,"Ethiopian Music : Mez Mariyé ""Alive"" New Ethiopian Music 2020(Official Video) by Minew Shewa Tube 1 year ago 3 minutes, 44 seconds 136,821 views",Minew Shewa Entertainment,136821,137320,499
715,"Tagesegn Tegene (Dororay) ታገሰኝ ተገኔ (ዶሮሬ)  - New Ethiopian Music 2020(Official Video) by Minew Shewa Tube 1 year ago 3 minutes, 18 seconds 13,557 views",Minew Shewa Entertainment,13557,13643,86
716,"Ethiopian Music : Tamrat Cholto ታምራት ጮልቶ (ኢሲ አዮ) New Ethiopian Music 2020(Official Video) by Minew Shewa Tube 1 year ago 5 minutes, 17 seconds 3,746 views",Minew Shewa Entertainment,3746,3746,0
717,"Ethiopian Music : ከፋለ ሞላ (በዓውዳመት) Kefale Molla (Bawudamet) New Ethiopian Music 2020(Official Video) by Minew Shewa Tube 1 year ago 5 minutes, 42 seconds 34,096 views",Minew Shewa Entertainment,34096,34107,11
718,"Ethiopian Music :Derese Bisrat (Mena) ደረሰ ብስራት (ሜና) New Ethiopian Music 2020(Official Video) by Minew Shewa Tube 1 year ago 5 minutes, 20 seconds 5,683 views",Minew Shewa Entertainment,5683,5688,5
719,"Ethiopian Music : Akiya Daniel አኪያ ዳንኤል (እጃችሁን ታጠቡ) New Ethiopian Music 2020(Official Video) by Minew Shewa Tube 1 year ago 1 minute, 41 seconds 3,724 views",Minew Shewa Entertainment,3724,3730,6
720,"Ethiopian Music : Ras Biruk Barky ""ባርኪ"" ኢትዬጵያዊ (Ethiopiawi) New Ethiopian Music 2020(Official Video) by Minew Shewa Tube 1 year ago 5 minutes, 15 seconds 5,598 views",Minew Shewa Entertainment,5598,5602,4
721,"Ethiopian Music :  Tilahun Elfineh ጥላሁን እልፍነህ ""አባይ ለኢትዮጵያ"" New Ethiopian Music 2020(Official Video) by Minew Shewa Tube 1 year ago 5 minutes, 16 seconds 13,339 views",Minew Shewa Entertainment,13339,13351,12
722,"Ethiopian Music : Tesfaye Belay (Awdamet) ተስፋዬ በላይ (አውዳመት) New Ethiopian Music 2020(Official Video) by Minew Shewa Tube 1 year ago 4 minutes, 50 seconds 21,290 views",Minew Shewa Entertainment,21290,21298,8
723,"Ethiopian Music: Yetem Beyene (Feker Aleme)የትም በየነ (ፍቅር አለሜ)New Ethiopian Music 2020(Official Video) by Minew Shewa Tube 1 year ago 5 minutes, 31 seconds 16,954 views",Minew Shewa Entertainment,16954,16983,29
724,"Ethiopian Music : Seble Z/Michael ሰብለ ዘሚካኤል (ሳቄ ይቀድመኛል) - New Ethiopian Music 2020(Official Video) by Minew Shewa Tube 1 year ago 5 minutes, 36 seconds 4,656 views",Minew Shewa Entertainment,4656,4665,9
725,"Ethiopian Music :Girum Shimelis (Ethiopiaye)ግሩም ሽመልስ (ኢትዮጵያዬ)New Ethiopian Music 2020(Official Video by Minew Shewa Tube 1 year ago 3 minutes, 46 seconds 9,932 views",Minew Shewa Entertainment,9932,9939,7
726,"Ethiopian Music: Selina Fantsh ""Yene"" ሰሊና ፋንትሽ ""የኔ"" New Ethiopian Music 2020(Official Video) by Minew Shewa Tube 1 year ago 4 minutes 5,668 views",Minew Shewa Entertainment,5668,5695,27
727,"Moaaggeet Ma'aazaa Hiikmaa Umar Naafil (Ogeessa Fayyaa) - New Ethiopian Music 2020(Official Video) by Minew Shewa Tube 1 year ago 5 minutes, 55 seconds 3,534 views",Minew Shewa Entertainment,3534,3560,26
728,"Samson Getachew X Milen Seyum ሳምሶን ጌታቸው X ሚለን ስዩም (አለን አሻራ) New Ethiopian Music 2020(Official Video) by Minew Shewa Tube 1 year ago 5 minutes, 15 seconds 3,574 views",Minew Shewa Entertainment,3574,3578,4
729,"Daniel -Wendmagegn - Haregwoin - Henok - Berhanu ""Ahun New"" New Ethiopian Music 2020(Official Video) by Minew Shewa Tube 1 year ago 4 minutes, 58 seconds 4,722 views",Minew Shewa Entertainment,4722,4723,1
730,"Victoria & Chguraph ""Agatami"" ቪክቶሪያ እና ጭጉራፍ ""ኣጋጣሚ"" New Ethiopian Music 2020(Official Video) · by Minew Shewa Tube 1 year ago 4 minutes, 56 seconds 36,585 views",Minew Shewa Entertainment,36585,36614,29
731,"Ethiopian Music : Dagi D | Beka | ዳጊ ዲ ""በቃ"" New Ethiopian Music 2020(Official Video) by Minew Shewa Tube 1 year ago 4 minutes, 20 seconds 15,032,170 views",Minew Shewa Entertainment,15032170,15106389,74219
732,"Ethiopian Music : Shambel Belayneh ሻምበል በላይነህ (እሳት የፈተነው) - New Ethiopian Music 2020(Official Video) by Minew Shewa Tube 1 year ago 7 minutes, 34 seconds 870,780 views",Minew Shewa Entertainment,870780,873079,2299
733,"Ethiopian Music : Burik | Mamaye | ቡሪክ ""ማማዬ"" New Ethiopian Music 2020(Official Video) by Minew Shewa Tube 1 year ago 3 minutes, 56 seconds 3,364,452 views",Minew Shewa Entertainment,3364452,3383161,18709
734,"Ethiopian Music : - Alexz Zee ""ባለሁበት"" New Ethiopian Music 2020(Official Video) by Minew Shewa Tube 1 year ago 5 minutes, 17 seconds 56,775 views",Minew Shewa Entertainment,56775,57041,266
735,"Ethiopian Music : Girum Asfaw (Mela Mela) ግሩም አስፋው ""መላ መላ"" New Ethiopian Music 2020(Official Video) by Minew Shewa Tube 1 year ago 4 minutes, 44 seconds 51,097 views",Minew Shewa Entertainment,51097,51116,19
736,"Ethiopian Music: Har'a moo (Cover Song by Muday Trio)  - New Ethiopian Music 2020(Official Video) by Minew Shewa Tube 1 year ago 4 minutes, 44 seconds 5,588 views",Minew Shewa Entertainment,5588,5597,9
737,"Ethiopian Music : Amare Seqo (Beni Beni) አማረ ሴቆ (ቤኒ ቤኒ) - New Ethiopian Music 2020(Official Video) by Minew Shewa Tube 1 year ago 5 minutes, 12 seconds 8,418 views",Minew Shewa Entertainment,8418,8432,14
738,"Ethiopian Music : ZeTadyan ዘታድያን (ቼ ፈረሴ ደሴ) - New Ethiopian Music 2020(Official Video) by Minew Shewa Tube 1 year ago 5 minutes, 24 seconds 8,264 views",Minew Shewa Entertainment,8264,8269,5
739,"Ethiopian Music :Yasin Yesuf (Yamarali) ያሲን ዮሱፍ (ሳሚ)""ያምራል""New Ethiopian Music 2020(Official Video) by Minew Shewa Tube 1 year ago 5 minutes, 19 seconds 35,115 views",Minew Shewa Entertainment,35115,35139,24
740,"Ethiopian Music :  - Betty Ke (Gebalgne) ቤቲ ኪ ""ግባልኝ"" New Ethiopian Music 2020(Official Video) by Minew Shewa Tube 1 year ago 4 minutes, 45 seconds 386,138 views",Minew Shewa Entertainment,386138,387312,1174
741,"Ethiopian Music : ሜሮን ደምሴ ተስፋ በክሩ ዘላለም እሸቱ “የኔ ነው”  New Ethiopian Music 2020(Official Video) by Minew Shewa Tube 1 year ago 4 minutes, 45 seconds 9,780 views",Minew Shewa Entertainment,9780,9797,17
742,"Tadele Bekele & Nardos Tesfaw ታደለ በቀለና ናርዶስ ተስፋው ""በስልክ አነጋግሪኝ"" New Ethiopian Music 2020 (Video) by Minew Shewa Tube 1 year ago 7 minutes, 9 seconds 168,946 views",Minew Shewa Entertainment,168946,170035,1089
743,"Ethiopian Music : Dagy Mamaye New Ethiopian Music 2020(Official Video) by Minew Shewa Tube 1 year ago 3 minutes, 17 seconds 84,686 views",Minew Shewa Entertainment,84686,84978,292
744,"Ethiopian Music: Nati Abraham  ናቲ አብርሀም ""እያሳጣሽኝ ነው"" New Ethiopian Music 2020(Official Video) by Minew Shewa Tube 1 year ago 4 minutes, 14 seconds 147,868 views",Minew Shewa Entertainment,147868,148397,529
745,"Ethiopian Music : Kanni Yohannes ""የመጨረሻው ዘመን""  New Ethiopian Music 2020(Official Video) by Minew Shewa Tube 1 year ago 3 minutes, 57 seconds 16,191 views",Minew Shewa Entertainment,16191,16258,67
746,"Ethiopian music : Menegesetu Geta መንግስቱ ጌታ ""ፍቅር መንኩሳ""  New Ethiopian Music 2020(Official Video) by Minew Shewa Tube 1 year ago 5 minutes, 28 seconds 8,998 views",Minew Shewa Entertainment,8998,9007,9
747,"Ethiopian music : ሮሃን ሰይፉ ""ሸሪ ባሁሽ ሊላ"" Rohan Seyifu New Ethiopian Music 2020(Official Video) by Minew Shewa Tube 1 year ago 5 minutes, 48 seconds 7,545 views",Minew Shewa Entertainment,7545,7556,11
748,"Abel Tesfaye (Hulum Yeleyal) አቤል ተስፋዬ (ሁሉም ይለያል)  - New Ethiopian Music 2020(Official Video) by Minew Shewa Tube 1 year ago 6 minutes, 17 seconds 4,639 views",Minew Shewa Entertainment,4639,4663,24
749,"Tigist Abera | Enyew Metaya ትግስት አበራ | እንየው መታያ (እናልፈዋለን)  New Ethiopian Music 2020(Official Video) by Minew Shewa Tube 1 year ago 4 minutes, 51 seconds 11,484 views",Minew Shewa Entertainment,11484,11485,1
750,"Ethiopian Music : Merikokeb Sime (Wered) መሪኮከብ ስሜ (ወረድ)  - New Ethiopian Music 2020(Official Video) by Minew Shewa Tube 1 year ago 4 minutes, 40 seconds 14,242 views",Minew Shewa Entertainment,14242,14319,77
751,"Ethiopian Music : Henok Berhanu (Degemigna) ሄኖክ ብርሃኑ (ድገሚኛ) New Ethiopian Music 2020(Official Video) by Minew Shewa Tube 1 year ago 5 minutes, 36 seconds 24,372 views",Minew Shewa Entertainment,24372,24429,57
752,"Awush Yekifiyaf አውሽ የኪፍያፍ (ቻቻ) - ዶክመንተሪ ቅኔ - New Ethiopian Music 2020(Official Video) by Minew Shewa Tube 1 year ago 12 minutes, 22 seconds 4,078 views",Minew Shewa Entertainment,4078,4079,1
753,"Yonas Sewnet ዮናስ ሰውነት (እንኑር በፍቅር) - New Ethiopian Music 2020(Official Video) by Minew Shewa Tube 1 year ago 5 minutes, 11 seconds 6,282 views",Minew Shewa Entertainment,6282,6287,5
754,"Ethiopian music : Ephrem Altaseb - Tiz Yelgnal (ትዝ ይለኛል) - New Ethiopian Music 2020 (Official Video) by Minew Shewa Tube 1 year ago 5 minutes, 35 seconds 151,678 views",Minew Shewa Entertainment,151678,153663,1985
755,"Ethiopian Music : Markon ""Serkalem"" ማርኮን(ሰርክአለሜ) New Ethiopian Music 2020(Official Video) by Minew Shewa Tube 1 year ago 4 minutes, 33 seconds 24,488 views",Minew Shewa Entertainment,24488,24546,58
756,"Ethiopian Music : Dagi Man ዳጊ ማን (ንዒ ናባይ) - New Ethiopian Music 2020(Official Video) by Minew Shewa Tube 1 year ago 5 minutes, 8 seconds 32,443 views",Minew Shewa Entertainment,32443,32515,72
757,"Ethiopian Music : Yared Shumet ያሬድ ሹመት (በሕይወት መንገድ ላይ) - New Ethiopian Music 2020(Official Video) by Minew Shewa Tube 1 year ago 5 minutes, 28 seconds 3,123 views",Minew Shewa Entertainment,3123,3125,2
758,"Ethiopian Music: Birhanu Taye  (Lomi | Lomii) ብርሃኑ ታዬ (ሎሚ) New Ethiopian Music 2020(Official Video) by Minew Shewa Tube 1 year ago 4 minutes, 57 seconds 49,271 views",Minew Shewa Entertainment,49271,49497,226
759,"Ethiopian Music : Yared Asrat ያሬድ አስራት (ኢትዮጵያችን ኑሪ) - New Ethiopian Music 2020(Official Video) by Minew Shewa Tube 1 year ago 6 minutes, 6 seconds 4,789 views",Minew Shewa Entertainment,4789,4791,2
760,"Selam Mulat | Yitages Baye ሰላም ሙላት | ይታገስ ባየ(ለነገ እንጠንቀቅ ዛሬ) New Ethiopian Music 2020(Official Video) by Minew Shewa Tube 1 year ago 4 minutes, 37 seconds 4,466 views",Minew Shewa Entertainment,4466,4467,1
761,"Zeariaya X Abi X HaddinQo (Birr) ዘአርያ X አቢ X ሐዲንቆ (ብር) - New Ethiopian Music 2020(Official Video) by Minew Shewa Tube 1 year ago 4 minutes, 45 seconds 7,350 views",Minew Shewa Entertainment,7350,7369,19
762,"Samrawit Dawit X Little Chain (Anten Tilobgnal) አንተን ጥሎብኛል -New Ethiopian Music 2020(Official Video) by Minew Shewa Tube 1 year ago 3 minutes, 50 seconds 8,072 views",Minew Shewa Entertainment,8072,8081,9
763,"Noss Da Boss X Jay Matic (Taste of Addis)  - New Ethiopian Music 2020(Official Video) by Minew Shewa Tube 1 year ago 5 minutes, 9 seconds 6,150 views",Minew Shewa Entertainment,6150,6154,4
764,"Hidota Boloshe (Wegene) ሂዶታ ቦሎሼ (ወገኔ) - New Ethiopian Music 2020(Official Video) by Minew Shewa Tube 1 year ago 4 minutes, 46 seconds 5,073 views",Minew Shewa Entertainment,5073,5076,3
765,"Nebil and Yonathan ነቢል እና ዮናታን (ብቻ ምኑን ልንገርህ) - New Ethiopian Music 2020(Official Video) by Minew Shewa Tube 1 year ago 4 minutes, 3 seconds 5,383 views",Minew Shewa Entertainment,5383,5391,8
766,"Alex yam k x kepa gk (Temechegn) ተመቸኝ  - New Ethiopian Music 2020(Official Video) by Minew Shewa Tube 1 year ago 4 minutes, 52 seconds 11,440 views",Minew Shewa Entertainment,11440,11453,13
767,"Kume Damtew (Seken Anakem) ቁሜ ዳምጠው (ስቀን አናውቅም)  - New Ethiopian Music 2020(Official Video) by Minew Shewa Tube 1 year ago 5 minutes, 55 seconds 9,728 views",Minew Shewa Entertainment,9728,9736,8
768,"Abdi Ahmed (Niqa) አብዲ አህመድ (ንቃ)  - New Ethiopian Music 2020(Official Video) by Minew Shewa Tube 1 year ago 6 minutes, 26 seconds 7,701 views",Minew Shewa Entertainment,7701,7710,9
769,"Aregahegn Worash (Yafekeresh ayine) አረጋኸኝ ወራሽ (ያፈቀረሽ አይኔ) - New Ethiopian Music 2020(Official Video) by Minew Shewa Tube 1 year ago 7 minutes, 34 seconds 2,313,760 views",Minew Shewa Entertainment,2313760,2358549,44789
770,"Yafet & Meseret ያፌት እና መሰረት (ሰላም በርቀት)  - New Ethiopian Music 2020(Official Video) by Minew Shewa Tube 1 year ago 5 minutes, 26 seconds 13,522 views",Minew Shewa Entertainment,13522,13530,8
771,"Feta & Mekbib ፈታ እና መክብብ (ንጤፕነ ኮሮና) - New Ethiopian Music 2020(Official Video) by Minew Shewa Tube 1 year ago 5 minutes, 54 seconds 7,331 views",Minew Shewa Entertainment,7331,7376,45
772,"Samuel Masresha (Zem Alelem) ሳሙኤል ማስረሻ (ዝም አልልም) - New Ethiopian Music 2020(Official Video) by Minew Shewa Tube 1 year ago 2 minutes, 41 seconds 6,225 views",Minew Shewa Entertainment,6225,6226,1
773,"Muday Trio (Lomi Bewerewer) ሙዳይ ትሪዮ (ሎሚ ብወረውር) - New Ethiopian Music 2020(Official Video) by Minew Shewa Tube 1 year ago 4 minutes, 26 seconds 13,234 views",Minew Shewa Entertainment,13234,13275,41
774,"Ethiopian Music : Tufaa Guraaraa (Hurgufi Keessaa) - New Ethiopian Music 2020(Official Video) by Minew Shewa Tube 1 year ago 5 minutes, 35 seconds 27,425 views",Minew Shewa Entertainment,27425,27710,285
775,"Endegena Amare (Yewenze Lij) እንደገና አማረ (የወንዜ ልጅ) - New Ethiopian Music 2020(Official Video) by Minew Shewa Tube 1 year ago 5 minutes, 23 seconds 9,994 views",Minew Shewa Entertainment,9994,10002,8
776,"Bitew Dawit ቢተው ዳዊት (እርቀ ሰላም)  - New Ethiopian Music 2020(Official Video) by Minew Shewa Tube 1 year ago 3 minutes, 44 seconds 5,723 views",Minew Shewa Entertainment,5723,5729,6
777,"ማህደር ፍቃዱ እና ቢንያም ካሳ (የሳረሁ ኧቸንቴ) - New Ethiopian Music 2020(Official Video) by Minew Shewa Tube 1 year ago 4 minutes, 36 seconds 6,026 views",Minew Shewa Entertainment,6026,6031,5
778,"Zeariaya ft Dagi (Wubet) ዛሪያ ft ዳጊ (ዉበት) - New Ethiopian Music 2020(Official Video) by Minew Shewa Tube 1 year ago 4 minutes, 43 seconds 5,749 views",Minew Shewa Entertainment,5749,5749,0
779,"Jon Varto & Rique Pantoja (No Matter Where You Are)- New Ethiopian Music 2020(Official Video) by Minew Shewa Tube 1 year ago 4 minutes, 7 seconds 4,195 views",Minew Shewa Entertainment,4195,4197,2
780,"Abinet | Yeshi | Simeon አብነት የሺ ስምኦን (አንድ እንሁን) - New Ethiopian Music 2020(Official Video) by Minew Shewa Tube 1 year ago 4 minutes, 58 seconds 27,300 views",Minew Shewa Entertainment,27300,27308,8
781,"Ethiopian Music : Yehalem Takele ይህዓለም ታከለ (አታሽኮርምሚኝ) - New Ethiopian Music 2020(Official Video) by Minew Shewa Tube 1 year ago 5 minutes, 53 seconds 17,144 views",Minew Shewa Entertainment,17144,17159,15
782,"Girum Teshome  ግሩም ተሾመ (አይኔ አያትና) - New Ethiopian Music 2020(Official Video) by Minew Shewa Tube 1 year ago 3 minutes, 57 seconds 7,928 views",Minew Shewa Entertainment,7928,7934,6
783,"Zebiba Girma (Yamal Qenew) ዘቢባ ግርማ (ያማል ቅኔው)  - New Ethiopian Music 2020(Official Video) by Minew Shewa Tube 1 year ago 5 minutes 9,223,467 views",Minew Shewa Entertainment,9223467,9254676,31209
784,"Wedneh Berhe ወድነይ በርሀ (የእናቴ ልጅ) - New Ethiopian Music 2020(Official Video) by Minew Shewa Tube 1 year ago 6 minutes, 4 seconds 9,488 views",Minew Shewa Entertainment,9488,9489,1
785,"Ethiopian Music: Addis Argaw(Zim Alilim) አዲስ አርጋው (ዝም አልልም) New Ethiopian Music 2020(Official Video) by Minew Shewa Tube 1 year ago 5 minutes, 36 seconds 8,242 views",Minew Shewa Entertainment,8242,8247,5
786,"Ethiopian Music : Haacaaluu Hundeessaa Tiif - New Ethiopian Music 2020(Official Video) by Minew Shewa Tube 1 year ago 4 minutes, 34 seconds 141,211 views",Minew Shewa Entertainment,141211,141382,171
787,"Kebad Anbesa (Abay Abaye)  ከባድ አንበሳ (አባይ አባዬ)  - New Ethiopian Music 2020(Official Video) by Minew Shewa Tube 1 year ago 3 minutes, 10 seconds 13,855 views",Minew Shewa Entertainment,13855,13867,12
788,"Yohannes Amdework (Taos Nayna) ዮሐንስ አምደወርቅ (ታኦስ ናይናን) - New Ethiopian Music 2020(Official Video) by Minew Shewa Tube 1 year ago 5 minutes, 36 seconds 7,990 views",Minew Shewa Entertainment,7990,7997,7
789,"Oromo Music : Urgeessaa Asheetuu (haacee koo) - New Ethiopian Music 2020(Official Video) by Minew Shewa Tube 1 year ago 5 minutes, 20 seconds 38,769 views",Minew Shewa Entertainment,38769,38903,134
790,"ቅድስት | ዘሪሁን | እስጢፋኖስ | ማህደር (ዓባይ) (Abay) - New Ethiopian Music 2020(Official Video) by Minew Shewa Tube 1 year ago 5 minutes, 32 seconds 44,902 views",Minew Shewa Entertainment,44902,45151,249
791,"Ethiopian Music : Em (Endefitu) ኤም (እንደፊቱ) - New Ethiopian Music 2020(Official Video) by Minew Shewa Tube 1 year ago 4 minutes, 18 seconds 3,183 views",Minew Shewa Entertainment,3183,3188,5
792,"Ethiopian Music : Yamlaksira Badarga ያምላክስራ ባደርጋ (አልቀይርሽም) New Ethiopian Music 2020(Official Video) by Minew Shewa Tube 1 year ago 4 minutes, 44 seconds 7,018 views",Minew Shewa Entertainment,7018,7019,1
793,"Ethiopian Music :  - Yosef Molla ዮሴፍ ሞላ ""ሁኚልኝ ደህና"" New Ethiopian Music 2020(Official Video) by Minew Shewa Tube 1 year ago 5 minutes, 24 seconds 6,312 views",Minew Shewa Entertainment,6312,6312,0
794,"ብቃት በነፃነት ወርቅነህ by Minew Shewa Tube 1 year ago 1 minute, 2 seconds 11,426 views",Minew Shewa Entertainment,11426,11438,12
795,"Ethiopian Music : Abiy Mero  አብይ መሮ (ኮሮና አፋቀረን)  - New Ethiopian Music 2020(Official Video) by Minew Shewa Tube 1 year ago 4 minutes, 30 seconds 7,634 views",Minew Shewa Entertainment,7634,7639,5
796,"Zerihun Mesfin Mekdes Kibkab ዘሪሁን መስፍን መቅድስ ክብካብ(የኛነው አባይ) New Ethiopian Music 2020(Official Video) by Minew Shewa Tube 1 year ago 4 minutes, 55 seconds 22,563 views",Minew Shewa Entertainment,22563,22572,9
797,"Ethiopian Music : Dagmawi Wube (Chiraro) ዳግማዊ ዉቤ (ጭራሮ) - New Ethiopian Music 2020(Official Video) by Minew Shewa Tube 1 year ago 5 minutes, 11 seconds 7,083 views",Minew Shewa Entertainment,7083,7102,19
798,"Ethiopian Music : Haftom G/Michael (Adeye) ሃፍቶም ገ/ሚካኤል (ዓደየ) New Tigrigna Music 2020(Official Video) by Minew Shewa Tube 1 year ago 5 minutes, 35 seconds 292,520 views",Minew Shewa Entertainment,292520,294363,1843
799,"Ethiopian Music : Ayene Brihan (Shentemo) አየነ ብርሃን (ሸንተሞ) - New Ethiopian Music 2020(Official Video) by Minew Shewa Tube 1 year ago 6 minutes 12,190 views",Minew Shewa Entertainment,12190,12197,7
800,"ጣይቱ የባህልና የትምህርት ማዕከል የ 20ኛ ዓመት ክብረ በዓል! by Minew Shewa Tube Streamed 1 year ago 1 hour, 58 minutes 4,146 views",Minew Shewa Entertainment,4146,4151,5
801,"ጣይቱ የባህልና የትምህርት ማዕከል የ 20ኛ ዓመት ክብረ በዓል! by Minew Shewa Tube Streamed 1 year ago 1 hour, 32 minutes 6,792 views",Minew Shewa Entertainment,6792,6795,3
802,"Ethiopian Music : Yonas Birhane (Abay) ዮናስ ብርሃኔ (ዓባይ) - New Ethiopian Music 2020(Official Video) by Minew Shewa Tube 1 year ago 4 minutes, 43 seconds 7,690 views",Minew Shewa Entertainment,7690,7696,6
803,"Ethiopian Music : Johannes Tadesse  ft. Punchi (መስሏቸው ነው) New Ethiopian Music 2020(Official Video) by Minew Shewa Tube 1 year ago 4 minutes, 20 seconds 4,388 views",Minew Shewa Entertainment,4388,4393,5
804,"Ethiopian Music : Tewodros Mosisa ቴዎድሮስ ሞሲሳ  (አመፀኛ ውሀ) - New Ethiopian Music 2020(Official Video) by Minew Shewa Tube 1 year ago 6 minutes, 23 seconds 211,751 views",Minew Shewa Entertainment,211751,212060,309
805,"Ethiopian Music : Mr problem (Taa Naath) - New Ethiopian Music 2020(Official Video) by Minew Shewa Tube 1 year ago 4 minutes, 32 seconds 7,992 views",Minew Shewa Entertainment,7992,8018,26
806,"Ethiopian Music : X off & LaL | Semagne | ስማኝ   - New Ethiopian Music 2020(Official Video) by Minew Shewa Tube 1 year ago 3 minutes, 33 seconds 5,747 views",Minew Shewa Entertainment,5747,5757,10
807,"Zerubabbel Molla (Behager New) ዘሩባቤል ሞላ (በሀገር ነው) New Ethiopian Music 2020(Official Audio) by Minew Shewa Tube 1 year ago 3 minutes, 59 seconds 6,621 views",Minew Shewa Entertainment,6621,6652,31
808,"Zerubabbel Molla (Ahun Tayesh) ዘሩባቤል ሞላ (አሁን ታየሽ) - New Ethiopian Music 2020(Official Audio) by Minew Shewa Tube 1 year ago 3 minutes, 17 seconds 4,864 views",Minew Shewa Entertainment,4864,4875,11
809,"Ethiopian Music : Em (Asalefkwat) ኤም (አሳለፍኳት) - New Ethiopian Music 2020(Official Video) by Minew Shewa Tube 1 year ago 3 minutes, 23 seconds 4,318 views",Minew Shewa Entertainment,4318,4322,4
810,"Eritrean Music : Goitom Mekonen (Birey) ጎይቶም መኮንን (ብረይ) - New Eritrean Music 2020(Official Video) by Minew Shewa Tube 1 year ago 7 minutes, 25 seconds 8,936 views",Minew Shewa Entertainment,8936,8972,36
811,"Ethiopian Music : Em (Nege Na) ኤም (ነገ ና) - New Ethiopian Music 2020(Official Video) by Minew Shewa Tube 1 year ago 3 minutes, 48 seconds 3,677 views",Minew Shewa Entertainment,3677,3690,13
812,"Sintayehu | Bisrat | Frehiwot | Tewodros (አባይ ሞላ) - New Ethiopian Music 2020(Official Video) by Minew Shewa Tube 1 year ago 5 minutes 105,494 views",Minew Shewa Entertainment,105494,105602,108
813,"Ethiopian Music : Vanus Zeda ቫኑስ ዜዳ (አለው መላ) - New Ethiopian Music 2020(Official Video) by Minew Shewa Tube 1 year ago 5 minutes, 49 seconds 21,018 views",Minew Shewa Entertainment,21018,21045,27
814,"Ethiopian Music : Tilahun Zayede (Wai Wai) ጥላሁን ዛዬደ (ዋይ ዋይ) New Ethiopian Music 2020(Official Video) by Minew Shewa Tube 1 year ago 6 minutes, 27 seconds 9,663 views",Minew Shewa Entertainment,9663,9664,1
815,"Dawit Kahsay (Kem Politica) ዳዊት ካህሳይ (ከም ፖለቲካ) - New Ethiopian Music 2020(Official Video) by Minew Shewa Tube 1 year ago 5 minutes 16,274 views",Minew Shewa Entertainment,16274,16289,15
816,"Ethiopian Music : Semegn Zegeye (Tolo Na) ስመኝ ዘገየ (ቶሎ ና) - New Ethiopian Music 2020(Official Video) by Minew Shewa Tube 1 year ago 4 minutes, 52 seconds 19,560 views",Minew Shewa Entertainment,19560,19585,25
817,"Ethiopian Music : Mame ft. Tare (Ene Negn) ማሜ ft ታሬ (እኔ ነኝ) New Ethiopian Music 2020(Official Video) by Minew Shewa Tube 1 year ago 3 minutes, 50 seconds 6,574 views",Minew Shewa Entertainment,6574,6576,2
818,"Minew Shewa Tube Live Stream with Djphatsu Saturday Night Live! by Minew Shewa Tube Streamed 1 year ago 37 minutes 2,180 views",Minew Shewa Entertainment,2180,2182,2
819,"Ethiopian Music : Leul Biruk ልዑል ብሩክ (ዓለም ነን እኛ) - New Ethiopian Music 2020(Official Video) by Minew Shewa Tube 1 year ago 5 minutes, 16 seconds 5,013 views",Minew Shewa Entertainment,5013,5029,16
820,"Ethiopian Music : Mieraf Teshome ምዕራፍ ተሾመ (ሸዋ ነኝ) - New Ethiopian Music 2020(Official Video) by Minew Shewa Tube 1 year ago 4 minutes, 41 seconds 18,556 views",Minew Shewa Entertainment,18556,18589,33
821,"Ethiopian Music : Em (Leka) ኤም (ለካ)  - New Ethiopian Music 2020(Official Video) by Minew Shewa Tube 1 year ago 2 minutes, 44 seconds 6,787 views",Minew Shewa Entertainment,6787,6792,5
822,"Ethiopian Music : Yeshi Birhane የሺ ብርሃኔ (በቃ ኣኸለ) New Ethiopian Music 2020(Official Video) by Minew Shewa Tube 1 year ago 5 minutes, 4 seconds 149,454 views",Minew Shewa Entertainment,149454,149713,259
823,"Ethiopian Music : Em (Mirkogna) ኤም (ምርኮኛ)  - New Ethiopian Music 2020(Official Video) by Minew Shewa Tube 1 year ago 4 minutes, 21 seconds 2,315 views",Minew Shewa Entertainment,2315,2315,0
824,"Alemayehu Tibebu (Wey Hager) አለማየሁ ጥበቡ (ወይ ሀገር) - New Ethiopian Music 2020(Official Video) by Minew Shewa Tube 1 year ago 7 minutes, 2 seconds 12,514 views",Minew Shewa Entertainment,12514,12526,12
825,"Ethiopian Music : Abraham Habte አብርሃም ሀብቴ (ጎንደሬዋን አምጡልኝ) - New Ethiopian Music 2020(Official Video) by Minew Shewa Tube 1 year ago 6 minutes, 59 seconds 7,272 views",Minew Shewa Entertainment,7272,7334,62
826,"Ethiopian Music : Em (Amchiew) ኤም (አምጪው) - New Ethiopian Music 2020(Official Video) by Minew Shewa Tube 1 year ago 4 minutes, 25 seconds 3,116 views",Minew Shewa Entertainment,3116,3123,7
827,"Ethiopian Music : Em ኤም (ካንቺ ባደረገኝ)  - New Ethiopian Music 2020(Official Video) by Minew Shewa Tube 1 year ago 5 minutes, 22 seconds 4,378 views",Minew Shewa Entertainment,4378,4383,5
828,"Ethiopian Music : EM (Mabede New) ኤም (ማበዴ ነው) - New Ethiopian Music 2020(Official Video) by Minew Shewa Tube 1 year ago 4 minutes, 14 seconds 10,179 views",Minew Shewa Entertainment,10179,10233,54
829,"Ethiopian Music : Kebek Teshome (Nan Qoppisa) - New Ethiopian Music 2020(Official Video) by Minew Shewa Tube 1 year ago 4 minutes, 51 seconds 9,094 views",Minew Shewa Entertainment,9094,9113,19
830,"Solomon | Abrish | Solomon ሰለሞን | አብርሽ | ሰለሞን (የለም ዳኛ) - New Ethiopian Music 2020(Official Video) by Minew Shewa Tube 1 year ago 5 minutes, 38 seconds 34,660 views",Minew Shewa Entertainment,34660,34784,124
831,"Ethiopian Music : Umer Idris (Ajaiba) - New Ethiopian Oromo Music 2020(Official Video) by Minew Shewa Tube 1 year ago 5 minutes, 57 seconds 126,027 views",Minew Shewa Entertainment,126027,126564,537
832,"Minew Shewa Tube Live Stream with Djphatsu Saturday Night Live! by Minew Shewa Tube Streamed 1 year ago 59 minutes 1,810 views",Minew Shewa Entertainment,1810,1814,4
833,"Ethiopian Music : Bazu Man(Ye Dejen Lej) ""Bekagn ባዙ ማን(በቃኝ) New Ethiopian Music 2020(Official Video) by Minew Shewa Tube 1 year ago 4 minutes, 14 seconds 54,582 views",Minew Shewa Entertainment,54582,54686,104
834,"Ethiopian Music : Aklilu Mekonen አክሊሉ መኮንን (አላገባም)  - New Ethiopian Music 2020(Official Video) by Minew Shewa Tube 1 year ago 5 minutes, 57 seconds 6,475 views",Minew Shewa Entertainment,6475,6486,11
835,"Ethiopian Music :Tintag zema (እምዬ ኢትዮጵያ) ትንታግ ዜማ New Ethiopian Music 2020(Official Video) by Minew Shewa Tube 1 year ago 5 minutes, 5 seconds 7,417 views",Minew Shewa Entertainment,7417,7433,16
836,"Ethiopian Music : Diamond ft Jay Matic (Attention) - New Ethiopian Music 2020(Official Video) by Minew Shewa Tube 1 year ago 4 minutes, 11 seconds 9,978 views",Minew Shewa Entertainment,9978,9993,15
837,"Ethiopian Music : Nasraa Gursum (Gaara Gamanaa)  - New Ethiopian Music 2020(Official Video) by Minew Shewa Tube 1 year ago 7 minutes, 6 seconds 187,392 views",Minew Shewa Entertainment,187392,187896,504
838,"Ethiopian Music: Abel G/Michael (Ney Ney) አቤል ገ/ሚካኤል (ነይ ነይ)New Ethiopian Music 2020(Official Video) by Minew Shewa Tube 1 year ago 4 minutes, 3 seconds 4,008 views",Minew Shewa Entertainment,4008,4018,10
839,"Ethiopian Music : Leul Hailu ልዑል ኃይሉ (ጅል ትግስት አለ)  - New Ethiopian Music 2020(Official Video) by Minew Shewa Tube 1 year ago 4 minutes, 27 seconds 29,676 views",Minew Shewa Entertainment,29676,29876,200
840,"Ethiopian Music : Wallee (Abbayyaa) - New Ethiopian Music 2020(Official Video) by Minew Shewa Tube 1 year ago 6 minutes, 38 seconds 7,836 views",Minew Shewa Entertainment,7836,7928,92
841,"Ethiopian Music : Eyerusalem Yegnasew እየሩሳሌም የኛሰው (የነታዬ) - New Ethiopian Music 2020(Official Video) by Minew Shewa Tube 1 year ago 5 minutes, 6 seconds 4,062 views",Minew Shewa Entertainment,4062,4067,5
842,"Ethiopian Music : Fira X Beka (Tewedajwa) ፊራ X ቤካ (ተወዳጇ) - New Ethiopian Music 2020(Official Video) by Minew Shewa Tube 1 year ago 3 minutes, 14 seconds 14,871 views",Minew Shewa Entertainment,14871,15261,390
843,"Ethiopian Music : Tideg Wondimu (Niqa) ትደግ ወንድሙ (ንቃ)  - New Ethiopian Music 2020(Official Video) by Minew Shewa Tube 1 year ago 6 minutes, 19 seconds 13,851 views",Minew Shewa Entertainment,13851,13865,14
844,"Ethiopian Music : Mindahun Girma ምንዳሁን ግርማ (እንደዘበት) - New Ethiopian Music 2020(Official Video) by Minew Shewa Tube 1 year ago 4 minutes, 35 seconds 7,869 views",Minew Shewa Entertainment,7869,7876,7
845,"Ethiopian music :Bzuayehu Selemon & Ermiyas desta ""በቃ በለን"" New Ethiopian Music 2020(Official Video) by Minew Shewa Tube 1 year ago 6 minutes, 15 seconds 8,711 views",Minew Shewa Entertainment,8711,8714,3
846,"Minew Shewa Tube Live Stream with Djphatsu Saturday Night Live! by Minew Shewa Tube Streamed 1 year ago 47 minutes 5,715 views",Minew Shewa Entertainment,5715,5718,3
847,"Ethiopian :Solomon Yazachew/Solyaz ሶልያዝ (hun yalew aykerem) New Ethiopian Music 2019(Official Video) by Minew Shewa Tube 1 year ago 6 minutes, 32 seconds 13,112 views",Minew Shewa Entertainment,13112,13237,125
848,"Ethiopian music: Natnael Teferi & Tsegazeab Demeke ""ቀውጢ"" New Ethiopian music 202 (official video) by Minew Shewa Tube 1 year ago 4 minutes, 7 seconds 11,205 views",Minew Shewa Entertainment,11205,11220,15
849,"Ethiopian music :ጆን ቫርቶ (የኔ ቆንጆ) Jon Varto ""Yene Konjo"" New Ethiopian Music 2019 by Minew Shewa Tube 1 year ago 4 minutes, 2 seconds 3,618 views",Minew Shewa Entertainment,3618,3621,3
850,"Ashebir Belay | Minalush Reta አሸብር በላይ | ምንአሉሽ ረታ (የእኔ ሰው) New Ethiopian Music 2020(Official Video) by Minew Shewa Tube 1 year ago 5 minutes, 59 seconds 87,294 views",Minew Shewa Entertainment,87294,87427,133
851,"Ethiopian Music : Asne & Abinezer አስኔ እና አቤኔዘር (ግድ ግድ ነው) New Ethiopian Music 2020(Official Video) by Minew Shewa Tube 1 year ago 3 minutes, 36 seconds 8,517 views",Minew Shewa Entertainment,8517,8519,2
852,"Ethiopian Music : Tewodros Delelegn ቴዎድሮስ ደለለኝ (ለወዳጄ) - New Ethiopian Music 2020(Official Video) by Minew Shewa Tube 1 year ago 3 minutes, 34 seconds 4,153 views",Minew Shewa Entertainment,4153,4158,5
853,"Nati Abraham  በህፃናት ጥቃት ላይ ያስተላለፈው መልዕክት by Minew Shewa Tube 1 year ago 1 minute, 56 seconds 5,945 views",Minew Shewa Entertainment,5945,5953,8
854,"Ethiopian Music : Tigist Turaa (Damma Koo) - New Ethiopian Music 2020(Official Video) by Minew Shewa Tube 1 year ago 5 minutes, 58 seconds 5,016 views",Minew Shewa Entertainment,5016,5028,12
855,"Ethiopian Music : Seyoum Mekonnen (Zeraf) ስዩም መኮንን (ዘራፍ)  - New Ethiopian Music 2020(Official Video) by Minew Shewa Tube 1 year ago 5 minutes, 14 seconds 9,447 views",Minew Shewa Entertainment,9447,9464,17
856,"Minew Shewa Tube Live Stream with Djphatsu Saturday Night Live! by Minew Shewa Tube Streamed 1 year ago 1 hour, 2 minutes 6,817 views",Minew Shewa Entertainment,6817,6817,0
857,"Ethiopian Music : Mikyas Cherinet ሚክያስ ቸርነት  - New Ethiopian Music 2020(Official Video) by Minew Shewa Tube 1 year ago 6 minutes, 32 seconds 69,513 views",Minew Shewa Entertainment,69513,69781,268
858,"Ethiopian Music : Binyam Tesfa (Mano) ቢኒያም ተስፋ (ማኖ)  - New Ethiopian Music 2020(Official Video) by Minew Shewa Tube 1 year ago 5 minutes, 12 seconds 34,389 views",Minew Shewa Entertainment,34389,34420,31
859,"Ethiopian Music : Kibrewesen Mechalo ክብረወሰን መጫሎ (ነይ ነይ ድማማ) New Ethiopian Music 2020(Official Video) by Minew Shewa Tube 1 year ago 5 minutes, 24 seconds 15,281 views",Minew Shewa Entertainment,15281,15321,40
860,"Ethiopian music:We are Ethiopia እኛ ነን ኢትዮጵያ Various Artists New Ethiopian Music 2020(Official Video) by Minew Shewa Tube 1 year ago 4 minutes, 4 seconds 4,898 views",Minew Shewa Entertainment,4898,4903,5
861,"Ethiopian Music : Mikyas Cherinet ሚክያስ ቸርነት (ፃፈው ስምሽን) - New Ethiopian Music 2020(Official Video) by Minew Shewa Tube 1 year ago 5 minutes, 23 seconds 146,700 views",Minew Shewa Entertainment,146700,147187,487
862,"Ethiopian Music : Fani (Ema) ፋኒ (እማ) - New Ethiopian Music 2020(Official Video) by Minew Shewa Tube 1 year ago 4 minutes, 11 seconds 12,949 views",Minew Shewa Entertainment,12949,12958,9
863,"Ethiopian Music: Merid W/Semayat መርድ ወ/ሰማያት (አባይ) New Ethiopian Music 2020(Official Video) by Minew Shewa Tube 1 year ago 4 minutes, 57 seconds 2,232 views",Minew Shewa Entertainment,2232,2233,1
864,"Ethiopian Music : Mc Mika (Abezan) ሚካ (አበዛን)  - New Ethiopian Music 2020(Official Video) by Minew Shewa Tube 1 year ago 3 minutes, 6 seconds 3,509 views",Minew Shewa Entertainment,3509,3511,2
865,"Ethiopian Music : Dagim Mekonnen | Elias Fetene (ፍቅርሽ አመረረ) New Ethiopian Music 2020(Official Video) by Minew Shewa Tube 1 year ago 5 minutes, 39 seconds 6,540 views",Minew Shewa Entertainment,6540,6561,21
866,"Ethiopian Music : Mikyas Cherinet ሚክያስ ቸርነት (ባባ ሆዴ) - New Ethiopian Music 2020(Official Video) by Minew Shewa Tube 1 year ago 5 minutes, 23 seconds 117,575 views",Minew Shewa Entertainment,117575,118079,504
867,"Ethiopian Music : Muse Hailesilasse ሙሴ ሃይለስላሴ (ይፈካል) - New Ethiopian Music 2020(Official Video) by Minew Shewa Tube 1 year ago 4 minutes, 25 seconds 4,705 views",Minew Shewa Entertainment,4705,4708,3
868,"Ethiopian Music : Mikyas Cherinet ሚክያስ ቸርነት (አለ ከነወዙ) - New Ethiopian Music 2020(Official Video) by Minew Shewa Tube 1 year ago 6 minutes, 46 seconds 113,289 views",Minew Shewa Entertainment,113289,113589,300
869,"Ethiopian Music : Rodas (Lemin) ሮዳስ (ለምን) - New Ethiopian Music 2020(Official Video) by Minew Shewa Tube 1 year ago 4 minutes, 11 seconds 4,720 views",Minew Shewa Entertainment,4720,4724,4
870,"Minew Shewa Tube Live Stream with Djphatsu Saturday Night Live! by Minew Shewa Tube Streamed 1 year ago 1 hour, 8 minutes 3,280 views",Minew Shewa Entertainment,3280,3289,9
871,"Bereket Bizuneh | Beki በረከት ብዙነህ | ቤኪ (ቀን በቀን)  - New Ethiopian Music 2020(Official Video) by Minew Shewa Tube 1 year ago 5 minutes, 5 seconds 8,118 views",Minew Shewa Entertainment,8118,8122,4
872,"Ethiopian Music:  Selamawit Gebru ""Shikor ሽኮር"" Ethiopian Tigrigna Music 2020 (Official Video) by Minew Shewa Tube 1 year ago 4 minutes, 33 seconds 203,974 views",Minew Shewa Entertainment,203974,204354,380
873,"Ethiopian Music : Miche (Kiya) Emwedesh ሚቼ (ኪያ) እምወድሽ  - New Ethiopian Music 2020(Official Video) by Minew Shewa Tube 1 year ago 3 minutes, 39 seconds 60,109 views",Minew Shewa Entertainment,60109,60219,110
874,"Ethiopian Music : Yosef Mersha ዮሴፍ መርሻ (አልመጣም ቀረሁኝ) - New Ethiopian Music 2020(Official Video) by Minew Shewa Tube 1 year ago 3 minutes, 47 seconds 18,045 views",Minew Shewa Entertainment,18045,18080,35
875,"Habtamu | Bereket | Maekel | Asher | Tamirat (ኮራሁ በአባቴ) - New Ethiopian Music 2020(Official Video) by Minew Shewa Tube 1 year ago 6 minutes, 8 seconds 34,946 views",Minew Shewa Entertainment,34946,35321,375
876,"Ethiopian Music : Awgchew Shewangizaw አውግቸው ሸዋንግዛው (አፍቀራ) - New Ethiopian Music 2020(Official Video) by Minew Shewa Tube 1 year ago 6 minutes, 7 seconds 48,580 views",Minew Shewa Entertainment,48580,48615,35
877,"Habesha kids by Fisum T ሐበሻ ኪድስ በነፃ ሁሉም ወላጅ በስማርት ስልኩ ላይ ሊኖረው የሚገባ ድንቅ መተግበሪያ! by Minew Shewa Tube 1 year ago 1 minute, 54 seconds 35,157 views",Minew Shewa Entertainment,35157,35158,1
878,"Mahlet Hailu | Bezabih Shawel | Mesh (ስማ ወገኔ) - New Ethiopian Music 2020(Official Video) by Minew Shewa Tube 1 year ago 4 minutes, 40 seconds 6,080 views",Minew Shewa Entertainment,6080,6087,7
879,"Ethiopian Music : Bini Boss (Beredu Selale) ቢኒ ቦስ (በሬዱ ሰላሌ) New Ethiopian Music 2020(Official Video) by Minew Shewa Tube 1 year ago 4 minutes, 21 seconds 7,358 views",Minew Shewa Entertainment,7358,7377,19
880,"Ethiopian Music : Mikyas Cherinet ሚክያስ ቸርነት (መቼ ነው) - New Ethiopian Music 2020(Official Video) by Minew Shewa Tube 1 year ago 5 minutes, 44 seconds 238,324 views",Minew Shewa Entertainment,238324,239181,857
881,"Ethiopian Music : Mikyas Cherinet ሚክያስ ቸርነት (ቅንልብ ያሸንፋል) - New Ethiopian Music 2020(Official Video) by Minew Shewa Tube 1 year ago 5 minutes, 49 seconds 273,057 views",Minew Shewa Entertainment,273057,273795,738
882,"Ethiopian Music : Mikyas Cherinet ሚክያስ ቸርነት (ቀረ ድሮ) - New Ethiopian Music 2020(Official Video) by Minew Shewa Tube 1 year ago 6 minutes, 40 seconds 60,421 views",Minew Shewa Entertainment,60421,60622,201
883,"Ethiopian Music :Mikyas Cherinet ሚክያስ ቸርነት (አንድ ነው ደማችን) - New Ethiopian Music 2020(Official Video) by Minew Shewa Tube 1 year ago 5 minutes, 52 seconds 56,202 views",Minew Shewa Entertainment,56202,56335,133
884,"Aklilu Mekonen (Atizenaga) አክሊሉ መኮንን (አትዘናጋ) New Ethiopian Music 2020(Official Video) by Minew Shewa Tube 1 year ago 2 minutes, 30 seconds 4,403 views",Minew Shewa Entertainment,4403,4409,6
885,"Minew Shewa Tube Live Stream #ለአንድኢትዮጲያበአንድላይ የመረዳዳት፡የመተባበር፡የመዝናኛ የኦንላይን ኮንሰርት by Minew Shewa Tube Streamed 1 year ago 6 hours, 53 minutes 12,990 views",Minew Shewa Entertainment,12990,12991,1
886,"Ethiopian Music : Mikyas Cherinet ሚክያስ ቸርነት (በካልቾ) - New Ethiopian Music 2020(Official Video) by Minew Shewa Tube 1 year ago 5 minutes, 11 seconds 168,217 views",Minew Shewa Entertainment,168217,168771,554
887,"Minew Shewa Tube Live Stream with Djphatsu! by Minew Shewa Tube Streamed 1 year ago 1 hour, 4 minutes 5,009 views",Minew Shewa Entertainment,5009,5037,28
888,"House Dance Crew ft Mohammed Oshe (ቀን አመጣ)  - New Ethiopian Music 2020(Official Video) by Minew Shewa Tube 1 year ago 4 minutes, 5 seconds 6,028 views",Minew Shewa Entertainment,6028,6041,13
889,"Ethiopian Music : Mikyas Cherinet ሚክያስ ቸርነት (ዚዮዜ) - New Ethiopian Music 2020(Official Video) by Minew Shewa Tube 1 year ago 5 minutes, 27 seconds 821,752 views",Minew Shewa Entertainment,821752,822565,813
890,"Ethiopian Music : Mikyas Cherinet ሚክያስ ቸርነት (ኪያ) - New Ethiopian Music 2020(Official Video) by Minew Shewa Tube 1 year ago 5 minutes, 30 seconds 177,483 views",Minew Shewa Entertainment,177483,178785,1302
891,"Ethiopian Music : Mikyas Cherinet ሚክያስ ቸርነት (አሁን ገባኝ) - New Ethiopian Music 2020(Official Video) by Minew Shewa Tube 1 year ago 6 minutes, 40 seconds 29,005 views",Minew Shewa Entertainment,29005,29115,110
892,"Ethiopian Music : Mikyas Cherinet ሚክያስ ቸርነት (ቱሪናፋ)  - New Ethiopian Music 2020(Official Video) by Minew Shewa Tube 1 year ago 4 minutes, 57 seconds 455,858 views",Minew Shewa Entertainment,455858,458428,2570
893,"Ethiopian Music : Fekerte Kassahun ፍቅርተ ካሳሁን (ቻለው)  - New Ethiopian Music 2020(Official Video) by Minew Shewa Tube 1 year ago 6 minutes, 7 seconds 448,453 views",Minew Shewa Entertainment,448453,448799,346
894,"Tsegaye Hailu (Yeker Belen) ፀጋዬ ኃይሉ (ይቅር በለን) - New Ethiopian Music 2020(Official Video) by Minew Shewa Tube 1 year ago 3 minutes, 20 seconds 3,554 views",Minew Shewa Entertainment,3554,3556,2
895,"Kibkab Tesfaye (Tena Yebeltale) ክብካብ ተስፋዬ (ጤና ይበልጣል) - New Ethiopian Music 2020(Official Video) by Minew Shewa Tube 1 year ago 2 minutes, 32 seconds 4,547 views",Minew Shewa Entertainment,4547,4548,1
896,"Ethiopian Music : Olif MJ (Ati ENYU) - New Ethiopian Music 2020(Official Video) by Minew Shewa Tube 1 year ago 3 minutes, 58 seconds 4,315 views",Minew Shewa Entertainment,4315,4325,10
897,"Ethiopian Music : Tarekegne Girma ታረቀኝ ግርማ (ስማኝ ወገኔ) - New Ethiopian Music 2020(Official Video) by Minew Shewa Tube 1 year ago 4 minutes, 10 seconds 3,254 views",Minew Shewa Entertainment,3254,3255,1
898,"Ethiopian Music : Besufekad Tibebu (Yene) በሱፍቃድ ጥበቡ (የኔ) - New Ethiopian Music 2020(Official Video) by Minew Shewa Tube 1 year ago 3 minutes, 49 seconds 13,159 views",Minew Shewa Entertainment,13159,13186,27
899,"Jhone, Maluda, Zemen Afkrini ማሉዳ ጆን እና ዘመን ""አፍቅርኒ” New Ethiopian Tigrigna Music 2020(Official Video) by Minew Shewa Tube 1 year ago 5 minutes, 32 seconds 77,521 views",Minew Shewa Entertainment,77521,78892,1371
900,"Ethiopian Music : Qene new Hager (ቅኔ ነው ሀገር) - New Ethiopian Music 2020(Official Video) by Minew Shewa Tube 1 year ago 6 minutes, 14 seconds 141,087 views",Minew Shewa Entertainment,141087,141215,128
901,"Zekre Ja ft Rebeka ዝክረ ጃ ft ርብቃ - አበባዬ ነሽ - New Ethiopian Music 2020(Official Video) by Minew Shewa Tube 1 year ago 4 minutes, 33 seconds 4,176 views",Minew Shewa Entertainment,4176,4178,2
902,"Netsanet Debebe - Yeadam Fitur ነፃነት ደበበ - የአዳም ፍጡር  - New Ethiopian Music 2020(Official Video by Minew Shewa Tube 1 year ago 5 minutes, 5 seconds 5,725 views",Minew Shewa Entertainment,5725,5733,8
903,"Ethiopian Music : Geez Dance  - New Ethiopian Music 2020(Official Video) by Minew Shewa Tube 1 year ago 3 minutes, 25 seconds 5,232 views",Minew Shewa Entertainment,5232,5254,22
904,"Minew Shewa Tube Live Stream  ለአንድ ኢትዮጵያ በአንድ ላይ!!አንድ ላይ ከቤት የመዝናናት የመተባበርና የመረዳዳት ዝግጅት ቁጥር 2 by Minew Shewa Tube Streamed 1 year ago 5 hours, 5 minutes 11,575 views",Minew Shewa Entertainment,11575,11586,11
905,"Ethiopian Music : Emuti (Enat)  እሙቲ (አንት) - New Ethiopian Music 2020(Official Video) by Minew Shewa Tube 1 year ago 5 minutes, 16 seconds 9,034 views",Minew Shewa Entertainment,9034,9044,10
906,"የኔነሽ በለጠ /እሙ ድሬ ለገሀሬ ""ያጥፋው ከምድር Yatifaw Kemeder""  New Ethiopian Music 2020(Official Video) by Minew Shewa Tube 1 year ago 5 minutes, 25 seconds 12,689 views",Minew Shewa Entertainment,12689,12694,5
907,"Ethiopian Music : Abenet Girma | አብነት ግርማ (እንዳመሰግንህ አሳልፈኝ) New Ethiopian Music 2020(Official Video) by Minew Shewa Tube 1 year ago 5 minutes, 53 seconds 260,521 views",Minew Shewa Entertainment,260521,261699,1178
908,"ለአንድ ኢትዮጵያ በአንድ ላይ አብረን እንጂ ብቻችንን አንድንም! Minew Shewa Tube Live Stream by Minew Shewa Tube Streamed 1 year ago 7 hours, 3 minutes 70,066 views",Minew Shewa Entertainment,70066,70398,332
909,"Ethiopian Music :  - Sinishaw Legesse ""Gize"" ስንሻው ለገሰ New Ethiopian Music 2020(Official Video) by Minew Shewa Tube 1 year ago 4 minutes, 50 seconds 5,324 views",Minew Shewa Entertainment,5324,5329,5
910,"Abebe Alemu | Daniel Chernet አበበ አለሙ | ዳንኤል ቸርነት (ሸኘው) - New Ethiopian Music 2020(Official Video) by Minew Shewa Tube 1 year ago 3 minutes, 56 seconds 10,051 views",Minew Shewa Entertainment,10051,10055,4
911,"Ethiopian Music : Dagi ft Minte (Corona) ዳጊ ft ምንቴ (ኮሮና) - New Ethiopian Music 2020(Official Video) by Minew Shewa Tube 1 year ago 2 minutes, 21 seconds 6,500 views",Minew Shewa Entertainment,6500,6506,6
912,"Ethiopian Music : Kidist Habtamu (Libij) ቅድስት ሃብታሙ (ልብጅ)  - New Ethiopian Music 2020(Official Video) by Minew Shewa Tube 1 year ago 5 minutes, 5 seconds 16,034 views",Minew Shewa Entertainment,16034,16042,8
913,"Ethiopian Music : Dagim Adane (Bale Gize) ዳግም አዳነ (ባለ ጊዜ) New Ethiopian Music 2020(Official Video) by Minew Shewa Tube 1 year ago 5 minutes, 42 seconds 32,560 views",Minew Shewa Entertainment,32560,32651,91
914,"Henok ሄኖክ | Nuru ኑሩ | Ehetnesh እህቴነሽ | Kalkidan ቃልኪዳን(ቸልታ) New Ethiopian Music 2020(Official Video) by Minew Shewa Tube 1 year ago 5 minutes, 15 seconds 9,962 views",Minew Shewa Entertainment,9962,9967,5
915,"Ethiopian Music : Dj sem ዲጄ ሴም Tisedal Zealem (ፅዳል ዘዓለም) - New Ethiopian Music 2020(Official Video) by Minew Shewa Tube 1 year ago 4 minutes, 34 seconds 8,862 views",Minew Shewa Entertainment,8862,8883,21
916,"Ethiopian Music : Hamelmal Abate ሀመልማል አባተ Andande አንዳንዴ - New Ethiopian Music 2020(Official Video) by Minew Shewa Tube 1 year ago 6 minutes, 10 seconds 313,199 views",Minew Shewa Entertainment,313199,315213,2014
917,"በዛወርቅ አስፋው (ይቅርታ) Bezawork Asfaw  የንስሀ መዝሙር New Orthodox Mezmur 2020(Official Video) by Minew Shewa Tube 1 year ago 8 minutes, 34 seconds 2,492,389 views",Minew Shewa Entertainment,2492389,2532630,40241
918,"Ethiopian Music: Fit Awrari (ፊት አውራሪ) Betselot New(በፀሎት ነው) New Ethiopian Music 2020(Official Video) by Minew Shewa Tube 1 year ago 6 minutes, 11 seconds 11,037 views",Minew Shewa Entertainment,11037,11049,12
919,"Mekuria Gugsa ዲ/ን መኩሪያ ጉግሣ (ገጣሚ) | እንዲህ ነው ያገኛት - New Ethiopian Poetry 2020(Official Video) by Minew Shewa Tube 1 year ago 4 minutes, 34 seconds 3,776 views",Minew Shewa Entertainment,3776,3788,12
920,"Belay Melese በላይ መልሴ (ስለድንግል ብሎ) - New Ethiopian Menfesawi mezmur 2020(Official Video) by Minew Shewa Tube 1 year ago 7 minutes, 27 seconds 11,106 views",Minew Shewa Entertainment,11106,11152,46
921,"Ethiopian Music : Haftom G/Michael ""Shikorina"" ሃፍቶም ገ/ሚካኤል (ሽኮሪና) - New Ethiopian Music 2020. by Minew Shewa Tube 1 year ago 5 minutes, 34 seconds 31,276 views",Minew Shewa Entertainment,31276,31351,75
922,"Ethiopian Music : Dawit Mengesha ዳዊት መንገሻ (ጠርጥር ወገኔ)  - New Ethiopian Music 2020(Official Video) by Minew Shewa Tube 1 year ago 4 minutes, 45 seconds 9,255 views",Minew Shewa Entertainment,9255,9259,4
923,"Sentayehu Sefane (Ej Nesahu) ሰንታየሁ ሰፈኔ (እጅ ነሳሁ)  - New Ethiopian Music 2020(Official Video) by Minew Shewa Tube 1 year ago 6 minutes, 28 seconds 635,254 views",Minew Shewa Entertainment,635254,638210,2956
924,"Getish Mamo ጌትሽ ማሞ ይቅር በለንና ከቤትህ መልሰን New Ethiopian Menfesawi mezmur  2020(Official Video) by Minew Shewa Tube 1 year ago 6 minutes, 18 seconds 265,111 views",Minew Shewa Entertainment,265111,265312,201
925,"Ethiopian Music :Semer Solomon(semmehola) EchiAlem እቺ አለም New Ethiopian Music 2020(Official Video) by Minew Shewa Tube 1 year ago 3 minutes, 18 seconds 4,130 views",Minew Shewa Entertainment,4130,4138,8
926,"Ethiopian Music : Eyob Edilu (Yelem) እዮብ እድሉ (የለም) - New Ethiopian Music 2020(Official Video) by Minew Shewa Tube 1 year ago 5 minutes, 31 seconds 20,015 views",Minew Shewa Entertainment,20015,20032,17
927,"Ethiopian Music : Dereje Delelegn ደረጄ ደለለኝ (ይህም ያልፋል) - New Ethiopian Music 2020(Official Video) by Minew Shewa Tube 1 year ago 6 minutes, 23 seconds 5,633 views",Minew Shewa Entertainment,5633,5636,3
928,"Yohannes Feleke (Yoni Cash) ዮሃንስ ፈለቀ (ዮኒ ካሽ) ""Ifa Jruu"" New Ethiopian Music 2020(Official Video) by Minew Shewa Tube 1 year ago 5 minutes, 21 seconds 19,788 views",Minew Shewa Entertainment,19788,19864,76
929,"ትምህርት ሚንስቴር እና ሙሉ ገበየሁ ፕሮሞሽን (ስለ Covid19 መደረግ ያለበት ጥንቃቄ) by Minew Shewa Tube 1 year ago 3 minutes, 45 seconds 3,802 views",Minew Shewa Entertainment,3802,3803,1
930,"Ethiopian music: ዮሃንስ ፈለቀ Yohannes Feleke (Yoni Cash) New Ethiopian music video coming soon! by Minew Shewa Tube 1 year ago 2 minutes, 25 seconds 4,168 views",Minew Shewa Entertainment,4168,4172,4
931,"ግንዛቤ ማስጨበጪያ ትምህርቱን ለመስጠት እንዳልካቸው ዘነበ እና ሮማን ፍልም ክሩ ተሰማርተዋል ወገኖቻችንን ከኮረና ቫይረስ እንታደግ! by Minew Shewa Tube 1 year ago 16 minutes 19,844 views",Minew Shewa Entertainment,19844,19847,3
932,"Fasil Anchihoye (Negere Jimaro) ፋሲል አንቺሆዬ (ነገረ ጅማሮ)  - New Ethiopian Music 2020(Official Video) by Minew Shewa Tube 1 year ago 5 minutes, 56 seconds 8,159 views",Minew Shewa Entertainment,8159,8160,1
933,"Endalkachew Zenbe እንዳልካቸው ዘነበ : ወገኖቻችንን ከኮረና ቫይረስ እንታደግ by Minew Shewa Tube 1 year ago 3 minutes, 7 seconds 16,399 views",Minew Shewa Entertainment,16399,16408,9
934,"Ethiopian Music : Kebad Anbesa (Ere Gud New CORONA) - New Ethiopian Music 2020(Official Video) by Minew Shewa Tube 1 year ago 3 minutes, 22 seconds 7,201 views",Minew Shewa Entertainment,7201,7207,6
935,"Ethiopian Music : Yab (Esat Esat) ያብ (እሳት እሳት) - New Ethiopian Music 2020(Official Video) by Minew Shewa Tube 1 year ago 3 minutes, 32 seconds 7,619 views",Minew Shewa Entertainment,7619,7633,14
936,"Ethiopian Music : Yohannes Tafesse ዮሐንስ ታፈሰ (አልበቃኝም ገና)  - New Ethiopian Music 2020(Official Video) by Minew Shewa Tube 1 year ago 5 minutes, 58 seconds 7,953 views",Minew Shewa Entertainment,7953,7981,28
937,"Ethiopian Music : Tedy Gech (Tayta) ቴዲ ጌች (ታይታ) - New Ethiopian Music 2020(Official Video) by Minew Shewa Tube 1 year ago 4 minutes, 11 seconds 15,699 views",Minew Shewa Entertainment,15699,15708,9
938,"Dagmawi Wubae (Yerapu Geta) ዳግማዊ ዉቤ (የራፑ ጌታ) - New Ethiopian Music 2020(Official Video) by Minew Shewa Tube 1 year ago 3 minutes, 24 seconds 7,398 views",Minew Shewa Entertainment,7398,7412,14
939,"Hamelmal Abate ሐመልማል አባተ ዘለሠኛ ""የኔ ቢጤ"" New Ethiopian Orthodox mezmur 2020 (Official Video) by Minew Shewa Tube 1 year ago 8 minutes, 9 seconds 394,943 views",Minew Shewa Entertainment,394943,395446,503
940,"Ethiopian Music : Tewodros Mekuye ቴወድሮሰ ሙኩየ (ትራፊኳ) - New Ethiopian Music 2020(Official Video) by Minew Shewa Tube 1 year ago 4 minutes, 3 seconds 4,962 views",Minew Shewa Entertainment,4962,4963,1
941,"Ethiopian Music : Hayleysus Eshetu ሀይለየሱስ እሸቱ (የሩቋ የሩቋ)  - New Ethiopian Music 2020(Official Video) by Minew Shewa Tube 1 year ago 6 minutes, 1 second 22,457 views",Minew Shewa Entertainment,22457,22483,26
942,"Ethiopian Music : Biruk Shewa ብሩክ ሸዋ (ወይኗ) - New Ethiopian Music 2020(Official Video) by Minew Shewa Tube 1 year ago 4 minutes 12,353 views",Minew Shewa Entertainment,12353,12398,45
943,"Ethiopian Music : Tigist (Ganda Jaalalaa)  - New Ethiopian Music 2020(Official Video) by Minew Shewa Tube 1 year ago 4 minutes, 34 seconds 21,504 views",Minew Shewa Entertainment,21504,21597,93
944,"Ethiopian Music : DJ Sun Eth ft C Low x Lula (Kale) - New Ethiopian Music 2020(Official Video) by Minew Shewa Tube 1 year ago 5 minutes, 1 second 278,126 views",Minew Shewa Entertainment,278126,278585,459
945,"Ethiopian Music : Rahel Tefera ራሄል ተፈራ (ተመችቶኛል)  - New Ethiopian Music 2020(Official Video) by Minew Shewa Tube 1 year ago 4 minutes, 47 seconds 7,801 views",Minew Shewa Entertainment,7801,7814,13
946,"Ethiopian Music : Humnessaa Sarbeechaa (Durbee Warraa) - New Ethiopian Music 2020(Official Video) by Minew Shewa Tube 1 year ago 5 minutes 9,744 views",Minew Shewa Entertainment,9744,9746,2
947,"Ethiopian Music : Lammaa Itichaa (Birraan Bariitee) - New Ethiopian Music 2020(Official Video) by Minew Shewa Tube 1 year ago 6 minutes, 55 seconds 5,626 views",Minew Shewa Entertainment,5626,5630,4
948,"Ethiopian Music : Yemekdela Lijoch የመቅደላ ልጆች (ሰው የለም ወይ)  - New Ethiopian Music 2020(Official Video) by Minew Shewa Tube 1 year ago 6 minutes, 5 seconds 14,385 views",Minew Shewa Entertainment,14385,14387,2
949,"Ethiopian Music : Blen (Konjo LIj) ብሌን (ቆንጆ ልጅ)  - New Ethiopian Music 2020(Official Video) by Minew Shewa Tube 1 year ago 4 minutes, 1 second 9,516 views",Minew Shewa Entertainment,9516,9533,17
950,"Ethiopian Music : Hana Belayneh ሃና በላይነህ (አከነፈኝ) - New Ethiopian Music 2020(Official Video) by Minew Shewa Tube 1 year ago 5 minutes, 43 seconds 14,593 views",Minew Shewa Entertainment,14593,14600,7
951,"Ethiopian Music : Metages Animut መታገስ አንሙት (አሰክስክ)  - New Ethiopian Music 2020(Official Video) by Minew Shewa Tube 1 year ago 6 minutes, 40 seconds 16,396 views",Minew Shewa Entertainment,16396,16403,7
952,ኢትዮጵያውያን ለኢትዮጵያችን (የራስ መስፍን ስለሺ የመታሰብያ ዝግጅት) 4/4 - New Ethiopian Music 2020(Official Video) by Minew Shewa Tube 1 year ago 16 minutes 936 views,Minew Shewa Entertainment,936,936,0
953,"ኢትዮጵያውያን ለኢትዮጵያችን (የራስ መስፍን ስለሺ የመታሰብያ ዝግጅት) 3/4 - New Ethiopian Music 2020(Official Video) by Minew Shewa Tube 1 year ago 23 minutes 1,015 views",Minew Shewa Entertainment,1015,1015,0
954,"ኢትዮጵያውያን ለኢትዮጵያችን (የራስ መስፍን ስለሺ የመታሰብያ ዝግጅት) 2/4 - New Ethiopian Music 2020(Official Video) by Minew Shewa Tube 1 year ago 4 minutes, 30 seconds 4,023 views",Minew Shewa Entertainment,4023,4024,1
955,"ኢትዮጵያውያን ለኢትዮጵያችን (የራስ መስፍን ስለሺ የመታሰብያ ዝግጅት) 1/4 - New Ethiopian Music 2020(Official Video) by Minew Shewa Tube 1 year ago 26 minutes 1,056 views",Minew Shewa Entertainment,1056,1056,0
956,"Ethiopian Music : Teshale Mekonnen (Hagere) ተሻለ መኮንን (ሀገሬ) New Ethiopian Music 2020(Official Video) by Minew Shewa Tube 1 year ago 5 minutes, 8 seconds 12,219 views",Minew Shewa Entertainment,12219,12253,34
957,"Ethiopian Music : Daniel Girma ዳንኤል ግርማ (ንገሪኝ)  - New Ethiopian Music 2020(Official Video) by Minew Shewa Tube 1 year ago 3 minutes, 41 seconds 5,585 views",Minew Shewa Entertainment,5585,5586,1
958,"Ethiopian Music: Ali baba (Wello Gerageru) አሊ ባባ (ወሎ ገራገሩ) New Ethiopian Music 2020(Official Video) by Minew Shewa Tube 1 year ago 4 minutes, 59 seconds 15,437 views",Minew Shewa Entertainment,15437,15461,24
959,"Ethiopian Music : Addisuu Girmaa (Shaggar Qarre) - New Ethiopian Music 2020(Official Video) by Minew Shewa Tube 1 year ago 5 minutes, 20 seconds 4,793 views",Minew Shewa Entertainment,4793,4800,7
960,"Ethiopian Music : Sami Getu (Sdidi) ሳሚ ጌቱ (ስዲዲ) - New Ethiopian Music 2020(Official Video) by Minew Shewa Tube 1 year ago 6 minutes, 8 seconds 18,302 views",Minew Shewa Entertainment,18302,18310,8
961,"Abraraw & Kefyalew አብራራው እና ከፍያለው (ኑ እንማር)  - New Ethiopian Music 2020(Official Video) by Minew Shewa Tube 1 year ago 5 minutes, 47 seconds 7,079 views",Minew Shewa Entertainment,7079,7080,1
962,"Tamrat Derib x Yared Dereje ታምራት ደርብ x ያሬድ ደረጄ (ኬቲ)  - New Ethiopian Music 2020(Official Video) by Minew Shewa Tube 1 year ago 5 minutes, 5 seconds 9,440 views",Minew Shewa Entertainment,9440,9461,21
963,"Ethiopian Music : Adu x Kaleab (Tenes) አዱ x ቃለአብ (ተነስ)  - New Ethiopian Music 2020(Official Video) by Minew Shewa Tube 1 year ago 3 minutes, 45 seconds 3,206 views",Minew Shewa Entertainment,3206,3210,4
964,"Ethiopian Music : Hilina Yirga ህሊና ይርጋ (እንዴት ልመን) - New Ethiopian Music 2020(Official Video) by Minew Shewa Tube 1 year ago 4 minutes, 40 seconds 55,272 views",Minew Shewa Entertainment,55272,55328,56
965,"Zackarias Eyassu (Enateye) ዘካርያስ ኢያሱ (እናትዬ) - New Ethiopian Music 2020(Official Video) by Minew Shewa Tube 1 year ago 4 minutes, 13 seconds 7,549 views",Minew Shewa Entertainment,7549,7554,5
966,"Ethiopian Music : Lij Abebe Mamo ልጅ አበበ ማሞ (ቅሪብኝ) - New Ethiopian Music 2020(Official Audio) by Minew Shewa Tube 1 year ago 3 minutes, 34 seconds 5,916 views",Minew Shewa Entertainment,5916,5925,9
967,"Ethiopian Music : Esayas (Adera) ኢሳያስ (አደራ)  - New Ethiopian Music 2020(Official Video) by Minew Shewa Tube 1 year ago 7 minutes, 36 seconds 12,098 views",Minew Shewa Entertainment,12098,12099,1
968,"Ethiopian Music : Mekuwanint Birhanu መኳንንት ብርሃኑ (እስኪ ላነሳሳሽ) New Ethiopian Music 2020(Official Video) by Minew Shewa Tube 1 year ago 8 minutes, 27 seconds 5,500 views",Minew Shewa Entertainment,5500,5503,3
969,"Fikru Wesene (Yene Desta) ፍቅሩ ወሰኔ (የኔ ደስታ) - New Ethiopian Music 2020(Official Video) by Minew Shewa Tube 1 year ago 4 minutes, 39 seconds 15,373 views",Minew Shewa Entertainment,15373,15388,15
970,"Ethiopian Music : Ze Lucy (ዘ ሉሲ) ሴት አይደለሽም እንዴ  - New Ethiopian Music 2020(Official Video) by Minew Shewa Tube 1 year ago 3 minutes, 21 seconds 29,465 views",Minew Shewa Entertainment,29465,29480,15
971,"Betty G x Asrat Aluba ቤቲ ጂ x አስራት አሉባ (ኖዮዶ) - New Ethiopian Music 2020(Official Video) by Minew Shewa Tube 1 year ago 4 minutes, 46 seconds 123,094 views",Minew Shewa Entertainment,123094,123172,78
972,"Ethiopian Music : Jelli ft Bubu Meda (Hachi Kalo) - New Ethiopian Music 2020(Official Video) by Minew Shewa Tube 1 year ago 4 minutes, 29 seconds 19,875 views",Minew Shewa Entertainment,19875,19912,37
973,"Ethiopian Music : Gebreshet Bitew ገብርሸት ቢተው (ወንድ የወለደው)  - New Ethiopian Music 2020(Official Video) by Minew Shewa Tube 1 year ago 4 minutes, 10 seconds 73,630 views",Minew Shewa Entertainment,73630,73729,99
974,"Asnake Ayalew (Wedagn New) አስናቀ አያሌው (ወዳኝ ነው) - New Ethiopian Music 2020(Official Video) by Minew Shewa Tube 1 year ago 6 minutes, 1 second 57,261 views",Minew Shewa Entertainment,57261,57283,22
975,"Ethiopian Music : Edil X Kiya -Enesu እድል X ኪያ (እነሱ) - New Ethiopian Music 2020(Official Video) by Minew Shewa Tube 1 year ago 4 minutes, 54 seconds 10,103 views",Minew Shewa Entertainment,10103,10170,67
976,"Ethiopian Music : Gene Amare ገኔ አማረ(ቁመቴ እንኳን አጥሮ) - New Ethiopian Music 2020(Official Video) by Minew Shewa Tube 1 year ago 5 minutes, 10 seconds 13,146 views",Minew Shewa Entertainment,13146,13169,23
977,"Ethiopian Music: Yezina Negash የዝና ነጋሽ (ዳኘው ሚኒልክ)New Ethiopian Music 2020(Official Video) by Minew Shewa Tube 2 years ago 7 minutes, 18 seconds 255,571 views",Minew Shewa Entertainment,255571,255824,253
978,"Ethiopian Music : Wendimu Tesfa ወንድሙ ተስፋ (ፍቅር ይበልጣል)  - New Ethiopian Music 2020(Official Video) by Minew Shewa Tube 2 years ago 5 minutes, 37 seconds 10,766 views",Minew Shewa Entertainment,10766,10768,2
979,"Ethiopian Music : Selam Gonderewa (Ateyut) ሰላም ጎንደሬዋ (አትዩት) New Ethiopian Music 2020(Official Video) by Minew Shewa Tube 2 years ago 5 minutes, 49 seconds 8,042 views",Minew Shewa Entertainment,8042,8047,5
980,"Ethiopian Music : Kirubel Daniel ኪሩቤል ዳንኤል (አልሆንሽም) - New Ethiopian Music 2020(Official Video) by Minew Shewa Tube 2 years ago 6 minutes, 9 seconds 8,745 views",Minew Shewa Entertainment,8745,8749,4
981,"Ethiopian Music : Teka Dereso ተካ ደረሶ (አይንሻን ልየው)  - New Ethiopian Music 2020(Official Video) by Minew Shewa Tube 2 years ago 3 minutes, 43 seconds 4,147 views",Minew Shewa Entertainment,4147,4149,2
982,"Ethiopian Music : Zeyed Hana Asmare Natnael (አነሳ ጠመንጃ) - New Ethiopian Music 2020(Official Video) by Minew Shewa Tube 2 years ago 9 minutes, 44 seconds 1,036,198 views",Minew Shewa Entertainment,1036198,1038411,2213
983,"Ethiopian Music : Teref Kasahun (Demo'Na) ጠረፍ ካሳሁን (ደሞ'ና) - New Ethiopian Music 2020(Official Video) by Minew Shewa Tube 2 years ago 4 minutes, 49 seconds 718,609 views",Minew Shewa Entertainment,718609,720066,1457
984,"Ethiopian Music : Dawit ft Hana (Gofere) ዳዊት ft ሃና (ጎፈሬ) - New Ethiopian Music 2020(Official Video) by Minew Shewa Tube 2 years ago 5 minutes, 50 seconds 6,385 views",Minew Shewa Entertainment,6385,6392,7
985,"Ethiopian Music: Hayleyesus Eshetu (Luba) ኃይለየሱስ እሸቱ (ሉባ) New Ethiopian Music 2020(Official Video) by Minew Shewa Tube 2 years ago 6 minutes, 41 seconds 7,082 views",Minew Shewa Entertainment,7082,7091,9
986,"Ethiopian Music : Abeselom Tsegaye አቤሴሎም ፀጋዬ (እንድያ ነው እንዴ) New Ethiopian Music 2020(Official Video) by Minew Shewa Tube 2 years ago 3 minutes, 59 seconds 7,288 views",Minew Shewa Entertainment,7288,7296,8
987,"Ethiopian Music: Zebider Assefa (Wendata) ዘቢደር አሰፋ (ወንዳታ) - New Ethiopian Music 2020(Official Video) by Minew Shewa Tube 2 years ago 4 minutes, 55 seconds 12,923 views",Minew Shewa Entertainment,12923,12938,15
988,"Ethiopian Music: Asrat Mesay (Zenbel bey) አስራት መሳይ (ዘንበል በይ)New Ethiopian Music 2020(Official Video) by Minew Shewa Tube 2 years ago 4 minutes, 13 seconds 12,282 views",Minew Shewa Entertainment,12282,12308,26
989,"Zemzem Shifa (Ani Sinjalele) ዘምዘም ሺፋ (አኒ ስንጃለሌ)  - New Ethiopian Music 2020(Official Video) by Minew Shewa Tube 2 years ago 5 minutes, 45 seconds 1,870 views",Minew Shewa Entertainment,1870,1873,3
990,"Zemzem Shifa (Demulsieyie) ዘምዘም ሺፋ (ደሙለሴዬ) - New Ethiopian Music 2020(Official Video) by Minew Shewa Tube 2 years ago 4 minutes, 54 seconds 1,777 views",Minew Shewa Entertainment,1777,1777,0
991,"Ethiopian Music : Zemzem Shifa (Ashema) ዘምዘም ሺፋ (አሸማ) - New Ethiopian Music 2020(Official Video) by Minew Shewa Tube 2 years ago 5 minutes, 30 seconds 3,376 views",Minew Shewa Entertainment,3376,3379,3
992,"Ethiopian Music : Zemzem Shifa (Hiyase) ዘምዘም ሺፋ (ሂያሴ) - New Ethiopian Music 2020(Official Video) by Minew Shewa Tube 2 years ago 3 minutes, 48 seconds 1,712 views",Minew Shewa Entertainment,1712,1713,1
993,"Ethiopian Music : Zemzem Shifa (Yahababo) ዘምዘም ሺፋ (ያሃባቦ) - New Ethiopian Music 2020(Official Video) by Minew Shewa Tube 2 years ago 5 minutes, 20 seconds 1,603 views",Minew Shewa Entertainment,1603,1603,0
994,"Ethiopian Music : Zemzem Shifa (Ohole) ዘምዘም ሺፋ (ኦሆሌ)  - New Ethiopian Music 2020(Official Video) by Minew Shewa Tube 2 years ago 5 minutes, 25 seconds 1,297 views",Minew Shewa Entertainment,1297,1298,1
995,"Ethiopian Music : Zemzem Shifa (Afake) ዘምዘም ሺፋ (አፋኬ) - New Ethiopian Music 2020(Official Video) by Minew Shewa Tube 2 years ago 6 minutes, 18 seconds 1,830 views",Minew Shewa Entertainment,1830,1831,1
996,"Ethiopian Music : Zemzem Shifa (Jemereto) ዘምዘም ሺፋ (ጀመሬቶ) - New Ethiopian Music 2020(Official Video) by Minew Shewa Tube 2 years ago 4 minutes, 53 seconds 2,005 views",Minew Shewa Entertainment,2005,2005,0
997,"Ethiopian Music : Zemzem Shifa (Aye) ዘምዘም ሺፋ (አዬ) - New Ethiopian Music 2020(Official Video) by Minew Shewa Tube 2 years ago 6 minutes, 36 seconds 1,802 views",Minew Shewa Entertainment,1802,1804,2
998,"Ethiopian Music : Zemzem Shifa (Aweya) ዘምዘም ሺፋ (አወያ) - New Ethiopian Music 2020(Official Video) by Minew Shewa Tube 2 years ago 4 minutes, 27 seconds 3,702 views",Minew Shewa Entertainment,3702,3706,4
999,"Ethiopian Music : Alem Admassu (Azmerina) ዓለም አድማሱ (አዝምሪና)- New Ethiopian Music 2020(Official Video) by Minew Shewa Tube 2 years ago 5 minutes, 11 seconds 5,817 views",Minew Shewa Entertainment,5817,5824,7
1000,"Ethiopian Music : Alamuu Baayyuu (Taliilee) - New Ethiopian Music 2020(Official Video) by Minew Shewa Tube 2 years ago 6 minutes, 43 seconds 4,013 views",Minew Shewa Entertainment,4013,4018,5
1001,"Ethiopian Music : Daniel Yohannes (Mayaye) ዳንኤል ዮሐንስ (ማያዬ)  New Ethiopian Music 2020(Official Video) by Minew Shewa Tube 2 years ago 4 minutes, 16 seconds 4,383 views",Minew Shewa Entertainment,4383,4387,4
1002,"Dani Man (Eskemayesh) ዳኒ ማን (እስከማይሽ) New Ethiopian Music 2020(Official Video) by Minew Shewa Tube 2 years ago 5 minutes, 24 seconds 15,427 views",Minew Shewa Entertainment,15427,15434,7
1003,"Ethiopian Music : Fellynova (Ethiopop) ኢትዮፖፕ  - New Ethiopian Music 2020(Official Video) by Minew Shewa Tube 2 years ago 4 minutes, 7 seconds 3,343 views",Minew Shewa Entertainment,3343,3343,0
1004,"Ethiopian Music: Fikerte Abebe (An'kitani) ፍቅርተ አበበ New Ethiopian Music 2020(Official Video) by Minew Shewa Tube 2 years ago 5 minutes, 38 seconds 9,980 views",Minew Shewa Entertainment,9980,9986,6
1005,"Ethiopian Music : Sefen Mohamoud ሰፈን መሐመድ (ፍቅራችን)  - New Ethiopian Music 2020(Official Video) by Minew Shewa Tube 2 years ago 4 minutes, 41 seconds 4,876 views",Minew Shewa Entertainment,4876,4878,2
1006,"Estegenet Hailemariam (Shi Gize) እፅገነት ሃይለማርያም (ሺ ጊዜ)  - New Ethiopian Music 2020(Official Video) by Minew Shewa Tube 2 years ago 4 minutes, 34 seconds 287,875 views",Minew Shewa Entertainment,287875,288626,751
1007,"Ethiopian Music : Frezer Kenaw ፍሬዘር ቀናው (ህያበይ)  - New Ethiopian Music 2020(Official Video) by Minew Shewa Tube 2 years ago 4 minutes, 37 seconds 189,207 views",Minew Shewa Entertainment,189207,190720,1513
1008,"Ethiopian Music : Elias T/Haymanot ኤልያስ ተ/ሃይማኖት (ድንብር)  - New Ethiopian Music 2020(Official Video) by Minew Shewa Tube 2 years ago 4 minutes, 41 seconds 397,563 views",Minew Shewa Entertainment,397563,397906,343
1009,"Dimiko X Nk5 X Mule King (Enka Selamta) እንካ ሰላምታ - New Ethiopian Music 2020(Official Video) by Minew Shewa Tube 2 years ago 4 minutes, 24 seconds 6,401 views",Minew Shewa Entertainment,6401,6431,30
1010,"Ethiopian Music : Anteneh Lamma (Ni Haftaaree) - New Ethiopian Music 2020(Official Video) by Minew Shewa Tube 2 years ago 6 minutes, 57 seconds 5,935 views",Minew Shewa Entertainment,5935,5966,31
1011,"Yeshambel Aregaw (Tesemagn) የሻምበል አረጋው (ተሰማኝ)  - New Ethiopian Music 2020(Official Video) by Minew Shewa Tube 2 years ago 5 minutes, 35 seconds 6,224 views",Minew Shewa Entertainment,6224,6227,3
1012,"Ethiopian Music : Seble Zemichael ሰብለ ዘሚካኤል (ላቆለጳጵሰው) - New Ethiopian Music 2020(Official Video) by Minew Shewa Tube 2 years ago 4 minutes, 33 seconds 8,573 views",Minew Shewa Entertainment,8573,8577,4
1013,"Ethiopian Music : Abush (Erefu) አቡሽ (እረፉ) - New Ethiopian Music 2020(Official Video) by Minew Shewa Tube 2 years ago 4 minutes, 55 seconds 5,248 views",Minew Shewa Entertainment,5248,5276,28
1014,"Ethiopian Music : Melke Tadelle መልኬ ታደለ (ና በላይ) - New Ethiopian Music 2020(Official Video) by Minew Shewa Tube 2 years ago 8 minutes, 56 seconds 142,104 views",Minew Shewa Entertainment,142104,142205,101
1015,"Ethiopian Music : Dajannee Guudataa (damee isaduma) - New Ethiopian Music 2020(Official Video) by Minew Shewa Tube 2 years ago 5 minutes, 11 seconds 5,463 views",Minew Shewa Entertainment,5463,5469,6
1016,"Ethiopian Music : Mekdes Esubalew መቅደስ እሱባለው (ሳሳሁ) - New Ethiopian Music 2020(Official Video) by Minew Shewa Tube 2 years ago 4 minutes, 43 seconds 8,215 views",Minew Shewa Entertainment,8215,8225,10
1017,"Ethiopian Music : Bezabih Birhanu በዛብህ ብርሃኑ (የይሁዳ ገመድ)  - New Ethiopian Poem 2020(Official Video) by Minew Shewa Tube 2 years ago 6 minutes, 12 seconds 6,165 views",Minew Shewa Entertainment,6165,6171,6
1018,"Merkeb Baryagabr (Bonitua) Ft Fana Abrha & Mesfen Brhanu ""Marsh Keyr""  New Ethiopian Music 2020. by Minew Shewa Tube 2 years ago 5 minutes, 16 seconds 2,637,044 views",Minew Shewa Entertainment,2637044,2647828,10784
1019,"Henok Getachew ft Gildo Kassa ሄኖክ ጌታቸው ft ጊልዶ ካሳ (ብሶብኛል) - New Ethiopian Music 2020(Official Video) by Minew Shewa Tube 2 years ago 4 minutes, 45 seconds 5,535,691 views",Minew Shewa Entertainment,5535691,5570395,34704
1020,"Mikyas Cherenet (Ahun Gebagn) ሚክያስ ቸርነት (አሁን ገባኝ)  - New Ethiopian Music 2020(Official Video) by Minew Shewa Tube 2 years ago 6 minutes, 45 seconds 5,740,992 views",Minew Shewa Entertainment,5740992,5780866,39874
1021,"Ethiopian Music : Meseret Demere መሰረት ደመረ (ብወድህ)  - New Ethiopian Music 2020(Official Video) by Minew Shewa Tube 2 years ago 4 minutes, 52 seconds 70,558 views",Minew Shewa Entertainment,70558,70683,125
1022,"Ethiopian Music : Lookoo Ashanee (Aagaroo) - New Ethiopian Music 2020(Official Video) by Minew Shewa Tube 2 years ago 5 minutes, 23 seconds 80,086 views",Minew Shewa Entertainment,80086,80931,845
1023,"Ethiopian Music : Henok Arage (Fegeg Bey) ሄኖክ አራጌ (ፈገግ በይ) New Ethiopian Music 2020(Official Video) by Minew Shewa Tube 2 years ago 5 minutes, 25 seconds 14,196 views",Minew Shewa Entertainment,14196,14216,20
1024,"Ethiopian Music : Yirgalem Desalegn ይርጋዓለም ደሳለኝ (ኢትዮጵያ ሀገሬ) New Ethiopian Music 2020(Official Video) by Minew Shewa Tube 2 years ago 5 minutes, 33 seconds 4,172 views",Minew Shewa Entertainment,4172,4173,1
1025,"Ethiopian Music : Dajannee Guudataa - (dhagahuu dhagahuu) - New Ethiopian Music 2020(Official Video) by Minew Shewa Tube 2 years ago 5 minutes, 2 seconds 5,292 views",Minew Shewa Entertainment,5292,5294,2
1026,"Ethiopian Music : Zulfa Kemal (Sera) ዙልፋ ከማል (ሴራ)  - New Ethiopian Music 2020(Official Video) by Minew Shewa Tube 2 years ago 5 minutes, 32 seconds 63,191 views",Minew Shewa Entertainment,63191,63705,514
1027,"Ethiopian Music : Netsanet Meresa (Ezweti) ነፃነት መረሳ (እዝውቲ) - New Ethiopian Music 2020(Official Video by Minew Shewa Tube 2 years ago 5 minutes, 13 seconds 11,364 views",Minew Shewa Entertainment,11364,11380,16
1028,"Teddy Yo. Ft Merkeb Bonitua ቴዲ ዮ ft መርከብ ቦኒቷ (ስደድለይ)  - New Ethiopian Music 2020(Official Video) by Minew Shewa Tube 2 years ago 4 minutes, 49 seconds 4,108,433 views",Minew Shewa Entertainment,4108433,4141045,32612
1029,"Ethiopian Music : Likawent Mamo ሊቃውንት ማሞ (በይ ነይ) - New Ethiopian Music 2020(Official Video) by Minew Shewa Tube 2 years ago 4 minutes, 41 seconds 8,438 views",Minew Shewa Entertainment,8438,8445,7
1030,"Sara Takele (Sirtana) ft Gildo (Bekagn) ሲርታና ft ጊልዶ (በቃኝ) New Ethiopian Music 2020(Official Video) by Minew Shewa Tube 2 years ago 4 minutes, 20 seconds 620,763 views",Minew Shewa Entertainment,620763,622664,1901
1031,"Ethiopian Music : Beza Kulu (Wub Konjo) ቤዛ ኩሉ (ውብ ቆንጆ)  - New Ethiopian Music 2020(Official Video) by Minew Shewa Tube 2 years ago 5 minutes, 10 seconds 7,341 views",Minew Shewa Entertainment,7341,7373,32
1032,"Ethiopian Music : Dawit Adane (Geredo) ዳዊት አዳነ (ገረዶ)  - New Ethiopian Music 2020(Official Video) by Minew Shewa Tube 2 years ago 5 minutes, 53 seconds 8,254 views",Minew Shewa Entertainment,8254,8255,1
1033,"Henok Ijarge (Motkulish Wedaje) ሄኖክ እጃርጌ (ሞትኩልሽ ወዳጄ) - New Ethiopian Music 2020(Official Video) by Minew Shewa Tube 2 years ago 4 minutes, 48 seconds 30,427 views",Minew Shewa Entertainment,30427,30433,6
1034,"Selamawit Abitew (Tsehaytu) ሰላማዊት አብተው (ፀሐይቱ) - New Ethiopian Music 2020(Official Video) by Minew Shewa Tube 2 years ago 6 minutes, 16 seconds 52,304 views",Minew Shewa Entertainment,52304,52369,65
1035,"Samrawit Tadesse (Histin Wostoo) ሳምራዊት ታደሰ - New Ethiopian Music 2020(Official Video) by Minew Shewa Tube 2 years ago 4 minutes, 19 seconds 11,634 views",Minew Shewa Entertainment,11634,11642,8
1036,"Ethiopian Music : Ararsa Gebisa (Hidda Abbichu) - New Ethiopian Music 2020(Official Video) by Minew Shewa Tube 2 years ago 5 minutes, 4 seconds 19,574 views",Minew Shewa Entertainment,19574,19684,110
1037,"Ermias Zerihun (Kuratun Tey) ኤርምያስ ዘሪሁን (ኩራቱን ተይ) - New Ethiopian Music 2020(Official Video) by Minew Shewa Tube 2 years ago 4 minutes, 30 seconds 8,447 views",Minew Shewa Entertainment,8447,8458,11
1038,"Ethiopian Music : Beenyaa Dhaabaa (Hin Jettuu Maallinnii) - New Ethiopian Music 2020(Official Video) by Minew Shewa Tube 2 years ago 5 minutes, 37 seconds 6,941 views",Minew Shewa Entertainment,6941,6958,17
1039,"Ethiopian Music : Naridos Mengistu (Maiikan)  - New Ethiopian Music 2020(Official Video) by Minew Shewa Tube 2 years ago 5 minutes, 18 seconds 3,928 views",Minew Shewa Entertainment,3928,3930,2
1040,"Ethiopian Music: Tasfayee Lagesee (Irreechii Irreekeenyaa) New Ethiopian Music 2020(Official Video) by Minew Shewa Tube 2 years ago 5 minutes, 42 seconds 3,303 views",Minew Shewa Entertainment,3303,3303,0
1041,"Ethiopian Music : Zerihun Tsegaw ዘሪሁን ፀጋው (ሞት አይፈራም አሉ) - New Ethiopian Music 2020(Official Video) by Minew Shewa Tube 2 years ago 5 minutes, 3 seconds 13,009 views",Minew Shewa Entertainment,13009,13020,11
1042,"Ethiopian Music : Eliyaas Qaabataa (Magallee Tiyyaa) - New Ethiopian Music 2020(Official Video) by Minew Shewa Tube 2 years ago 4 minutes 9,634 views",Minew Shewa Entertainment,9634,9638,4
1043,"Ethiopian Music : Shimeles Debash (Welo) ሽመልስ ደባሽ (ወሎ) - New Ethiopian Music 2020(Official Video by Minew Shewa Tube 2 years ago 5 minutes, 47 seconds 98,073 views",Minew Shewa Entertainment,98073,98173,100
1044,"Ethiopian Music : Abbishuu Alemuu (Oromtittii Sooddoo) - New Ethiopian Music 2020(Official Video) by Minew Shewa Tube 2 years ago 7 minutes, 26 seconds 4,812 views",Minew Shewa Entertainment,4812,4833,21
1045,"Daniel Fisseha (Aman Selam) ዳንኤል ፍስሃ (አማን ሰላም) - New Ethiopian Music 2020(Official Vide0) by Minew Shewa Tube 2 years ago 5 minutes, 31 seconds 10,337 views",Minew Shewa Entertainment,10337,10353,16
1046,"Ethiopian Music : Weyneshet Ayenew ወይንሸት አየነው (የአባይን ልጅ ወዶ) New Ethiopian Music 2020(Official Video) by Minew Shewa Tube 2 years ago 5 minutes, 13 seconds 131,973 views",Minew Shewa Entertainment,131973,132387,414
1047,"Ethiopian Music : Samrawit Ayalew ሳምራዊት አያሌው (ኢትዮጵያዊ ነኝ) - New Ethiopian Music 2020(Official Video) by Minew Shewa Tube 2 years ago 6 minutes, 35 seconds 18,618 views",Minew Shewa Entertainment,18618,18656,38
1048,"Ethiopian Music : Fraol Getachew ፍራኦል ጌታቸው (መወደዷ) - New Ethiopian Music 2020(Official Video) by Minew Shewa Tube 2 years ago 5 minutes, 37 seconds 10,202 views",Minew Shewa Entertainment,10202,10206,4
1049,"Ethiopian Music : Muleye Derso ሙልዬ ደርሶ (ተጠንቀቅ ቁ2) - New Ethiopian Music 2020(Official Video) by Minew Shewa Tube 2 years ago 5 minutes, 10 seconds 17,636 views",Minew Shewa Entertainment,17636,17670,34
1050,"Eritrean Music : Beki Masawa (Konjitey) ቤኪ ማሳዋ (ቆንጂተይ) - New Eritrean Music 2020(Official Video) by Minew Shewa Tube 2 years ago 3 minutes, 39 seconds 5,255 views",Minew Shewa Entertainment,5255,5262,7
1051,"Ethiopian Music : Degu Tesfaye (Arada) ደጉ ተስፋዬ (አራዳ)  - New Ethiopian Music 2020(Official Video) by Minew Shewa Tube 2 years ago 5 minutes, 47 seconds 10,878 views",Minew Shewa Entertainment,10878,10907,29
1052,"Ethiopian Music : Zulfa Kemal (Ama'Lemo) ዙልፋ ከማል (አማ'ለሞ) - New Ethiopian Music 2020(Official Video) by Minew Shewa Tube 2 years ago 5 minutes, 3 seconds 62,934 views",Minew Shewa Entertainment,62934,63645,711
1053,"Addis Aragaw (Alehulish Libel)  አዲስ አርጋው (አለሁልሽ ልበል) - New Ethiopian Music 2020(Official Video) by Minew Shewa Tube 2 years ago 6 minutes, 31 seconds 6,019 views",Minew Shewa Entertainment,6019,6039,20
1054,"Admasu Wana (Kobelelch Alu) አድማሱ ዋና (ኮበለለች አሉ) - New Ethiopian Music 2020(Official Video) by Minew Shewa Tube 2 years ago 5 minutes, 45 seconds 131,284 views",Minew Shewa Entertainment,131284,131488,204
1055,"Ethiopian Music : Hani Alazar (Lela Lela) ሃኒ አላዛር (ሌላ ሌላ) - New Ethiopian Music 2020(Official Video) by Minew Shewa Tube 2 years ago 3 minutes, 57 seconds 16,726 views",Minew Shewa Entertainment,16726,16737,11
1056,"Ethiopian Music : Meles Tefera (Hodyabaw) መለስ ተፈራ (ሆድያባው) New Ethiopian Music 2020(Official Video) by Minew Shewa Tube 2 years ago 7 minutes 15,921 views",Minew Shewa Entertainment,15921,15970,49
1057,"Ethiopian Music : Gizachew Tadesse ግዛቸው ታደሰ (አምሳያም የላት) - New Ethiopian Music 2020(Official Video) by Minew Shewa Tube 2 years ago 6 minutes, 15 seconds 23,982 views",Minew Shewa Entertainment,23982,24023,41
1058,"Yilma Shewa (Yeshewa Abeba) ይልማ ሸዋ (የሽዋ አበባ) - New Ethiopian Music 2020(Official Video) by Minew Shewa Tube 2 years ago 6 minutes, 28 seconds 516,368 views",Minew Shewa Entertainment,516368,517648,1280
1059,"Robel Mideksa & Zebiba Girma (Temeles) ሮቤል ሚዴቅሳ እና ዘቢባ ግርማ (ተመለስ)- New Ethiopian Music 2020 by Minew Shewa Tube 2 years ago 5 minutes, 52 seconds 2,559,125 views",Minew Shewa Entertainment,2559125,2580809,21684
1060,"Ethiopian Music : Derejaw Habte ደረጃው ሀብቴ (ገዳይ ሲያረፋፍድ)  - New Ethiopian Music 2020(Official Video) by Minew Shewa Tube 2 years ago 6 minutes, 2 seconds 1,428,891 views",Minew Shewa Entertainment,1428891,1431728,2837
1061,"Ethiopian Music : Bazu Man ባዙ ማን (የእናትሽ ነው እንዴ)  - New Ethiopian Music 2020(Official Video) by Minew Shewa Tube 2 years ago 6 minutes, 48 seconds 11,421 views",Minew Shewa Entertainment,11421,11457,36
1062,"Ethiopian Music: Abi ft Afro(Temekerech) አቢ እና አፍሮ(ተመከረች) New Ethiopian Music 2020(Official Video) by Minew Shewa Tube 2 years ago 4 minutes, 20 seconds 6,085 views",Minew Shewa Entertainment,6085,6092,7
1063,"Ethiopian Music : Tesfaye Assefa (Weyneye) ተስፋዬ አሰፋ (ወይንዬ) New Ethiopian Music 2020(Official Video) by Minew Shewa Tube 2 years ago 6 minutes, 40 seconds 19,392 views",Minew Shewa Entertainment,19392,19434,42
1064,"Ethiopian Music : Temesgen Arega (Yihuna) ተመስገን አረጋ (ይሁና) - New Ethiopian Music 2020(Official Video) by Minew Shewa Tube 2 years ago 6 minutes, 8 seconds 4,456 views",Minew Shewa Entertainment,4456,4465,9
1065,"Ethiopian Music : Okaash Ahmad (Goonii Gubbaa) - New Ethiopian Music 2020(Official Video) by Minew Shewa Tube 2 years ago 5 minutes, 54 seconds 6,980 views",Minew Shewa Entertainment,6980,7002,22
1066,"Asheber Belay (Mushera Nesh Gondar) አሸብር በላይ (ሙሽራ ነሽ ጎንደር) New Ethiopian Music 2019(Official Video) by Minew Shewa Tube 2 years ago 5 minutes, 52 seconds 230,310 views",Minew Shewa Entertainment,230310,230409,99
1067,"Ethiopian Music : Letebirhan Kifle ለተብርሃን ክፍሌ (ዕዛዘይ) - New Ethiopian Music 2020(Official Video) by Minew Shewa Tube 2 years ago 4 minutes, 57 seconds 6,467 views",Minew Shewa Entertainment,6467,6469,2
1068,"Tazebachew Demelash (Nama Nama) ታዘባቸው ደመላሽ (ናማ ናማ) - New Ethiopian Music 2020(Official Video) by Minew Shewa Tube 2 years ago 6 minutes, 55 seconds 83,666 views",Minew Shewa Entertainment,83666,83697,31
1069,"Ethiopian Music : Addisu Girma አዲሱ ግርማ (ተፈጥሬ) - New Ethiopian Music 2020(Official Video) by Minew Shewa Tube 2 years ago 5 minutes, 52 seconds 3,414 views",Minew Shewa Entertainment,3414,3417,3
1070,"Ethiopian Music : Biqilla (Lookoo Liyyaa) - New Ethiopian Music 2020(Official Video) by Minew Shewa Tube 2 years ago 6 minutes, 24 seconds 4,323 views",Minew Shewa Entertainment,4323,4326,3
1071,"Ethiopian Music : Mastewal Chane ማስተዋል ጫኔ (እጅ ስጥ አለኝ) - New Ethiopian Music 2020(Official Video) by Minew Shewa Tube 2 years ago 6 minutes, 10 seconds 387,987 views",Minew Shewa Entertainment,387987,388340,353
1072,"Ethiopian Music : Liyu Gezu (Adiyo) ልዩ ገዙ (አዲዮ)  - New Ethiopian Music 2020(Official Video) by Minew Shewa Tube 2 years ago 4 minutes, 48 seconds 11,179 views",Minew Shewa Entertainment,11179,11221,42
1073,"Dagmawit Tsehaye (waza newey) ዳግማዊት ፀሐይ (ዋዛ ነ'ወይ) - New Ethiopian Music 2020(Official Video) by Minew Shewa Tube 2 years ago 4 minutes, 11 seconds 365,246 views",Minew Shewa Entertainment,365246,365735,489
1074,"Ethiopian Music : Muluken Haregu (Gihon) ሙሉቀን ሐረጉ (ጊዮን) - New Ethiopian Music 2020(Official Video) by Minew Shewa Tube 2 years ago 6 minutes, 17 seconds 13,192 views",Minew Shewa Entertainment,13192,13198,6
1075,"Tirusew Sisay (Yejama Lej) ጥሩሰው ሲሳይ (የጃማ ልጅ) - New Ethiopian Music 2020(Official Vide) by Minew Shewa Tube 2 years ago 6 minutes, 5 seconds 9,637 views",Minew Shewa Entertainment,9637,9662,25
1076,"Ethiopian Music : Mafi Afro (Lene Beye) ማፊ አፍሮ (ለኔ ብዬ)  - New Ethiopian Music 2020(Official Video) by Minew Shewa Tube 2 years ago 4 minutes, 45 seconds 3,056,069 views",Minew Shewa Entertainment,3056069,3080918,24849
1077,"Ethiopian Music : Simmany Maammoo (Badhaasa Koo) - New Ethiopian Music 2020(Official Video) by Minew Shewa Tube 2 years ago 5 minutes, 46 seconds 101,093 views",Minew Shewa Entertainment,101093,101272,179
1078,"Ethiopian Music : Dawit Kastero (Ethio-Addis) - New Ethiopian Music 2020(Official Video) by Minew Shewa Tube 2 years ago 4 minutes, 39 seconds 18,878 views",Minew Shewa Entertainment,18878,18918,40
1079,"Ethiopian Music : Maritu Legesse (Kemekem) ማሪቱ ለገሰ (ከመከም) - New Ethiopian Music 2020(Official Video) by Minew Shewa Tube 2 years ago 5 minutes, 6 seconds 469,920 views",Minew Shewa Entertainment,469920,472548,2628
1080,"Ragi Moss ft. Sofi Mic & Samri (Semi) | ስሚ - New Ethiopian Music 2020(Official Video) by Minew Shewa Tube 2 years ago 5 minutes, 7 seconds 7,077 views",Minew Shewa Entertainment,7077,7085,8
1081,"Ethiopian Music : Mekdelawit Gizaw መቅደላዊት ግዛው (እየረታኝ)  - New Ethiopian Music 2020(Official Video) by Minew Shewa Tube 2 years ago 5 minutes, 13 seconds 10,535 views",Minew Shewa Entertainment,10535,10542,7
1082,"Ethiopian Music : Ifaa Mul'ataa (AMBOO GUBBAA) - New Ethiopian Music 2020(Official Video) by Minew Shewa Tube 2 years ago 6 minutes, 1 second 13,523 views",Minew Shewa Entertainment,13523,13631,108
1083,"Ethiopian Music : Wabi Eshete ዋቢ እሸቴ (በይ እንቺ)  - New Ethiopian Music 2020(Official Video) by Minew Shewa Tube 2 years ago 5 minutes, 13 seconds 13,664 views",Minew Shewa Entertainment,13664,13673,9
1084,"Ethiopian Music: Dawit Amsalu (Lanesasaw) ዳዊት አምሳሉ (ላነሳሳው) New Ethiopian Music 2020(Official Video) by Minew Shewa Tube 2 years ago 5 minutes, 51 seconds 29,514 views",Minew Shewa Entertainment,29514,29589,75
1085,"Ethiopian Music : Teshome Aklilu ተሾመ አክሊሉ (አዳም ብሔር የለውም) - New Ethiopian Music 2020(Official Video) by Minew Shewa Tube 2 years ago 6 minutes, 59 seconds 22,769 views",Minew Shewa Entertainment,22769,22783,14
1086,"Ashenafi Zeberge (Nor Nor) አሸናፊ ዘበርጋ (ኖር ኖር) - New Ethiopian Music 2020(Official Video) by Minew Shewa Tube 2 years ago 5 minutes, 7 seconds 15,771 views",Minew Shewa Entertainment,15771,15795,24
1087,"Ethiopian Music : Dance Habesha ዳንስ ሀበሻ - New Ethiopian Music 2020(Official Video) by Minew Shewa Tube 2 years ago 7 minutes, 14 seconds 214,244 views",Minew Shewa Entertainment,214244,214305,61
1088,"Ethiopian Music : Halewat Hagos ሃለዋት ሓጎስ (ኣነ ጓል'ያቱ) - New Tigrigna Music 2020(Official Video) by Minew Shewa Tube 2 years ago 5 minutes, 8 seconds 112,390 views",Minew Shewa Entertainment,112390,112652,262
1089,"Ethiopian Music : Bisrat Garedew ብስራት ጋረደው (የበላይ የበላይ) - New Ethiopian Music 2020(Official Video) by Minew Shewa Tube 2 years ago 5 minutes, 32 seconds 88,923 views",Minew Shewa Entertainment,88923,89099,176
1090,"Ethiopian Music : Lielina Sebsibe ልዕልና ሰብስቤ (ሴት ናት) - New Ethiopian Music 2020(Official Video) by Minew Shewa Tube 2 years ago 6 minutes, 12 seconds 11,324 views",Minew Shewa Entertainment,11324,11349,25
1091,"Ethiopian Music : Nuti Lamii (Ethiopia Dha)  - New Ethiopian Music 2020(Official Video) by Minew Shewa Tube 2 years ago 6 minutes, 24 seconds 7,829 views",Minew Shewa Entertainment,7829,7835,6
1092,"Ethiopian Music : Caalaa Bayyana - Yaa Ayyaana Waggaa - New Ethiopian Music 2020(Official Video) by Minew Shewa Tube 2 years ago 5 minutes, 33 seconds 7,406 views",Minew Shewa Entertainment,7406,7430,24
1093,"Asfer Ababu (Mere Meragna) አስፈር አባቡ (መሬ መራኛ) - New Ethiopian Music 2020(Official Video) by Minew Shewa Tube 2 years ago 8 minutes, 48 seconds 129,317 views",Minew Shewa Entertainment,129317,129764,447
1094,"Ethiopian Music : Meaza Moges (Leyew) መአዛ ሞገስ (ልየው) - New Ethiopian Music 2019(Official Video) by Minew Shewa Tube 2 years ago 4 minutes, 49 seconds 9,215 views",Minew Shewa Entertainment,9215,9219,4
1095,"Ethiopian Music : Birhaanuu Margaa (Sooreettii Too) - New Ethiopian Music 2019(Official Video) by Minew Shewa Tube 2 years ago 5 minutes, 41 seconds 16,878 views",Minew Shewa Entertainment,16878,17113,235
1096,"PK arada & Merry Mac ፒኬ አራዳ & ሜሪ ማክ (ኢትዮጵያ አራድኛ) - New Ethiopian Music 2019(Official Video) ) by Minew Shewa Tube 2 years ago 5 minutes, 14 seconds 6,267 views",Minew Shewa Entertainment,6267,6273,6
1097,"Ethiopian Music : Qalbeessaa Baay'isaa (Meeqan Darbee) - New Ethiopian Music 2019(Official Video) by Minew Shewa Tube 2 years ago 6 minutes, 8 seconds 6,411 views",Minew Shewa Entertainment,6411,6416,5
1098,"Ethiopian Music : Bayisaa Dabalii (Qeerroon Gaddisaa)  - New Ethiopian Music 2019(Official Video) by Minew Shewa Tube 2 years ago 5 minutes, 43 seconds 3,063 views",Minew Shewa Entertainment,3063,3066,3
1099,"Ethiopian Music : Tigist Buzaayyoo (Eessa Jirta?) - New Ethiopian Music 2019(Official Video) by Minew Shewa Tube 2 years ago 4 minutes, 49 seconds 19,830 views",Minew Shewa Entertainment,19830,19844,14
1100,"Ethiopian Music : Habtamu Yirga ሀብታሙ ይርጋ (ሕያው ነው) - New Ethiopian Music 2019(Official Video) by Minew Shewa Tube 2 years ago 7 minutes, 6 seconds 19,707 views",Minew Shewa Entertainment,19707,19716,9
1101,"Biruk ft Gildo kassa (Bisobignal) ብሩክ ft ጊልዶ ካሳ (ብሶብኛል) - New Ethiopian Music 2019(Official Video) by Minew Shewa Tube 2 years ago 3 minutes, 47 seconds 29,879 views",Minew Shewa Entertainment,29879,30011,132
1102,"Ethiopian Music :- Lense Lemessa ""Amaleemoo Dire"" New Ethiopian Music 2019(Official Video) by Minew Shewa Tube 2 years ago 5 minutes, 27 seconds 23,998 views",Minew Shewa Entertainment,23998,24048,50
1103,"Ethiopian Music : Dj Moss ft Chingling Zeye ዲጄ ሞስ (ዝቅ ዝቅ) - New Ethiopian Music 2019(Official Video) by Minew Shewa Tube 2 years ago 5 minutes, 8 seconds 9,087 views",Minew Shewa Entertainment,9087,9097,10
1104,"Mekuanent Melese & Daniel ""Weynoye"" መኳንንት መለሰ ft ዳንኤል ሃ/ስላሴ ""ወይኖየ"" New Ethiopian Music 2019(Video) by Minew Shewa Tube 2 years ago 6 minutes, 5 seconds 772,598 views",Minew Shewa Entertainment,772598,781293,8695
1105,"Ethiopian Music : Fetene Ababu (Neylgn) ፈጠነ አባቡ (ነይልኝ) - New Ethiopian Music 2019(Official Video) by Minew Shewa Tube 2 years ago 5 minutes, 38 seconds 5,545 views",Minew Shewa Entertainment,5545,5552,7
1106,"Ethiopian Music : Naatii Deddebi'e (Gaaddisa sharro)  - New Ethiopian Music 2019(Official Video) by Minew Shewa Tube 2 years ago 4 minutes, 34 seconds 5,113 views",Minew Shewa Entertainment,5113,5114,1
1107,"Ethiopian Music : Wegene Megersa ወገኔ መገርሳ (እሺ በይኝ) - New Ethiopian Music 2019(Official Video) by Minew Shewa Tube 2 years ago 4 minutes, 13 seconds 6,563 views",Minew Shewa Entertainment,6563,6565,2
1108,"Ethiopian Music : Bekalu Dereje በቃሉ ደረጄ (በንጋት) - New Ethiopian Music 2019(Official Video) by Minew Shewa Tube 2 years ago 5 minutes, 43 seconds 17,255 views",Minew Shewa Entertainment,17255,17265,10
1109,"Ethiopian Music : Lemlem Temesgen ለምለም ተመስገን (ችላ አትበለኝ) - New Ethiopian Music 2019(Official Video) by Minew Shewa Tube 2 years ago 4 minutes, 45 seconds 6,606 views",Minew Shewa Entertainment,6606,6619,13
1110,"Ethiopian Music : Samri Birhanu ሳምሪ ብርሃኑ (ሁሌ አስብሃለው) - New Ethiopian Music 2019(Official Video) by Minew Shewa Tube 2 years ago 4 minutes, 44 seconds 8,537 views",Minew Shewa Entertainment,8537,8548,11
1111,"Ethiopian Music: Melaku Belay (Embi Bel) መላኩ በላይ (እንቢ በል) New Ethiopian Music 2019(Official Video) by Minew Shewa Tube 2 years ago 6 minutes, 26 seconds 496,997 views",Minew Shewa Entertainment,496997,498270,1273
1112,"Temesgen ft Bruk  (Sewnete) ተመስገን ብሩክ (ሰውነቴ) - New Ethiopian Music 2019(Official Video) by Minew Shewa Tube 2 years ago 3 minutes, 54 seconds 6,515 views",Minew Shewa Entertainment,6515,6516,1
1113,"Ethiopian Music : Shimalis Zawuduu (Intalaa abba Gaddaa) - New Ethiopian Music 2019(Official Video) by Minew Shewa Tube 2 years ago 5 minutes, 30 seconds 8,220 views",Minew Shewa Entertainment,8220,8256,36
1114,"Ethiopian Music : Werkeye Mekwanint ወርቅዬ መኳንንት (ገዳይ ናና) - New Ethiopian Music 2019(Official Video) by Minew Shewa Tube 2 years ago 5 minutes, 52 seconds 13,860 views",Minew Shewa Entertainment,13860,13863,3
1115,"Ethiopian Music : Erma Karu ft Don Tony (Maal haa Godhu) - New Ethiopian Music 2019(Official Video) by Minew Shewa Tube 2 years ago 5 minutes, 25 seconds 8,479 views",Minew Shewa Entertainment,8479,8488,9
1116,"Ethiopian Music : Ake Adole (Sixxiqophe) - New Ethiopian Music 2019(Official Video) by Minew Shewa Tube 2 years ago 3 minutes, 45 seconds 6,673 views",Minew Shewa Entertainment,6673,6676,3
1117,"Ethiopian Music: Nola Fila ft Hune ኖላ ፊላ ft ሁኔ (እኔ ማን ነኝ) New Ethiopian Music 2019(Official Video) by Minew Shewa Tube 2 years ago 4 minutes, 41 seconds 5,727 views",Minew Shewa Entertainment,5727,5731,4
1118,"Bishiriyyaa Borshaa (Washii) - New Ethiopian Music 2019(Official Video) by Minew Shewa Tube 2 years ago 5 minutes, 46 seconds 406,729 views",Minew Shewa Entertainment,406729,411136,4407
1119,"Ethiopian Music : Sami Dan ሳሚ ዳን (Anchin Beye አንቺን ብዬ) New Ethiopian Music 2019(Official Video) by Minew Shewa Tube 2 years ago 4 minutes, 9 seconds 69,244 views",Minew Shewa Entertainment,69244,69582,338
1120,"Ethiopian Music : Bizuayehu Berihun ብዙአየሁ በሪሁን (ሰጥቸው አደራ) - New Ethiopian Music 2019(Official Video) by Minew Shewa Tube 2 years ago 6 minutes, 12 seconds 188,623 views",Minew Shewa Entertainment,188623,188713,90
1121,"Ethiopian Music : Mulugeta Shite ሙሉጌታ ሽቴ (መልሺኝ) - New Ethiopian Music 2019(Official Video) by Minew Shewa Tube 2 years ago 5 minutes, 26 seconds 74,922 views",Minew Shewa Entertainment,74922,75471,549
1122,"Ethiopian Music : Zintalem Bayeh ዝንታለም ባየህ (እንደገና) - New Ethiopian Music 2019(Official Video) by Minew Shewa Tube 2 years ago 6 minutes, 4 seconds 45,132 views",Minew Shewa Entertainment,45132,45152,20
1123,"Ethiopian Music : Hana Yigezu ሃና ይገዙ (አልልም) - New Ethiopian Music 2019(Official Video by Minew Shewa Tube 2 years ago 4 minutes, 33 seconds 67,319 views",Minew Shewa Entertainment,67319,67341,22
1124,"Ethiopian Music : Sosina Girma ሶሥና ግርማ (ቃልአባይ) - New Ethiopian Music 2019(Official Video) by Minew Shewa Tube 2 years ago 3 minutes, 47 seconds 12,114 views",Minew Shewa Entertainment,12114,12118,4
1125,"Ethiopian Music : Jema Tadese (Suman Fedha) - New Ethiopian Music 2019(Official Video) by Minew Shewa Tube 2 years ago 5 minutes, 4 seconds 6,658 views",Minew Shewa Entertainment,6658,6659,1
1126,"Ethiopian Music : Amanuel Sinishaw አማኑኤል ስንሻው (ማኛ ነው) - New Ethiopian Music 2019(Official Video) by Minew Shewa Tube 2 years ago 4 minutes, 29 seconds 9,939 views",Minew Shewa Entertainment,9939,9940,1
1127,"Ethiopian Music : Yaba D. ft Ras Kawintsab (Shashe Harufa) New Ethiopian Music 2019(Official Video) by Minew Shewa Tube 2 years ago 5 minutes, 12 seconds 6,674 views",Minew Shewa Entertainment,6674,6678,4
1128,"Ethiopian Music : Ashebir Ayenew አሸብር አየነው (ከሀዲሽ ነኝ እኔ) - New Ethiopian Music 2019(Official Video) by Minew Shewa Tube 2 years ago 5 minutes, 2 seconds 4,500 views",Minew Shewa Entertainment,4500,4501,1
1129,"Ethiopian Music : Betey Beta ft Jino ቤቲ ቤታ ft ጂኖ (ኩነኒ) - New Ethiopian Music 2019(Official Video) by Minew Shewa Tube 2 years ago 4 minutes, 21 seconds 8,237 views",Minew Shewa Entertainment,8237,8241,4
1130,"Ethiopian Music : Anteneh Tesfaye አንተነህ ተስፋዬ (የቁርጥ ለታ) - New Ethiopian Music 2019(Official Video) by Minew Shewa Tube 2 years ago 6 minutes, 16 seconds 288,391 views",Minew Shewa Entertainment,288391,289410,1019
1131,"Ethiopian Music : Kalkidan Meshesha ""KIBRE ክብሬ"" ቃልኪዳን መሸሻ New Ethiopian Music 2019 (Official Video
) by Minew Shewa Tube 2 years ago 6 minutes, 6 seconds 228,909 views",Minew Shewa Entertainment,228909,229270,361
1132,"Ethiopian Music : Melakamu Fetahi (Selame) መልካሙ ፈታሂ (ሰላሜ)- New Ethiopian Music 2019(Official Video) by Minew Shewa Tube 2 years ago 5 minutes, 36 seconds 10,534 views",Minew Shewa Entertainment,10534,10539,5
1133,"Ethiopian Music : Solans (Yelechim) ሶላንስ (የለችም) - New Ethiopian Music 2019(Official Video) by Minew Shewa Tube 2 years ago 4 minutes, 3 seconds 9,755 views",Minew Shewa Entertainment,9755,9767,12
1134,"Ethiopian Music : MAX15KING (Ibsaadhu) - New Ethiopian Music 2019(Official Video) by Minew Shewa Tube 2 years ago 4 minutes, 42 seconds 27,736 views",Minew Shewa Entertainment,27736,27846,110
1135,"Ethiopian Music : Mesfin Abera መስፍን አበራ (ወይ አለመታደል) - New Ethiopian Music 2019(Official Video) by Minew Shewa Tube 2 years ago 5 minutes, 44 seconds 9,214 views",Minew Shewa Entertainment,9214,9218,4
1136,"Ethiopian Music : Fantahun Molla ፋንታሁን ሞላ (ቃልኪ ቃለይ) - New Ethiopian Music 2019(Official Video) by Minew Shewa Tube 2 years ago 4 minutes, 44 seconds 7,481 views",Minew Shewa Entertainment,7481,7493,12
1137,"Ethiopian Music : Abbabaa Dhugaasaa (Nin Deema)   - New Ethiopian Music 2019(Official Video) by Minew Shewa Tube 2 years ago 5 minutes, 29 seconds 53,420 views",Minew Shewa Entertainment,53420,53610,190
1138,"Shewangizaw Mengistu (Ney Jeba) ሸዋንግዛው መንግስቱ (ነይ ጀባ)  - New Ethiopian Music 2019(Official Video) by Minew Shewa Tube 2 years ago 6 minutes, 43 seconds 12,688 views",Minew Shewa Entertainment,12688,12714,26
1139,"Ethiopian Music : Tame Saucy (Kuru Konjo) ታሜ ሶሲ (ኩሩ ቆንጆ) - New Ethiopian Music 2019(Official Video) by Minew Shewa Tube 2 years ago 4 minutes, 24 seconds 6,707 views",Minew Shewa Entertainment,6707,6708,1
1140,"Ethiopian music (ጓደኝነት) ብርሃኑ፣ ብስራት፣ ያሬድ፣ ኒና፣ አለማየሁ፣ አበባው፣ ማይኮ፣ተአምር፣ አዲስ እና ቢታንያ-New Ethiopian Music. by Minew Shewa Tube 2 years ago 4 minutes, 59 seconds 842,459 views",Minew Shewa Entertainment,842459,844527,2068
1141,"Ethiopian Music : Dassaleny Birhaanuu (Habuu Too) - New Ethiopian Music 2019(Official Video) by Minew Shewa Tube 2 years ago 6 minutes, 37 seconds 9,765 views",Minew Shewa Entertainment,9765,9771,6
1142,"Ethiopian Music : Dagnachew Lemma (Zemenay) ዳኛቸው ለማ (ዘመናይ) New Ethiopian Music 2019(Official Video) by Minew Shewa Tube 2 years ago 5 minutes, 17 seconds 18,543 views",Minew Shewa Entertainment,18543,18561,18
1143,"Ethiopian music - Danny Magna Bete israel ዳኒ ማኛ ""ቤተ እስራኤል"" New Ethiopian Music 2019(Official Video) by Minew Shewa Tube 2 years ago 6 minutes, 2 seconds 323,264 views",Minew Shewa Entertainment,323264,323924,660
1144,"Ethiopian Music : Teklu Jenbere ተክሉ ጀምበሬ (አልለይሽም) - New Ethiopian Music 2019(Official Video) by Minew Shewa Tube 2 years ago 5 minutes, 1 second 10,609 views",Minew Shewa Entertainment,10609,10613,4
1145,"Ethiopian Music : Henok Melkamu ሄኖክ መልካሙ (ያልተረጋጋ ልብ) - New Ethiopian Music 2019(Official Video) by Minew Shewa Tube 2 years ago 5 minutes, 3 seconds 5,117 views",Minew Shewa Entertainment,5117,5119,2
1146,"Ethiopian Music : Sisay Kagnew (Maleda) ሲሣይ ቃኘው (ማለዳ) - New Ethiopian Music 2019(Official Video by Minew Shewa Tube 2 years ago 5 minutes, 27 seconds 8,113 views",Minew Shewa Entertainment,8113,8132,19
1147,"Ethiopian Music : Mulu Gebeyu (Selam) ሙሉ ገበየሁ (ሰላም)  - New Ethiopian Music 2019(Official Video) by Minew Shewa Tube 2 years ago 5 minutes, 53 seconds 6,325 views",Minew Shewa Entertainment,6325,6334,9
1148,"Amanuel Molla (Feker Siten) አማኑኤል ሞላ (ፍቅር ስጠን) - New Ethiopian Music 2019(Official Video) by Minew Shewa Tube 2 years ago 5 minutes, 8 seconds 6,932 views",Minew Shewa Entertainment,6932,6951,19
1149,"Habtamu Gulilat (Aybejen) ሀብታሙ ጉልላት (አይበጀንም) - New Ethiopian Music 2019(Official Video by Minew Shewa Tube 2 years ago 6 minutes, 21 seconds 8,346 views",Minew Shewa Entertainment,8346,8372,26
1150,"Ethiopian Music : Bewketu Sewmehon በእውቀቱ ሰውመሆን (ለኔስ ሀገሬ) New Ethiopian Music 2019(Official Video) by Minew Shewa Tube 2 years ago 5 minutes, 43 seconds 211,464 views",Minew Shewa Entertainment,211464,211638,174
1151,"Ethiopian Music : Mele (Yawru) መሌ (ያውሩ) - New Ethiopian Music 2019(Official Video) by Minew Shewa Tube 2 years ago 3 minutes, 39 seconds 9,225 views",Minew Shewa Entertainment,9225,9234,9
1152,"Ethiopian Music: Samrawit Yacob (YaleSaq) ሳምራዊት ያእቆብ (ያለሳቅ) New Ethiopian Music 2019(Official Video) by Minew Shewa Tube 2 years ago 5 minutes, 24 seconds 14,961 views",Minew Shewa Entertainment,14961,14976,15
1153,"Alemayehu Edmealem አለማየሁ እድሜዓለም (ባንቺ ቀልድ የለም) - New Ethiopian Music 2019(Official Video) by Minew Shewa Tube 2 years ago 5 minutes, 6 seconds 29,244 views",Minew Shewa Entertainment,29244,29260,16
1154,"Ethiopian Music : Buju Star ft Gildo Kassa (Laboro) - New Ethiopian Music 2019(Official Video) by Minew Shewa Tube 2 years ago 5 minutes, 11 seconds 280,418 views",Minew Shewa Entertainment,280418,281275,857
1155,"Meron Tekle Desta (Haraj) ሜሮን ተክሌ ደስታ (ሐራጅ) - New Ethiopian Music 2019(Official Video) by Minew Shewa Tube 2 years ago 5 minutes, 44 seconds 164,950 views",Minew Shewa Entertainment,164950,164981,31
1156,"Ethiopian Music : Em (Atargew) ኤም (አታርገው) - New Ethiopian Music 2019(Official Video) by Minew Shewa Tube 2 years ago 3 minutes, 18 seconds 2,000 views",Minew Shewa Entertainment,2000,2001,1
1157,"Falmataa shifarraa (Goototaa lammiif wareegee) - New Ethiopian Music 2019(Official Video) by Minew Shewa Tube 2 years ago 7 minutes, 28 seconds 4,138 views",Minew Shewa Entertainment,4138,4150,12
1158,"Ethiopian Music : Benyam Tesfa | Wude | ቢኒያም ተስፋ (ውዴ)New Ethiopian Music 2019(Official Video) by Minew Shewa Tube 2 years ago 6 minutes, 14 seconds 45,171 views",Minew Shewa Entertainment,45171,45177,6
1159,"Ermiyas Mulugeta Ft  Besufekad Tibebu (CheChe) - New Ethiopian Music 2019(Official Video) by Minew Shewa Tube 2 years ago 4 minutes, 14 seconds 5,715 views",Minew Shewa Entertainment,5715,5728,13
1160,"Ethiopian Music : Abebaw Abebe (Tew lebe) አበባው አበበ (ልቤ) - New Ethiopian Music 2019(Official Video) by Minew Shewa Tube 2 years ago 5 minutes, 39 seconds 26,095 views",Minew Shewa Entertainment,26095,26156,61
1161,"Ethiopian Music : Em (Meskin Ethiopia) ኤም (ምስኪን ኢትዮጵያ)  - New Ethiopian Music 2019(Official Video) by Minew Shewa Tube 2 years ago 5 minutes, 13 seconds 6,063 views",Minew Shewa Entertainment,6063,6094,31
1162,"Ethiopian Music : Em (Tebela) ኤም (ተበላ) - New Ethiopian Music 2019(Official Video) by Minew Shewa Tube 2 years ago 3 minutes, 32 seconds 21,093 views",Minew Shewa Entertainment,21093,21149,56
1163,"Ethiopian Music : Em (Marwa) ኤም (ማርዋ) - New Ethiopian Music 2019(Official Video) by Minew Shewa Tube 2 years ago 3 minutes, 44 seconds 1,297 views",Minew Shewa Entertainment,1297,1302,5
1164,"Ethiopian Music : Em (Liyu) ኤም (ልዩ) - New Ethiopian Music 2019(Official Video) by Minew Shewa Tube 2 years ago 4 minutes, 1 second 1,154 views",Minew Shewa Entertainment,1154,1157,3
1165,"Ethiopian Music : Em (Yene) ኤም (የኔ) - New Ethiopian Music 2019(Official Video) by Minew Shewa Tube 2 years ago 4 minutes, 10 seconds 772 views",Minew Shewa Entertainment,772,773,1
1166,"Ethiopian Music : Em (Suse) ኤም (ሱሴ)  - New Ethiopian Music 2019(Official Video) by Minew Shewa Tube 2 years ago 3 minutes, 25 seconds 12,534 views",Minew Shewa Entertainment,12534,12583,49
1167,"Ethiopian Music : Em (leke) ኤም (ልኬ) - New Ethiopian Music 2019(Official Video) by Minew Shewa Tube 2 years ago 3 minutes, 6 seconds 8,215 views",Minew Shewa Entertainment,8215,8226,11
1168,"Ethiopian Music : Em (Yelem) ኤም (የለም) - New Ethiopian Music 2019(Official Video) by Minew Shewa Tube 2 years ago 3 minutes, 45 seconds 4,322 views",Minew Shewa Entertainment,4322,4338,16
1169,"Balageru (Giba Belew Shewa) ባላገሩ (ግባ በለው ሸዋ) New Ethiopian Music 2019(Official Audio) by Minew Shewa Tube 2 years ago 6 minutes, 35 seconds 180,090 views",Minew Shewa Entertainment,180090,180345,255
1170,"Ethiopian Music : ኤም (ኢትዮጵያ ትቅደም) - New Ethiopian Music 2019(Official Video) by Minew Shewa Tube 2 years ago 4 minutes, 57 seconds 2,190 views",Minew Shewa Entertainment,2190,2197,7
1171,"Ethiopian Music : ኤም (ካንተ ጋር / ካንቺ ጋር ) - New Ethiopian Music 2019(Official Video) by Minew Shewa Tube 2 years ago 3 minutes, 40 seconds 1,047 views",Minew Shewa Entertainment,1047,1052,5
1172,"Ethiopian Music : ኤም (ፐ!) - New Ethiopian Music 2019(Official Video) by Minew Shewa Tube 2 years ago 2 minutes, 59 seconds 4,827 views",Minew Shewa Entertainment,4827,4836,9
1173,"Ethiopian Music : Em (Sekerku) ኤም (ሰከርኩ) - New Ethiopian Music 2019(Official Video) by Minew Shewa Tube 2 years ago 3 minutes, 56 seconds 8,119 views",Minew Shewa Entertainment,8119,8129,10
1174,"Ethiopian Music : Em (Yelebe Tireta) ኤም (የልቤ ትርታ) - New Ethiopian Music 2019(Official Video) by Minew Shewa Tube 2 years ago 4 minutes, 14 seconds 2,505 views",Minew Shewa Entertainment,2505,2511,6
1175,"Ethiopian Music : ኤም (ምንህን ነው) - New Ethiopian Music 2019(Official Video) by Minew Shewa Tube 2 years ago 5 minutes, 32 seconds 3,388 views",Minew Shewa Entertainment,3388,3397,9
1176,"Ethiopian Music : ኤም (ኪኒኔ)  - New Ethiopian Music 2019(Official Video) by Minew Shewa Tube 2 years ago 3 minutes, 51 seconds 123,040 views",Minew Shewa Entertainment,123040,123745,705
1177,"Ethiopian Music : Helen Mehari ሄለን መሃሪ (ብቸኝነት) - New Ethiopian Music 2019(Official Video) by Minew Shewa Tube 2 years ago 6 minutes, 35 seconds 7,764 views",Minew Shewa Entertainment,7764,7785,21
1178,"Mekonen Getachew (Yene Abeba) መኮንን ጌታቸው (የኔ አበባ) - New Ethiopian Music 2019(Official Video) by Minew Shewa Tube 2 years ago 5 minutes, 51 seconds 7,624 views",Minew Shewa Entertainment,7624,7631,7
1179,"Ethiopian Music : Gech Boss - New Ethiopian Music 2019(Official Video) by Minew Shewa Tube 2 years ago 3 minutes, 39 seconds 7,362 views",Minew Shewa Entertainment,7362,7368,6
1180,"Ethiopian Music : Ali Wendimu (Achawchigna) አሊ ወንድሙ (አጫውቺኛ) New Ethiopian Music 2019(Official Video) by Minew Shewa Tube 2 years ago 4 minutes, 45 seconds 7,316 views",Minew Shewa Entertainment,7316,7317,1
1181,"Ethiopian Music : Lij Abebe Mamo ልጅ አበበ ማሞ (አዲሲቷ ኢትዮጵያ) - New Ethiopian Music 2019(Official Video) by Minew Shewa Tube 2 years ago 4 minutes 5,477 views",Minew Shewa Entertainment,5477,5483,6
1182,"Ethiopian Music : Mesfin Bekele | Lemin መስፍን በቀለ (ለምን) - New Ethiopian Music 2019(Lyrics Video) by Minew Shewa Tube 2 years ago 7 minutes, 7 seconds 70,892 views",Minew Shewa Entertainment,70892,71002,110
1183,"Fretsadik Weldehawariat (Selam) ፍሬፃዲቅ ወ/ሐዋርያት (ሰላም) - New Ethiopian Music 2019(Official Video) by Minew Shewa Tube 2 years ago 7 minutes, 9 seconds 6,944 views",Minew Shewa Entertainment,6944,6981,37
1184,"Haimi Asrat ft. Yared Negu & Didi Gaga (Bopa) New Ethiopian Music 2019(Official Video) by Minew Shewa Tube 2 years ago 4 minutes, 33 seconds 150,045 views",Minew Shewa Entertainment,150045,150693,648
1185,"Ethiopian Music : Tariku Alemayehu ታሪኩ አለማየሁ (አስደነገጠኝ) - New Ethiopian Music 2019(Official Video) by Minew Shewa Tube 2 years ago 4 minutes, 41 seconds 4,078 views",Minew Shewa Entertainment,4078,4079,1
1186,"Ethiopian Music : Yosef Alemseged ዮሴፍ አለምሰገድ (እመኚኝ) - New Ethiopian Music 2019(Official Video) by Minew Shewa Tube 2 years ago 6 minutes, 6 seconds 29,169 views",Minew Shewa Entertainment,29169,29178,9
1187,"Ethiopian Music : Ashu Tsige (Harar) አሹ ጽጌ (ሐረር) - New Ethiopian Music 2019(Official Video) by Minew Shewa Tube 2 years ago 5 minutes, 9 seconds 5,898 views",Minew Shewa Entertainment,5898,5913,15
1188,"Ethiopian Music : Makonnin Bayyanaa (Gumaata Jaalalaa) - New Ethiopian Music 2019(Official Video) by Minew Shewa Tube 2 years ago 6 minutes, 32 seconds 15,480 views",Minew Shewa Entertainment,15480,15503,23
1189,"Ethiopian Music : Baalchaa Bajigaa (Dhis Gara Laafummaa) - New Ethiopian Music 2019(Official Video) by Minew Shewa Tube 2 years ago 6 minutes, 12 seconds 3,502 views",Minew Shewa Entertainment,3502,3505,3
1190,"Ethiopian Music : Mintesnot Tamiru (Gattootie) - New Ethiopian Music 2019(Official Video) by Minew Shewa Tube 2 years ago 4 minutes, 24 seconds 3,878 views",Minew Shewa Entertainment,3878,3885,7
1191,"Ethiopian Music : Kebad Anbesa x Ellaman (One Ethiopia) - New Ethiopian Music 2019(Official Video) by Minew Shewa Tube 2 years ago 3 minutes, 33 seconds 4,769 views",Minew Shewa Entertainment,4769,4771,2
1192,"Ethiopian Music : Firaanboon Bajigaa (Lefeetu Dubbate) - New Ethiopian Music 2019(Official Video) by Minew Shewa Tube 2 years ago 7 minutes, 4 seconds 3,399 views",Minew Shewa Entertainment,3399,3405,6
1193,"Ethiopian Music : Teshome Wube ተሾመ ውቤ (ያገሬን ጎዳና) - New Ethiopian Music 2019(Official Video) by Minew Shewa Tube 2 years ago 5 minutes, 29 seconds 5,107 views",Minew Shewa Entertainment,5107,5116,9
1194,"Ethiopian Music : Mulat Wagnew (Haregeye) ሙላት ዋኘው (ሐረግዬ) - New Ethiopian Music 2019(Official Video) by Minew Shewa Tube 2 years ago 5 minutes, 23 seconds 19,835 views",Minew Shewa Entertainment,19835,19868,33
1195,"Kalkidan Yaregal (Kelal New) ቃልኪዳን ያረጋል (ቀላል ነው) - New Ethiopian Music 2019(Official Video) by Minew Shewa Tube 2 years ago 3 minutes, 53 seconds 89,248 views",Minew Shewa Entertainment,89248,89284,36
1196,"Ethiopian Music : አብርሃም ዳኘው ምሳሌ አብርሃም (ታምኖብሻል) - New Ethiopian Music 2019(Official Video) by Minew Shewa Tube 2 years ago 3 minutes, 58 seconds 3,422 views",Minew Shewa Entertainment,3422,3422,0
1197,"Ethiopian Music: Ashenafi T/Haimanot አሸናፊ ተ/ሃይማኖት (አቻም የለሽ) New Ethiopian Music 2019(Official Video) by Minew Shewa Tube 2 years ago 6 minutes, 42 seconds 10,157 views",Minew Shewa Entertainment,10157,10180,23
1198,"Ethiopian Music: Kidus Metye (Medmekiyaye) ቅዱስ መትዬ (መድመቅያዬ) New Ethiopian Music 2019(Official Video) by Minew Shewa Tube 2 years ago 4 minutes, 51 seconds 8,710 views",Minew Shewa Entertainment,8710,8711,1
1199,"Ethiopian Music : Ambassuu Tassammaa (Foollee) - New Ethiopian Music 2019(Official Video) by Minew Shewa Tube 2 years ago 5 minutes, 3 seconds 3,082 views",Minew Shewa Entertainment,3082,3083,1
1200,"Biniyam Eshetu (Kalew Tetega) ብንያም እሸቱ (ካለው ተጠጋ) - New Ethiopian Music 2019(Official Video) by Minew Shewa Tube 2 years ago 5 minutes, 25 seconds 6,484 views",Minew Shewa Entertainment,6484,6493,9
1201,"Klinten Mesfin ft Neway Tesema ክሊንተን መስፍን ነዋይ ተሰማ (እልልታዬ) New Ethiopian Music 2019(Official Video) by Minew Shewa Tube 2 years ago 4 minutes, 36 seconds 4,030 views",Minew Shewa Entertainment,4030,4033,3
1202,"Ethiopian Music : Desalegn Bekama (Fano) - New Ethiopian Music 2019(Official Video) by Minew Shewa Tube 2 years ago 6 minutes, 11 seconds 391,732 views",Minew Shewa Entertainment,391732,392769,1037
1203,"Ethiopian Music: Tarekegn Rejaw (Sebebegna) ታረቀኝ ረጃው (ሰበበኛ) New Ethiopian Music 2019(Official Video) by Minew Shewa Tube 2 years ago 5 minutes, 54 seconds 11,903 views",Minew Shewa Entertainment,11903,11910,7
1204,"Ethiopian Music : Alexo (Broke Life)  - New Ethiopian Music 2019(Official Video) by Minew Shewa Tube 2 years ago 3 minutes, 11 seconds 4,478 views",Minew Shewa Entertainment,4478,4483,5
1205,"Ethiopian Music: Abraham Worku(Atsebery) አብርሃም ወርቁ(አትሰበሪ) New Ethiopian Music 2019(Official Video) by Minew Shewa Tube 2 years ago 5 minutes, 32 seconds 10,567 views",Minew Shewa Entertainment,10567,10600,33
1206,"Tihut ft Bezuayehu (Michu) ትሁት አህመድ እና ብዙአየሁ ክፍሌ (ምቹ) - New Ethiopian Music 2019(Official Video) by Minew Shewa Tube 2 years ago 4 minutes, 57 seconds 9,476 views",Minew Shewa Entertainment,9476,9483,7
1207,"Ethiopian Music: Damisee Dhugoo(Lammiin Lammii Dhiibaaree) New Ethiopian Music 2019(Official Video) by Minew Shewa Tube 2 years ago 7 minutes, 20 seconds 4,299 views",Minew Shewa Entertainment,4299,4304,5
1208,"Ethiopian Music : Ambbassuu Tassammaa (Aadaa) - New Ethiopian Music 2019(Official Video) by Minew Shewa Tube 2 years ago 6 minutes, 26 seconds 2,284 views",Minew Shewa Entertainment,2284,2285,1
1209,"Ethiopian Music : Melkamu Getawey መልካሙ ጌታወይ (ይሻላል) - New Ethiopian Music 2019(Official Video) by Minew Shewa Tube 2 years ago 4 minutes, 15 seconds 5,001 views",Minew Shewa Entertainment,5001,5008,7
1210,"Ethiopian Music : Alemayehu Honjamo አለማየሁ ሶንጌላ (ታማሬሶጌላ) - New Ethiopian Music 2019(Official Video) by Minew Shewa Tube 2 years ago 5 minutes, 41 seconds 3,790 views",Minew Shewa Entertainment,3790,3792,2
1211,"Ethiopian Music : Metaferia Bekele ft Juke Box (Weyne) - New Ethiopian Music 2019(Official Video) by Minew Shewa Tube 2 years ago 4 minutes, 12 seconds 14,910 views",Minew Shewa Entertainment,14910,14973,63
1212,"Ethiopian Music : Ermias Sophia ኤርምያስ ሶፍያ (አሪፍ አሪፍ) - New Ethiopian Music 2019(Official Video) by Minew Shewa Tube 2 years ago 4 minutes, 59 seconds 6,003 views",Minew Shewa Entertainment,6003,6003,0
1213,"Ethiopian Music: Belay Kasahun (Tega Bey) በላይ ካሳሁን (ጠጋ በይ) New Ethiopian Music 2019(Official Video) by Minew Shewa Tube 2 years ago 6 minutes, 2 seconds 5,293 views",Minew Shewa Entertainment,5293,5310,17
1214,"Ethiopian Music : Habtamu Yeneabat ሀብታሙ የኔ አባት (አማራ ንስር ነው) New Ethiopian Music 2019(Official Video) by Minew Shewa Tube 2 years ago 11 minutes, 31 seconds 5,903 views",Minew Shewa Entertainment,5903,5912,9
1215,"Ethiopian Music : Kabbadaa Girmaa (Kolfaa Nu Murmuru) - New Ethiopian Music 2019(Official Video) by Minew Shewa Tube 2 years ago 5 minutes, 47 seconds 6,660 views",Minew Shewa Entertainment,6660,6665,5
1216,"Ethiopian Music : Baayisaa Dabalii (Jajjabeewaan) - New Ethiopian Music 2019(Official Video) by Minew Shewa Tube 2 years ago 6 minutes, 27 seconds 3,515 views",Minew Shewa Entertainment,3515,3515,0
1217,"Ethiopian Music : Addis Falasfaawu (Bareedaa Gurbaa) - New Ethiopian Music 2019(Official Video) by Minew Shewa Tube 2 years ago 7 minutes 7,494 views",Minew Shewa Entertainment,7494,7505,11
1218,"Ethiopian Music: Tesfaye Taye(Sherur Gashe) ተስፋዬ ታዬ(ሽሩር ጋሼ) New Ethiopian Music 2019(Official Video) by Minew Shewa Tube 2 years ago 4 minutes, 40 seconds 10,610 views",Minew Shewa Entertainment,10610,10653,43
1219,"Ethiopian Music : Isayas Arefaine ኢሳያስ አረፋይነ(Merat Ayney) - New Ethiopian Music 2019(Official Video) by Minew Shewa Tube 2 years ago 6 minutes, 22 seconds 6,111 views",Minew Shewa Entertainment,6111,6120,9
1220,"Ethiopian Music : Dabballee Asaffaa (Sabboontittii) - New Ethiopian Music 2019(Official Video) by Minew Shewa Tube 2 years ago 4 minutes, 52 seconds 6,536 views",Minew Shewa Entertainment,6536,6552,16
1221,"Ethiopian Music : Fisseha Wedaj (Salayesh) ፍስሃ ወዳጅ (ሳላይሽ) - New Ethiopian Music 2019(Official Video) by Minew Shewa Tube 2 years ago 6 minutes, 18 seconds 45,457 views",Minew Shewa Entertainment,45457,45474,17
1222,"Ethiopian Music : Ermi Salsa ኤርሚ ሳልሳ (ይነዳል)  - New Ethiopian Music 2019(Official Video) by Minew Shewa Tube 2 years ago 4 minutes, 38 seconds 11,223 views",Minew Shewa Entertainment,11223,11230,7
1223,"Ethiopian Music : Addisu Furgassa (amalee koo)- New Ethiopian Music 2019(Official Video) by Minew Shewa Tube 2 years ago 5 minutes, 14 seconds 6,738 views",Minew Shewa Entertainment,6738,6767,29
1224,"Ethiopian Music : Kiyyaa Iddoosaa (Yaa Shimala Koo) - New Ethiopian Music 2019(Official Video) by Minew Shewa Tube 2 years ago 6 minutes, 8 seconds 3,169 views",Minew Shewa Entertainment,3169,3172,3
1225,"Ethiopian Music : Mesfin Zeleke መስፍን ዘለቀ (ያዛት) - New Ethiopian Music 2019(Official Video) by Minew Shewa Tube 2 years ago 5 minutes, 42 seconds 7,384 views",Minew Shewa Entertainment,7384,7389,5
1226,"Ethiopian Music : Birhane Tefera (Naa Koo Kaa) - New Ethiopian Music 2019(Official Video) by Minew Shewa Tube 2 years ago 4 minutes, 42 seconds 32,507 views",Minew Shewa Entertainment,32507,32633,126
1227,"Ethiopian Music : Diinaraas Qaasiim (Dubbiin Teenyaa) - New Ethiopian Music 2019(Official Video) by Minew Shewa Tube 2 years ago 6 minutes, 13 seconds 3,751 views",Minew Shewa Entertainment,3751,3755,4
1228,"Ethiopian Music : Titi Noli Dimondo (Awandi) - New Ethiopian Music 2019(Official Video) by Minew Shewa Tube 2 years ago 4 minutes, 1 second 20,887 views",Minew Shewa Entertainment,20887,20915,28
1229,"Ethiopian Music :  Zerihun Fikre ዘሪሁን ፍቅሬ (ሳቋ) - New Ethiopian Music 2019(Official Video) by Minew Shewa Tube 2 years ago 4 minutes, 34 seconds 7,674 views",Minew Shewa Entertainment,7674,7682,8
1230,"Ethiopian Music :  Slex X Omex (Balaye Balaye) ባላየ ባላየ - New Ethiopian Music 2019(Official Video) by Minew Shewa Tube 2 years ago 4 minutes, 4 seconds 9,132 views",Minew Shewa Entertainment,9132,9186,54
1231,"Ethiopian Music : Alamaayyoo Kabbadaa (Foolleen Rooba) - New Ethiopian Music 2019(Official Video) by Minew Shewa Tube 2 years ago 6 minutes, 47 seconds 3,489 views",Minew Shewa Entertainment,3489,3500,11
1232,"Ethiopian Music : Badru Ibro (Shamarran Oromoo) - New Ethiopian Music 2019(Official Video) by Minew Shewa Tube 2 years ago 7 minutes, 1 second 148,094 views",Minew Shewa Entertainment,148094,149011,917
1233,"Ethiopian Music : Yared Yohannes ያሬድ ዮሃንስ(ያዶ) ""ኧረ መላ"" - New Ethiopian Music 2019(Official Video) by Minew Shewa Tube 2 years ago 5 minutes, 20 seconds 4,770 views",Minew Shewa Entertainment,4770,4775,5
1234,"Ethiopian Music : Gadisaa Waldee (Dammee Maaloo) - New Ethiopian Music 2019(Official Video) by Minew Shewa Tube 2 years ago 5 minutes, 45 seconds 6,290 views",Minew Shewa Entertainment,6290,6295,5
1235,"Ethiopian Music : Yalew Aneley (tiger) ያለው አንለይ (ስሜ ማነው) - New Ethiopian Music 2019(Official Video) by Minew Shewa Tube 2 years ago 5 minutes, 51 seconds 8,119 views",Minew Shewa Entertainment,8119,8133,14
1236,"Ethiopian Music : Haylemichael Kenaw ኃይለሚካኤል ቀናው (አንቺየዋ) - New Ethiopian Music 2019(Official Video) by Minew Shewa Tube 2 years ago 6 minutes, 13 seconds 3,735 views",Minew Shewa Entertainment,3735,3735,0
1237,"Ethiopian Music : Nahome Beyene (Selam) ናሆም በየነ (ሰላም)- New Ethiopian Music 2019(Official Video) by Minew Shewa Tube 2 years ago 5 minutes, 3 seconds 6,368 views",Minew Shewa Entertainment,6368,6377,9
1238,"Ethiopian Music : Caalaa Bayyanaa (Kuffisii)   - New Ethiopian Music 2019(Official Video) by Minew Shewa Tube 2 years ago 7 minutes, 7 seconds 4,939 views",Minew Shewa Entertainment,4939,4958,19
1239,"Ethiopian Music: Zeritu Kebede & Tadele Gemechu (#LibYaleh) New Ethiopian Music 2019(Official Video) by Minew Shewa Tube 2 years ago 6 minutes, 54 seconds 43,824 views",Minew Shewa Entertainment,43824,43853,29
1240,"Ethiopian Music :  Dagy Man ዳጊ ማን (አንቺ አማላይ)  - New Ethiopian Music 2019(Official Video) by Minew Shewa Tube 2 years ago 3 minutes, 20 seconds 3,711 views",Minew Shewa Entertainment,3711,3715,4
1241,"Ethiopian Music : Birhanu Worke ብርሃኑ ወርቄ (ሳዱሌ) - New Ethiopian Music 2019(Official Video) by Minew Shewa Tube 2 years ago 4 minutes, 52 seconds 86,638 views",Minew Shewa Entertainment,86638,86789,151
1242,"Ethiopian Music : Fetene Ababu ፈጠነ አባቡ (መኖር ደግ ነገር)- New Ethiopian Music 2019(Official Audio) by Minew Shewa Tube 2 years ago 5 minutes, 28 seconds 4,162 views",Minew Shewa Entertainment,4162,4167,5
1243,"Ethiopian Music : Beki T (ይመችህ) - New Ethiopian Music 2019(Official Video) by Minew Shewa Tube 2 years ago 3 minutes, 38 seconds 3,832 views",Minew Shewa Entertainment,3832,3837,5
1244,"Ethiopian Music : Alemtsehay Berhe አለምፅሐይ በርሄ (ሽሙንሙን) - New Ethiopian Music 2019(Official Video) by Minew Shewa Tube 2 years ago 3 minutes, 37 seconds 7,129 views",Minew Shewa Entertainment,7129,7140,11
1245,"Ethiopian Music : Geetaachoo Alamuu (Adaraa Seeraa)- New Ethiopian Music 2019(Official Video) by Minew Shewa Tube 2 years ago 6 minutes, 44 seconds 1,523 views",Minew Shewa Entertainment,1523,1526,3
1246,"Ethiopian Music : Vanus Zeda ቫኑስ ዜዳ (አለ መላ)  - New Ethiopian Music 2019(Official Video) by Minew Shewa Tube 2 years ago 5 minutes, 59 seconds 10,280 views",Minew Shewa Entertainment,10280,10290,10
1247,"Ethiopian Music : Amanuel Belete አማኑኤል በለጠ (ስለ አንድ ሀገር) - New Ethiopian Music 2019(Official Video) by Minew Shewa Tube 2 years ago 4 minutes, 50 seconds 7,824 views",Minew Shewa Entertainment,7824,7828,4
1248,"Ethiopian Music : Fayyiissaa Lammaa (Siduukaa Jirraa)  - New Ethiopian Music 2019(Official Video) by Minew Shewa Tube 2 years ago 5 minutes, 19 seconds 2,358 views",Minew Shewa Entertainment,2358,2358,0
1249,"Aiddsuu Daggagaa Guddataa(Riqichaa Dhalootaa Yaa Foollee)New Ethiopian Music 2019(Official Video) by Minew Shewa Tube 2 years ago 6 minutes, 21 seconds 2,889 views",Minew Shewa Entertainment,2889,2890,1
1250,"Ethiopian Music : Baay'isaa Fayyisaa (Gubba Laphee Jala) - New Ethiopian Music 2019(Official Video) by Minew Shewa Tube 2 years ago 5 minutes, 33 seconds 3,004 views",Minew Shewa Entertainment,3004,3005,1
1251,"Ethiopian Music : Addisuu Likkii (Kan Qaban Jabessaan)- New Ethiopian Music 2019(Official Video) by Minew Shewa Tube 2 years ago 5 minutes, 14 seconds 3,152 views",Minew Shewa Entertainment,3152,3153,1
1252,"Ethiopian Music : Mehret Zewdie ምህረት ዘውዴ (አሁንስ በዛ)  - New Ethiopian Music 2019(Official Video) by Minew Shewa Tube 2 years ago 6 minutes 10,897 views",Minew Shewa Entertainment,10897,10911,14
1253,"Ethiopian Music : Alemayehu Seyoum  አለማየሁ ስዩም (የደስታ ቀን ነው) New Ethiopian Music 2019(Official Video) by Minew Shewa Tube 2 years ago 4 minutes, 41 seconds 3,250 views",Minew Shewa Entertainment,3250,3250,0
1254,"Ethiopian Music : Mamush (Ethiopia) ማሙሽ (ኢትዮጵያ) - New Ethiopian Music 2019(Official Video) by Minew Shewa Tube 2 years ago 3 minutes, 42 seconds 4,750 views",Minew Shewa Entertainment,4750,4757,7
1255,"Ethiopian Music : Muluken Taju (Akale) ሙሉቀን ታጁ (አካሌ) - New Ethiopian Music 2019(Official Video) by Minew Shewa Tube 2 years ago 4 minutes, 17 seconds 11,951 views",Minew Shewa Entertainment,11951,11970,19
1256,"Ethiopian Music : Ketema Bogale (Duruu Sanyiin Kushi)  - New Ethiopian Music 2019(Official Video) by Minew Shewa Tube 2 years ago 5 minutes, 22 seconds 3,565 views",Minew Shewa Entertainment,3565,3568,3
1257,"Ethiopian Music : Megersa Negesa (Sumeya) - New Ethiopian Music 2019(Official Video) by Minew Shewa Tube 2 years ago 7 minutes, 1 second 5,139 views",Minew Shewa Entertainment,5139,5152,13
1258,"Ethiopian Music : Damee Daraje (Dhissaa Gandumma) - New Ethiopian Music 2019(Official Video) by Minew Shewa Tube 2 years ago 5 minutes, 35 seconds 4,801 views",Minew Shewa Entertainment,4801,4817,16
1259,"Ethiopian Music : Darribee Taddasaa (Seenan Hayadatuu)- New Ethiopian Music 2019(Official Video) by Minew Shewa Tube 2 years ago 6 minutes, 50 seconds 12,650 views",Minew Shewa Entertainment,12650,12854,204
1260,"Ethiopian Music : Taarikuu Isheetuu (Ya Obbeessaa koo) - New Ethiopian Music 2019(Official Video) by Minew Shewa Tube 2 years ago 5 minutes, 13 seconds 2,513 views",Minew Shewa Entertainment,2513,2532,19
1261,"Ethiopian Music : Avi Kአብርሃም ክንዴ (አይዞህ) - New Ethiopian Music 2019(Official Video) by Minew Shewa Tube 2 years ago 5 minutes, 36 seconds 12,102 views",Minew Shewa Entertainment,12102,12107,5
1262,"Ethiopian Music : Asheber Belay አሸብር በላይ (በል ግጠም) - New Ethiopian Music 2019(Official Video) by Minew Shewa Tube 2 years ago 5 minutes, 20 seconds 85,879 views",Minew Shewa Entertainment,85879,86011,132
1263,"Ethiopian Music : Amanuel Melaku አማኑኤል መላኩ (አለብኝ አደራ)- New Ethiopian Music 2019(Official Video) by Minew Shewa Tube 2 years ago 7 minutes, 14 seconds 4,360 views",Minew Shewa Entertainment,4360,4364,4
1264,"Ethiopian Music : Sami Go and Dezry Kay (Dari Dari) - New Ethiopian Music 2019(Official Video) by Minew Shewa Tube 2 years ago 5 minutes, 15 seconds 719,738 views",Minew Shewa Entertainment,719738,720239,501
1265,"Ethiopian Music : Gebreshet Bitew ገብርሸት ቢተው (ጀነነኝ)- New Ethiopian Music 2019(Official Video) by Minew Shewa Tube 2 years ago 5 minutes, 56 seconds 281,750 views",Minew Shewa Entertainment,281750,281888,138
1266,"Ethiopian Music : Dagim Adane (Hanazi) በዚ ጊዜ New Ethiopian Music 2019(Official Video) by Minew Shewa Tube 2 years ago 4 minutes, 58 seconds 152,385 views",Minew Shewa Entertainment,152385,153035,650
1267,"Ethiopian Music : Tesfaye Taye ተስፋዬ ታዬ (ሁሉቃ ሲዳማ) - New Ethiopian Music 2019(Official Video) by Minew Shewa Tube 2 years ago 7 minutes, 18 seconds 5,326 views",Minew Shewa Entertainment,5326,5332,6
1268,"Ethiopian Music: Abeel Isheetuu(Diina Doofaaf Bara Moofaa) New Ethiopian Music 2019(Official Video) by Minew Shewa Tube 2 years ago 5 minutes, 46 seconds 13,426 views",Minew Shewa Entertainment,13426,13429,3
1269,"Ethiopian Music : Alamuu Dhugumaa (Siin Allafedhuu) - New Ethiopian Music 2019(Official Video) by Minew Shewa Tube 2 years ago 5 minutes, 29 seconds 3,982 views",Minew Shewa Entertainment,3982,3993,11
1270,"Ethiopian Music : Lammii Zarihun (Galaane)  - New Ethiopian Music 2019(Official Video) by Minew Shewa Tube 2 years ago 5 minutes, 26 seconds 4,811 views",Minew Shewa Entertainment,4811,4814,3
1271,"Ethiopian Music  : Bilisummaa Agarii (fifinnee) - New Ethiopian Music 2019(Official Video) by Minew Shewa Tube 2 years ago 7 minutes, 3 seconds 6,841 views",Minew Shewa Entertainment,6841,6860,19
1272,"Ethiopian Music: Desalegn and Mekdes ደሳለኝ እና መቀደስ (እንማከርበት) New Ethiopian Music 2019(Official Video) by Minew Shewa Tube 2 years ago 5 minutes, 54 seconds 10,982 views",Minew Shewa Entertainment,10982,10988,6
1273,"Ethiopian Music : Habtamu Birhanu ሀብታሙ ብርሃኑ (በሰላም ኑሪልኝ) - New Ethiopian Music 2019(Official Video) by Minew Shewa Tube 2 years ago 5 minutes, 19 seconds 3,973 views",Minew Shewa Entertainment,3973,3981,8
1274,"Ethiopian Music : Keekiyaa Badhaadhaa (Oromiyaa) - New Ethiopian Music 2019(Official Video) by Minew Shewa Tube 2 years ago 5 minutes, 21 seconds 3,797 views",Minew Shewa Entertainment,3797,3804,7
1275,"Ethiopian Music : Keekiyaa Badhaadhaa (Walkakaasaa) - New Ethiopian Music 2019(Official Video) by Minew Shewa Tube 2 years ago 5 minutes, 40 seconds 3,820 views",Minew Shewa Entertainment,3820,3884,64
1276,"Ethiopian Music : Keekiyaa Badhaadhaa (Raase Raasee) - New Ethiopian Music 2019(Official Video) by Minew Shewa Tube 2 years ago 6 minutes, 11 seconds 6,290 views",Minew Shewa Entertainment,6290,6363,73
1277,"Ethiopian Music : Keekiyaa Badhaadhaa (Nageenya) - New Ethiopian Music 2019(Official Video) by Minew Shewa Tube 2 years ago 4 minutes, 42 seconds 1,876 views",Minew Shewa Entertainment,1876,1878,2
1278,"Ethiopian Music : Keekiyaa Badhaadhaa (Yaadannoo) - New Ethiopian Music 2019(Official Video) by Minew Shewa Tube 2 years ago 4 minutes, 43 seconds 3,252 views",Minew Shewa Entertainment,3252,3265,13
1279,"Ethiopian Music : Keekiyaa Badhaadhaa (Hawwaashirran) - New Ethiopian Music 2019(Official Video) by Minew Shewa Tube 2 years ago 4 minutes, 39 seconds 3,879 views",Minew Shewa Entertainment,3879,3931,52
1280,"Ethiopian Music : Keekiyaa Badhaadhaa (Fandalali) - New Ethiopian Music 2019(Official Video) by Minew Shewa Tube 2 years ago 5 minutes, 17 seconds 2,637 views",Minew Shewa Entertainment,2637,2640,3
1281,"Ethiopian Music : Keekiyaa Badhaadhaa (Shaggar) - New Ethiopian Music 2019(Official Video) by Minew Shewa Tube 2 years ago 5 minutes, 41 seconds 18,430 views",Minew Shewa Entertainment,18430,18553,123
1282,"Ethiopian Music : Keekiyaa Badhaadhaa (Odaa Hulled) - New Ethiopian Music 2019(Official Video) by Minew Shewa Tube 2 years ago 5 minutes, 5 seconds 2,821 views",Minew Shewa Entertainment,2821,2832,11
1283,"Ethiopian Music : Keekiyaa Badhaadhaa (Warra Kam) - New Ethiopian Music 2019(Official Video) by Minew Shewa Tube 2 years ago 5 minutes, 31 seconds 149,905 views",Minew Shewa Entertainment,149905,150281,376
1284,"Ethiopian Music : Keekiyaa Badhaadhaa (Sinyaachisa) - New Ethiopian Music 2019(Official Video) by Minew Shewa Tube 2 years ago 5 minutes, 51 seconds 6,960 views",Minew Shewa Entertainment,6960,6988,28
1285,"Ethiopian Music : Keekiyaa Badhaadhaa (Tolte kaayyoon) - New Ethiopian Music 2019(Official Video) by Minew Shewa Tube 2 years ago 4 minutes, 43 seconds 2,247 views",Minew Shewa Entertainment,2247,2251,4
1286,"Ethiopian Music :Keekiyaa Badhaadhaa (Ilmoo waaqaati) - New Ethiopian Music 2019(Official Video) by Minew Shewa Tube 2 years ago 5 minutes, 48 seconds 6,619 views",Minew Shewa Entertainment,6619,6630,11
1287,"Ethiopian Music : Keekiyaa Badhaadhaa (Barnoota) - New Ethiopian Music 2019(Official Video) by Minew Shewa Tube 2 years ago 3 minutes, 48 seconds 3,440 views",Minew Shewa Entertainment,3440,3475,35
1288,"Ethiopian Music : Keekiyaa Badhaadhaa (Doorii)- New Ethiopian Music 2019(Official Video) by Minew Shewa Tube 2 years ago 4 minutes, 31 seconds 6,459 views",Minew Shewa Entertainment,6459,6535,76
1289,"Ethiopian Music : Bezawit Ashagere ቤዛዊት አሻግሬ (የኔ ጀግና) - New Ethiopian Music 2019(Official Video) by Minew Shewa Tube 2 years ago 5 minutes, 31 seconds 14,352 views",Minew Shewa Entertainment,14352,14371,19
1290,"Ethiopian Music : Boontuu Kabbadaa (Garaa Jaalalaa)- New Ethiopian Music 2019(Official Video) by Minew Shewa Tube 2 years ago 6 minutes, 13 seconds 5,928 views",Minew Shewa Entertainment,5928,5941,13
1291,"Ethiopian Music : Aman T 28 ft Patsy (konjo leza)- New Ethiopian Music 2019(Official Video) by Minew Shewa Tube 2 years ago 4 minutes, 38 seconds 6,380 views",Minew Shewa Entertainment,6380,6384,4
1292,"Ethiopian Music : Znabu Kiros(Zenach) ዝናቡ ኪሮስ (ዘናጭ) መን ይሞንያ New Ethiopian Music 2019(Official Video) by Minew Shewa Tube 2 years ago 4 minutes, 32 seconds 79,127 views",Minew Shewa Entertainment,79127,79241,114
1293,"Ethiopian Music : Sinaf Dejene (Addooyye) - New Ethiopian Music 2019(Official Video) by Minew Shewa Tube 2 years ago 5 minutes, 9 seconds 72,449 views",Minew Shewa Entertainment,72449,72661,212
1294,"Ethiopian Music : Nagaash Bagaashaa (Hawwiikoo) - New Ethiopian Music 2019(Official Video) by Minew Shewa Tube 2 years ago 4 minutes, 29 seconds 2,070 views",Minew Shewa Entertainment,2070,2070,0
1295,"Ethiopian Music: Darrajjee Darrabaa (Filadhuu Yaa Qeerroo) New Ethiopian Music 2019(Official Video) by Minew Shewa Tube 2 years ago 6 minutes, 32 seconds 4,902 views",Minew Shewa Entertainment,4902,4904,2
1296,"Damee Taffassa (Waaqeffannaan Sirna Ganamaati) - New Ethiopian Music 2019(Official Video) by Minew Shewa Tube 2 years ago 5 minutes, 27 seconds 3,570 views",Minew Shewa Entertainment,3570,3572,2
1297,"Ethiopian Music : Burik ft Gildo Kassa (ከኔ በላይ)- New Ethiopian Music 2019(Official Video) by Minew Shewa Tube 2 years ago 4 minutes, 25 seconds 3,216,296 views",Minew Shewa Entertainment,3216296,3236052,19756
1298,"Ethiopian Music : Zaalikaa Rabboo (Yaa Shufeera) - New Ethiopian Music 2019(Official Video) by Minew Shewa Tube 2 years ago 5 minutes, 21 seconds 5,835 views",Minew Shewa Entertainment,5835,5836,1
1299,"Ethiopian Music : Aman አማን (እመኚኝ)- New Ethiopian Music 2019(Official Video) by Minew Shewa Tube 2 years ago 4 minutes, 21 seconds 10,270 views",Minew Shewa Entertainment,10270,10314,44
1300,"Ethiopian Music : Gezahegn Tadesse ገዛኧኝ  ታደሰ (ያሉትን ይበሉ)- New Ethiopian Music 2019(Official Video) by Minew Shewa Tube 2 years ago 4 minutes, 48 seconds 11,017 views",Minew Shewa Entertainment,11017,11022,5
1301,"Ethiopian Music : Ibraahim Mohaammad (Yaa Ililli)- New Ethiopian Music 2019(Official Video) by Minew Shewa Tube 2 years ago 5 minutes, 38 seconds 9,000 views",Minew Shewa Entertainment,9000,9010,10
1302,"Ethiopian Music : Bilisummaa Qaabataa (Gaaddoo) - New Ethiopian Music 2019(Official Video) by Minew Shewa Tube 2 years ago 4 minutes, 33 seconds 4,173 views",Minew Shewa Entertainment,4173,4188,15
1303,"Ethiopian Music : Gabi edaoo (Tokkichummaa) - New Ethiopian Music 2019(Official Video) by Minew Shewa Tube 2 years ago 7 minutes, 7 seconds 7,239 views",Minew Shewa Entertainment,7239,7271,32
1304,"Ethiopian Music : ሃቺካሎ (ባርባር አለው ሆዴን) - New Ethiopian Music 2019(Official Video) by Minew Shewa Tube 2 years ago 6 minutes, 18 seconds 11,457 views",Minew Shewa Entertainment,11457,11458,1
1305,"Ethiopian Music : Mulualem Takele (Shurureye)ሙላለም ታከለ ""ሹሩረዬ""New Ethiopian Music 2019(Official Video) by Minew Shewa Tube 2 years ago 4 minutes, 12 seconds 6,332,338 views",Minew Shewa Entertainment,6332338,6352599,20261
1306,"Ethiopian Music : Maditu Weday (Endewaza) ማዲቱ ወዳይ (እንደዋዛ) - New Ethiopian Music 2019(Official Video) by Minew Shewa Tube 2 years ago 5 minutes, 14 seconds 2,001,371 views",Minew Shewa Entertainment,2001371,2008013,6642
1307,"Ethiopian Music : Amare (Ye Chewa Lij) አማረ (የጨዋ ልጅ)- New Ethiopian Music 2019(Official Video) by Minew Shewa Tube 2 years ago 4 minutes, 37 seconds 5,912 views",Minew Shewa Entertainment,5912,5913,1
1308,"Ethiopian Music : Merawit Genanaw መራዊት ገናናው (ተው ልቤ) - New Ethiopian Music 2019(Official Video) by Minew Shewa Tube 2 years ago 4 minutes, 22 seconds 9,414 views",Minew Shewa Entertainment,9414,9415,1
1309,"Ethiopian Music : Nigaatuu Dammaqaa (Chee Jedhi) - New Ethiopian Music 2019(Official Video) by Minew Shewa Tube 2 years ago 5 minutes, 35 seconds 4,304 views",Minew Shewa Entertainment,4304,4307,3
1310,"Ethiopian Music : Taarikuu Isheetuu (Nuu Waaqeffatota)- New Ethiopian Music 2019(Official Video) by Minew Shewa Tube 2 years ago 4 minutes, 27 seconds 3,905 views",Minew Shewa Entertainment,3905,3911,6
1311,"Ethiopian Music : Miku Baba (Suse) ሚኩ ባባ (ሱሴ) - New Ethiopian Music 2019(Official Video) by Minew Shewa Tube 2 years ago 4 minutes, 32 seconds 5,529 views",Minew Shewa Entertainment,5529,5537,8
1312,"Ethiopian Music : Tizazu Betru (Moja) ትዛዙ በትሩ (ሞጃ) - New Ethiopian Music 2019(Official Video) by Minew Shewa Tube 2 years ago 6 minutes 70,153 views",Minew Shewa Entertainment,70153,70370,217
1313,"Ethiopian Music : Abdi Adam (Ni Turtii Malee) - New Ethiopian Music 2019(Official Video) by Minew Shewa Tube 2 years ago 5 minutes, 48 seconds 14,606 views",Minew Shewa Entertainment,14606,14659,53
1314,"Ethiopian Music: Jiidhaa Leellisaa (Gadaan Quufaa Gabbina) New Ethiopian Music 2019(Official Video) by Minew Shewa Tube 2 years ago 5 minutes, 47 seconds 12,088 views",Minew Shewa Entertainment,12088,12090,2
1315,"Ethiopian Music : Damee Darajee (Dhiisaa Gandummaa) - New Ethiopian Music 2019(Official Video) by Minew Shewa Tube 2 years ago 5 minutes, 34 seconds 8,900 views",Minew Shewa Entertainment,8900,8919,19
1316,"Mulualem Takele {Shurureye) ሙሉዓለም ታከለ ""ሹሩረዬ"" New music video coming soon! by Minew Shewa Tube 2 years ago 1 minute, 41 seconds 162,414 views",Minew Shewa Entertainment,162414,162445,31
1317,"Ethiopian Music : Dagu Dagnew ዳጉ ዳኘው (ጨረቃ ድቡሉቃ) - New Ethiopian Music 2019(Official Video) by Minew Shewa Tube 2 years ago 5 minutes, 13 seconds 5,415 views",Minew Shewa Entertainment,5415,5418,3
1318,"Ethiopian Music : Tibebe Adefris ጥበበ አደፍርስ (ማነው)  - New Ethiopian Music 2019(Official Video) by Minew Shewa Tube 2 years ago 4 minutes, 56 seconds 16,560 views",Minew Shewa Entertainment,16560,16597,37
1319,"Ethiopian Music : Habtish (Fegegtash) ሀብትሽ (ፈገግታሽ)- New Ethiopian Music 2019(Official Video) by Minew Shewa Tube 2 years ago 3 minutes, 41 seconds 4,068 views",Minew Shewa Entertainment,4068,4075,7
1320,"Ethiopian Music : Gosaa Wasanauu (Ya Kullee) - New Ethiopian Music 2019(Official Video) by Minew Shewa Tube 2 years ago 6 minutes, 51 seconds 9,013 views",Minew Shewa Entertainment,9013,9019,6
1321,"Ethiopian Music : Solomon Admasu ሰለሞን አድማሱ (እንቢ እንጃ) - New Ethiopian Music 2019(Official Video) by Minew Shewa Tube 2 years ago 5 minutes, 57 seconds 202,713 views",Minew Shewa Entertainment,202713,203053,340
1322,"Ethiopian Music : Kalkidan Nigussie ቃልኪዳን ንጉሴ (አደራ አለብኝ) - New Ethiopian Music 2019(Official Video) by Minew Shewa Tube 2 years ago 5 minutes, 23 seconds 83,250 views",Minew Shewa Entertainment,83250,83481,231
1323,"Ethiopian Music : Benu Benu (Tulu Ketema)  - New Ethiopian Music 2019(Official Video) by Minew Shewa Tube 2 years ago 6 minutes, 7 seconds 5,910 views",Minew Shewa Entertainment,5910,5922,12
1324,"Ethiopian Music : Alamuu Baayyuu (Koo Yaa Birraa) - New Ethiopian Music 2019(Official Video) by Minew Shewa Tube 2 years ago 5 minutes, 35 seconds 2,133 views",Minew Shewa Entertainment,2133,2137,4
1325,"Dave on the track ft. Alula & Gedi - Ligoda (ልጎዳ) - New Ethiopian Music 2019(Official Video) by Minew Shewa Tube 2 years ago 4 minutes, 53 seconds 168,867 views",Minew Shewa Entertainment,168867,169182,315
1326,"Ethiopian Music : Firoomsaa Gaaddiisaa (Gaddaa Roobalee) - New Ethiopian Music 2019(Official Video) by Minew Shewa Tube 2 years ago 6 minutes, 58 seconds 3,881 views",Minew Shewa Entertainment,3881,3889,8
1327,"Ethiopian Music : Fistum Zebasil ፍፁም ዘባሲል (ዘላለም ኑሪልኝ) New Ethiopian Music 2019(Official Video) by Minew Shewa Tube 2 years ago 6 minutes, 12 seconds 18,383 views",Minew Shewa Entertainment,18383,18388,5
1328,"Ethiopian Music : Henok Berhanu ft Kidi (Negn Beyegna) - New Ethiopian Music 2019(Official Video) by Minew Shewa Tube 2 years ago 4 minutes, 55 seconds 312,960 views",Minew Shewa Entertainment,312960,313484,524
1329,"Ethiopian Music : Humneesaa Badhaasaa (Foollee)- New Ethiopian Music 2019(Official Video) by Minew Shewa Tube 2 years ago 5 minutes, 4 seconds 9,692 views",Minew Shewa Entertainment,9692,9753,61
1330,"Mekdelawit & Amdegebriel መቅደላዊት እና አምደገብርኤል (ደስ ይላል) - New Ethiopian Music 2019(Official Video) by Minew Shewa Tube 2 years ago 5 minutes, 38 seconds 26,589 views",Minew Shewa Entertainment,26589,26603,14
1331,"Ethiopian Music : Haymanot Fantahun ሃይማኖት ፋንታሁን (የኔ ነው) - New Ethiopian Music 2019(Official Video) by Minew Shewa Tube 2 years ago 3 minutes, 48 seconds 9,286 views",Minew Shewa Entertainment,9286,9318,32
1332,"Ethiopian Music : Mekdes Tekalign መቅደስ ተካልኝ (እንፃይና) - New Ethiopian Music 2019(Official Video) by Minew Shewa Tube 2 years ago 4 minutes, 48 seconds 11,870 views",Minew Shewa Entertainment,11870,11881,11
1333,"Ethiopian Music : Kabir G Hageyo (Leello) - New Ethiopian Music 2019(Official Video) by Minew Shewa Tube 2 years ago 3 minutes, 58 seconds 26,453 views",Minew Shewa Entertainment,26453,26494,41
1334,"Ethiopian Music : Endalew Sitotaw እንዳለው ስጦታው (ግፋ በለው) - New Ethiopian Music 2019(Official Video) by Minew Shewa Tube 2 years ago 6 minutes, 24 seconds 899,414 views",Minew Shewa Entertainment,899414,901260,1846
1335,"Ethiopian Music : Haregenesh Habtamu ሐረግነሽ ሀብታሙ (በማተቡ ጠና) - New Ethiopian Music 2019(Official Video) by Minew Shewa Tube 2 years ago 6 minutes, 23 seconds 1,154,459 views",Minew Shewa Entertainment,1154459,1162946,8487
1336,"Ethiopian Music : Bacho Girma (Dabaree Seenaa) - New Ethiopian Music 2019(Official Video) by Minew Shewa Tube 2 years ago 5 minutes, 21 seconds 5,253 views",Minew Shewa Entertainment,5253,5280,27
1337,"Ethiopian Music : Biruk Kassahun (Ney Gela) ብሩክ ካሳሁን(ነይ ገላ) New Ethiopian Music 2019(Official Video) by Minew Shewa Tube 2 years ago 6 minutes, 11 seconds 6,248 views",Minew Shewa Entertainment,6248,6252,4
1338,"Ethiopian Music : Abdiisaa Nagawoo (Meeti Jaalalleen) - New Ethiopian Music 2019(Official Video) by Minew Shewa Tube 2 years ago 5 minutes, 39 seconds 5,619 views",Minew Shewa Entertainment,5619,5626,7
1339,"Ethiopian Music : Ashenafi Dagnew አሸናፊ ዳኘው (አይሸሽም ጎንደሬ) - New Ethiopian Music 2019(Official Video) by Minew Shewa Tube 2 years ago 6 minutes, 46 seconds 9,738 views",Minew Shewa Entertainment,9738,9745,7
1340,"Ethiopian Music : Tsegaye Hailu ፀጋዬ ኃይሉ (ፍቅር የጋራ ነው)- New Ethiopian Music 2019(Official Video) by Minew Shewa Tube 2 years ago 5 minutes, 49 seconds 7,871 views",Minew Shewa Entertainment,7871,7878,7
1341,"Ethiopian Music : Atse Yab (Hagere) አፄ  ያብ (ሀገሬ) - New Ethiopian Music 2019(Official Video) by Minew Shewa Tube 2 years ago 3 minutes, 52 seconds 3,473 views",Minew Shewa Entertainment,3473,3481,8
1342,"Ethiopian Music : Bati Feleke (Temeleshi) ባቲ ፈለቀ (ተመለሽ) - New Ethiopian Music 2019(Official Video) by Minew Shewa Tube 2 years ago 6 minutes, 40 seconds 16,832 views",Minew Shewa Entertainment,16832,16856,24
1343,"Ethiopian Music : Daawii Tolasaa (Ayyaana Waggaa) - New Ethiopian Music 2019(Official Video) by Minew Shewa Tube 2 years ago 5 minutes, 6 seconds 16,400 views",Minew Shewa Entertainment,16400,16446,46
1344,"Ethiopian Music : Amdegebriel Admasu አምደገብርኤል አድማሱ (አቼንዌ) New Ethiopian Music 2019(Official Video) by Minew Shewa Tube 2 years ago 6 minutes, 13 seconds 43,122 views",Minew Shewa Entertainment,43122,43411,289
1345,"Ethiopian Music : Caalaa Fiqaaduu (Har'a Geenye)- New Ethiopian Music 2019(Official Video) by Minew Shewa Tube 2 years ago 6 minutes, 9 seconds 30,532 views",Minew Shewa Entertainment,30532,30667,135
1346,"Izack x Lefarusknows ft Yabu Echo (Washesh) - New Ethiopian Music 2019(Official Video) by Minew Shewa Tube 2 years ago 4 minutes, 13 seconds 5,069 views",Minew Shewa Entertainment,5069,5075,6
1347,"Ethiopian Music : Zerubabbel Molla ዘሩባቤል ሞላ (የኢትዮጵያ አምላክ) - New Ethiopian Music 2019(Official Audio) by Minew Shewa Tube 2 years ago 4 minutes, 4 seconds 7,122 views",Minew Shewa Entertainment,7122,7131,9
1348,"Bewket Setegn (Ney Shegawa) በውቀት ሰጠኝ (ነይ ሸጋዋ) - New Ethiopian Music 2019(Official Video) by Minew Shewa Tube 2 years ago 5 minutes, 49 seconds 13,196 views",Minew Shewa Entertainment,13196,13225,29
1349,"Ethiopian Music : Makbell Hagere ማክቤል አገሬ (ቃል አለኝ)- New Ethiopian Music 2019(Official Video) by Minew Shewa Tube 2 years ago 4 minutes, 21 seconds 14,346 views",Minew Shewa Entertainment,14346,14348,2
1350,"የእርዳታ_ጥሪ ለድምፃዊ ሙሉአለም ታከለ by Minew Shewa Tube 2 years ago 37 seconds 31,573 views",Minew Shewa Entertainment,31573,31659,86
1351,"Ethiopian Music : Atse Tinsu (Fikeraleme) አጼ ትንሱ (ፍቅርአለሜ)- New Ethiopian Music 2019(Official Video) by Minew Shewa Tube 2 years ago 4 minutes, 42 seconds 5,958 views",Minew Shewa Entertainment,5958,5979,21
1352,"Ethiopian Music : Habtaamu Abbabaa (Roorroo)- New Ethiopian Music 2019(Official Video) by Minew Shewa Tube 2 years ago 6 minutes, 2 seconds 11,390 views",Minew Shewa Entertainment,11390,11393,3
1353,"Ethiopian Music: Sochoosaa Lammii (Keenya Finfineen Keenya) New Ethiopian Music 2019(Official Video) by Minew Shewa Tube 2 years ago 7 minutes, 24 seconds 2,894 views",Minew Shewa Entertainment,2894,2895,1
1354,"Ethiopian Music : Azeb Hussien አዜብ ሁሴን (ያዘኝ)- New Ethiopian Music 2019(Official Video) by Minew Shewa Tube 2 years ago 4 minutes, 31 seconds 12,058 views",Minew Shewa Entertainment,12058,12075,17
1355,"Birrara Molla (Anchin Beye) ቢራራ ሞላ (አንቺን ብዬ) - New Ethiopian Music 2019(Official Video) by Minew Shewa Tube 2 years ago 5 minutes, 46 seconds 13,415 views",Minew Shewa Entertainment,13415,13415,0
1356,"Helen Mehari (Senay Zemen) ሄለን መሃሪ (ሰናይ  ዘመን)- New Ethiopian Music 2019(Official Video) by Minew Shewa Tube 2 years ago 4 minutes, 37 seconds 10,464 views",Minew Shewa Entertainment,10464,10468,4
1357,"Abraham Berhe (Abrahaley) (Ferihe) አብርሃም በርሀ (አብርሃለይ) (ፈሪሐ) New Ethiopian Music 2019(Official Video) by Minew Shewa Tube 2 years ago 7 minutes, 3 seconds 2,842 views",Minew Shewa Entertainment,2842,2854,12
1358,"Fanta Bele x Tilahun Bazezew ፋንታ በሌ እና ጥላሁን ባዘዘው(ልማል በስምህ) New Ethiopian Music 2019(Official Video) by Minew Shewa Tube 2 years ago 9 minutes, 2 seconds 11,892 views",Minew Shewa Entertainment,11892,11911,19
1359,"Ethiopian Music : Maamud Kurkee (Tokkummaa) - New Ethiopian Music 2019(Official Video) by Minew Shewa Tube 2 years ago 5 minutes, 58 seconds 4,016 views",Minew Shewa Entertainment,4016,4028,12
1360,"Ethiopian Music : Haylemichael Kenaw ኃይለሚካኤል ቀናው (አንቺየዋ) - New Ethiopian Music 2019(Official Video) by Minew Shewa Tube 2 years ago 6 minutes, 19 seconds 6,171 views",Minew Shewa Entertainment,6171,6173,2
1361,"Ethiopian Music : Raggaasaa Dachaasaa (An Sinega) - New Ethiopian Music 2019(Official Video) by Minew Shewa Tube 2 years ago 3 minutes, 37 seconds 7,633 views",Minew Shewa Entertainment,7633,7641,8
1362,"Yehualaw Admas ft Yalew የኃላው አድማስ ft ያለው (ፈራሁ) - New Ethiopian Music 2019(Official Video) by Minew Shewa Tube 2 years ago 5 minutes, 39 seconds 8,881 views",Minew Shewa Entertainment,8881,8887,6
1363,"Ethiopian Music : Habtamu Gudeta ሀብታሙ ጉደታ (እንጨፍራ) - New Ethiopian Music 2019(Official Video) by Minew Shewa Tube 2 years ago 4 minutes, 43 seconds 5,472 views",Minew Shewa Entertainment,5472,5474,2
1364,"Ethiopian Music: Amarech Molla (Yale Selam) አማረች ሞላ(ያለ ሰላም) New Ethiopian Music 2019(Official Video) by Minew Shewa Tube 2 years ago 5 minutes 23,098 views",Minew Shewa Entertainment,23098,23115,17
1365,"Alemayehu Soramo (Hayalalo) አለማየሁ ሶራሞ (ሃያላሎ) - New Ethiopian Music 2019(Official Video) by Minew Shewa Tube 2 years ago 4 minutes, 39 seconds 5,583 views",Minew Shewa Entertainment,5583,5589,6
1366,"Ethiopian Music : Addisu Furgasa (Kemise) - New Ethiopian Music 2019(Official Video) by Minew Shewa Tube 2 years ago 6 minutes, 37 seconds 38,293 views",Minew Shewa Entertainment,38293,38590,297
1367,"Ethiopian Music : Sami Dan ሳሚ ዳን (Anchin Beye አንቺን ብዬ) New Ethiopian Music 2019(Official Video) by Minew Shewa Tube 2 years ago 4 minutes, 9 seconds 182,231 views",Minew Shewa Entertainment,182231,183957,1726
1368,"Sami Dan (Behind the Scene) ሳም ዳን (ከመድረክ ጀርባ) - Promotional Video by Minew Shewa Tube 2 years ago 2 minutes, 15 seconds 4,269 views",Minew Shewa Entertainment,4269,4282,13
1369,"Bisrat Alemayehu (Awdamet) ብስራት አለማየሁ (አውዳመት) - New Ethiopian Music 2019(Official Video) by Minew Shewa Tube 2 years ago 6 minutes, 21 seconds 12,673 views",Minew Shewa Entertainment,12673,12684,11
1370,"Ethiopian Music : Hana Tadesse (Zare New) ሃና ታደሰ (ዛሬ ነው) - New Ethiopian Music 2019(Official Video) by Minew Shewa Tube 2 years ago 3 minutes, 59 seconds 12,737 views",Minew Shewa Entertainment,12737,12749,12
1371,"Ethiopian Music : Birhaanuu Margaa (Yaa Hawwashaa) - New Ethiopian Music 2019(Official Video) by Minew Shewa Tube 2 years ago 5 minutes, 18 seconds 33,668 views",Minew Shewa Entertainment,33668,34077,409
1372,"ቀራለም ዘውዱ ፣ ሰውዓለም ደምሌ ፣ አላቸው አስቻለ (እንግጫችን ደነፋ) - New Ethiopian Music 2019(Official Video) by Minew Shewa Tube 2 years ago 7 minutes, 47 seconds 75,379 views",Minew Shewa Entertainment,75379,75411,32
1373,"Ethiopian Music : Caalaa Negaasaa (Mucaa Biyya Ko) - New Ethiopian Music 2019(Official Video) by Minew Shewa Tube 2 years ago 6 minutes, 10 seconds 5,604 views",Minew Shewa Entertainment,5604,5607,3
1374,"Ethiopian Music : Senedu Alie (Zemaye Neh) ስንዱ አሌ (ዜማዬ ነህ) New Ethiopian Music 2019(Official Video) by Minew Shewa Tube 2 years ago 5 minutes, 54 seconds 265,403 views",Minew Shewa Entertainment,265403,266358,955
1375,"ዮሴፍ አለምሰገድ ፣ ተፈሪ ውድነህ ፣ ዘጌት ደጀኔ ፣ ይታገሱ ወንደሰን (አውዳመት) - New Ethiopian Music 2019(Official Video) by Minew Shewa Tube 2 years ago 4 minutes, 59 seconds 36,891 views",Minew Shewa Entertainment,36891,36891,0
1376,"Ethiopian Music : Zerihun Asrat (Zemen) ዘሪሁን አስራት (ዘመን)- New Ethiopian Music 2019(Official Video) by Minew Shewa Tube 2 years ago 4 minutes, 53 seconds 8,852 views",Minew Shewa Entertainment,8852,8863,11
1377,"Ethiopian Music: Betelhem Fikru (Tamraleh) ቤተልሄም ፍቅሩ (ታምራለህ)New Ethiopian Music 2019(Official Video) by Minew Shewa Tube 2 years ago 4 minutes, 7 seconds 9,932 views",Minew Shewa Entertainment,9932,9937,5
1378,"Abeselom Bihonegn ft Kidist Wolde (Yedmek) አቢሴሎም ቢሆነኝ እና ቅድስት ወልዴ (ይድመቅ) - New Ethiopian Music 2019 by Minew Shewa Tube 2 years ago 4 minutes, 36 seconds 82,727 views",Minew Shewa Entertainment,82727,82744,17
1379,"Ethiopian Music : Muluken Taju (Amen) ሙሉቀን ታጁ (አሜን) - New Ethiopian Music 2019(Official Video) by Minew Shewa Tube 2 years ago 4 minutes, 42 seconds 18,310 views",Minew Shewa Entertainment,18310,18314,4
1380,"Ethiopian Music : Zemenu Nega (Kuzi) ዘመኑ ነጋ (ኩዚ) (ስመኝ) - New Ethiopian Music 2019(Official Video) by Minew Shewa Tube 2 years ago 4 minutes, 3 seconds 58,590 views",Minew Shewa Entertainment,58590,58715,125
1381,"Ethiopian Music : Mikaba ሚክ አባ (ተዋህደናል) - New Ethiopian Music 2019(Official Video) by Minew Shewa Tube 2 years ago 5 minutes, 10 seconds 12,645 views",Minew Shewa Entertainment,12645,12647,2
1382,"Ethiopian Music : Fikadu Belay ፍቃዱ በላይ (ዝናው ኩራቴ) - New Ethiopian Music 2019(Official Video) by Minew Shewa Tube 2 years ago 5 minutes, 3 seconds 5,799 views",Minew Shewa Entertainment,5799,5800,1
1383,"Ethiopian Music : Zerihun Alemayew ዘሪሁን አለማየሁ (መምር ይሽር) New Ethiopian Music 2019(Official Video) by Minew Shewa Tube 2 years ago 5 minutes, 2 seconds 4,687 views",Minew Shewa Entertainment,4687,4693,6
1384,"Ethiopian Music : Biruk Dejene (Tolo Ney) ብሩክ ደጀኔ (ቶሎ ነይ) - New Ethiopian Music 2019(Official Video) by Minew Shewa Tube 2 years ago 4 minutes, 56 seconds 50,815 views",Minew Shewa Entertainment,50815,50841,26
1385,"Ethiopian Music : Zufan Abebe (Awdamet) ዙፋን አበበ (አውዳመት) - New Ethiopian Music 2019(Official Video) by Minew Shewa Tube 2 years ago 5 minutes, 45 seconds 28,638 views",Minew Shewa Entertainment,28638,28770,132
1386,"Badhaasa Abboyyee (Hiriyee Jalqabniko Summa) - New Ethiopian Music 2019(Official Video) by Minew Shewa Tube 2 years ago 5 minutes, 24 seconds 4,398 views",Minew Shewa Entertainment,4398,4401,3
1387,"Ethiopian Music : Asheber Belay (Wazemaw) አሸብር በላይ (ዋዜማው) - New Ethiopian Music 2019(Official Video) by Minew Shewa Tube 2 years ago 4 minutes, 14 seconds 99,287 views",Minew Shewa Entertainment,99287,99354,67
1388,"Ethiopian music: Tadelo Yesheber (Lomeye) ታድሎ የሽበር (ሎምየ) New Ethiopian Music 2019(Official Video) by Minew Shewa Tube 2 years ago 7 minutes, 4 seconds 19,160 views",Minew Shewa Entertainment,19160,19178,18
1389,"Ethiopian Music : Feeysal Abdurahmaan (Dabaala Dabeessaa) - New Ethiopian Music 2019(Official Video) by Minew Shewa Tube 2 years ago 6 minutes, 45 seconds 9,656 views",Minew Shewa Entertainment,9656,9657,1
1390,"Ethiopian Music : Tensayi Girma (Yikerta) ተንሳይ ግርማ (ይቅርታ) - New Ethiopian Music 2019(Official Video) by Minew Shewa Tube 2 years ago 5 minutes, 33 seconds 4,632 views",Minew Shewa Entertainment,4632,4643,11
1391,"Ethiopian Music : Desalew Simeneh ደሳለው ስሜነህ (እናትዬ ጠለምት) - New Ethiopian Music 2019(Official Video) by Minew Shewa Tube 2 years ago 7 minutes, 19 seconds 6,421 views",Minew Shewa Entertainment,6421,6423,2
1392,"Ethiopian Music : Hundesa Regassa (Ergaa Dubbin akkanaa) - New Ethiopian Music 2019(Official Video) by Minew Shewa Tube 2 years ago 4 minutes, 41 seconds 3,562 views",Minew Shewa Entertainment,3562,3563,1
1393,"Ethiopian Music : Feyyiissaa Lammaa (Siduukaa Jirra) - New Ethiopian Music 2019(Official Video) by Minew Shewa Tube 2 years ago 5 minutes, 8 seconds 4,601 views",Minew Shewa Entertainment,4601,4602,1
1394,"Ethiopian Music : Belay Abfenta በላይ አብፈንታ (አረጋጊው)  - New Ethiopian Music 2019(Official Video) by Minew Shewa Tube 2 years ago 6 minutes, 3 seconds 91,718 views",Minew Shewa Entertainment,91718,91753,35
1395,"Ethiopian Music : Solo Zema ሶሎ ዜማ (ያነገስኩሽ) - New Ethiopian Music 2019(Official Video) by Minew Shewa Tube 2 years ago 5 minutes, 7 seconds 52,157 views",Minew Shewa Entertainment,52157,52169,12
1396,"Ethiopian Music: Asrat Alubo (Shishoende) አስራት አሉቦ (ሺሾእንዴ) New Ethiopian Music 2019(Official Video) by Minew Shewa Tube 2 years ago 6 minutes, 16 seconds 11,923 views",Minew Shewa Entertainment,11923,12005,82
1397,"Ethiopian Music : Badhaasa Abboyyee (Qallo Shoororotiyaa) - New Ethiopian Music 2019(Official Video) by Minew Shewa Tube 2 years ago 6 minutes, 31 seconds 5,496 views",Minew Shewa Entertainment,5496,5506,10
1398,"Ethiopian Music : Befirdu Tefera (Sokki Jalaa) - New Ethiopian Music 2019(Official Video) by Minew Shewa Tube 2 years ago 6 minutes, 2 seconds 5,932 views",Minew Shewa Entertainment,5932,5935,3
1399,"Ethiopian Music : Mesfin Bekele መስፍን በቀለ (እዮሃ አበባዬ) - New Ethiopian Music 2019(Official Video) by Minew Shewa Tube 2 years ago 6 minutes, 56 seconds 2,450,606 views",Minew Shewa Entertainment,2450606,2452843,2237
1400,"Dawit H/Mariam (Kena Beye) ዳዊት ሃ/ማርያም (ቀና ብዬ) - New Ethiopian Music 2019(Official Video) by Minew Shewa Tube 2 years ago 7 minutes, 15 seconds 14,413 views",Minew Shewa Entertainment,14413,14417,4
1401,"Ethiopian Music :Yoseph Alemseged (Meraf) ዮሴፍ ዓለምሰገድ (ምዕራፍ) New Ethiopian Music 2019(Official Video) by Minew Shewa Tube 2 years ago 5 minutes, 3 seconds 5,348 views",Minew Shewa Entertainment,5348,5355,7
1402,"Ethiopian Music : Gammadaa Gammachuu (Yaa Tamiimaa) - New Ethiopian Music 2019(Official Video) by Minew Shewa Tube 2 years ago 4 minutes, 44 seconds 7,584 views",Minew Shewa Entertainment,7584,7601,17
1403,"Ethiopian Music : Obsaa Musxafaa (Utuba Jiruu) - New Ethiopian Music 2019(Official Video) by Minew Shewa Tube 2 years ago 5 minutes, 6 seconds 8,412 views",Minew Shewa Entertainment,8412,8418,6
1404,"Ethiopian Music : Tesfahun Atalele (Agegnew Fiker) - New Ethiopian Music 2019(Official Video) by Minew Shewa Tube 2 years ago 5 minutes, 54 seconds 16,020 views",Minew Shewa Entertainment,16020,16030,10
1405,"Ethiopian Music : Redet Tolosa & Menale Tadesse (Lale) - New Ethiopian Music 2019(Official Video) by Minew Shewa Tube 2 years ago 6 minutes, 35 seconds 232,093 views",Minew Shewa Entertainment,232093,233399,1306
1406,"Ethiopian Music: Tesfaye Adugna (Qene Nat) ተስፋዬ አዱኛ(ቅኔ ናት) New Ethiopian Music 2019(Official Video) by Minew Shewa Tube 2 years ago 6 minutes, 34 seconds 143,941 views",Minew Shewa Entertainment,143941,144589,648
1407,"Ethiopian Music : Dess + Yamlu Molla ደስ + ያምሉ ሞላ (እዮሀ) - New Ethiopian Music 2019(Official Video) by Minew Shewa Tube 2 years ago 4 minutes, 12 seconds 7,162 views",Minew Shewa Entertainment,7162,7174,12
1408,"Ethiopian Music : Toshii Nuurassa (Baga Geessan) - New Ethiopian Music 2019(Official Video) by Minew Shewa Tube 2 years ago 5 minutes, 31 seconds 5,143 views",Minew Shewa Entertainment,5143,5145,2
1409,"Ethiopian Music : Myco Ft Bek Key (Rashin Hun) ራስህን ሁን - New Ethiopian Music 2019(Official Video) by Minew Shewa Tube 2 years ago 4 minutes, 14 seconds 4,976 views",Minew Shewa Entertainment,4976,4982,6
1410,"Tadele Menweye (Tolo na Belew) ታደለ ምንውዬ (ቶሎ ና በለው)- New Ethiopian Music 2019(Official Video) by Minew Shewa Tube 2 years ago 7 minutes, 21 seconds 34,012 views",Minew Shewa Entertainment,34012,34032,20
1411,"Ethiopian Music : Seenaa Shifaraa (Amboo Kessa) - New Ethiopian Music 2019(Official Video) by Minew Shewa Tube 2 years ago 7 minutes, 56 seconds 29,938 views",Minew Shewa Entertainment,29938,30131,193
1412,"Ethiopian Music : Fallaqaa Zannaba (Tokkoo Ta aa)- New Ethiopian Music 2019(Official Video) by Minew Shewa Tube 2 years ago 7 minutes, 5 seconds 4,472 views",Minew Shewa Entertainment,4472,4480,8
1413,"Ethiopian Music : Saartuu Usmaayoo (Yanni Kee) - New Ethiopian Music 2019(Official Video) by Minew Shewa Tube 2 years ago 5 minutes, 11 seconds 69,406 views",Minew Shewa Entertainment,69406,70316,910
1414,"Getch Ft Jo (Anchin Salay) ጌች እና ጆ (አንቺን ሳላይ) - New Ethiopian Music 2019(Official Video) by Minew Shewa Tube 2 years ago 4 minutes, 33 seconds 6,448 views",Minew Shewa Entertainment,6448,6460,12
1415,"Ethiopian Music : Yabu JC (Atawkem) አታውቅም  - New Ethiopian Music 2019(Official Video) by Minew Shewa Tube 2 years ago 3 minutes, 55 seconds 6,369 views",Minew Shewa Entertainment,6369,6385,16
1416,"Ethiopian Music : Haymi Leneger ሃይሚ ልንገር (አደንቀዋለሁ) - New Ethiopian Music 2019(Official Video) by Minew Shewa Tube 2 years ago 5 minutes 30,253 views",Minew Shewa Entertainment,30253,30269,16
1417,"Ethiopian Music : Biraanuu Margaa (Yoo Warraaqsan) - New Ethiopian Music 2019(Official Video) by Minew Shewa Tube 2 years ago 7 minutes, 7 seconds 23,104 views",Minew Shewa Entertainment,23104,23421,317
1418,"Ethiopian Music : Anteneh & Jossy (Ameletkush) አመለጥኩሽ- New Ethiopian Music 2019(Official Video) by Minew Shewa Tube 2 years ago 3 minutes, 44 seconds 4,168 views",Minew Shewa Entertainment,4168,4171,3
1419,"Shegaw Alebaw (Echi Nat Hagere) ሸጋው አለባው (እቺ ናት ሃገሬ) - New Ethiopian Music 2019(Official Video) by Minew Shewa Tube 2 years ago 5 minutes, 52 seconds 6,760 views",Minew Shewa Entertainment,6760,6765,5
1420,"Solomon Yazachew (Solyaz) Eski Hode Chalew ሶልያዝ(እስኪ ሆዴ ቻለው)New Ethiopian Music 2019(Official Video) by Minew Shewa Tube 2 years ago 6 minutes, 25 seconds 40,049 views",Minew Shewa Entertainment,40049,40382,333
1421,"Ethiopian Music : George (William Shamper) ጆርጅ - New Ethiopian Music 2019(Official Video) by Minew Shewa Tube 2 years ago 3 minutes, 42 seconds 3,068 views",Minew Shewa Entertainment,3068,3074,6
1422,"Abey Kasahun (Yetsedey Eshoh) አብይ ካሳሁን (የፀደይ እሾህ) - New Ethiopian Music 2019(Official Video) by Minew Shewa Tube 2 years ago 5 minutes, 4 seconds 6,483 views",Minew Shewa Entertainment,6483,6494,11
1423,"Ethiopian music : Fitsum Hagos (Lebey) ፍፁም ሐጎስ (ልበይ) - New Ethiopian Music 2019(Official Video) by Minew Shewa Tube 2 years ago 4 minutes, 24 seconds 9,958 views",Minew Shewa Entertainment,9958,9965,7
1424,"Ethiopian Music : Jamiil Abduu (Eessaa Dhufe)- New Ethiopian Music 2019(Official Video) by Minew Shewa Tube 2 years ago 7 minutes, 9 seconds 4,608 views",Minew Shewa Entertainment,4608,4611,3
1425,"Ethiopian Music : Bethelhem Birhan ቤተልሄም ብርሃን (ሸርውጣ)- New Ethiopian Music 2019(Official Video) by Minew Shewa Tube 2 years ago 5 minutes, 6 seconds 16,063 views",Minew Shewa Entertainment,16063,16084,21
1426,"Gildo Kassa ft Shakura (Lageba New) ጊልዶ ካሳ እና ሻኩራ (ላገባ ነው) New Ethiopian Music 2019(Official Video) by Minew Shewa Tube 2 years ago 4 minutes, 41 seconds 12,064,637 views",Minew Shewa Entertainment,12064637,12099479,34842
1427,"Frestadik W/Hawariat ፍሬፃዲቅ ወ/ሐዋርያት (ክበሪ ዘላለም) - New Ethiopian Music 2019(Official Video) by Minew Shewa Tube 2 years ago 4 minutes, 30 seconds 5,383 views",Minew Shewa Entertainment,5383,5385,2
1428,"Ethiopian Music : Leensaa Abdulmaalik (Na Simadhu) - New Ethiopian Music 2019(Official Video) by Minew Shewa Tube 2 years ago 4 minutes, 53 seconds 12,133 views",Minew Shewa Entertainment,12133,12162,29
1429,"Ethiopian Music : Derese Bisrat | Joro | ደረሰ ብስራት | ጆሮ | New Ethiopian Music 2019(Official Video) by Minew Shewa Tube 2 years ago 4 minutes, 57 seconds 7,783 views",Minew Shewa Entertainment,7783,7800,17
1430,"Ethiopian Music: Hidota Eden Dagi ሂዶታ ኤደን ዳጊ (ባለ ብዙ ቀለም) - New Ethiopian Music 2019(Official Video) by Minew Shewa Tube 2 years ago 5 minutes, 59 seconds 11,371 views",Minew Shewa Entertainment,11371,11376,5
1431,"Ethiopian Music : Do'ii Leemman (Duubati Hin Deebinu) - New Ethiopian Music 2019(Official Video) by Minew Shewa Tube 2 years ago 5 minutes, 26 seconds 6,019 views",Minew Shewa Entertainment,6019,6033,14
1432,"Emenet Mesay (Anten Beye) እምነት መሳይ (አንተን ብዬ) New Ethiopian Music 2019(Official Video) by Minew Shewa Tube 2 years ago 4 minutes, 22 seconds 9,998 views",Minew Shewa Entertainment,9998,10022,24
1433,"Ethiopian Music : Admasu Wana (Yemechal) አድማሱ ዋና (ይመቻል) - New Ethiopian Music 2019(Official Video) by Minew Shewa Tube 2 years ago 7 minutes, 7 seconds 169,454 views",Minew Shewa Entertainment,169454,169974,520
1434,"Zenawi & Asefa (Weyzerazr Tigray) ዜናዊ እና አሰፋ (ወይዘራዝር ትግራይ) New Ethiopian Music 2019(Official Video) by Minew Shewa Tube 2 years ago 5 minutes, 18 seconds 145,464 views",Minew Shewa Entertainment,145464,147797,2333
1435,"Ethiopian Music : Bety (Terf Alfelegem) ቤቲ (ትርፍ አልፈልግም) - New Ethiopian Music 2019(Official Video) by Minew Shewa Tube 2 years ago 3 minutes, 56 seconds 8,120 views",Minew Shewa Entertainment,8120,8123,3
1436,"Ethiopian Music : Samuel Teshager (Aman) ሳሙኤል ተሻገር (አማን) - New Ethiopian Music 2019(Official Video) by Minew Shewa Tube 2 years ago 5 minutes, 31 seconds 18,532 views",Minew Shewa Entertainment,18532,0,-18532
1437,"Ethiopian Music : Raskey (Konjo) ራስኪይ (ቆንጆ)- New Ethiopian Music 2019(Official Video) by Minew Shewa Tube 2 years ago 4 minutes, 38 seconds 5,007 views",Minew Shewa Entertainment,5007,5009,2
1438,"Ethiopian Music : Jada King (Ande Eyeta) ጃዳ ኪንግ (አንድ እይታ) New Ethiopian Music 2019(Official Video) by Minew Shewa Tube 2 years ago 4 minutes, 28 seconds 6,612 views",Minew Shewa Entertainment,6612,6626,14
1439,"Ethiopian Music : Lijalem Taye (Na Belay) ልጅዓለም ታዬ (ና በላይ) New Ethiopian Music 2019(Official Video) by Minew Shewa Tube 2 years ago 5 minutes, 15 seconds 12,517 views",Minew Shewa Entertainment,12517,12526,9
1440,"Ethiopian Music: Eskedar Berihun(Enawga) እስከዳር በሪሁን(እናውጋ) - New Ethiopian Music 2019(Official Video) by Minew Shewa Tube 2 years ago 4 minutes, 57 seconds 97,162 views",Minew Shewa Entertainment,97162,97742,580
1441,"Ethiopian Music : Bekan Melka (Ulaagaa Biyyummaa) - New Ethiopian Music 2019(Official Video) by Minew Shewa Tube 2 years ago 6 minutes, 45 seconds 6,936 views",Minew Shewa Entertainment,6936,6938,2
1442,"Berihun Lemeneh (Belay Zelko Sihed) በሪሁን ልመንህ (በላይ ዘልቆ ሲሄድ)New Ethiopian Music 2019(Official Video) by Minew Shewa Tube 2 years ago 5 minutes, 33 seconds 8,287 views",Minew Shewa Entertainment,8287,8294,7
1443,"Ethiopian Music : Gannat Magarsaa (Oromoo Koo) - New Ethiopian Music 2019(Official Video) by Minew Shewa Tube 2 years ago 5 minutes, 12 seconds 3,633 views",Minew Shewa Entertainment,3633,3634,1
1444,"Ethiopian Music : Boontuu Kebada (Harmee) - New Ethiopian Music 2019(Official Video) by Minew Shewa Tube 2 years ago 6 minutes, 14 seconds 5,768 views",Minew Shewa Entertainment,5768,5779,11
1445,"Ethiopian Music : Tsega Berhe (NaNa) ፀጋ በርሄ (ናና) - New Ethiopian Music 2019(Official Video) by Minew Shewa Tube 2 years ago 4 minutes, 32 seconds 7,248 views",Minew Shewa Entertainment,7248,7257,9
1446,"Ethiopian Music : Oromiyaa Guuta (Fungee Tiyyaa) - New Ethiopian Music 2019(Official Video) by Minew Shewa Tube 2 years ago 5 minutes, 37 seconds 9,429 views",Minew Shewa Entertainment,9429,9564,135
1447,"Ethiopian Music : Araarsaa Dhaabaa (Waanofii Koo)- New Ethiopian Music 2019(Official Video) by Minew Shewa Tube 2 years ago 5 minutes, 28 seconds 4,680 views",Minew Shewa Entertainment,4680,4683,3
1448,"Nati Z Qene ft Dayan ናቲ (ዘ ቅኔ) እና ዳያን (ተባለልሽ) - New Ethiopian Music 2019(Official Video) by Minew Shewa Tube 2 years ago 4 minutes, 42 seconds 6,942 views",Minew Shewa Entertainment,6942,6948,6
1449,"Ethiopian Music: Samuel Mohamed (Man Ale) ሳሙኤል መሐመድ (ማን አለ) New Ethiopian Music 2019(Official Video) by Minew Shewa Tube 2 years ago 4 minutes, 31 seconds 7,975 views",Minew Shewa Entertainment,7975,7982,7
1450,"Ethiopian Music : Melkam Beze (Nama) መልካም በዜ (ናማ) - New Ethiopian Music 2019(Official Video) by Minew Shewa Tube 2 years ago 4 minutes, 41 seconds 5,671 views",Minew Shewa Entertainment,5671,5683,12
1451,"Upper Dem Ute ft Tsega Kiros ""Kongoja ነይ በለኝ"" Uganda Ethiopian New Music 2019(Official Video) by Minew Shewa Tube 2 years ago 3 minutes, 56 seconds 6,753 views",Minew Shewa Entertainment,6753,6760,7
1452,"Anteneh Adenew (Ciao Ciao) አንተነህ አድነው (ቻው ቻው) - New Ethiopian Music 2019(Official Video) by Minew Shewa Tube 2 years ago 6 minutes, 30 seconds 37,717 views",Minew Shewa Entertainment,37717,37724,7
1453,"Ethiopian Music : AB MAN (Tasike) - New Ethiopian Music 2019(Official Video) by Minew Shewa Tube 2 years ago 3 minutes, 52 seconds 5,794 views",Minew Shewa Entertainment,5794,5795,1
1454,"Ethiopian Music : Dagy (Yeleb Weg) ዳጊ (የልብ ወግ)- New Ethiopian Music 2019(Official Video) by Minew Shewa Tube 2 years ago 3 minutes, 32 seconds 2,973 views",Minew Shewa Entertainment,2973,2980,7
1455,"Ethiopian Music : Darejjee Katamaa (Yaa Jajjabee) - New Ethiopian Music 2019(Official Video) by Minew Shewa Tube 2 years ago 6 minutes, 22 seconds 3,798 views",Minew Shewa Entertainment,3798,3808,10
1456,"Ethiopian Music : Nimoonnaa Sintaayyoo (Tokummaa)- New Ethiopian Music 2019(Official Video) by Minew Shewa Tube 2 years ago 6 minutes, 53 seconds 4,038 views",Minew Shewa Entertainment,4038,4038,0
1457,"Ethiopian Music : Adera Ashu (Yekerta) አደራ አሹ (ይቅርታ) - New Ethiopian Music 2019(Official Video) by Minew Shewa Tube 2 years ago 4 minutes, 40 seconds 4,742 views",Minew Shewa Entertainment,4742,4742,0
1458,"Ethiopian Music : Zema Ahadu (Adera) ዜማ አሃዱ (አደራ) - New Ethiopian Music 2019(Official Video) by Minew Shewa Tube 2 years ago 4 minutes, 48 seconds 17,558 views",Minew Shewa Entertainment,17558,17573,15
1459,"Ethiopian Music: Solomon Addisu(Selam New) ሰለሞን አዲሱ(ሰላም ነው) New Ethiopian Music 2019(Official Video) by Minew Shewa Tube 2 years ago 6 minutes 8,246 views",Minew Shewa Entertainment,8246,8255,9
1460,"Ethiopian Music : Mente X ft Tom Aladametehem (አላዳምጥህም)- New Ethiopian Music 2019(Official Video) by Minew Shewa Tube 2 years ago 4 minutes, 55 seconds 5,421 views",Minew Shewa Entertainment,5421,5426,5
1461,"Ethiopian Music : Aweke Lemlemu አወቀ ለምለሙ (ይፈራታል ልቤ) - New Ethiopian Music 2019(Official Video) by Minew Shewa Tube 2 years ago 5 minutes, 31 seconds 20,047 views",Minew Shewa Entertainment,20047,20053,6
1462,"Ethiopian Music : Saamii Abdii (Safuu Jalaltikee) - New Ethiopian Music 2019(Official Video) by Minew Shewa Tube 2 years ago 4 minutes, 46 seconds 5,615 views",Minew Shewa Entertainment,5615,5617,2
1463,"Ethiopian Music: Ashuu Baqqalaa (Yeroon Yeroo tokkummaati) New Ethiopian Music 2019(Official Video) by Minew Shewa Tube 2 years ago 7 minutes, 10 seconds 4,947 views",Minew Shewa Entertainment,4947,4961,14
1464,"Ethiopian Music : Dawit Alemu (Shekerker) ዳዊት አለሙ (ሽቅርቅር) - New Ethiopian Music 2019(Official Video) by Minew Shewa Tube 2 years ago 4 minutes, 32 seconds 11,879 views",Minew Shewa Entertainment,11879,11882,3
1465,"Ethiopian Music : Geetuu Damissu (Soddoma)- New Ethiopian Music 2019(Official Video) by Minew Shewa Tube 2 years ago 6 minutes, 53 seconds 9,401 views",Minew Shewa Entertainment,9401,9408,7
1466,"Ethiopian Music : Yabebal Dese (Zomawa) ያብባል ደሴ (ዞማዋ) - New Ethiopian Music 2019(Official Video) by Minew Shewa Tube 2 years ago 7 minutes, 6 seconds 79,093 views",Minew Shewa Entertainment,79093,79190,97
1467,"Ethiopian Music : Darajjee Raggaasaa (Oroomiyaa) - New Ethiopian Music 2019(Official Video) by Minew Shewa Tube 2 years ago 5 minutes, 18 seconds 8,478 views",Minew Shewa Entertainment,8478,8481,3
1468,"Ethiopian Music : Zebiba Girma (Gerager) ዘቢባ ግርማ (ገራገር) - New Ethiopian Music 2019(Official Video) by Minew Shewa Tube 2 years ago 4 minutes, 36 seconds 15,201,427 views",Minew Shewa Entertainment,15201427,15228363,26936
1469,"Ethiopian Music : Serawit Tadesse (Metek) ሰራዊት ታደሰ (መቴክ) - New Ethiopian Music 2019(Official Video) by Minew Shewa Tube 2 years ago 3 minutes, 45 seconds 14,869 views",Minew Shewa Entertainment,14869,14875,6
1470,"Henok Ambaye (Heni Bench) ሄኖክ አምባዬ (ሄኒ ቤንች) ""ልበሽ Libesh"" New Ethiopian Music 2019(Official Video) by Minew Shewa Tube 2 years ago 5 minutes, 31 seconds 29,346 views",Minew Shewa Entertainment,29346,29368,22
1471,"Ethiopian Music : Abara Mojo (Oromiyaa) - New Ethiopian Music 2019(Official Video) by Minew Shewa Tube 2 years ago 5 minutes, 7 seconds 4,278 views",Minew Shewa Entertainment,4278,4292,14
1472,"Alex Olompia (አሌክስ ኦሎምፒያ) ""ሪሓነይ Rihanney"" New Ethiopian & Eritrean Music 2019 (Official Video) by Minew Shewa Tube 2 years ago 5 minutes, 58 seconds 151,189 views",Minew Shewa Entertainment,151189,151713,524
1473,"Ethiopian Music : Aklilu Mekonnen አክሊሉ መኮንን (ምነው በዛ) - New Ethiopian Music 2019(Official Video) by Minew Shewa Tube 2 years ago 4 minutes, 32 seconds 7,523 views",Minew Shewa Entertainment,7523,7529,6
1474,"Leoul Biruk (Asrekebun Hager) ልዑል ብሩክ (አስረክቡን ሀገር) - New Ethiopian Music 2019(Official Video) by Minew Shewa Tube 2 years ago 3 minutes, 42 seconds 14,540 views",Minew Shewa Entertainment,14540,14542,2
1475,"Ethiopian Music: Habtam Birara (Nurelign) ሃብታም ቢራራ (ኑርልኝ) New Ethiopian Music 2019(Official Video) by Minew Shewa Tube 2 years ago 4 minutes, 43 seconds 5,488 views",Minew Shewa Entertainment,5488,5490,2
1476,"Ethiopian Music : Dag off (የሺ) በሃሳብ ውጥረቴ - New Ethiopian Music 2019(Official Video) by Minew Shewa Tube 2 years ago 4 minutes, 11 seconds 9,234 views",Minew Shewa Entertainment,9234,9246,12
1477,"Ethiopian MUSIC: Mikiyas Nigussie (Miki Lala) ft Maki Kebi ""አዲስ ስሜት"" New Ethiopian Music video 2019. by Minew Shewa Tube 2 years ago 4 minutes, 41 seconds 600,039 views",Minew Shewa Entertainment,600039,601824,1785
1478,"Oromo Music : Habiibaa Huseen (Harmee Koo)- New Ethiopian Music 2019(Official Video) by Minew Shewa Tube 2 years ago 5 minutes, 15 seconds 31,410 views",Minew Shewa Entertainment,31410,31629,219
1479,"Oromo Music : Teediy Baqqalaa (Intala Mootii) - New Ethiopian Music 2019(Official Video) by Minew Shewa Tube 2 years ago 5 minutes, 28 seconds 7,879 views",Minew Shewa Entertainment,7879,7898,19
1480,"Yidnekachew Tsegaye (Alchel Beye) ይድነቃቸው ፀጋዬ (አልችል ብዬ) - New Ethiopian Music 2019(Official Video) by Minew Shewa Tube 2 years ago 5 minutes, 31 seconds 13,599 views",Minew Shewa Entertainment,13599,13626,27
1481,"Ethiopian music :Melkamu Yohannes መልካሙ ዮሐንስ ""ወዲያልኝ Wedialgn""New Ethiopian Music 2019(Official Video) by Minew Shewa Tube 2 years ago 5 minutes, 57 seconds 122,835 views",Minew Shewa Entertainment,122835,122917,82
1482,"Ethiopian Music : Betelehem Reta ቤተልሄም ረታ (እንዳይርቅ) - New Ethiopian Music 2019(Official Video) by Minew Shewa Tube 2 years ago 3 minutes, 56 seconds 19,003 views",Minew Shewa Entertainment,19003,19020,17
1483,"Ethiopian Music : Amarti Tamiru (Hawwii Bara Dheeraa) - New Ethiopian Music 2019(Official Video) by Minew Shewa Tube 2 years ago 4 minutes, 8 seconds 15,434 views",Minew Shewa Entertainment,15434,15451,17
1484,"Ethiopian Music : Nasra Gursum (Faganyi Wal Nu Dhabsisu) - New Ethiopian Music 2019(Official Video) by Minew Shewa Tube 2 years ago 4 minutes, 13 seconds 77,963 views",Minew Shewa Entertainment,77963,78096,133
1485,"Ethiopian Music : Amir Wada (Aboche) አሚር ዋዳ (አቦጭ) - New Ethiopian Music 2019(Official Video) by Minew Shewa Tube 2 years ago 6 minutes, 33 seconds 36,773 views",Minew Shewa Entertainment,36773,37430,657
1486,"Ethiopian Music : Zerubabbel Molla | Biso | ዘሩባቤል ሞላ |ብሶ | New Ethiopian Music 2019(Official Video) by Minew Shewa Tube 2 years ago 4 minutes, 45 seconds 233,795 views",Minew Shewa Entertainment,233795,234554,759
1487,"Ethiopian Music : One Ethiopia (አንድ ኢትዮጵያ) - New Ethiopian Music 2019(Official Video) by Minew Shewa Tube 2 years ago 5 minutes, 43 seconds 44,236 views",Minew Shewa Entertainment,44236,44252,16
1488,"Tare Marya (Zemenu Yanchi  New) ታሬ ማርያ (ዘመኑ ያንቺ ነው) - New Ethiopian Music 2019(Official Video) by Minew Shewa Tube 2 years ago 4 minutes 6,543 views",Minew Shewa Entertainment,6543,6545,2
1489,"Ethiopian Music : Sura Takele (DammeeKoo) - New Ethiopian Music 2019(Official Video) by Minew Shewa Tube 2 years ago 4 minutes, 31 seconds 12,218 views",Minew Shewa Entertainment,12218,12279,61
1490,"Tewodros Dawit (Endatnegrign) ቴዎድሮስ ዳዊት (እንዳትነግሪኝ) - New Ethiopian Music 2019(Official Video) by Minew Shewa Tube 2 years ago 4 minutes, 36 seconds 20,066 views",Minew Shewa Entertainment,20066,20092,26
1491,"Solomon Yazachew (Solyaz) (Metadel New) ሶልያዝ (መታደል ነው) - New Ethiopian Music 2019(Official Video) by Minew Shewa Tube 2 years ago 4 minutes, 42 seconds 26,650 views",Minew Shewa Entertainment,26650,26762,112
1492,"Ethiopian Music : Konjit Getahun ቆንጂት ጌታሁን (ሰውን አትንኩብኝ) - New Ethiopian Music 2019(Official Video) by Minew Shewa Tube 2 years ago 4 minutes, 59 seconds 15,427 views",Minew Shewa Entertainment,15427,15434,7
1493,"Ethiopian Music : Abuki Bedru (Harma) አቡኪ በድሩ (ሃርማ)  - New Ethiopian Music 2019(Official Video) by Minew Shewa Tube 2 years ago 5 minutes, 39 seconds 9,883 views",Minew Shewa Entertainment,9883,9901,18
1494,"Ethiopian Music : Nesru Muktar ነስሩ ሙክታር (ዘቤ ዘቤ)- New Ethiopian Music 2019(Official Video) by Minew Shewa Tube 2 years ago 5 minutes, 27 seconds 25,939 views",Minew Shewa Entertainment,25939,26158,219
1495,"Ethiopian music : Fisum T ፍፁም ቲ ""ደስ ይላል Dess Yelal"" New Ethiopian Music 2019(Official Video) by Minew Shewa Tube 2 years ago 4 minutes, 14 seconds 106,500 views",Minew Shewa Entertainment,106500,106657,157
1496,"Yewondesen W/Mariam (Fit Awrari) የወንደሰን ወ/ማርያም (ፊታውራሪ) - New Ethiopian Music 2019(Official Video) by Minew Shewa Tube 2 years ago 6 minutes, 39 seconds 15,856 views",Minew Shewa Entertainment,15856,15870,14
1497,"Ethiopian Music : Bazu Man (Feta Feta) ባዙ ማን (ፈታ ፈታ) - New Ethiopian Music 2019(Official Video) by Minew Shewa Tube 2 years ago 5 minutes, 51 seconds 30,760 views",Minew Shewa Entertainment,30760,30873,113
1498,"Ethiopian Music : Fayissa Kuree (Lencatu Gale) - New Ethiopian Music 2019(Official Video) by Minew Shewa Tube 2 years ago 7 minutes, 24 seconds 5,635 views",Minew Shewa Entertainment,5635,5636,1
1499,"Ayenew Arega (Talak Hager) አየነዉ አረጋ (ታላቅ ሀገር) New Ethiopian Music 2019(Official Video) by Minew Shewa Tube 2 years ago 7 minutes, 13 seconds 158,627 views",Minew Shewa Entertainment,158627,158825,198
1500,"Ethiopian Music : Kabir G Hageyo (Enun Jibbita) - New Ethiopian Music 2019(Official Video) by Minew Shewa Tube 2 years ago 4 minutes, 49 seconds 74,329 views",Minew Shewa Entertainment,74329,74415,86
1501,"Ethiopian Music : Ayalew Ayew አያሌው አየው (አትነካካኝማ)- New Ethiopian Music 2019(Official Video) by Minew Shewa Tube 2 years ago 6 minutes, 15 seconds 25,911 views",Minew Shewa Entertainment,25911,25945,34
1502,"Ethiopian Music : Amanuel Tadesse አማኑኤል ታደሰ (ምን አገኘሽ) - New Ethiopian Music 2019(Official Video) by Minew Shewa Tube 2 years ago 5 minutes, 51 seconds 315,264 views",Minew Shewa Entertainment,315264,315893,629
1503,"Ethiopian Music : Taarikuu Isheetuu (Qeerroo) - New Ethiopian Music 2019(Official Video) by Minew Shewa Tube 2 years ago 5 minutes, 32 seconds 5,474 views",Minew Shewa Entertainment,5474,5480,6
1504,"Ethiopian Music : Zedash Emey ዜዳሽ እመይ (ይገፈፍ ጨለማ)- New Ethiopian Music 2019(Official Video) by Minew Shewa Tube 2 years ago 4 minutes, 29 seconds 3,441 views",Minew Shewa Entertainment,3441,3442,1
1505,"Ethiopian Music : Eyob Belay እዩብ በላይ ""ደስ ይላል Dess Yelal"" New Ethiopian Music 2019(Official Video) by Minew Shewa Tube 2 years ago 4 minutes, 15 seconds 19,170 views",Minew Shewa Entertainment,19170,19338,168
1506,"Ethiopian Music : Tilahun Bekele ጥላሁን በቀለ (ኢትዮጵያዊነት) - New Ethiopian Music 2019(Official Video) by Minew Shewa Tube 2 years ago 5 minutes, 5 seconds 13,658 views",Minew Shewa Entertainment,13658,13669,11
1507,"Ethiopian Music : Alemuu Ajabii (Finfinnen Haadha Kooti) - New Ethiopian Music 2019(Official Video) by Minew Shewa Tube 2 years ago 6 minutes, 56 seconds 7,472 views",Minew Shewa Entertainment,7472,7489,17
1508,"Ethiopian Music : Birtukan Bizuayehu ብርቱካን ብዙአየሁ (እምየ ጎንደር) New Ethiopian Music 2019(Official Video) by Minew Shewa Tube 2 years ago 4 minutes, 6 seconds 16,252 views",Minew Shewa Entertainment,16252,16293,41
1509,"Ethiopian Music : Abdii Adam (Konkonee) - New Ethiopian Music 2019(Official Video) by Minew Shewa Tube 2 years ago 5 minutes, 47 seconds 16,853 views",Minew Shewa Entertainment,16853,16874,21
1510,"Ethiopian Music: Belyan Jemal (Akale Nesh) በልያን ጀማል (አካሌ ነሽ)New Ethiopian Music 2019(Official Video) by Minew Shewa Tube 2 years ago 4 minutes, 25 seconds 11,802 views",Minew Shewa Entertainment,11802,11810,8
1511,"Ethiopian Music : Bizuayew Areaya ብዙአየሁ አራያ (ሃሳብ) - New Ethiopian Music 2019(Official Video) by Minew Shewa Tube 2 years ago 7 minutes, 17 seconds 3,666 views",Minew Shewa Entertainment,3666,3670,4
1512,"Ethiopian Music : Darajjee Lammaa (Abiyifi Lamma) - New Ethiopian Music 2019(Official Video) by Minew Shewa Tube 2 years ago 6 minutes, 16 seconds 13,167 views",Minew Shewa Entertainment,13167,13174,7
1513,"Ethiopian Music : Leencoo Saanoo (Wal Malee Maal Qabna) - New Ethiopian Music 2019(Official Video) by Minew Shewa Tube 2 years ago 6 minutes, 29 seconds 17,351 views",Minew Shewa Entertainment,17351,17420,69
1514,"Ethiopian Music : Aman Wayu (Siumaafi) - New Ethiopian Music 2019(Official Video) by Minew Shewa Tube 2 years ago 4 minutes, 27 seconds 14,483 views",Minew Shewa Entertainment,14483,14494,11
1515,"Ethiopian Music : Catty Mu (Sim Alat) ካቲ ሙ (ስም አላት) - New Ethiopian Music 2019(Official Video) by Minew Shewa Tube 2 years ago 4 minutes, 2 seconds 6,245 views",Minew Shewa Entertainment,6245,6255,10
1516,"Ethiopian Music : Gadaa Dilboo (Kuffisi Gantuu) - New Ethiopian Music 2019(Official Video) by Minew Shewa Tube 2 years ago 6 minutes, 42 seconds 6,547 views",Minew Shewa Entertainment,6547,6553,6
1517,"Ethiopian Music : Sisaay Dhabaa (Obsuuduhmma Wayyaa) - New Ethiopian Music 2019(Official Video) by Minew Shewa Tube 2 years ago 6 minutes, 23 seconds 8,576 views",Minew Shewa Entertainment,8576,8591,15
1518,"Ethiopian Music : NODREM Andenand (ኖድረም ፩ናንድ) - New Ethiopian Music 2019(Official Video) by Minew Shewa Tube 2 years ago 3 minutes, 42 seconds 3,697 views",Minew Shewa Entertainment,3697,3697,0
1519,"Ethiopian Music : Jo Black (Putu Ga) - New Ethiopian Music 2019(Official Video) by Minew Shewa Tube 2 years ago 4 minutes, 11 seconds 10,147 views",Minew Shewa Entertainment,10147,10149,2
1520,"Ethiopian Music: Biadglign Belay (Meleye) ቢያድግልኝ በላይ (መልዬ) New Ethiopian Music 2019(Official Video) by Minew Shewa Tube 2 years ago 5 minutes, 25 seconds 130,675 views",Minew Shewa Entertainment,130675,130793,118
1521,"Ethiopian Music : Temesgen G/Hare ተመስገን ገ/ሄር (ግደፉኒ) - New Eritrean Music 2019(Official Video) by Minew Shewa Tube 2 years ago 6 minutes, 48 seconds 8,413 views",Minew Shewa Entertainment,8413,8419,6
1522,"Ethiopian Music : Fisum T ft Ras Beat ""Gushim ጉሽም"" New Ethiopian Music 2019(Official Video) by Minew Shewa Tube 2 years ago 4 minutes, 10 seconds 720,317 views",Minew Shewa Entertainment,720317,721773,1456
1523,"Ethiopian Music : Alemayew Rebbumaa (Barri Akkami) - New Ethiopian Music 2019(Official Video) by Minew Shewa Tube 2 years ago 5 minutes, 29 seconds 5,057 views",Minew Shewa Entertainment,5057,5065,8
1524,"Dawite Mekonnen ""Abbabaa Rattaa አባባ ራታ"" New Ethiopian Oromo Music 2019(Official Video) by Minew Shewa Tube 2 years ago 5 minutes, 42 seconds 817,865 views",Minew Shewa Entertainment,817865,820751,2886
1525,"Ethiopian Music : Melkam Aragaw መልካም አራጋው (የሰው ልኩ) - New Ethiopian Music 2019(Official Video) by Minew Shewa Tube 2 years ago 5 minutes, 47 seconds 16,619 views",Minew Shewa Entertainment,16619,16666,47
1526,"Ethiopian Music : Soninaaf Aadam ""Amma Hoo Maal Taate"" New Ethiopian Music 2019(Official Video) by Minew Shewa Tube 2 years ago 5 minutes, 27 seconds 402,791 views",Minew Shewa Entertainment,402791,406398,3607
1527,"Mekanen Tadesse & Keste Kahesaye ""JEGANU"" መካነን ታደሰና ከስተ ካሕሳይ (ጀጋኑ)New Ethiopian Music 2019. by Minew Shewa Tube 2 years ago 5 minutes, 18 seconds 5,031 views",Minew Shewa Entertainment,5031,5034,3
1528,"Ethiopian Music : Zeritu Tilahun ""Bale"" ft Sami Go New Ethiopian Oromo Music 2019(Official Video) by Minew Shewa Tube 2 years ago 4 minutes, 37 seconds 19,488 views",Minew Shewa Entertainment,19488,19523,35
1529,"Tsinat Ayal (wuro) ""Kere Kegone"" ፅናት አያል (ውሮ) ቀረ ከጎኔ New Ethiopian Music 2019(Official Video) by Minew Shewa Tube 2 years ago 5 minutes, 16 seconds 12,598 views",Minew Shewa Entertainment,12598,12612,14
1530,"Ethiopian : Demeke bitew ""Atenka Belut አትንካ በሉት"" ደመቀ ቢተው New Ethiopian Music 2019(Official Video) by Minew Shewa Tube 2 years ago 5 minutes, 39 seconds 112,341 views",Minew Shewa Entertainment,112341,112409,68
1531,"Yeshi Tadese(Anigo) Dingerger Atargegn የሺ ታደሠ(አኒጎ)""ድንግርግር"" New Ethiopian Music 2019(Official Video) by Minew Shewa Tube 2 years ago 5 minutes, 31 seconds 19,527 views",Minew Shewa Entertainment,19527,19540,13
1532,"Bogallaa Katamaa (Oromiyaa Tiyya Badhaatuu) - New Ethiopian Music 2019(Official Video) by Minew Shewa Tube 2 years ago 5 minutes, 56 seconds 5,304 views",Minew Shewa Entertainment,5304,5315,11
1533,"Ethiopian Music : Dawit Mengesha ዳዊት መንገሻ (ግዕዜ) - New Ethiopian Music 2019(Official Video) by Minew Shewa Tube 2 years ago 5 minutes, 22 seconds 29,179 views",Minew Shewa Entertainment,29179,29203,24
1534,"Ethiopian Music : Gaaddisaa Bulchaa (Ayyoo Gaaddisa Odaa) - New Ethiopian Music 2019(Official Video) by Minew Shewa Tube 2 years ago 5 minutes, 6 seconds 4,484 views",Minew Shewa Entertainment,4484,4489,5
1535,"Ethiopian Music : Hayiluu Dhaqqabaa (Jiradhuu Leenca) - New Ethiopian Music 2019(Official Video) by Minew Shewa Tube 2 years ago 6 minutes, 32 seconds 4,640 views",Minew Shewa Entertainment,4640,4642,2
1536,"Ethiopian Music : Galataa Labuu (Shamarree Oromoo) - New Ethiopian Music 2019(Official Video) by Minew Shewa Tube 2 years ago 6 minutes, 28 seconds 32,805 views",Minew Shewa Entertainment,32805,33031,226
1537,"Ethiopian Music : Tolassaa Sanbataa (Si Suma) - New Ethiopian Music 2019(Official Video) by Minew Shewa Tube 2 years ago 4 minutes, 56 seconds 10,219 views",Minew Shewa Entertainment,10219,10221,2
1538,"Mekedelawit Hailu(Maki) መቅደላዊት ሀይሉ(ማኪ) ""እንዳትኮራ Endatikora"" New Ethiopian Music 2019(Official Video) by Minew Shewa Tube 2 years ago 5 minutes, 18 seconds 25,180 views",Minew Shewa Entertainment,25180,25198,18
1539,"Ethiopian music : Funny moment from behind the scenes of Buze Man, New Music video ""Hello"" making. by Minew Shewa Tube 2 years ago 1 minute, 1 second 35,417 views",Minew Shewa Entertainment,35417,35474,57
1540,"Sudan music- Afandii sayyoo ""Suudan"" New Ethiopian Music 2019(Official Video) by Minew Shewa Tube 2 years ago 7 minutes, 15 seconds 52,097 views",Minew Shewa Entertainment,52097,52409,312
1541,"Habtamu Gudeta (Fikir Yashenifal) ሃብታሙ ጉደታ (ፍቅር ያሸንፋል) - New Ethiopian Music 2019(Official Video) by Minew Shewa Tube 2 years ago 4 minutes, 29 seconds 12,678 views",Minew Shewa Entertainment,12678,12687,9
1542,"Ethiopian Music : Lammii Battee (Karrayyuu) - New Ethiopian Music 2019(Official Video) by Minew Shewa Tube 2 years ago 7 minutes, 18 seconds 13,182 views",Minew Shewa Entertainment,13182,13253,71
1543,"Ethiopian Music : Gammachisi Gurmeessaa (Tokkummaa)  - New Ethiopian Music 2019(Official Video) by Minew Shewa Tube 2 years ago 6 minutes, 56 seconds 12,171 views",Minew Shewa Entertainment,12171,12178,7
1544,"ብዙአየሁ በሪሁን | Bizuayehu Berihun ""Foker Endashahe ፎክር እንዳሻህ"" New Ethiopian Music 2019(Official Video) by Minew Shewa Tube 2 years ago 5 minutes, 38 seconds 276,237 views",Minew Shewa Entertainment,276237,276339,102
1545,"Ethiopian Music : Gadaa Mokonnen (Jajjabee Kiyyaa) - New Ethiopian Oromo Music 2019(Official Video) by Minew Shewa Tube 2 years ago 6 minutes, 46 seconds 8,295 views",Minew Shewa Entertainment,8295,8301,6
1546,"Ethiopian Music : Kido | Jay | Eden (Plastic)- New Ethiopian Music 2019(Official Video) by Minew Shewa Tube 2 years ago 3 minutes, 49 seconds 11,059 views",Minew Shewa Entertainment,11059,11066,7
1547,"Ethiopian Music : Amsal Mitike | አምሳል ምትኬ ""እንደ ሺህ የሚቆጠር"" New Ethiopian Music 2019(Official Video) by Minew Shewa Tube 2 years ago 7 minutes, 44 seconds 7,844,990 views",Minew Shewa Entertainment,7844990,7926239,81249
1548,"Heaven | Mistre | Lamrot | Kuftu (Wanko Koo) - New Ethiopian Music 2019(Official Video) by Minew Shewa Tube 2 years ago 5 minutes, 27 seconds 32,746 views",Minew Shewa Entertainment,32746,32749,3
1549,"Ethiopian Music : Bilisummaa Baqqalaa (Koottu Maaloo) - New Ethiopian Music 2019(Official Video) by Minew Shewa Tube 2 years ago 5 minutes, 31 seconds 42,034 views",Minew Shewa Entertainment,42034,42164,130
1550,"Ethiopian Music : Solomon Tefera ሰለሞን ተፈራ (ሳቅሽን) - New Ethiopian Music 2019(Official Video) by Minew Shewa Tube 2 years ago 5 minutes, 38 seconds 13,870 views",Minew Shewa Entertainment,13870,13875,5
1551,"Ethiopian Music : Fiker Worku (Habesha) ፍቅሩ ወርቁ (ሐበሻ) - New Ethiopian Music 2019(Official Video) by Minew Shewa Tube 2 years ago 6 minutes, 19 seconds 37,136 views",Minew Shewa Entertainment,37136,37160,24
1552,"Helara Tesfaye (Lidete New) ሄላራ ተስፋዬ (ልደቴ ነው) - New Ethiopian Music 2019(Official Video) by Minew Shewa Tube 2 years ago 3 minutes, 28 seconds 19,605 views",Minew Shewa Entertainment,19605,19667,62
1553,"Ethiopian Music : Amarech Alemu አማረች አለሙ (ድማምየ) - New Ethiopian Music 2019(Official Video) by Minew Shewa Tube 2 years ago 6 minutes, 39 seconds 25,952 views",Minew Shewa Entertainment,25952,25970,18
1554,"Ethiopian Music : Tefera Fekadu ተፈራ ፍቃዱ (ሽርሽር ባረ) - New Ethiopian Music 2019(Official Video) by Minew Shewa Tube 2 years ago 4 minutes, 53 seconds 12,718 views",Minew Shewa Entertainment,12718,12756,38
1555,"Ethiopian Music : Yasin Kedir (Istakatah Makata) - New Ethiopian Music 2019(Official Video) by Minew Shewa Tube 2 years ago 5 minutes, 6 seconds 177,313 views",Minew Shewa Entertainment,177313,179023,1710
1556,"Ethiopian Music : Endashaw Shume እንዳሻው ሹሜ (ሳብ ቀጥል) - New Ethiopian Music 2019(Official Video) by Minew Shewa Tube 2 years ago 5 minutes, 40 seconds 23,160 views",Minew Shewa Entertainment,23160,23193,33
1557,"Ethiopian Music : Temesgen Ilka ተመስገን ኢልካ (ፈታ በይ) - New Ethiopian Music 2019(Official Video) by Minew Shewa Tube 2 years ago 4 minutes, 33 seconds 7,263 views",Minew Shewa Entertainment,7263,7266,3
1558,"Michael Melaku (Myko) ft Asge Dendasho | Akukulu አኩኩሉ | New Ethiopian Music 2019(Official Video) by Minew Shewa Tube 2 years ago 4 minutes, 41 seconds 13,052,047 views",Minew Shewa Entertainment,13052047,13098337,46290
1559,"Ethiopian Music : Mesfin Bekele መስፍን በቀለ (ሰው እንሁን) - New Ethiopian Music 2019(Official Video) by Minew Shewa Tube 2 years ago 6 minutes, 27 seconds 122,372 views",Minew Shewa Entertainment,122372,122407,35
1560,"Yeayneabeba Nigus የአይኔአበባ ንጉስ (የመጀመሪያው መጨረሻ) - New Ethiopian Music 2019(Official Video) by Minew Shewa Tube 2 years ago 6 minutes, 56 seconds 24,254 views",Minew Shewa Entertainment,24254,24281,27
1561,"Ethiopian Music : Hayile Birhanu (An Sindhiisu) - New Ethiopian Oromo Music 2019(Official Video) by Minew Shewa Tube 2 years ago 5 minutes, 49 seconds 21,889 views",Minew Shewa Entertainment,21889,21937,48
1562,"Ethiopian Music : Galataa Labuu (Shamarree Oromoo) - New Ethiopian Oromo Music 2019(Official Video) by Minew Shewa Tube 2 years ago 6 minutes, 28 seconds 59,545 views",Minew Shewa Entertainment,59545,61053,1508
1563,"Ethiopian Music : Mesfin Bekele መስፍን በቀለ (ሰው እንሁን) - New Ethiopian Music 2019(Official Video) by Minew Shewa Tube 2 years ago 6 minutes, 25 seconds 329,040 views",Minew Shewa Entertainment,329040,329605,565
1564,"Ethiopian Music : Desalegn Abebe ደሳለኝ አበበ (አዬ ፖለቲካ) - New Ethiopian Music 2019(Official Video) by Minew Shewa Tube 2 years ago 5 minutes, 15 seconds 46,526 views",Minew Shewa Entertainment,46526,46645,119
1565,"Ethiopian Music : Anteneh Asrat (Weyno) አንተነህ አስራት (ወይኖ) - New Ethiopian Music 2019(Official Video) by Minew Shewa Tube 2 years ago 4 minutes, 24 seconds 48,010 views",Minew Shewa Entertainment,48010,48028,18
1566,"Ethiopian Music : Fentabil Abebe ፈንታቢል አበበ (ዘናበይ)  - New Ethiopian Music 2019(Official Video) by Minew Shewa Tube 2 years ago 5 minutes, 44 seconds 11,859 views",Minew Shewa Entertainment,11859,11864,5
1567,"Addisuu Abarraa (Yaa Hattuu Sanqaa Sitti Cufanii)- New Ethiopian Music 2019(Official Video) by Minew Shewa Tube 2 years ago 5 minutes, 42 seconds 23,610 views",Minew Shewa Entertainment,23610,23682,72
1568,"Ethiopian Music : Jiidhaa Leellisaa (Ani Oromoon Argee)  - New Ethiopian Music 2019(Official Video) by Minew Shewa Tube 2 years ago 6 minutes, 53 seconds 2,984 views",Minew Shewa Entertainment,2984,2987,3
1569,"Ethiopian Music : Alemayehu Molla አለማየሁ ሞላ (ያልጅነቴ) - New Ethiopian Music 2019(Official Video) by Minew Shewa Tube 2 years ago 5 minutes, 40 seconds 9,257 views",Minew Shewa Entertainment,9257,9263,6
1570,"Ethiopian Music : Ella Jah (Techawech) ኤላ ጃህ (ተጫወች)- New Ethiopian Music 2019(Official Video) by Minew Shewa Tube 2 years ago 4 minutes, 11 seconds 10,166 views",Minew Shewa Entertainment,10166,10180,14
1571,"Abdoo Badhaasoo (karrayyuu) ""Addaan Turree"" | New Ethiopian Oromo Music 2019(Official Video) by Minew Shewa Tube 2 years ago 6 minutes, 59 seconds 24,852 views",Minew Shewa Entertainment,24852,24998,146
1572,"Ethiopian Music : Eyerusalem Girma እየሩሳሌም ግርማ (ስም ያንስሻል)- New Ethiopian Music 2019(Official Video) by Minew Shewa Tube 2 years ago 5 minutes, 7 seconds 6,474 views",Minew Shewa Entertainment,6474,6479,5
1573,"Shumet Andarge & Feteh Tesfa ሹመት አንዳርጌ እና ፍትህ ተስፋ (ተማማሉ)- New Ethiopian Music 2019(Official Video) by Minew Shewa Tube 2 years ago 6 minutes, 15 seconds 68,712 views",Minew Shewa Entertainment,68712,68738,26
1574,"Ethiopian Music: Befi Yad በፊ ያድ ""እንዲ ነው ወይ"" Endi new wey | New Ethiopian Music 2019(Official Video) by Minew Shewa Tube 2 years ago 5 minutes, 49 seconds 1,569,523 views",Minew Shewa Entertainment,1569523,1579364,9841
1575,"Abinet Agonafir አብነት አጎናፍር | የእውነት መንገድ | Yewunet Menged  New Ethiopian Music 2019 Wedding Video. by Minew Shewa Tube 2 years ago 8 minutes, 30 seconds 9,909,328 views",Minew Shewa Entertainment,9909328,9963409,54081
1576,"Ethiopian Music : Henok Muheden (Heni MK)ሄኖክ ሙህዲን ""አሻምዴ"" New Ethiopian music 2019(Official Video) by Minew Shewa Tube 2 years ago 5 minutes, 23 seconds 200,185 views",Minew Shewa Entertainment,200185,200249,64
1577,"Fedhasaa Gurmuu (Qeerroo Qarri Biyyaa Kuni) - New Ethiopian Oromo Music 2019(Official Video) by Minew Shewa Tube 2 years ago 7 minutes, 12 seconds 15,912 views",Minew Shewa Entertainment,15912,15953,41
1578,"Ethiopian Music :Solomon Mitaw ሰለሞና ምታው (እያማረ መጣ) - New Ethiopian Music 2019(Official Video) by Minew Shewa Tube 2 years ago 4 minutes, 56 seconds 20,472 views",Minew Shewa Entertainment,20472,20478,6
1579,"Ethiopian Music: Margaa Wandimmuu (Gooni Hin Ciisu) - New Ethiopian Oromo Music 2019(Official Video) by Minew Shewa Tube 2 years ago 5 minutes, 43 seconds 11,487 views",Minew Shewa Entertainment,11487,11501,14
1580,"Ethiopian Music : Hana Derebe (Yalteyaze) ሃና ደረበ (ያልተያዘ) - New Ethiopian Music 2019(Official Video) by Minew Shewa Tube 2 years ago 7 minutes, 17 seconds 51,532 views",Minew Shewa Entertainment,51532,51644,112
1581,"Ethiopian Music : Katamaa Dhabaa (Bareeduu Kiyya) - New Ethiopian Oromo Music 2019(Official Video) by Minew Shewa Tube 2 years ago 6 minutes, 35 seconds 9,370 views",Minew Shewa Entertainment,9370,9380,10
1582,"Kg man & Netsi Aku | አንቺ ብቻ አንደኛ (1ኛ) Anchi Bicha Andegna New Ethiopian Music 2019 (Official Video) by Minew Shewa Tube 2 years ago 4 minutes, 31 seconds 32,976 views",Minew Shewa Entertainment,32976,33138,162
1583,"Ethiopian Music :Buze Man | Buzayehu Kifle (Hello)ቡዜ ማን (ሄሎ)New Ethiopian Music 2019(Official Video) by Minew Shewa Tube 2 years ago 4 minutes, 27 seconds 1,216,872 views",Minew Shewa Entertainment,1216872,1222011,5139
1584,"Yohannes Feleke (Yoni Cash) ዮሃንስ ፈለቀ (ዮኒ ካሽ)""የፈረንሳይ ልጅ ነኝ ""New Ethiopian Music 2019(Official Video) by Minew Shewa Tube 2 years ago 4 minutes, 9 seconds 5,996 views",Minew Shewa Entertainment,5996,5999,3
1585,"Meklit Tessma (Maki) |መክሊት ተሰማ(ማኪ) | Wede gedelew ወደ ገደለው New Ethiopian Music 2019(Official Video) by Minew Shewa Tube 2 years ago 4 minutes, 59 seconds 32,268 views",Minew Shewa Entertainment,32268,32339,71
1586,"Ethiopian Music : Abdu Tahiro (Yaa obboleessa Koo)  - New Ethiopian Oromo Music 2019(Official Video) by Minew Shewa Tube 2 years ago 7 minutes, 18 seconds 8,788 views",Minew Shewa Entertainment,8788,8804,16
1587,"Ethiopian Music : Meskir Tekalign ምስክር ተካልኝ (በያ ነፍሴ) - New Ethiopian Music 2019(Official Video) by Minew Shewa Tube 2 years ago 4 minutes, 33 seconds 5,540 views",Minew Shewa Entertainment,5540,5546,6
1588,"Ethiopian Music : Helen Argaw (Yichilal) ሄለን አርጋው (ይችላል)- New Ethiopian Music 2019(Official Video) by Minew Shewa Tube 2 years ago 5 minutes, 58 seconds 166,793 views",Minew Shewa Entertainment,166793,166893,100
1589,"Ethiopian Music : Abdii Caalaa (Qeerroo Koo) - New Ethiopian Oromo Music 2019(Official Video) by Minew Shewa Tube 2 years ago 5 minutes, 32 seconds 8,555 views",Minew Shewa Entertainment,8555,8567,12
1590,"Ethiopian Music : Aschalew Biazin አስቻለው ቢያዝን (የጎጃም እሸት) - New Ethiopian Music 2019(Official Video) by Minew Shewa Tube 2 years ago 5 minutes, 16 seconds 8,431 views",Minew Shewa Entertainment,8431,8449,18
1591,"Ethiopian Music : Daasaalany Ijara (Si Yaadee) - New Ethiopian Oromo Music 2019(Official Video) by Minew Shewa Tube 2 years ago 6 minutes, 18 seconds 9,886 views",Minew Shewa Entertainment,9886,9939,53
1592,"Ethiopian Music : Abdii Fufaa (Walabee Koo) - New Ethiopian Oromo Music 2019(Official Video) by Minew Shewa Tube 2 years ago 5 minutes, 39 seconds 14,761 views",Minew Shewa Entertainment,14761,14862,101
1593,"Ethiopian music :- Mulualem Takele | Amerobishal አምሮብሻል New Ethiopian Music 2019(Official Video) by Minew Shewa Tube 2 years ago 4 minutes, 31 seconds 2,548,479 views",Minew Shewa Entertainment,2548479,2555509,7030
1594,"Ethiopian Music : Abbu Ganamoo (Yaa Finfinnee) - New Ethiopian Oromo Music 2019(Official Video) by Minew Shewa Tube 2 years ago 6 minutes, 20 seconds 23,429 views",Minew Shewa Entertainment,23429,23468,39
1595,"Ethiopian music : - Mamila Lukas ማሚላ ሉቃስ ""Atimelaye አትመለይ"" New Ethiopian Music 2019(Official Video) by Minew Shewa Tube 2 years ago 5 minutes, 15 seconds 193,095 views",Minew Shewa Entertainment,193095,193335,240
1596,"Ablex ft Hewan (Kebraraye) አብሌክስ ft ሄዋን (ቀብራራዬ) - New Ethiopian Music 2019(Official Video) by Minew Shewa Tube 2 years ago 4 minutes, 36 seconds 2,716,891 views",Minew Shewa Entertainment,2716891,2720262,3371
1597,"Haftom Gebremichael Gualgrazmach (ጓል-ግራዝማች) New Ethiopian Tigrigna Music 2019(Official Video) by Minew Shewa Tube 2 years ago 5 minutes, 11 seconds 92,668 views",Minew Shewa Entertainment,92668,92695,27
1598,"Ethiopian Music : Raskey (Konjo) ራስኪ (ቆንጆ) - New Ethiopian Music 2019(Official Video) by Minew Shewa Tube 2 years ago 4 minutes, 38 seconds 6,186 views",Minew Shewa Entertainment,6186,6188,2
1599,"Darribee Taaddasaa (Ililchaa Gammadaa) - New Ethiopian Oromo Music 2019(Official Video) by Minew Shewa Tube 2 years ago 6 minutes, 21 seconds 7,098 views",Minew Shewa Entertainment,7098,7161,63
1600,"Ethiopian Music : Solomon Yimer ሰለሞን ይመር (ሲከፋሽ አልወድም) - New Ethiopian Music 2019(Official Video) by Minew Shewa Tube 2 years ago 5 minutes, 18 seconds 68,224 views",Minew Shewa Entertainment,68224,68243,19
1601,"Ethiopian Music : Zerihun Wedajo (Maarshi Gashi) - New Ethiopian Oromo Music 2019(Official Video) by Minew Shewa Tube 2 years ago 7 minutes, 25 seconds 19,572 views",Minew Shewa Entertainment,19572,19785,213
1602,"Ethiopian Music : Chelina (Ayzon) ቸሊና (አይዞን) New Ethiopian Music 2019 (Official Video) by Minew Shewa Tube 2 years ago 3 minutes, 57 seconds 197,504 views",Minew Shewa Entertainment,197504,198001,497
1603,"Ethiopian Music : Beyene Tsegaw (Selame) በየነ ፀጋው (ሰላሜ) - New Ethiopian Music 2019(Official Video) by Minew Shewa Tube 2 years ago 5 minutes, 21 seconds 164,388 views",Minew Shewa Entertainment,164388,164461,73
1604,"Ethiopian Music : Yared Dereje (Wanofi) ያሬድ ደረጄ (ዋኖፊ) - New Ethiopian Music 2019(Official Video) by Minew Shewa Tube 2 years ago 4 minutes, 29 seconds 9,447 views",Minew Shewa Entertainment,9447,9455,8
1605,"ከፋለ ሞላ (አንድ ነው ቃሉ) Kefale Molla (And neaw kalu) New Ethiopian Music 2019 (Official Video) by Minew Shewa Tube 2 years ago 5 minutes, 33 seconds 27,663 views",Minew Shewa Entertainment,27663,27720,57
1606,"Ethiopian Music : Henok Ayfokir ሄኖክ አይፎክር (መሬ ነው) - New Ethiopian Music 2019(Official Video) by Minew Shewa Tube 2 years ago 5 minutes, 43 seconds 398,927 views",Minew Shewa Entertainment,398927,400025,1098
1607,"Ethiopian Music: Maritu Legesse (Enechawet) ማሪቱ ለገሰ (እንጫወት) New Ethiopian Music 2019(Official Video) by Minew Shewa Tube 2 years ago 8 minutes, 30 seconds 3,519,395 views",Minew Shewa Entertainment,3519395,3542704,23309
1608,"Ethiopian Music: Molla Kassa (Mata Mata) ሞላ ካሳ (ማታ ማታ) New Ethiopian Music 2019 (Official Video) by Minew Shewa Tube 2 years ago 5 minutes, 17 seconds 12,683 views",Minew Shewa Entertainment,12683,12701,18
1609,"Ethiopian Music : Solomon Asalif ሰለሞን አሳልፍ (ሃሳቤ እንደአሞራ ) - New Ethiopian Music 2019(Official Video) by Minew Shewa Tube 2 years ago 6 minutes, 15 seconds 49,426 views",Minew Shewa Entertainment,49426,49616,190
1610,"Azmeraw Mulusew (Alkebelim) አዝመራው ሙሉሰው (አልቀበልም) - New Ethiopian Music 2019(Official Video) by Minew Shewa Tube 2 years ago 5 minutes, 26 seconds 1,931,501 views",Minew Shewa Entertainment,1931501,1933793,2292
1611,"Ethiopian Music : Frehiwot Girma (Samegn) ፍሬሕይወት ግርማ(ሳመኝ) - New Ethiopian Music 2019(Official Video) by Minew Shewa Tube 2 years ago 5 minutes, 31 seconds 50,891 views",Minew Shewa Entertainment,50891,50963,72
1612,"Ethiopian Music : Tsegereda Mesafint ጽጌረዳ መሳፍንት (ገዳይ ነው) - New Ethiopian Music 2019(Official Video) by Minew Shewa Tube 2 years ago 6 minutes, 34 seconds 12,113 views",Minew Shewa Entertainment,12113,12120,7
1613,"Ethiopian Music : Ethio Man (አዲስ ትውልድ)- New Ethiopian Music 2019(Official Video) by Minew Shewa Tube 2 years ago 5 minutes, 44 seconds 100,637 views",Minew Shewa Entertainment,100637,100738,101
1614,"Ethiopian Music : Aklilu Adise አክሊሉ አዲሴ (አደይ ማረይ') - New Ethiopian Music 2019(Official Video) by Minew Shewa Tube 2 years ago 6 minutes, 19 seconds 8,795 views",Minew Shewa Entertainment,8795,8818,23
1615,"Ethiopian Music : Sanyii Baayissa (Maalif Boora'aa) - New Ethiopian Oromo Music 2019(Official Video) by Minew Shewa Tube 2 years ago 6 minutes, 20 seconds 7,049 views",Minew Shewa Entertainment,7049,7065,16
1616,"Ethiopian Music : Yakob Fered (Lominey) ያቆብ ፈረድ (ሎሚነይ) - New Ethiopian Music 2019(Official Video) by Minew Shewa Tube 2 years ago 4 minutes, 1 second 16,981 views",Minew Shewa Entertainment,16981,16992,11
1617,"Ethiopian Music :Isaaq Zeenuu (Anattiikee) - New Ethiopian Music 2019(Official Video) by Minew Shewa Tube 2 years ago 5 minutes, 59 seconds 221,122 views",Minew Shewa Entertainment,221122,224047,2925
1618,"Ethiopian Music: Gammachuu Huseen (Tisse Tokkummaa) New Ethiopian Oromo Music 2019(Official Video) by Minew Shewa Tube 2 years ago 7 minutes, 27 seconds 5,797 views",Minew Shewa Entertainment,5797,5938,141
1619,"Ethiopian Music : Beshewa Zemedu በሸዋ ዘመዱ (ውረድ ሸዋ ሜዳ)  - New Ethiopian Music 2019(Official Video) by Minew Shewa Tube 2 years ago 7 minutes, 51 seconds 263,381 views",Minew Shewa Entertainment,263381,264224,843
1620,"Ethiopian Music : Abdii Kadiir (Na Jaaltta Ati) - New Ethiopian Oromo Music 2019(Official Video) by Minew Shewa Tube 2 years ago 6 minutes, 4 seconds 5,756 views",Minew Shewa Entertainment,5756,5762,6
1621,"Ethiopian Music: Mulusew Babey(Lanileyay) ሙሉሰው ባበይ (ላንለያይ) New Ethiopian Music 2019(Official Video) by Minew Shewa Tube 2 years ago 5 minutes, 12 seconds 10,272 views",Minew Shewa Entertainment,10272,10291,19
1622,"Anchi Zema (Selam Legna Alem) አንቺ ዜማ (ሰላም ለኛ ዓለም) - New Ethiopian Music 2019(Official Video) by Minew Shewa Tube 2 years ago 3 minutes, 58 seconds 7,203 views",Minew Shewa Entertainment,7203,7210,7
1623,"Merkeb Bonitua ft Yohanna Rubi (Terakibna)New Ethiopian & Eritrean Music 2019 (Official Video) by Minew Shewa Tube 2 years ago 4 minutes, 51 seconds 789,079 views",Minew Shewa Entertainment,789079,790135,1056
1624,"Ethiopian Music :  Manim ""Ete-mete"" New Ethiopian Rap Music 2019 (Official Video) by Minew Shewa Tube 2 years ago 4 minutes 22,206 views",Minew Shewa Entertainment,22206,22244,38
1625,"Ethiopian Music : Moosisaa Shaanqoo (Finfinnee) - New Ethiopian Oromo Music 2019(Official Video) by Minew Shewa Tube 2 years ago 5 minutes, 31 seconds 6,165 views",Minew Shewa Entertainment,6165,6184,19
1626,"Ethiopian Music :Tsehay Debebe ማር አትበላት (Mar Atbelat) New Ethiopian Music 2019 (Official Video) by Minew Shewa Tube 2 years ago 4 minutes, 53 seconds 30,919 views",Minew Shewa Entertainment,30919,30927,8
1627,"Ethiopian Music : Zedo Baheru (Helme) ዜዶ ባህሩ (ህልሜ) - New Ethiopian Music 2019(Official Video) by Minew Shewa Tube 2 years ago 4 minutes, 25 seconds 4,692 views",Minew Shewa Entertainment,4692,4711,19
1628,"Ethiopian Music : Sinaaf Dejanee (Bashaasha Koo) - New Ethiopian Oromo Music 2019(Official Video) by Minew Shewa Tube 2 years ago 5 minutes, 45 seconds 755,789 views",Minew Shewa Entertainment,755789,758865,3076
1629,"Ethiopian Music : Seblaa Gulummaa (Keera Keeraa) - New Ethiopian Oromo Music 2019(Official Video) by Minew Shewa Tube 2 years ago 4 minutes, 46 seconds 4,545 views",Minew Shewa Entertainment,4545,4548,3
1630,"Ethiopian Music: Meaza Tegegn(Ayselechegn) መዓዛ ተገኝ (አይሰለቸኝ)New Ethiopian Music 2019(Official Video) by Minew Shewa Tube 2 years ago 5 minutes, 22 seconds 5,508 views",Minew Shewa Entertainment,5508,5510,2
1631,"Ethiopian Music : Warqeesaa Taakkalee (Oromiyaa) - New Ethiopian Oromo Music 2019(Official Video) by Minew Shewa Tube 2 years ago 5 minutes, 2 seconds 3,566 views",Minew Shewa Entertainment,3566,3592,26
1632,"Ethiopian Music : Tefera Fikadu ተፈራ ፈቃዱ (ሀለተ ወርቅ) - New Ethiopian Music 2019(Official Video) by Minew Shewa Tube 2 years ago 4 minutes, 56 seconds 9,047 views",Minew Shewa Entertainment,9047,9075,28
1633,"Afro Gisho ft Jiregna Shiferaw (Rakkoo 99) New Ethiopian Oromo Music 2019(Official Video) by Minew Shewa Tube 2 years ago 3 minutes, 40 seconds 81,291 views",Minew Shewa Entertainment,81291,81532,241
1634,"Ethiopian Music :Ashenafi Yada (Guyyaa Guyyaadhan)- New Ethiopian Oromo Music 2019(Official Video) by Minew Shewa Tube 2 years ago 5 minutes, 28 seconds 4,010 views",Minew Shewa Entertainment,4010,4023,13
1635,"Ethiopian Music : Senay Habutom (Amalay) ሰናይ ሃቡቶም (አማላይ) - New Ethiopian Music 2019(Official Video) by Minew Shewa Tube 2 years ago 4 minutes, 29 seconds 7,158 views",Minew Shewa Entertainment,7158,7180,22
1636,"Ethiopian Music : Boontuu Daadhii (Sabboona Oromoo) New Ethiopian Oromo Music 2019(Official Video) by Minew Shewa Tube 2 years ago 6 minutes, 2 seconds 28,408 views",Minew Shewa Entertainment,28408,28509,101
1637,"Ethiopian Music : Demeke Bitew ደመቀ ቢተው (እንደዛ ነው) - New Ethiopian Music 2019(Official Video) by Minew Shewa Tube 2 years ago 4 minutes, 32 seconds 52,205 views",Minew Shewa Entertainment,52205,52450,245
1638,"Ethiopian Music: Yalem Tadese (Wured Beka) ያለም ታደሰ (ውረድ በቃ)New Ethiopian Music 2019(Official Video) by Minew Shewa Tube 2 years ago 6 minutes, 27 seconds 809,302 views",Minew Shewa Entertainment,809302,809654,352
1639,"Boonaa Kumsaa (Qeerransa koo qeerroo) - New Ethiopian Oromo Music 2019(Official Video) by Minew Shewa Tube 2 years ago 6 minutes, 27 seconds 4,838 views",Minew Shewa Entertainment,4838,4857,19
1640,"Ethiopian Music : Rabbirraa Damissee (Garaan Dide) - New Ethiopian Oromo Music 2019(Official Video) by Minew Shewa Tube 2 years ago 7 minutes 16,826 views",Minew Shewa Entertainment,16826,16861,35
1641,"Ethiopian Music : Samuel Yitayal ሳሙኤል ይታያል (አንድ ስንሆን ነው) - New Ethiopian Music 2019(Official Video) by Minew Shewa Tube 2 years ago 5 minutes, 38 seconds 5,350 views",Minew Shewa Entertainment,5350,5355,5
1642,"Ethiopian Music : Abel Jemaneh (Melkam) አቤል ጀማነህ (መልካም) - New Ethiopian Music 2019(Official Video) by Minew Shewa Tube 2 years ago 5 minutes, 14 seconds 7,090 views",Minew Shewa Entertainment,7090,7098,8
1643,"Ethiopian Music : Nugusuu Gamachuu (Birra Birra) - New Ethiopian Oromo Music 2018(Official Video) by Minew Shewa Tube 2 years ago 5 minutes, 37 seconds 25,254 views",Minew Shewa Entertainment,25254,25308,54
1644,"Ethiopian Music : Yabu JC (Addis Ababa) Ft Kal Ab - New Ethiopian Music 2019(Official Video) by Minew Shewa Tube 2 years ago 3 minutes, 45 seconds 4,792 views",Minew Shewa Entertainment,4792,4802,10
1645,"Ethiopian Music : Abarraa Mojoo (Kiyyoo Diigee) - New Ethiopian Oromo Music 2019(Official Video) by Minew Shewa Tube 2 years ago 6 minutes, 38 seconds 11,746 views",Minew Shewa Entertainment,11746,11991,245
1646,"Ethiopian Music : Dhaabaa Caalaa (Hin Raafamnuu) - New Ethiopian Oromo Music 2019(Official Video) by Minew Shewa Tube 2 years ago 6 minutes, 58 seconds 16,984 views",Minew Shewa Entertainment,16984,17041,57
1647,"Ethiopian Music : Xanna Zamalaak (Baabur Kaee)- New Ethiopian Oromo Music 2019(Official Video) by Minew Shewa Tube 2 years ago 5 minutes, 57 seconds 1,628 views",Minew Shewa Entertainment,1628,1628,0
1648,"Ethiopian Music : Mulu Gebeyew ሙሉ ገበየሁ (አንድ ነው ልባችን) - New Ethiopian Music 2019(Official Video) by Minew Shewa Tube 2 years ago 4 minutes, 4 seconds 5,436 views",Minew Shewa Entertainment,5436,5442,6
1649,"Ethiopian Music : Sabbooqaa Girma (Ya Kulee)  - New Ethiopian Oromo Music 2019(Official Video) by Minew Shewa Tube 2 years ago 7 minutes, 12 seconds 3,324 views",Minew Shewa Entertainment,3324,3344,20
1650,"Ethiopian Music : Kira Abigaro ኪራ አቢጋሮ (አያሌው ሞኙ) - New Ethiopian Music 2019(Official Video) by Minew Shewa Tube 2 years ago 6 minutes, 20 seconds 44,360 views",Minew Shewa Entertainment,44360,44418,58
1651,"Girmaayee Dhinsaa (Yaa Warra Abeebee)- New Ethiopian Oromo Music 2019(Official Video) by Minew Shewa Tube 2 years ago 7 minutes, 4 seconds 66,131 views",Minew Shewa Entertainment,66131,66230,99
1652,"Wendmagegn Getu ft Habtamu Werku (Eyesemahush New) - New Ethiopian Music 2019(Official Video) by Minew Shewa Tube 2 years ago 3 minutes, 26 seconds 3,660 views",Minew Shewa Entertainment,3660,3664,4
1653,"Dhaabaa Lammaa (Maaloo Jaalalee too) - New Ethiopian Oromo Music 2019(Official Video) by Minew Shewa Tube 2 years ago 4 minutes, 54 seconds 9,476 views",Minew Shewa Entertainment,9476,9495,19
1654,"Ethiopian Music: Yidnekachew Mekonnen ይድነቃቸው መኮንን (አትሂጂብኝ) New Ethiopian Music 2019(Official Video) by Minew Shewa Tube 2 years ago 5 minutes, 52 seconds 27,949 views",Minew Shewa Entertainment,27949,27981,32
1655,"Arboo Ganamoo (Qeerroo Falme) New Ethiopian Oromo Music 2019(Official Video) by Minew Shewa Tube 2 years ago 6 minutes, 45 seconds 8,599 views",Minew Shewa Entertainment,8599,8630,31
1656,"Agare Legassa (Waal Barbaana Lammikoo) - New Ethiopian Oromo Music 2019(Official Video) by Minew Shewa Tube 2 years ago 5 minutes, 32 seconds 4,573 views",Minew Shewa Entertainment,4573,4577,4
1657,"Ethiopian Music : Abarraa Mojoo (Waaqeffannaa) - New Ethiopian Oromo Music 2019(Official Video) by Minew Shewa Tube 2 years ago 5 minutes, 53 seconds 6,098 views",Minew Shewa Entertainment,6098,6110,12
1658,"Yapi Mapi ft Winta Birhane ያፒ ማፒ ft ዊንታ ብርሃኔ (ለለ ንዕናይ) - New Ethiopian Music 2019(Official Video) by Minew Shewa Tube 2 years ago 6 minutes 442,600 views",Minew Shewa Entertainment,442600,443213,613
1659,"Mohammed Idris (Koottu Shamiizee To) - New Ethiopian Oromo Music 2019(Official Video) by Minew Shewa Tube 2 years ago 5 minutes, 55 seconds 85,418 views",Minew Shewa Entertainment,85418,86100,682
1660,"Ethiopian Music : Ato Nega Getahun አቶ ነጋ ጌታሁን (ያስገርማል) - New Ethiopian Music 2019(Official Video) by Minew Shewa Tube 2 years ago 6 minutes, 47 seconds 4,928 views",Minew Shewa Entertainment,4928,4930,2
1661,"Ethiopian Music : Abebe Kefeni (Shakkii Malee) - New Ethiopian Oromo Music 2019(Official Video) by Minew Shewa Tube 2 years ago 5 minutes, 50 seconds 171,817 views",Minew Shewa Entertainment,171817,172210,393
1662,"Ethiopian Music : Gebreshet Bitew ገብርሸት ቢተው (አደቡን ላስገዛው) - New Ethiopian Music 2019(Official Video) by Minew Shewa Tube 2 years ago 5 minutes, 58 seconds 1,368,621 views",Minew Shewa Entertainment,1368621,1370742,2121
1663,"Ethiopian Music : Ayyaanaa Tsaggayyee (Onnee) - New Ethiopian Oromo Music 2019(Official Video) by Minew Shewa Tube 2 years ago 6 minutes, 53 seconds 8,213 views",Minew Shewa Entertainment,8213,8254,41
1664,"Ashu Man (Yayewat Lejagered) አሹ ማን (ያየዋት ልጃገረድ) - New Ethiopian Music 2019(Official Video) by Minew Shewa Tube 2 years ago 3 minutes, 33 seconds 4,883 views",Minew Shewa Entertainment,4883,4901,18
1665,"Ethiopian Music : Geetu Alamayyoo (Godoo Jaalalaa) - New Ethiopian Oromo Music 2019(Official Video) by Minew Shewa Tube 2 years ago 6 minutes, 28 seconds 32,121 views",Minew Shewa Entertainment,32121,32186,65
1666,"Tensay ft Feromsa (Anchieye) ተንሳይ ft ፌሮምሳ (አንቺዬ) - New Ethiopian Music 2019(Official Video) by Minew Shewa Tube 2 years ago 3 minutes, 53 seconds 4,702 views",Minew Shewa Entertainment,4702,4703,1
1667,"Samuel G (Ere Anchi alem) ሳሙኤል (ኧረ አንቺ ዓለም)- New Ethiopian Music 2019(Official Video) by Minew Shewa Tube 2 years ago 5 minutes, 15 seconds 4,763 views",Minew Shewa Entertainment,4763,4773,10
1668,"Tesfaye Taye and Zulfa Kemal ተስፋዬ ታዬ እና ዙልፋ ከማል (ቁልቁሌ) - New Ethiopian Music 2019(Official Video) by Minew Shewa Tube 2 years ago 6 minutes, 25 seconds 92,462 views",Minew Shewa Entertainment,92462,93542,1080
1669,"Ethiopian Music : Lammii Ittafaa (Nutu Xumura) - New Ethiopian Oromo Music 2019(Official Video) by Minew Shewa Tube 2 years ago 6 minutes, 42 seconds 7,100 views",Minew Shewa Entertainment,7100,7109,9
1670,"Ethiopian Music : Feti945 ፈቲ945 (ብቅ ጥልቅ) - New Ethiopian Music 2019(Official Video) by Minew Shewa Tube 2 years ago 4 minutes, 56 seconds 5,451 views",Minew Shewa Entertainment,5451,5457,6
1671,"Ethiopian Music: Qenubish Bilew (Shi Geday)ቀኑብሽ ቢለው (ሺ ገዳይ)New Ethiopian Music 2019(Official Video) by Minew Shewa Tube 2 years ago 6 minutes, 26 seconds 11,136 views",Minew Shewa Entertainment,11136,11177,41
1672,"Ethiopian Music : Bitew Dawit (Selam New) ቢተው ዳዊት (ሰላም ነው) New Ethiopian Music 2019(Official Video) by Minew Shewa Tube 2 years ago 6 minutes 3,751 views",Minew Shewa Entertainment,3751,3756,5
1673,"Ethiopian Music : Addisalem Tesfaye አዲስዓለም ተስፋዬ (ባለ ባጃጁ) - New Ethiopian Music 2019(Official Video) by Minew Shewa Tube 2 years ago 5 minutes, 45 seconds 4,252 views",Minew Shewa Entertainment,4252,4261,9
1674,"Ethiopian Music : Biniyaam Girmaa (Siin Barbaada) - New Ethiopian Oromo Music 2019(Official Video) by Minew Shewa Tube 2 years ago 6 minutes, 52 seconds 17,271 views",Minew Shewa Entertainment,17271,17287,16
1675,"Ethiopian Music: ዘካርያስ ሀብቴ (ልዩ ናት) Zekarias Habte (Liyu Nat)New Ethiopian Music 2019(Official Video) by Minew Shewa Tube 2 years ago 5 minutes, 51 seconds 24,238 views",Minew Shewa Entertainment,24238,24245,7
1676,"Ethiopian Music : Jiidhaa Leellisaa (Badhaatuu) - New Ethiopian Oromo Music 2019(Official Video) by Minew Shewa Tube 2 years ago 6 minutes, 30 seconds 4,175 views",Minew Shewa Entertainment,4175,4181,6
1677,"Ethiopian Music : Dess + Papa (Teyayzenal) ደስ + ፓፓ (ተያይዘናል) New Ethiopian Music 2019(Official Video) by Minew Shewa Tube 2 years ago 3 minutes, 56 seconds 2,774 views",Minew Shewa Entertainment,2774,2774,0
1678,"Ethiopian Music : Shime Ro jerk (Sinbarbaada) - New Ethiopian Oromo Music 2019(Official Video) by Minew Shewa Tube 2 years ago 6 minutes, 39 seconds 9,716 views",Minew Shewa Entertainment,9716,9724,8
1679,"Ethiopian Music : Fasil Demoz (Aynuma) ፋሲል ደሞዝ (አይኑማ)- New Ethiopian Music 2019(Official Video) by Minew Shewa Tube 2 years ago 10 minutes, 33 seconds 28,808 views",Minew Shewa Entertainment,28808,28819,11
1680,"Ethiopian Music: Sintaayyoo Balaay (Bareedduu Oromo) New Ethiopian Oromo Music 2019(Official Video) by Minew Shewa Tube 2 years ago 6 minutes, 38 seconds 39,756 views",Minew Shewa Entertainment,39756,39882,126
1681,"Ethiopian Music : Alamuu Ajabii (Dammaan Wal makaa) New Ethiopian Oromo Music 2019(Official Video) by Minew Shewa Tube 2 years ago 6 minutes 31,257 views",Minew Shewa Entertainment,31257,31392,135
1682,"Ethiopian Music: Selamawit Tarekegn(Samegn) ሰላማዊት ታረቀኝ(ሳመኝ)New Ethiopian Music 2019(Official Video) by Minew Shewa Tube 2 years ago 5 minutes, 44 seconds 7,995 views",Minew Shewa Entertainment,7995,8001,6
1683,"Ethiopian Music : Ashabirr Taasisaa (Jeeqamuun) - New Ethiopian Oromo Music 2019(Official Video) by Minew Shewa Tube 2 years ago 6 minutes, 33 seconds 6,589 views",Minew Shewa Entertainment,6589,6590,1
1684,"Ethiopian Music: Birhanu Hailu (Amrirwal) ብርሃኑ ኃይሉ (አምርሯል)- New Ethiopian Music 2019(Official Video) by Minew Shewa Tube 2 years ago 6 minutes, 18 seconds 2,783 views",Minew Shewa Entertainment,2783,2785,2
1685,"Ethiopian Music : Mulu Gebeyehu ሙሉ ገበየሁ (የአየር መንገድ ጀግኖች) - New Ethiopian Music 2019(Official Video) by Minew Shewa Tube 2 years ago 5 minutes, 43 seconds 28,739 views",Minew Shewa Entertainment,28739,28744,5
1686,"Ethiopian Music : Abebe Alemu & Redwan Nuredin (Sew Hun) - New Ethiopian Music 2019(Official Video) by Minew Shewa Tube 2 years ago 4 minutes, 13 seconds 5,183 views",Minew Shewa Entertainment,5183,5186,3
1687,"Ethiopian Music: Habtamu Gulilat(Yamenal) ሃብታሙ ጉልላት (ያመናል) New Ethiopian Music 2019(Official Video) by Minew Shewa Tube 2 years ago 6 minutes, 59 seconds 129,755 views",Minew Shewa Entertainment,129755,129798,43
1688,"Ethiopian Music : Caaltuu Abdii (Lammiiko) - New Ethiopian Oromo Music 2019(Official Video) by Minew Shewa Tube 2 years ago 6 minutes, 5 seconds 7,103 views",Minew Shewa Entertainment,7103,7132,29
1689,"Adisha Desu ft Betty (Adagnu) አዲሻ ደሱ (አዳኙ) - New Ethiopian Music 2019(Official Video) by Minew Shewa Tube 2 years ago 4 minutes, 34 seconds 7,044 views",Minew Shewa Entertainment,7044,7046,2
1690,"Ethiopian Music : Temesgen Tiringo ተመስገን ትርንጎ (ብርሃኖች) - New Ethiopian Music 2019(Official Video) by Minew Shewa Tube 2 years ago 4 minutes, 34 seconds 2,840 views",Minew Shewa Entertainment,2840,2841,1
1691,"Ethiopian Music : Alamaayyoo Tolaa (Lootuun Lootee) New Ethiopian Oromo Music 2019(Official Video) by Minew Shewa Tube 2 years ago 5 minutes, 38 seconds 5,763 views",Minew Shewa Entertainment,5763,5774,11
1692,"Ethiopian Music : Asaffaa Yaadasaa (Hoodhukaa) - New Ethiopian Oromo Music 2019(Official Video) by Minew Shewa Tube 2 years ago 8 minutes, 8 seconds 6,029 views",Minew Shewa Entertainment,6029,6036,7
1693,"Ethiopian Music : Molalign Meselu (Teneqe) ሞላልኝ መሰሉ (ተንቄ) New Ethiopian Music 2019(Official Video) by Minew Shewa Tube 2 years ago 6 minutes, 52 seconds 6,208 views",Minew Shewa Entertainment,6208,6217,9
1694,"Ethiopian Music : Hasan Muhaammad (Gadoo) - New Ethiopian Oromo Music 2019(Official Video) by Minew Shewa Tube 2 years ago 5 minutes, 49 seconds 115,662 views",Minew Shewa Entertainment,115662,115989,327
1695,"Ethiopian Music : Mulu Gebeyehu ሙሉ ገበየሁ (የአየር መንገድ ጀግኖች) - New Ethiopian Music 2019(Official Video) by Minew Shewa Tube 2 years ago 4 minutes, 3 seconds 12,437 views",Minew Shewa Entertainment,12437,12444,7
1696,"Gaaddisaa Gammadaa (Aman Qabsoon Misoomatti) New Ethiopian Oromo Music 2019(Official Video) by Minew Shewa Tube 2 years ago 5 minutes, 27 seconds 10,873 views",Minew Shewa Entertainment,10873,10892,19
1697,"Senait Hailemariam ሰናይት ኃ/ማርያም (ብሰላም ክንጥቅም ብሔርና) - New Eritrean Music 2019(Official Video) by Minew Shewa Tube 2 years ago 5 minutes, 8 seconds 21,209 views",Minew Shewa Entertainment,21209,21220,11
1698,"Ethiopian Music : Abdii Gammadaa (Finfinnee Koo) - New Ethiopian Oromo Music 2019(Official Video) by Minew Shewa Tube 2 years ago 7 minutes, 5 seconds 10,262 views",Minew Shewa Entertainment,10262,10280,18
1699,"Mulugeetaa Asaffaa (Yeroon Geesse Galii) New Ethiopian Oromo Music 2019(Official Video) by Minew Shewa Tube 2 years ago 6 minutes, 5 seconds 5,968 views",Minew Shewa Entertainment,5968,5988,20
1700,"Ethiopian Music : Efrem Wanaw ኤፍሬም ዋናው (እሸት ገላ) New Ethiopian Music 2019(Official Video) by Minew Shewa Tube 2 years ago 5 minutes, 37 seconds 83,722 views",Minew Shewa Entertainment,83722,83760,38
1701,"Ethiopian Music : Mahadii Xahaa (Gaaddisa Tokkummaa) - New Ethiopian Music 2019(Official Video) by Minew Shewa Tube 2 years ago 4 minutes, 24 seconds 4,077 views",Minew Shewa Entertainment,4077,4081,4
1702,"Demeke Alemu (Alem aleme) ደመቀ አለሙ (ዓለም ዓለሜ) - New Ethiopian Music 2019(Official Video) by Minew Shewa Tube 2 years ago 5 minutes, 55 seconds 14,770 views",Minew Shewa Entertainment,14770,14791,21
1703,"Ethiopian Music : Yodarnos Shiferaw ዮርዳኖስ ሽፈራው (እሱን ይለኛል) - New Ethiopian Music 2019(Official Video) by Minew Shewa Tube 2 years ago 5 minutes, 55 seconds 6,314 views",Minew Shewa Entertainment,6314,6326,12
1704,"Birraa Makonnin (Ija Jaalalaan Na Rukutte) - New Ethiopian Oromo Music 2019(Official Video) by Minew Shewa Tube 2 years ago 5 minutes, 12 seconds 8,367 views",Minew Shewa Entertainment,8367,8370,3
1705,"Diinaraas Tsaggayee (Finfinee dachee keenyaa) - New Ethiopian Oromo Music 2019(Official Video) by Minew Shewa Tube 2 years ago 6 minutes, 53 seconds 106,034 views",Minew Shewa Entertainment,106034,106265,231
1706,"Samsom Muez (SMZ) ሳምሶም ሙዑዝ Embi Aybehalin እምቢ አይበሃልን New Ethiopian Music 2019(Official Video) by Minew Shewa Tube 2 years ago 6 minutes, 29 seconds 462,282 views",Minew Shewa Entertainment,462282,465423,3141
1707,"Ethiopian Music: Cimdeessaa Ayyalaa(Guulaanta Ulfinna)New Ethiopian Oromo Music 2019(Official Video) by Minew Shewa Tube 2 years ago 5 minutes, 41 seconds 8,041 views",Minew Shewa Entertainment,8041,8062,21
1708,"Fikirte Geleta | Emebet Geleta ፍቅርተ ገለታ | እመቤት ገለታ (እንዋደድ) New Ethiopian Music 2019(Official Video) by Minew Shewa Tube 2 years ago 4 minutes, 13 seconds 8,455 views",Minew Shewa Entertainment,8455,8455,0
1709,"Tamirat Solomon ታምራት ሰለሞን(ወደላይ ወደታች) wede lay wedetach New Ethiopian Music 2019(Official Video) by Minew Shewa Tube 2 years ago 3 minutes, 49 seconds 6,367 views",Minew Shewa Entertainment,6367,6371,4
1710,"Ethiopian Music : Askaala Wandimmuu (Namiitee) - New Ethiopian Oromo Music 2019(Official Video) by Minew Shewa Tube 2 years ago 6 minutes, 34 seconds 48,396 views",Minew Shewa Entertainment,48396,48507,111
1711,"Ethiopian Music: Bilisummaaa Sarbeessaa (Ifti Baate) New Ethiopian Oromo Music 2019(Official Video) by Minew Shewa Tube 2 years ago 6 minutes, 9 seconds 7,338 views",Minew Shewa Entertainment,7338,7341,3
1712,"Ethiopian Music : Dagne Wale ዳኜ ዋለ (ዘርትሁን ጎንደር) - New Ethiopian Music 2019(Official Video) by Minew Shewa Tube 2 years ago 9 minutes, 28 seconds 15,539 views",Minew Shewa Entertainment,15539,15589,50
1713,"Ethiopian Music: I Bro ft Mk 12(Yesemay Sefatu | የሰማይ ስፋቱ) New Ethiopian Music 2019(Official Video) by Minew Shewa Tube 2 years ago 4 minutes, 43 seconds 3,728 views",Minew Shewa Entertainment,3728,3729,1
1714,"Urgeessaa Isheetuu (Dubbii nyaatti malee) - New Ethiopian Oromo Music 2019(Official Video) by Minew Shewa Tube 2 years ago 7 minutes, 21 seconds 380,272 views",Minew Shewa Entertainment,380272,384979,4707
1715,"Ethiopian Music : Enedeg Wondemeneh እንደግ ወንድሜነህ (የሰሚ ያለህ)  New Ethiopian Music 2019(Official Video) by Minew Shewa Tube 2 years ago 8 minutes, 4 seconds 182,464 views",Minew Shewa Entertainment,182464,183209,745
1716,"Absis ft Melak Mola (Neyilign) አብሲስ ft መላክ ሞላ (ነይልኝ)  New Ethiopian Music 2019(Official Video) by Minew Shewa Tube 2 years ago 5 minutes, 4 seconds 4,815 views",Minew Shewa Entertainment,4815,4818,3
1717,"Ethiopian Music: Dhaqqabaa Tashoomaa (Taddee Jedhee) New Ethiopian Oromo Music 2019(Official Video) by Minew Shewa Tube 2 years ago 6 minutes, 17 seconds 317,567 views",Minew Shewa Entertainment,317567,319927,2360
1718,"Ethiopian Music : Mekdes Zewdu መቅደስ ዘውዱ (ጉድ ሰራኝ) New Ethiopian Music 2019(Official Video) by Minew Shewa Tube 2 years ago 5 minutes, 35 seconds 355,642 views",Minew Shewa Entertainment,355642,356341,699
1719,"Galaanaa Nugusee (Egalle malee hin Xumurre)- New Ethiopian Oromo Music 2019(Official Video) by Minew Shewa Tube 2 years ago 6 minutes, 37 seconds 60,706 views",Minew Shewa Entertainment,60706,60788,82
1720,"Biniam Birhane - Woori Mannam 우리 만남 ኡሪ ማናም - New Ethiopian Music 2019 (official video by Minew Shewa Tube 2 years ago 4 minutes, 39 seconds 20,004 views",Minew Shewa Entertainment,20004,20026,22
1721,"Tewodros | Tedi Mati (Endanleyay) ቴዎድሮስ | ቴዲ ማቲ (እንዳንለያይ) New Ethiopian Music 2019(Official Video) by Minew Shewa Tube 2 years ago 5 minutes, 23 seconds 4,477 views",Minew Shewa Entertainment,4477,4482,5
1722,"Ethiopian Music :Tintag zema (Ketetsafelet)ትንታግ ዜማ (ከተፃፈለት) New Ethiopian Music 2019(Official Video) by Minew Shewa Tube 3 years ago 5 minutes, 32 seconds 103,286 views",Minew Shewa Entertainment,103286,103833,547
1723,"Bilisummaa Araarsaa (Finfinnee gubbaadha) - New Ethiopian Oromo Music 2019(Official Video) by Minew Shewa Tube 3 years ago 6 minutes, 13 seconds 34,859 views",Minew Shewa Entertainment,34859,34925,66
1724,"Kalkidan & Birhanu (Adwa) ቃልኪዳን ቢካሱና ብርሃኑ አሞኘ (አድዋ) New Ethiopian Music 2019(Official Video) by Minew Shewa Tube 3 years ago 6 minutes, 31 seconds 14,800 views",Minew Shewa Entertainment,14800,14875,75
1725,"Eriterian Music : Haben T/Michael (Qemem) ሓበን ተ/ሚካኤል (ቀመም) New Eriterian Music 2019(Official Video) by Minew Shewa Tube 3 years ago 5 minutes, 25 seconds 12,599 views",Minew Shewa Entertainment,12599,12603,4
1726,"Ethiopian Music : Defaru Getnet ደፋሩ ጌትነት (ሀበሻው ደሜ) - New Ethiopian Music 2019(Official Video) by Minew Shewa Tube 3 years ago 6 minutes, 4 seconds 34,357 views",Minew Shewa Entertainment,34357,34488,131
1727,"Ethiopian Music :Zemenu Teshale (Aman) ዘመኑ ተሻለ (አማን) - New Ethiopian Music 2019(Official Video) by Minew Shewa Tube 3 years ago 7 minutes, 10 seconds 7,074 views",Minew Shewa Entertainment,7074,7078,4
1728,"Ethiopian Music : Rahel Getu (Tilobign) ራሄል ጌቱ (ጥሎብኝ) - New Ethiopian Music 2019(Official Video) by Minew Shewa Tube 3 years ago 5 minutes, 13 seconds 17,927,693 views",Minew Shewa Entertainment,17927693,17952524,24831
1729,"Ethiopian Music : Ha Ge'ez (Mareye) ሀ-ግዕዝ (ማርዬ) - New Ethiopian Music 2019(Official Video) by Minew Shewa Tube 3 years ago 4 minutes, 20 seconds 13,436 views",Minew Shewa Entertainment,13436,13449,13
1730,"Ethiopian Music: Ephrem Altaseb ኤፍሬም አልታሰብ (ሽው በይ)Shew bey -New Ethiopian Music 2019(Official Video) by Minew Shewa Tube 3 years ago 5 minutes, 36 seconds 136,699 views",Minew Shewa Entertainment,136699,136844,145
1731,"Ethiopian Music: Xilaahun Zallaqa (Jibba Hin Beekuu) New Ethiopian Oromo Music 2019(Official Video) by Minew Shewa Tube 3 years ago 5 minutes, 39 seconds 18,180 views",Minew Shewa Entertainment,18180,18194,14
1732,"Ethiopian Music : Abeba Desalegn/አበባ ደሳለኝ ""Melest ምልሰት"" New Ethiopian Music 2019 (Official Video) by Minew Shewa Tube 3 years ago 6 minutes, 13 seconds 1,655,840 views",Minew Shewa Entertainment,1655840,1660833,4993
1733,"Ethiopian Music : Ashennaafi Baqqalaa (Maaltu Beeka) New Ethiopian Oromo Music 2019(Official Video) by Minew Shewa Tube 3 years ago 5 minutes, 6 seconds 192,923 views",Minew Shewa Entertainment,192923,194005,1082
1734,"Ethiopian Music : Dereje Dessalegn ደረጀ ደሳለኝ (የነፃነት አርማ) - New Ethiopian Music 2019(Official Video) by Minew Shewa Tube 3 years ago 7 minutes, 24 seconds 4,686 views",Minew Shewa Entertainment,4686,4686,0
1735,"Ethiopian Music : Nasra Gursum (Bonna Afran Qaloo) - New Ethiopian Oromo Music 2019(Official Video) by Minew Shewa Tube 3 years ago 6 minutes, 38 seconds 287,878 views",Minew Shewa Entertainment,287878,288902,1024
1736,"Ethiopian Music : Haylee Maammuyyee (Abbichu Moo) - New Ethiopian Oromo Music 2019(Official Video) by Minew Shewa Tube 3 years ago 5 minutes, 49 seconds 17,525 views",Minew Shewa Entertainment,17525,17535,10
1737,"Ethiopian Music : Faaxee Anniyyaa (Ati Kiyya) - New Ethiopian Oromo Music 2019(Official Video) by Minew Shewa Tube 3 years ago 7 minutes, 31 seconds 1,298,048 views",Minew Shewa Entertainment,1298048,1308132,10084
1738,"Ethiopian Music : ፊልሞን ሃብቱ እና ቴድሮስ ደለለኝ (የኔላ ናት) - New Ethiopian Music 2019(Official Video) by Minew Shewa Tube 3 years ago 6 minutes, 5 seconds 8,374 views",Minew Shewa Entertainment,8374,8379,5
1739,"Ethiopian Music : Endris Umer (Burqaa Bareedina) - New Ethiopian Oromo Music 2019(Official Video) by Minew Shewa Tube 3 years ago 6 minutes, 41 seconds 41,288 views",Minew Shewa Entertainment,41288,41414,126
1740,"Ethiopian Music : Maditu Weday (Shumeye) ማዲቱ ወዳይ (ሹምየ) - New Ethiopian Music 2019(Official Video) by Minew Shewa Tube 3 years ago 6 minutes, 27 seconds 2,630,479 views",Minew Shewa Entertainment,2630479,2639219,8740
1741,"Ethiopian Music : AFO (Amboo Ambaa Lafaa) - New Ethiopian Oromo Music 2019(Official Video) by Minew Shewa Tube 3 years ago 6 minutes, 26 seconds 5,812 views",Minew Shewa Entertainment,5812,5813,1
1742,"Oromo Music : Zeeynabaa Abbaa Jihaad (Kiyya Kiyya) - New Ethiopian Oromo Music 2019(Official Video) by Minew Shewa Tube 3 years ago 4 minutes, 5 seconds 11,184 views",Minew Shewa Entertainment,11184,11194,10
1743,"Kebur W/Giyorgis (Wesedechew Liben) ክቡር ወ/ጊዮርጊስ (ወሰደችው ልቤን) New Ethiopian Music 2019(Official Video) by Minew Shewa Tube 3 years ago 6 minutes, 26 seconds 9,772 views",Minew Shewa Entertainment,9772,9809,37
1744,"Ethiopian Music : Meri Kokeb (Wey Nedo) መሪ ኮኮብ (ወይ ነዶ)  - New Ethiopian Music 2019(Official Video) by Minew Shewa Tube 3 years ago 4 minutes, 49 seconds 8,817 views",Minew Shewa Entertainment,8817,8825,8
1745,"Bazu Man ባዙ ማን (የደጀን ልጅ ) Asenkew beya asnekew  ""አስነኪው በያ አሰነኪው"" New Ethiopian Music 2019 music. by Minew Shewa Tube 3 years ago 4 minutes, 46 seconds 10,656 views",Minew Shewa Entertainment,10656,10666,10
1746,"Caalaa fi Quuftuu (Tokkummaa Kennya Cimsi) New Ethiopian Oromo Music 2019(Official Video) by Minew Shewa Tube 3 years ago 7 minutes, 7 seconds 13,919 views",Minew Shewa Entertainment,13919,13945,26
1747,"Ethiopian Music : Dagi D (Mababel) ዳጊ ዲ (ማባበል)  - New Ethiopian Music 2019(Official Video) by Minew Shewa Tube 3 years ago 4 minutes, 17 seconds 18,172 views",Minew Shewa Entertainment,18172,18229,57
1748,"Oromo Music : Anagaatuu Baalchaa ""Galle Booa koo"" New Ethiopian Oromo Music 2019(Official Video) by Minew Shewa Tube 3 years ago 6 minutes, 58 seconds 11,953 views",Minew Shewa Entertainment,11953,11963,10
1749,"Ethiopian Music: Maliyaa Abdullee (Narra Hin Haffin) New Ethiopian Oromo Music 2019(Official Video) by Minew Shewa Tube 3 years ago 5 minutes 22,872 views",Minew Shewa Entertainment,22872,22892,20
1750,"Diriirsaa Elemoo (Aduun dhara dhiite) - New Ethiopian Oromo Music 2019(Official Video) by Minew Shewa Tube 3 years ago 6 minutes, 32 seconds 481,358 views",Minew Shewa Entertainment,481358,485062,3704
1751,"Oromo music: Ganat Kormee (Dhaabileen Siyaasaa) - New Ethiopian Oromo Music 2019(Official Video) by Minew Shewa Tube 3 years ago 5 minutes, 29 seconds 16,452 views",Minew Shewa Entertainment,16452,16471,19
1752,"Deme Lula (Jege Minjar No.2) ደሜ ሉላ (ጅጌ ምንጃር ቁ.2) - New Ethiopian Music 2019(Official Video) by Minew Shewa Tube 3 years ago 5 minutes, 47 seconds 222,546 views",Minew Shewa Entertainment,222546,224906,2360
1753,"Ethiopian Music : Tizetaw Minilik ትዝታው ሚኒሊክ (ሃሎ ውዴ) - New Ethiopian Music 2019(Official Video) by Minew Shewa Tube 3 years ago 6 minutes, 4 seconds 7,422 views",Minew Shewa Entertainment,7422,7427,5
1754,"Ethiopian Music : Kumaa Mallasall (Lakkii Lakkii) - New Ethiopian Oromo Music 2019(Official Video) by Minew Shewa Tube 3 years ago 6 minutes, 15 seconds 7,245 views",Minew Shewa Entertainment,7245,7253,8
1755,"Ethiopian music: Henok Abebe - Tagebignalesh Wey ሄኖክ አበበ - ታገቢግኛለሽ ወይ (Valentine official music ) by Minew Shewa Tube 3 years ago 7 minutes, 9 seconds 105,671 views",Minew Shewa Entertainment,105671,105847,176
1756,"Ethiopian Music : Tola Diribbaa (Geesse) - New Ethiopian Oromo Music 2019(Official Video) by Minew Shewa Tube 3 years ago 5 minutes, 58 seconds 33,751 views",Minew Shewa Entertainment,33751,33793,42
1757,"Ethiopian Music :Addis Walelegn አዲስ ዋለልኝ Amele neaw(አመሌ ነው)New Ethiopian Music 2019(Official Video) by Minew Shewa Tube 3 years ago 5 minutes, 13 seconds 5,689 views",Minew Shewa Entertainment,5689,5693,4
1758,"Ethiopian Music : Fraol Debere (Merga Tufo) - New Ethiopian Oromo Music 2019(Official Video) by Minew Shewa Tube 3 years ago 5 minutes, 18 seconds 58,120 views",Minew Shewa Entertainment,58120,58164,44
1759,"Ethiopian Music : Abeba Desalegn/አበባ ደሳለኝ ""Melest ምልስት"" New Ethiopian Music 2019(Official Music) by Minew Shewa Tube 3 years ago 6 minutes, 10 seconds 482,785 views",Minew Shewa Entertainment,482785,483143,358
1760,"Ethiopian Music : Gemechu Ashmo (Biyyakoo) New Ethiopian Oromo Music 2019 (Official Video) by Minew Shewa Tube 3 years ago 6 minutes, 15 seconds 7,052 views",Minew Shewa Entertainment,7052,7054,2
1761,"Ethiopian Music: Mahamadsa'id Huseen (Suma Anaaf Dawaan) New Wollo Oromo Music 2019(Official Video) by Minew Shewa Tube 3 years ago 7 minutes, 54 seconds 220,512 views",Minew Shewa Entertainment,220512,222365,1853
1762,"Ethiopian Music : Musxafaa Abraar (Yaada Moo'ataa) - New Ethiopian Oromo Music 2019(Official Video) by Minew Shewa Tube 3 years ago 7 minutes, 7 seconds 6,897 views",Minew Shewa Entertainment,6897,6918,21
1763,"Ethiopian Music : Fasil Demoz (Gonder) ፋሲል ደሞዝ (ጎንደር) - New Ethiopian Music 2018(Official Video) by Minew Shewa Tube 3 years ago 12 minutes, 46 seconds 17,549 views",Minew Shewa Entertainment,17549,17594,45
1764,"Ethiopian Music : Caalaa Booni (Kootuyaa Saboontuu) - New Ethiopian Music 2019(Official Video) by Minew Shewa Tube 3 years ago 5 minutes, 12 seconds 8,792 views",Minew Shewa Entertainment,8792,8796,4
1765,"Ethiopian Music : Alemayehu Mola (Lijinet) አለማየሁ ሞላ (ልጅነት) New Ethiopian Music 2019(Official Video) by Minew Shewa Tube 3 years ago 5 minutes, 27 seconds 25,518 views",Minew Shewa Entertainment,25518,25522,4
1766,"Ethiopian Music : Baay'isaa Fayisaa (Ni milkoofna) - New Ethiopian Oromo Music 2019(Official Video) by Minew Shewa Tube 3 years ago 7 minutes, 3 seconds 18,391 views",Minew Shewa Entertainment,18391,18431,40
1767,"Ethiopian Music : Nimonaa (Harma Walhoonaa) - New Ethiopian Oromo Music 2019(Official Video) by Minew Shewa Tube 3 years ago 5 minutes, 57 seconds 4,408 views",Minew Shewa Entertainment,4408,4408,0
1768,"Ethiopian Music : ማይኪ 91 ft Redi ጃ (ያኔ ካንቺ ጋራ) - New Ethiopian Music 2019(Official Video) by Minew Shewa Tube 3 years ago 4 minutes, 4 seconds 5,661 views",Minew Shewa Entertainment,5661,5666,5
1769,"Ethiopian Music : Lakachew Birhane ላቃቸው ብርሃኔ (ፍቅር ከባድ) - New Ethiopian Music 2019(Official Video) by Minew Shewa Tube 3 years ago 5 minutes, 36 seconds 5,491 views",Minew Shewa Entertainment,5491,5491,0
1770,"Oromo Music : Haayluu Caalaa (Gaafa Xiiqii) - New Ethiopian Oromo Music 2019(Official Video) by Minew Shewa Tube 3 years ago 6 minutes, 21 seconds 15,348 views",Minew Shewa Entertainment,15348,15363,15
1771,"Humneesaa Badhaasaa (Akkatti Baashaatu) - New Ethiopian Oromo Music 2019(Official Video) by Minew Shewa Tube 3 years ago 5 minutes, 31 seconds 10,520 views",Minew Shewa Entertainment,10520,10536,16
1772,"Eritrean music : Samrawit Aklilu (Aymeno) ሳምራዊት ኣኽሊሉ (ኣይምኖ) New Eriteria Music 2019(Official Video) by Minew Shewa Tube 3 years ago 4 minutes, 20 seconds 215,870 views",Minew Shewa Entertainment,215870,215996,126
1773,"Ethiopian Music : Ahmad Abdulla (Naannooyyee) - New Ethiopian Oromo Music 2019(Official Video) by Minew Shewa Tube 3 years ago 6 minutes, 16 seconds 90,573 views",Minew Shewa Entertainment,90573,91128,555
1774,"Leulseged ""Lee"" Admassie & Nahum Sonson Ethiopia Forever ኢትዮጵያ ለዘላለም  New Ethiopian Music 2019 by Minew Shewa Tube 3 years ago 5 minutes, 17 seconds 8,281 views",Minew Shewa Entertainment,8281,8282,1
1775,"Mangistuu Raggaasaa (Goota Dhoowwan Dhibe) - New Ethiopian Oromo Music 2019(Official Video) by Minew Shewa Tube 3 years ago 7 minutes, 47 seconds 6,299 views",Minew Shewa Entertainment,6299,6305,6
1776,"Ethiopian Music : Tiki G ትኪ ጂ (እብድ ናት) - New Ethiopian Music 2019(Official Video) by Minew Shewa Tube 3 years ago 6 minutes, 32 seconds 6,432 views",Minew Shewa Entertainment,6432,6435,3
1777,"Mesfinu Kebede (Ethiopia) መስፍኑ ከበደ (ኢትዮጵያ) - New Ethiopian Music 2019(Official Video) by Minew Shewa Tube 3 years ago 7 minutes, 10 seconds 6,158 views",Minew Shewa Entertainment,6158,6160,2
1778,"Temesgen Tiringo (Tadamqe) ተመስገን ትርንጎ (ታዳምቄ) - New Ethiopian Music 2019(Official Video) by Minew Shewa Tube 3 years ago 9 minutes, 51 seconds 2,314 views",Minew Shewa Entertainment,2314,2315,1
1779,"Samuel Tesfaye (Nafkeshignal) ሳሙኤል ተስፋዬ (ናፍቀሽኛል) - New Ethiopian Music 2019(Official Video) by Minew Shewa Tube 3 years ago 4 minutes, 36 seconds 29,074 views",Minew Shewa Entertainment,29074,29116,42
1780,"Yafet Legese (Beshenena Beylign) ያፌት ለገሰ (በሸነና በይልኝ) - New Ethiopian Music 2019(Official Video) by Minew Shewa Tube 3 years ago 5 minutes, 46 seconds 9,208 views",Minew Shewa Entertainment,9208,9218,10
1781,"10APART - ""WINTA"" New R&B music 2019 (Official video) by Minew Shewa Tube 3 years ago 2 minutes, 18 seconds 19,364 views",Minew Shewa Entertainment,19364,19383,19
1782,"Ethiopian Music : Jamaal Aadam (Qodda Malee) - New Ethiopian Oromo Music 2019(Official Video) by Minew Shewa Tube 3 years ago 6 minutes, 46 seconds 14,030 views",Minew Shewa Entertainment,14030,14092,62
1783,"Ethiopian Music : Mudin Jemal (Sirri) - New Ethiopian Oromo Music 2019(Official Video) by Minew Shewa Tube 3 years ago 4 minutes, 47 seconds 30,327 views",Minew Shewa Entertainment,30327,30451,124
1784,"Ethiopian Music : Beki Formula (ሩጥ ቢያምህም)  - New Ethiopian Music 2019(Official Video) by Minew Shewa Tube 3 years ago 3 minutes, 28 seconds 5,892 views",Minew Shewa Entertainment,5892,5896,4
1785,"Ethiopian Music : Katamaa Dhaabaa (Jajjabee) - New Ethiopian Oromo Music 2019(Official Video) by Minew Shewa Tube 3 years ago 4 minutes, 57 seconds 7,965 views",Minew Shewa Entertainment,7965,7973,8
1786,"Ethiopian Music : Sulxaan Aabbo (Qeerookoo) - New Ethiopian Oromo Music 2019(Official Video) by Minew Shewa Tube 3 years ago 7 minutes, 44 seconds 4,075 views",Minew Shewa Entertainment,4075,4081,6
1787,"Ethiopian Music : LilPac (Aneye Rapper) ኣባ ነዲ (ኣነ'የ ራፐር) - New Ethiopian Music 2019(Official Video) by Minew Shewa Tube 3 years ago 3 minutes, 39 seconds 4,275 views",Minew Shewa Entertainment,4275,4279,4
1788,"Ethiopian Music : NG (Berta) በርታ - New Ethiopian Music 2019(Official Video) by Minew Shewa Tube 3 years ago 5 minutes, 4 seconds 5,144 views",Minew Shewa Entertainment,5144,5146,2
1789,"Binny Lastta (Sem ena Werq) ቢኒ ላስታ (ሰምና ወርቅ) New Ethiopian Music 2019(Official Video) by Minew Shewa Tube 3 years ago 7 minutes, 24 seconds 65,606 views",Minew Shewa Entertainment,65606,65827,221
1790,"Ethiopian Music : Adaanech Taamanaa (Gadda) - New Ethiopian Oromo Music 2019(Official Video) by Minew Shewa Tube 3 years ago 6 minutes, 47 seconds 10,700 views",Minew Shewa Entertainment,10700,10717,17
1791,"Naafroobika Tottoobaa (Amboo irra dihaaphee) - New Ethiopian Oromo Music 2019(Official Video) by Minew Shewa Tube 3 years ago 5 minutes, 24 seconds 5,300 views",Minew Shewa Entertainment,5300,5308,8
1792,"Ethiopian Music : Fasil Demoz (Hidelegn) ፋሲል ደሞዝ (ሂድልኝ) - New Ethiopian Music 2018(Official Video) by Minew Shewa Tube 3 years ago 6 minutes, 13 seconds 6,965 views",Minew Shewa Entertainment,6965,6971,6
1793,"Ethiopian Music : Blatenaw (Bene Lay) ብላቴናው (በኔ ላይ) - New Ethiopian Music 2019(Official Video) by Minew Shewa Tube 3 years ago 3 minutes, 23 seconds 4,740 views",Minew Shewa Entertainment,4740,4764,24
1794,"Markos Lemma (Kebole Eriteria) ማርቆስ ለማ (ከቦሌ ኤርትራ)- New Ethiopian Music 2019(Official Video) by Minew Shewa Tube 3 years ago 4 minutes, 13 seconds 11,413 views",Minew Shewa Entertainment,11413,11413,0
1795,"Ethiopian Music : Yohannes Endale ዮሃንስ እንዳለ (የአበባ ዘር) - New Ethiopian Music 2019(Official Video) by Minew Shewa Tube 3 years ago 6 minutes, 8 seconds 18,336 views",Minew Shewa Entertainment,18336,18341,5
1796,"Asrat Amare (Beketemaw) አስራት አማረ (በከተማው) - New Ethiopian Music 2019(Official Video) by Minew Shewa Tube 3 years ago 5 minutes, 28 seconds 4,507 views",Minew Shewa Entertainment,4507,4510,3
1797,"Ethiopian music Desalegn Abebe (Sima Belew)ደሳለኝ አበበ (ስማ በለው)New Ethiopian Music 2019(Official Video) by Minew Shewa Tube 3 years ago 6 minutes, 10 seconds 424,185 views",Minew Shewa Entertainment,424185,424945,760
1798,"Ethiopian Music : Yabu JC (Kene Wey Kante) ከኔ ወይ ካንተ - New Ethiopian Music 2019(Official Video) by Minew Shewa Tube 3 years ago 3 minutes, 14 seconds 3,093 views",Minew Shewa Entertainment,3093,3101,8
1799,"Ethiopian Music : Micky Shady (Gual Mama) - New Ethiopian Tigrigna Music 2019(Official Video) by Minew Shewa Tube 3 years ago 4 minutes, 45 seconds 10,857 views",Minew Shewa Entertainment,10857,10865,8
1800,"Ethiopian Music : Ibsaa Looshee (Rorro Jalalaa) - New Ethiopian Oromo Music 2019(Official Video) by Minew Shewa Tube 3 years ago 5 minutes, 2 seconds 9,175 views",Minew Shewa Entertainment,9175,9208,33
1801,"Ethiopian Music : Neba Habesha (Zenkata) ነባ ሐበሻ (ዘንካታ)- New Ethiopian Music 2019(Official Video) by Minew Shewa Tube 3 years ago 4 minutes, 4 seconds 14,241 views",Minew Shewa Entertainment,14241,14263,22
1802,"Zaalikaa Rabboo fi Aadam Nuurii (Kallacha Koo) - New Ethiopian Oromo Music 2019(Official Video) by Minew Shewa Tube 3 years ago 6 minutes, 49 seconds 21,363 views",Minew Shewa Entertainment,21363,21392,29
1803,"Ethiopian Music :Guramayle (Yilugnta) ጉርማይሌ (ይሉኝታ)  - New Ethiopian Music 2019(Official Video) by Minew Shewa Tube 3 years ago 4 minutes, 31 seconds 3,209 views",Minew Shewa Entertainment,3209,3214,5
1804,"Muktar Adeero ft Malika Mohamed (Baredu) New Ethiopian Oromo Music 2019(Official Video) by Minew Shewa Tube 3 years ago 5 minutes, 52 seconds 78,922 views",Minew Shewa Entertainment,78922,79663,741
1805,"Ethiopian Music : Nishan Belay (Shebelaw) ኒሻን በላይ (ሸበላው) - New Ethiopian Music 2019(Official Video) by Minew Shewa Tube 3 years ago 7 minutes, 21 seconds 7,180 views",Minew Shewa Entertainment,7180,7185,5
1806,"Ethiopian Music : Keven Abereham  ኬቨን አብርሃም (እዛም ወሬ) - New Ethiopian Music 2019(Official Video) by Minew Shewa Tube 3 years ago 4 minutes, 28 seconds 20,245 views",Minew Shewa Entertainment,20245,20261,16
1807,"Bonsa Lelliso (Nujalaa Awwaadhuu) - New Ethiopian Oromo Music 2019(Official Video) by Minew Shewa Tube 3 years ago 8 minutes, 36 seconds 5,638 views",Minew Shewa Entertainment,5638,5647,9
1808,"Oromo Music : Fraol Debere (Hiyyasee) - New Ethiopian Oromo Music 2019(Official Video) by Minew Shewa Tube 3 years ago 5 minutes, 40 seconds 18,249 views",Minew Shewa Entertainment,18249,18356,107
1809,"Ethiopian Music : Bokona Bayu (Kopha ko)  - New Ethiopian Oromo Music 2019(Official Video) by Minew Shewa Tube 3 years ago 6 minutes, 53 seconds 15,731 views",Minew Shewa Entertainment,15731,15743,12
1810,"Ethiopian Music : አይናዲስ ባብል (አይንዬ) - New Ethiopian Music 2019(Official Video) by Minew Shewa Tube 3 years ago 5 minutes, 8 seconds 15,590 views",Minew Shewa Entertainment,15590,15596,6
1811,"Qindeessaa Dheeressaa (Qeerroo Yaadee) - New Ethiopian Music 2019(Official Video) by Minew Shewa Tube 3 years ago 6 minutes, 9 seconds 28,211 views",Minew Shewa Entertainment,28211,28267,56
1812,"Ethiopian Music : Zegate Dejene (Tafach) ዘጌት ደጀኔ (ጣፋጭ)  - New Ethiopian Music 2019(Official Video) by Minew Shewa Tube 3 years ago 5 minutes, 48 seconds 14,170 views",Minew Shewa Entertainment,14170,14171,1
1813,"Okaash fi Faaxumaa (Bareedduu Afran aql'oo) - New Ethiopian Oromo Music 2019(Official Video) by Minew Shewa Tube 3 years ago 7 minutes, 20 seconds 2,348,947 views",Minew Shewa Entertainment,2348947,2369245,20298
1814,"Daanyee Asaffaa (Wal Jabeeffachuun Yoona) New Ethiopian Oromo Music 2019(Official Video) by Minew Shewa Tube 3 years ago 5 minutes, 10 seconds 25,365 views",Minew Shewa Entertainment,25365,25489,124
1815,"Ethiopian Music : Meri Amanuel መሪ አማኑኤል (ስነ-ምግባር) - New Ethiopian Music 2019(Official Video) by Minew Shewa Tube 3 years ago 3 minutes, 18 seconds 5,250 views",Minew Shewa Entertainment,5250,5254,4
1816,"Ethiopian Music : Sami Getu (Sabign) ሳሚ ጌቱ (ሳቢኝ) - New Ethiopian Music 2019(Official Video) by Minew Shewa Tube 3 years ago 5 minutes, 47 seconds 48,522 views",Minew Shewa Entertainment,48522,48550,28
1817,"Ethiopian Music : Adem Mohammed(Ammas Tokkuma) - New Ethiopian Oromo Music 2019(Official Video) by Minew Shewa Tube 3 years ago 7 minutes, 6 seconds 85,867 views",Minew Shewa Entertainment,85867,85964,97
1818,"Ethiopian Music : Tati and YoYo (Na Ahun) ታቲ እና ዮዮ (ና አሁን) New Ethiopian Music 2019(Official Video) by Minew Shewa Tube 3 years ago 4 minutes, 31 seconds 4,539 views",Minew Shewa Entertainment,4539,4541,2
1819,"Oromo Music : Hayyuu Naggasuu (Sororoo) - New Ethiopian Oromo Music 2019(Official Video) by Minew Shewa Tube 3 years ago 8 minutes, 27 seconds 122,995 views",Minew Shewa Entertainment,122995,123252,257
1820,"Ethiopian Music : Saddam Negeso ሳዳም ነጌሶ (ዜመኛ ነኝ)- New Ethiopian Music 2019(Official Video) by Minew Shewa Tube 3 years ago 5 minutes, 1 second 3,014 views",Minew Shewa Entertainment,3014,3019,5
1821,"Ethiopian Music : Caalaa Bultumee (Isin Lachuu) - New Ethiopian Oromo Music 2019(Official Video) by Minew Shewa Tube 3 years ago 11 minutes, 23 seconds 196,142 views",Minew Shewa Entertainment,196142,196468,326
1822,"Ethiopian Music : Fasil Demoz (Maninet) ፋሲል ደሞዝ (ማንነት) - New Ethiopian Music 2018(Official Video) by Minew Shewa Tube 3 years ago 7 minutes, 5 seconds 12,671 views",Minew Shewa Entertainment,12671,12681,10
1823,"Ethiopian Music : Frezer Kenaw (Kena) ፍሬዘር ቀናው (ቀና) - New Ethiopian Music 2019(Official Video) by Minew Shewa Tube 3 years ago 4 minutes, 56 seconds 62,658 views",Minew Shewa Entertainment,62658,62933,275
1824,"Ethiopian Music: Etsubdenk Tibebu(Eyulgn) እፁብድንቅ ጥበቡ (እዩልኝ)New Ethiopian Music 2019(Official Video) by Minew Shewa Tube 3 years ago 5 minutes, 22 seconds 54,866 views",Minew Shewa Entertainment,54866,54873,7
1825,"Sisay Dida (Wetnenaye) ft Gofer ሲሳይ ዲዳ (ወትነናዬ) ft ጎፈር - New Ethiopian Music 2019(Official Video) by Minew Shewa Tube 3 years ago 5 minutes 5,246 views",Minew Shewa Entertainment,5246,5252,6
1826,"Ezana Niguesse (Bandiraw lay) ኢዛና ንጉሴ (ባንዲራው ላይ) - New Ethiopian Music 2019(Official Video) by Minew Shewa Tube 3 years ago 6 minutes, 47 seconds 10,988 views",Minew Shewa Entertainment,10988,10994,6
1827,"Oromo Music :Tiyyaa Husseen (Bekan Sea Sifan Kelbi Kute) New Ethiopian Music 2019(Official Video) by Minew Shewa Tube 3 years ago 5 minutes, 30 seconds 355,629 views",Minew Shewa Entertainment,355629,356037,408
1828,"Oromo Music: Nafroobika Tottobaa (Hagessi Hind Danda'u) New Ethiopian Music 2019(Official Video) by Minew Shewa Tube 3 years ago 6 minutes, 20 seconds 4,759 views",Minew Shewa Entertainment,4759,4760,1
1829,"Zerihun Alemayew (Yeslkun Guday) ዘሪሁን አለማየሁ (የስልኩን ጉዳይ) - New Ethiopian Music 2019(Official Video) by Minew Shewa Tube 3 years ago 5 minutes, 27 seconds 9,062 views",Minew Shewa Entertainment,9062,9073,11
1830,"Danayit G/Medhin (Yiftweka) ዳናይት ገ/መድህን (ይፍትወካ) - New Ethiopian Music 2019(Official Video) by Minew Shewa Tube 3 years ago 5 minutes, 3 seconds 13,299 views",Minew Shewa Entertainment,13299,13302,3
1831,"Ethiopian Music : ዋንኮ (ጓደኝነት) - New Ethiopian Music 2019(Official Video) by Minew Shewa Tube 3 years ago 5 minutes, 7 seconds 15,618 views",Minew Shewa Entertainment,15618,15650,32
1832,"Biniam Yohanes (Mechwni) ቢንያም ዮሃንስ (መችውኒ) New Ethiopian Tigrigna Music 2018(Official Video) by Minew Shewa Tube 3 years ago 5 minutes, 25 seconds 20,785 views",Minew Shewa Entertainment,20785,20786,1
1833,"Ethiopian Music: Janhoy Ayelegn(Amtulegn) ጃንሆይ አየልኝ (አምጡልኝ) New Ethiopian Music 2019(Official Video) by Minew Shewa Tube 3 years ago 4 minutes, 51 seconds 35,163 views",Minew Shewa Entertainment,35163,35176,13
1834,"Ethiopian Music : ያብስራ መስፍን | ቴዎድሮስ አይቸው (ትዝታሽ) - New Ethiopian Music 2019(Official Video) by Minew Shewa Tube 3 years ago 5 minutes, 26 seconds 12,397 views",Minew Shewa Entertainment,12397,12408,11
1835,"Melese Tezera (Fiker Yeshalenal) መለሰ ተዘራ (ፍቅር ይሻለናል) - New Ethiopian Music 2019(Official Video) by Minew Shewa Tube 3 years ago 5 minutes, 37 seconds 6,333 views",Minew Shewa Entertainment,6333,6340,7
1836,"Ethiopian Music : ፃዲቁ ወተራ (አይኗ) Tsadiku Wetera (Aynwa) - New Ethiopian Music 2018(Official Video) by Minew Shewa Tube 3 years ago 5 minutes 10,504 views",Minew Shewa Entertainment,10504,10509,5
1837,"Ethiopian Music: Hayleyesus Feyssa (Beleke) ኃይለየሱስ ፈይሳ(በልኬ) New Ethiopian Music 2019(Official Video) by Minew Shewa Tube 3 years ago 5 minutes, 16 seconds 567,343 views",Minew Shewa Entertainment,567343,570323,2980
1838,"Oromo Music : Ashannaafi Yaadaa (Aadaan Koo)  - New Ethiopian Oromo Music 2019(Official Video) by Minew Shewa Tube 3 years ago 5 minutes, 4 seconds 13,865 views",Minew Shewa Entertainment,13865,13875,10
1839,"Ethiopian Music :ማርቆስና ጆን (ኔኤሮ ታኤሮ)- New Ethiopian Music 2019(Official Video) by Minew Shewa Tube 3 years ago 4 minutes, 45 seconds 5,814 views",Minew Shewa Entertainment,5814,5816,2
1840,"Merkeb Baryagaber (Bonitua) መርከብ ባርያጋብር (ቦኒቷ) | (ከይትጠልማ) - New Ethiopian Music 2019(Official Video) by Minew Shewa Tube 3 years ago 5 minutes, 59 seconds 2,504,162 views",Minew Shewa Entertainment,2504162,2509274,5112
1841,"Ethiopian Music : Tade Philo(Eyareru) ታዴ ፊሎ (እያረሩ) - New Ethiopian Music 2019(Official Video) by Minew Shewa Tube 3 years ago 5 minutes, 58 seconds 35,436 views",Minew Shewa Entertainment,35436,35482,46
1842,"Ethiopian Music : Bekan Melka (Biyyi Abbaan Malee) - New Ethiopian Oromo Music 2019(Official Video) by Minew Shewa Tube 3 years ago 6 minutes, 48 seconds 11,587 views",Minew Shewa Entertainment,11587,11588,1
1843,"Ethiopian Music : Fremichael Belete ፍሬሚካኤል በለጠ (አሽሪኝ) - New Ethiopian Music 2018(Official Video) by Minew Shewa Tube 3 years ago 6 minutes, 42 seconds 55,388 views",Minew Shewa Entertainment,55388,55401,13
1844,"Ethiopian Music : Fraol Debere (Ababole) - New Ethiopian Oromo Music 2019(Official Video) by Minew Shewa Tube 3 years ago 4 minutes, 33 seconds 29,474 views",Minew Shewa Entertainment,29474,29494,20
1845,"Ethiopian Music : ሳዳም ነጌሶ (ሕሊና) ጌድዮን ፍቃዱና ፍራያት - New Ethiopian Music 2019(Official Video) by Minew Shewa Tube 3 years ago 4 minutes, 38 seconds 15,581 views",Minew Shewa Entertainment,15581,15584,3
1846,"Ethiopian Music : Lina Mon (Hagere) ሊና ሞን (ሃገሬ) - New Ethiopian Music 2018(Official Video) by Minew Shewa Tube 3 years ago 4 minutes, 27 seconds 6,374 views",Minew Shewa Entertainment,6374,6375,1
1847,"Ethiopian Music : Atinaaboon Ajjamaa (Sirna Gadaa) New Ethiopian Oromo Music 2018(Official Video) by Minew Shewa Tube 3 years ago 7 minutes, 16 seconds 11,239 views",Minew Shewa Entertainment,11239,11246,7
1848,"Ethiopian Music : Keenbooni Baratta (Gadaan Bulla)- New Ethiopian Oromo Music 2018(Official Video) by Minew Shewa Tube 3 years ago 7 minutes, 25 seconds 13,456 views",Minew Shewa Entertainment,13456,13468,12
1849,"Ethiopian Music : Yohannes Feleke  ""Abichu"" New Ethiopian Music 2019(Official Video) by Minew Shewa Tube 3 years ago 5 minutes, 3 seconds 30,133 views",Minew Shewa Entertainment,30133,30186,53
1850,"Ethiopian Music : Birhanu Taye (Zemenay) ብርሃኑ ታዬ (ዘመናይ)- New Ethiopian Music 2019(Official Video) by Minew Shewa Tube 3 years ago 5 minutes, 19 seconds 495,669 views",Minew Shewa Entertainment,495669,496430,761
1851,"Tewabech Abebe (Yetizita Nefas) ተዋበች አበበ (የትዝታ ነፋስ) - New Ethiopian Music 2018(Official Video) by Minew Shewa Tube 3 years ago 4 minutes, 55 seconds 10,897 views",Minew Shewa Entertainment,10897,10917,20
1852,"Ethiopian Music : Xahishuu Ahmad (Bareddu Kamettii)- New Ethiopian Oromo Music 2018(Official Video) by Minew Shewa Tube 3 years ago 5 minutes, 6 seconds 8,054 views",Minew Shewa Entertainment,8054,8061,7
1853,"Oromo Music : Nafroobika Tottobaa (Qabi Shimaalan) - New Ethiopian Oromo Music 2018(Official Video) by Minew Shewa Tube 3 years ago 6 minutes, 26 seconds 7,718 views",Minew Shewa Entertainment,7718,7728,10
1854,"Ethiopian Music : Fasil Demoz (Aresut 2) ፋሲል ደሞዝ (አረሱት 2) - New Ethiopian Music 2018(Official Video) by Minew Shewa Tube 3 years ago 7 minutes, 13 seconds 24,659 views",Minew Shewa Entertainment,24659,24671,12
1855,"Mulatu Bogale (etebikishalehu) ሙላቱ ቦጋለ (እጠብቅሻለው)- New Ethiopian Music 2018(Official Video) by Minew Shewa Tube 3 years ago 5 minutes, 17 seconds 4,156 views",Minew Shewa Entertainment,4156,4160,4
1856,"Oromo Music : Megersa Negesa (Gaddate Nu Waame) - New Ethiopian Oromo Music 2018(Official Video) by Minew Shewa Tube 3 years ago 6 minutes, 33 seconds 27,105 views",Minew Shewa Entertainment,27105,27124,19
1857,"Ethiopian Music :Temesgen Tirngo ተመስገን ትርንጎ (ሮዝ ባለጊዜ) - New Ethiopian Music 2018(Official Video) by Minew Shewa Tube 3 years ago 3 minutes, 43 seconds 11,178 views",Minew Shewa Entertainment,11178,11179,1
1858,"Ethiopian Music :Habtamu Batte (Qeerroo) - New Ethiopian Oromo Music 2018(Official Video) by Minew Shewa Tube 3 years ago 6 minutes, 42 seconds 339,518 views",Minew Shewa Entertainment,339518,340073,555
1859,"Ethiopian Music : Alelegn Lemma አለልኝ ለማ (ኢትዮጵያዬ) - New Ethiopian Music 2018(Official Video) by Minew Shewa Tube 3 years ago 5 minutes, 9 seconds 8,015 views",Minew Shewa Entertainment,8015,8017,2
1860,"Ethiopian Music : Abbabaa Daadhii (Intaloo) - New Ethiopian Oromo Music 2018(Official Video) by Minew Shewa Tube 3 years ago 4 minutes, 29 seconds 3,865 views",Minew Shewa Entertainment,3865,3874,9
1861,"Ethiopian Music: Bethelhem Belete(Salayeh) ቤተልሄም በለጠ (ሳላይህ) New Ethiopian Music 2018(Official Video) by Minew Shewa Tube 3 years ago 5 minutes, 1 second 15,647 views",Minew Shewa Entertainment,15647,15664,17
1862,"Oromo Music : Abbabu Qanani (Ya Barreda) - New Ethiopian Oromo Music 2018(Official Video) by Minew Shewa Tube 3 years ago 6 minutes, 41 seconds 45,723 views",Minew Shewa Entertainment,45723,45757,34
1863,"Ethiopian Music: Gelaneh Abebe(Babawelish) ገላነህ አበበ (ባባሁልሽ) New Ethiopian Music 2018(Official Video) by Minew Shewa Tube 3 years ago 5 minutes, 30 seconds 52,780 views",Minew Shewa Entertainment,52780,52926,146
1864,"Ethiopian Music : Degefa Dabi (Ni Mariyana) - New Ethiopian Oromo Music 2018(Official Video) by Minew Shewa Tube 3 years ago 7 minutes, 22 seconds 28,561 views",Minew Shewa Entertainment,28561,28594,33
1865,"Ethiopian Music : Kefyalew Fenta ከፍያለው ፈንታ (ልቤ በሮ) - New Ethiopian Music 2018(Official Video) by Minew Shewa Tube 3 years ago 6 minutes, 57 seconds 132,938 views",Minew Shewa Entertainment,132938,133000,62
1866,"Ethiopian Music : Dess (Ney) ደስ (ነይ) - New Ethiopian Music 2018(Official Video) by Minew Shewa Tube 3 years ago 3 minutes, 20 seconds 4,383 views",Minew Shewa Entertainment,4383,4384,1
1867,"Ethiopian Music : Abraham Kebede አብርሃም ከበደ (እምር በይልኝ)  - New Ethiopian Music 2018(Official Video) by Minew Shewa Tube 3 years ago 5 minutes, 11 seconds 8,183 views",Minew Shewa Entertainment,8183,8189,6
1868,"Kg Man X Eyobed | Jordan | Bek Geez (Wedet Keresh) - New Ethiopian Music 2018(Official Video) by Minew Shewa Tube 3 years ago 4 minutes, 43 seconds 11,521 views",Minew Shewa Entertainment,11521,11551,30
1869,"Ethiopian Music : Fasil Demoz (Aresut) ፋሲል ደሞዝ (አረሱት) - New Ethiopian Music 2018(Official Video) by Minew Shewa Tube 3 years ago 11 minutes, 11 seconds 62,151 views",Minew Shewa Entertainment,62151,62269,118
1870,"Ethiopian Music : Webit Mersha (Nafekegn) ውቢት መርሻ (ናፈቅከኝ) - New Ethiopian Music 2018(Official Video) by Minew Shewa Tube 3 years ago 5 minutes, 47 seconds 27,827 views",Minew Shewa Entertainment,27827,27848,21
1871,"Ethiopian Music : አጥናፉ አባተ (ዳውሮ ነው ዳንግራሳው) - New Ethiopian Music 2018(Official Video) by Minew Shewa Tube 3 years ago 5 minutes, 48 seconds 3,950 views",Minew Shewa Entertainment,3950,3957,7
1872,"Ethiopian Music : Abraham Girma (Mareye) አብርሃም ግርማ (ማርዬ) - New Ethiopian Music 2018(Official Video) by Minew Shewa Tube 3 years ago 4 minutes, 41 seconds 7,479 views",Minew Shewa Entertainment,7479,7483,4
1873,"Ethiopian Music : Kennedy Tsegaye ኬነዲ ፀጋዬ (እንቢ ነው የጎዳኝ) - New Ethiopian Music 2018(Official Video) by Minew Shewa Tube 3 years ago 4 minutes, 57 seconds 3,980 views",Minew Shewa Entertainment,3980,3986,6
1874,"Oromo Music : Jamil Abduu (Dubbiin Haa Bilchaatu) - New Ethiopian Oromo Music 2018(Official Video) by Minew Shewa Tube 3 years ago 5 minutes, 10 seconds 18,231 views",Minew Shewa Entertainment,18231,18241,10
1875,"Ethiopian Music : Yeshiber Honelegn የሽበር ሆነልኝ (የዋግምራ ቆንጆ) - New Ethiopian Music 2018(Official Video) by Minew Shewa Tube 3 years ago 7 minutes, 9 seconds 143,969 views",Minew Shewa Entertainment,143969,144062,93
1876,"Ethiopian Music : Bilisummaa Baqqalaa (Foollee)- New Ethiopian Oromo Music 2018(Official Video) by Minew Shewa Tube 3 years ago 7 minutes, 35 seconds 41,212 views",Minew Shewa Entertainment,41212,41386,174
1877,"Ethiopian Music : Nugusuu Gammachuu (Ya bulee ko) - New Ethiopian Oromo Music 2018(Official Video) by Minew Shewa Tube 3 years ago 5 minutes, 50 seconds 4,209 views",Minew Shewa Entertainment,4209,4216,7
1878,"Ethiopian Music : Temesgen Belay (Arada) ተመስገን በላይ (አራዳ) - New Ethiopian Music 2018(Official Video) by Minew Shewa Tube 3 years ago 5 minutes, 6 seconds 4,688 views",Minew Shewa Entertainment,4688,4696,8
1879,"New Oromo Music : Sabkeebar Damee (Jabeeffadhu Mudhii) - New Ethiopian Music 2018(Official Video) by Minew Shewa Tube 3 years ago 7 minutes, 52 seconds 78,237 views",Minew Shewa Entertainment,78237,78349,112
1880,"Oromo Music :Muktar Adeero & Malika Mohamed (Lilse) - New Ethiopian Music 2018(Official Video) by Minew Shewa Tube 3 years ago 9 minutes, 2 seconds 172,152 views",Minew Shewa Entertainment,172152,172748,596
1881,"Oromo Music : Hirphaa Bareedaa (Lalisuu Barbaannaan) - New Ethiopian Music 2018(Official Video) by Minew Shewa Tube 3 years ago 4 minutes, 57 seconds 110,891 views",Minew Shewa Entertainment,110891,110996,105
1882,"Ethiopian Music : Mekuanent Assefa መኳንንት አሰፋ (ሃበሻ ናት)- New Ethiopian Music 2018(Official Video) by Minew Shewa Tube 3 years ago 6 minutes, 36 seconds 3,787 views",Minew Shewa Entertainment,3787,3791,4
1883,"Ethiopian Music: Feleke Maru (Aye Merkato) ፈለቀ ማሩ (አይ መርካቶ) New Ethiopian Music 2018(Official Video) by Minew Shewa Tube 3 years ago 5 minutes, 32 seconds 20,960 views",Minew Shewa Entertainment,20960,20996,36
1884,"Ethiopian Music : Naafroobika Tottooba (Goonnii Saafaa Lola) - New Oromo Music 2018(Official Video) by Minew Shewa Tube 3 years ago 5 minutes, 38 seconds 3,570 views",Minew Shewa Entertainment,3570,3581,11
1885,"Oromo Music : Ijaaraa Ligaabaa (geerarsa) - New Ethiopian Oromo Music 2018(Official Video) by Minew Shewa Tube 3 years ago 5 minutes, 56 seconds 11,951 views",Minew Shewa Entertainment,11951,12024,73
1886,"Tigist G/Meskel (Yaalamacakoo) ትግስት ገ/መስቀል (ያለመቸኮ) - New Ethiopian Music 2018(Official Video) by Minew Shewa Tube 3 years ago 4 minutes, 36 seconds 7,215 views",Minew Shewa Entertainment,7215,7223,8
1887,"Oromo Music: Caalaa Asaffaa (Naaf Yaadda haadhatoo) New Ethiopian Oromo Music 2018(Official Video) by Minew Shewa Tube 3 years ago 4 minutes, 20 seconds 10,745 views",Minew Shewa Entertainment,10745,10765,20
1888,"Ethiopian Music : Marta Mulugeta (Hareg) ማርታ ሙሉጌታ (ሐረግ)- New Ethiopian Music 2018(Official Video) by Minew Shewa Tube 3 years ago 5 minutes, 14 seconds 512,095 views",Minew Shewa Entertainment,512095,512191,96
1889,"Ethiopian Music : ሳምኬት (መላው መላ ነው) - New Ethiopian Music 2018(Official Video) by Minew Shewa Tube 3 years ago 5 minutes, 58 seconds 4,818 views",Minew Shewa Entertainment,4818,4820,2
1890,"Oromo Music : Abbabaa Daadhii (Oromiyaa) - New Ethiopian Oromo Music 2018(Official Video) by Minew Shewa Tube 3 years ago 6 minutes, 12 seconds 6,008 views",Minew Shewa Entertainment,6008,6024,16
1891,"Ethiopian Music :Ameleset G/Meskel (Zem) አምለሰት ገ/መስቀል (ዝም) New Ethiopian Music 2018(Official Video) by Minew Shewa Tube 3 years ago 5 minutes, 17 seconds 3,213 views",Minew Shewa Entertainment,3213,3214,1
1892,"Ethiopian Music: Kalkidan Aweke ቃልኪዳን አወቀ (አንድ ዓለም አንድ ዘር) New Ethiopian Music 2018(Official Video) by Minew Shewa Tube 3 years ago 6 minutes, 47 seconds 6,334 views",Minew Shewa Entertainment,6334,6361,27
1893,"Ethiopian Music : Sintalfwal Bereded ስንትአልፏል በረደድ (ልኮብኛል)- New Ethiopian Music 2018(Official Video) by Minew Shewa Tube 3 years ago 6 minutes, 32 seconds 52,329 views",Minew Shewa Entertainment,52329,52352,23
1894,"Ethiopian Music : Falmataa Mohammed (Oo Jaalala)- New Ethiopian Oromo Music 2018(Official Video) by Minew Shewa Tube 3 years ago 6 minutes, 18 seconds 11,269 views",Minew Shewa Entertainment,11269,11350,81
1895,"Ethiopian Music : Tigist Alemayehu ትግስት አለማየሁ (አልዳኝም) - New Ethiopian Music 2018(Official Video) by Minew Shewa Tube 3 years ago 5 minutes, 33 seconds 7,407 views",Minew Shewa Entertainment,7407,7413,6
1896,"Ethiopian Music : Degefa Dabi (Ciro)- New Ethiopian Oromo Music 2018(Official Video) by Minew Shewa Tube 3 years ago 6 minutes, 22 seconds 191,323 views",Minew Shewa Entertainment,191323,191559,236
1897,"Oromo Music : Addisuu (Arada Jalele) - New Ethiopian Oromo Music 2018(Official Video) by Minew Shewa Tube 3 years ago 3 minutes, 52 seconds 26,627 views",Minew Shewa Entertainment,26627,26632,5
1898,"Samuel G/Mariam (Yelijenete) ሳሙኤል ገ/ማርያም (የልጅነቴ) - New Ethiopian Music 2018(Official Video) by Minew Shewa Tube 3 years ago 4 minutes, 37 seconds 7,043 views",Minew Shewa Entertainment,7043,7047,4
1899,"Ethiopian Music : ወንድማገኝ ደገፉ (ካንቺ ጋር) - New Ethiopian Music 2018(Official Video) by Minew Shewa Tube 3 years ago 4 minutes, 8 seconds 12,041 views",Minew Shewa Entertainment,12041,12050,9
1900,"Ethiopian Music : Fikadu Girma ፍቃዱ ግርማ (አራዳ እንዲህ ነው) - New Ethiopian Music 2018(Official Video) by Minew Shewa Tube 3 years ago 7 minutes, 40 seconds 1,070,272 views",Minew Shewa Entertainment,1070272,1072289,2017
1901,"Ethiopian Music : Shushay Adane ሹሻይ አዳነ (ኢትዮጵያ ሃገሬ) - New Ethiopian Music 2018(Official Video) by Minew Shewa Tube 3 years ago 6 minutes, 1 second 3,416 views",Minew Shewa Entertainment,3416,3417,1
1902,"Ethiopian Music: Asher Habesha (Tarike Mish) ft Ujulu Fera New Ethiopian Music 2018(Official Video) by Minew Shewa Tube 3 years ago 5 minutes, 48 seconds 8,073 views",Minew Shewa Entertainment,8073,8086,13
1903,"Oromo Music : Abini Ko (Beredu Oromo) - New Oromo Music 2018(Official Video) by Minew Shewa Tube 3 years ago 5 minutes, 22 seconds 10,333 views",Minew Shewa Entertainment,10333,10335,2
1904,"Oromo Music : Bulii Biraanuu (Geerarsa) - New Oromo Music 2018(Official Video) by Minew Shewa Tube 3 years ago 7 minutes, 12 seconds 8,945 views",Minew Shewa Entertainment,8945,9011,66
1905,"Ethiopian Music :Molash Bayu (Yene Neh) ሞላሽ ባዩ (የኔ ነህ)- New Ethiopian Music 2018(Official Video) by Minew Shewa Tube 3 years ago 8 minutes, 15 seconds 279,863 views",Minew Shewa Entertainment,279863,280351,488
1906,"Ethiopian Music : Naafroobika Tottooba (Amboo irra dihaaphee) - New Oromo Music 2018(Official Video) by Minew Shewa Tube 3 years ago 5 minutes, 35 seconds 12,135 views",Minew Shewa Entertainment,12135,12137,2
1907,"Ethiopian Music : Afro Mic (Washechign) አፍሮ ማይክ (ዋሸችኝ) - New Ethiopian Music 2018(Official Video) by Minew Shewa Tube 3 years ago 4 minutes, 8 seconds 10,050 views",Minew Shewa Entertainment,10050,10051,1
1908,"Oromo Music : Urgeessaa Isheetuu (Obsii) - New Ethiopian Oromo Music 2018(Official Video) by Minew Shewa Tube 3 years ago 6 minutes, 58 seconds 9,576 views",Minew Shewa Entertainment,9576,9616,40
1909,"Ethiopian Music : Sifen Beyene (Temeker) ሲፈን በየነ (ተመከር)- New Ethiopian Music 2018(Official Video) by Minew Shewa Tube 3 years ago 4 minutes, 38 seconds 12,559 views",Minew Shewa Entertainment,12559,12585,26
1910,"Ethiopian Music : Chombe (አፄ ፍቅር) አላማርርም - New Ethiopian Music 2018(Official Video) by Minew Shewa Tube 3 years ago 5 minutes, 57 seconds 53,394 views",Minew Shewa Entertainment,53394,53404,10
1911,"Ethiopian Music : Adino Ayenew አድኖ አየነው (ጨመረብኝ ፍቅርሽ)  - New Ethiopian Music 2018(Official Video) by Minew Shewa Tube 3 years ago 4 minutes, 50 seconds 74,391 views",Minew Shewa Entertainment,74391,74410,19
1912,"Oromo Music : Abbabuu Qananii (Oromiyaa) - New Ethiopian Oromo Music 2018(Official Video) by Minew Shewa Tube 3 years ago 6 minutes, 29 seconds 16,785 views",Minew Shewa Entertainment,16785,16804,19
1913,"Biruk Samuel (Nuri Ethiopiaye) ብሩክ ሳሙኤል (ኑሪ ኢትዮጵያዬ) - New Ethiopian Music 2018(Official Video) by Minew Shewa Tube 3 years ago 5 minutes, 1 second 7,153 views",Minew Shewa Entertainment,7153,7156,3
1914,"Oromo Music : Alamuu Ajabii (Irreechaa) - New Ethiopian Music 2018 (Official Video) by Minew Shewa Tube 3 years ago 5 minutes, 12 seconds 17,752 views",Minew Shewa Entertainment,17752,17766,14
1915,"Ethiopian Music :Meaza Befekadu መዓዛ በፍቃዱ (በውበትህ ማርከህ)  - New Ethiopian Music 2018(Official Video) by Minew Shewa Tube 3 years ago 5 minutes, 49 seconds 9,546 views",Minew Shewa Entertainment,9546,9547,1
1916,"Oromo Music :Bulaa Nadhii (Kichuu) - New Ethiopian Oromo Music 2018(Official Video) by Minew Shewa Tube 3 years ago 7 minutes, 14 seconds 12,905 views",Minew Shewa Entertainment,12905,12927,22
1917,"Oromo Music :Feysi Galaan (Hiphop Oromifa) ft Hawwi H.Qanani - New Oromo Music 2018(Official Video) by Minew Shewa Tube 3 years ago 5 minutes, 6 seconds 74,826 views",Minew Shewa Entertainment,74826,75365,539
1918,"Ethiopian Music : Ali Wendimu (Sisite) አሊ ወንድሙ (ስስቴ) - New Ethiopian Music 2018(Official Video) by Minew Shewa Tube 3 years ago 4 minutes, 49 seconds 17,141 views",Minew Shewa Entertainment,17141,17150,9
1919,"New Oromo Music : Fayo Moti (Mooti-2) - New Ethiopian Oromo Music 2018(Official Video) by Minew Shewa Tube 3 years ago 6 minutes, 19 seconds 47,246 views",Minew Shewa Entertainment,47246,47393,147
1920,"Temesgen Alemayehu (Asaminat) ft Bubu Elias - New Ethiopian Music 2018(Official Video) by Minew Shewa Tube 3 years ago 3 minutes, 57 seconds 9,532 views",Minew Shewa Entertainment,9532,9538,6
1921,"Ethiopian Music : Betty G (Gereye) ቤቲ ጂ (ገርዬ) - New Ethiopian Music 2018(Official Video) by Minew Shewa Tube 3 years ago 4 minutes, 52 seconds 2,322,930 views",Minew Shewa Entertainment,2322930,2325261,2331
1922,"Oromo Musuc : Fayyisaa Baqqalaa (Lafattu Nuuf ife) - New Ethiopian Oromo Music 2018(Official Video) by Minew Shewa Tube 3 years ago 6 minutes, 53 seconds 9,880 views",Minew Shewa Entertainment,9880,9894,14
1923,"New Oromo Music : Jamiil Abdu (Hakagara) - New Ethiopian Oromo Music 2018(Official Video) by Minew Shewa Tube 3 years ago 5 minutes 24,114 views",Minew Shewa Entertainment,24114,24124,10
1924,"Ethiopian Music : Fetilework Tesfaye ፈትለወርቅ ተስፋዬ (ኑ አዬ) - New Ethiopian Music 2018(Official Video) by Minew Shewa Tube 3 years ago 5 minutes, 18 seconds 12,916 views",Minew Shewa Entertainment,12916,12920,4
1925,"Ethiopian Music : Adiss Moges  አዲስ ሞገስ (ድፈር ድፈር) - New Ethiopian Music 2018(Official Video) by Minew Shewa Tube 3 years ago 4 minutes, 43 seconds 8,315 views",Minew Shewa Entertainment,8315,8324,9
1926,"New Oromo Music : Ikraam Mahammad (Barri Kun waa tolee) - New Ethiopian Music 2018(Official Video) by Minew Shewa Tube 3 years ago 5 minutes, 9 seconds 87,311 views",Minew Shewa Entertainment,87311,87324,13
1927,"Ethiopian Music: Yohannes Kidane(Ethiopia) ዮሃንስ ኪዳኔ (ኢትዮጵያ) New Ethiopian Music 2018(Official Video) by Minew Shewa Tube 3 years ago 6 minutes, 7 seconds 6,660 views",Minew Shewa Entertainment,6660,6662,2
1928,"Ethiopian Music : ዳግም መኮንን (ሰላም) ft ኤልያስ ፈጠነ  - New Ethiopian Music 2018(Official Video) by Minew Shewa Tube 3 years ago 4 minutes, 1 second 10,307 views",Minew Shewa Entertainment,10307,10310,3
1929,"Ethiopian Music : Birtukan Mesfin ብርቱካን መስፍን (እኔስ ለሀገሬ) - New Ethiopian Music 2018(Official Video) by Minew Shewa Tube 3 years ago 5 minutes, 38 seconds 103,910 views",Minew Shewa Entertainment,103910,103958,48
1930,"New Oromo Music : Geda Hamda (Nu Tokko) - New Ethiopian Oromo Music 2018(Official Video) by Minew Shewa Tube 3 years ago 5 minutes, 46 seconds 19,389 views",Minew Shewa Entertainment,19389,19405,16
1931,"Ethiopian Music : Habetamu Tedla (Sew Mehon)ሃብታሙ ተድላ(ሰው መሆን)New Ethiopian Music 2018(Official Video) by Minew Shewa Tube 3 years ago 5 minutes, 58 seconds 53,200 views",Minew Shewa Entertainment,53200,53204,4
1932,"Ethiopian Music : Mustepha Idris(Feri) ሙስጠፋ እድሪስ (ፈሪ) - New Ethiopian Music 2018(Official Video) by Minew Shewa Tube 3 years ago 5 minutes, 9 seconds 8,734 views",Minew Shewa Entertainment,8734,8735,1
1933,"New Oromo Music : Nugusuu Gammachuu (Been Dhaqnee) - New Ethiopian Music 2018 (Official Video) by Minew Shewa Tube 3 years ago 5 minutes, 16 seconds 10,899 views",Minew Shewa Entertainment,10899,10905,6
1934,"Ethiopian Music : Tigist Abebaw  ትግስት አበባው (የኔ ጉብል) - New Ethiopian Music 2018(Official Video) by Minew Shewa Tube 3 years ago 5 minutes, 14 seconds 184,978 views",Minew Shewa Entertainment,184978,185051,73
1935,"Oromo Music : Zarihuun Wodaajo (Si Jibbe) - New Ethiopian Oromo Music 2018 (Official Music Video) by Minew Shewa Tube 3 years ago 8 minutes, 34 seconds 37,941 views",Minew Shewa Entertainment,37941,38298,357
1936,"Ethiopian Music : Kal (Liyu Habeshaye) ft Abu & Es. Esho - New Ethiopian Music 2018(Official Video) by Minew Shewa Tube 3 years ago 4 minutes, 50 seconds 8,527 views",Minew Shewa Entertainment,8527,8530,3
1937,"Ethiopian Music : Tewodros Bazie ቴዎድሮስ ባዜ (እናትዬ ጎንደር) - New Ethiopian Music 2018(Official Video) by Minew Shewa Tube 3 years ago 6 minutes, 5 seconds 12,805 views",Minew Shewa Entertainment,12805,12809,4
1938,"New Oromo Music : Katamaa Dhaabaa (Follee) - New Ethiopian Music 2018(Official Video) by Minew Shewa Tube 3 years ago 5 minutes, 37 seconds 11,099 views",Minew Shewa Entertainment,11099,11112,13
1939,"Sewi (Tegodahugn) ft AB-BETA ሰዊ (ተጎዳሁኝ) ft ኤቢ-ቤታ - New Ethiopian Music 2018(Official Video) by Minew Shewa Tube 3 years ago 4 minutes, 17 seconds 9,149 views",Minew Shewa Entertainment,9149,9158,9
1940,"Oromo Music : Mulugeetaa Diroo (Hin Cabsin Waadaa) - New Ethiopian Oromo Music 2018(Official Video) by Minew Shewa Tube 3 years ago 5 minutes, 20 seconds 11,486 views",Minew Shewa Entertainment,11486,11491,5
1941,"Maranata Asres Gebre (Kashew) ማራናታ አስረስ ገብሬ (ካሽው)- New Ethiopian Music 2018(Official Video) by Minew Shewa Tube 3 years ago 6 minutes, 4 seconds 44,306 views",Minew Shewa Entertainment,44306,44671,365
1942,"Sami Acts (Acts Interlude) Ft Like An Olive Tree - New Ethiopian Music 2018(Official Video) by Minew Shewa Tube 3 years ago 1 minute, 53 seconds 3,015 views",Minew Shewa Entertainment,3015,3017,2
1943,"Ethiopian Music : Habtamu Chaklie ሃብታሙ ጫቅሌ (በወጣትነቴ) - New Ethiopian Music 2018(Official Video) by Minew Shewa Tube 3 years ago 5 minutes, 42 seconds 13,400 views",Minew Shewa Entertainment,13400,13403,3
1944,"Oromo Music : Awal Abdurroo (Wareega Jaalalaa) - New Ethiopian Oromo Music 2018(Official Video) by Minew Shewa Tube 3 years ago 6 minutes, 19 seconds 116,948 views",Minew Shewa Entertainment,116948,117012,64
1945,"Ethiopian Music : Fikadu Alemu ፍቃዱ አለሙ (አታውቂውም ወይ) - New Ethiopian Music 2018(Official Video) by Minew Shewa Tube 3 years ago 4 minutes, 15 seconds 12,702 views",Minew Shewa Entertainment,12702,12704,2
1946,"Ethiopian Music : Yitagesu Wondwosen ይታገሱ ወንድወሰን (ምሳሌ ነሽ)- New Ethiopian Music 2018(Official Video) by Minew Shewa Tube 3 years ago 6 minutes, 10 seconds 13,797 views",Minew Shewa Entertainment,13797,13800,3
1947,"Ethiopian Music : Keven Abraham ኬቨን አብርሃም (ይቅርብኝ) - New Ethiopian Music 2018(Official Video) by Minew Shewa Tube 3 years ago 4 minutes, 28 seconds 16,478 views",Minew Shewa Entertainment,16478,16485,7
1948,"Oromo Music : Halima Abdela (Melanu) New Ethiopian Music 2018(Official Video) by Minew Shewa Tube 3 years ago 4 minutes, 55 seconds 708,052 views",Minew Shewa Entertainment,708052,709167,1115
1949,"Ethiopian Music : ጂ Bella (ነግሣ) - New Ethiopian Music 2018(Official Video) by Minew Shewa Tube 3 years ago 4 minutes, 12 seconds 4,636 views",Minew Shewa Entertainment,4636,4637,1
1950,"Oromo Music : Baroo Didhaa (NUUF NUMA!) - New Ethiopian Music 2018(Official Video) by Minew Shewa Tube 3 years ago 7 minutes, 13 seconds 11,094 views",Minew Shewa Entertainment,11094,11111,17
1951,"Ethiopian Music : Yemsrach Mekurya  የምስራች መኩሪያ (ትኩስ ትኩሱን)- New Ethiopian Music 2018(Official Video) by Minew Shewa Tube 3 years ago 4 minutes, 47 seconds 4,122 views",Minew Shewa Entertainment,4122,4122,0
1952,"Oromo Music : Waltaanaa Diroo (Burqaa Areeree) - New Ethiopian Oromo Music 2018(Official Video) by Minew Shewa Tube 3 years ago 7 minutes, 41 seconds 15,487 views",Minew Shewa Entertainment,15487,15493,6
1953,"Ethiopian music : Andarg Negash (Nesh Addis Alem) አንዳርግ ነጋሽ (ነሽ አዲስ ዓለም) - New Ethiopian Music 2018 by Minew Shewa Tube 3 years ago 5 minutes, 9 seconds 18,706 views",Minew Shewa Entertainment,18706,18708,2
1954,"Ethiopian Music : Abi Mekasha (Temeles) አቢ መካሻ (ተመለስ) - New Ethiopian Music 2018(Official Video) by Minew Shewa Tube 3 years ago 4 minutes, 47 seconds 35,102 views",Minew Shewa Entertainment,35102,35231,129
1955,"Ethiopian Music : Seyfu Dekeba (Sirbedbada) - New Ethiopian Oromo Music 2018(Official Video) by Minew Shewa Tube 3 years ago 4 minutes, 46 seconds 6,722 views",Minew Shewa Entertainment,6722,6729,7
1956,"Oromo Music : Naol Lema (Adda Dha) - New Ethiopian Oromo Music 2018(Official Video) by Minew Shewa Tube 3 years ago 5 minutes, 53 seconds 64,893 views",Minew Shewa Entertainment,64893,64928,35
1957,"Ethiopian Music : Young Nebo (Free Q) - New Ethiopian Music 2018(Official Video) by Minew Shewa Tube 3 years ago 3 minutes, 12 seconds 8,722 views",Minew Shewa Entertainment,8722,8743,21
1958,"Ethiopian Music : Tamrat Derib ታምራት ደርብ (ኧረ ቁሚ) - New Ethiopian Music 2018(Official Video) by Minew Shewa Tube 3 years ago 4 minutes, 9 seconds 12,106 views",Minew Shewa Entertainment,12106,12111,5
1959,"Ethiopian Music: Biruk Samuel (Tizitash) ብሩክ ሳሙኤል (ትዝታሽ) - New Ethiopian Music 2018(Official Video) by Minew Shewa Tube 3 years ago 5 minutes, 30 seconds 18,148 views",Minew Shewa Entertainment,18148,18179,31
1960,"Ethiopian Music : Jah Yeab (Deme malo) - New Ethiopian Music 2018(Official Video) by Minew Shewa Tube 3 years ago 4 minutes, 7 seconds 6,245 views",Minew Shewa Entertainment,6245,6252,7
1961,"Ethiopian Music: Ayanaw Terualem (Simech) አያናው ጥሩዓለም (ሲመች)- New Ethiopian Music 2018(Official Video) by Minew Shewa Tube 3 years ago 6 minutes, 57 seconds 21,427 views",Minew Shewa Entertainment,21427,21451,24
1962,"Ethiopian Music : Yabu Jc (Yinegal) Ft Ahadu - New Ethiopian Music 2018(Official Video) by Minew Shewa Tube 3 years ago 3 minutes, 8 seconds 2,589 views",Minew Shewa Entertainment,2589,2591,2
1963,"Ethiopian Music : Yabu Jc (Lemen Lezen) - New Ethiopian Music 2018(Official Video) by Minew Shewa Tube 3 years ago 4 minutes, 8 seconds 2,595 views",Minew Shewa Entertainment,2595,2595,0
1964,"Ethiopian Music : Yabu Jc (Marewa) Ft Syco David - New Ethiopian Music 2018(Official Video) by Minew Shewa Tube 3 years ago 3 minutes, 41 seconds 1,999 views",Minew Shewa Entertainment,1999,2001,2
1965,"Ethiopian Music :Yohannes Girma (Jony) Endet Lehun ዮሐንስ ግርማ (ጆኒ) እንዴት ልሁን - New Ethiopian Music 2018 by Minew Shewa Tube 3 years ago 5 minutes, 55 seconds 515,675 views",Minew Shewa Entertainment,515675,517573,1898
1966,"Ethiopian Music : Yohanes Gezahegn ዮሀንስ ገዛህኝ (Bandirachen ባንዲራችን) New Ethiopian Music 2018. by Minew Shewa Tube 3 years ago 4 minutes, 41 seconds 8,779 views",Minew Shewa Entertainment,8779,8782,3
1967,"Ethiopian Music : Zedash Emey ዜዳሽ እሜይ (ዛሬ ናት ቀናችን) - New Ethiopian Music 2018(Official Video) by Minew Shewa Tube 3 years ago 4 minutes, 41 seconds 5,939 views",Minew Shewa Entertainment,5939,5943,4
1968,"Ethiopian Music : Habtamu Tebeje ሀብታሙ ተበጀ (ሲላ ምን ይባላል)- New Ethiopian Music 2018(Official Video) by Minew Shewa Tube 3 years ago 5 minutes, 48 seconds 25,658 views",Minew Shewa Entertainment,25658,25697,39
1969,"Ethiopian Music : Tesfalidet T/Markos (አንድ ነን) - New Ethiopian Music 2018(Official Video) by Minew Shewa Tube 3 years ago 7 minutes, 21 seconds 249,887 views",Minew Shewa Entertainment,249887,249958,71
1970,"Ethiopian music : Girum Tameru (Kiya) Elalale - New Ethiopian Oromo Music 2018(Official Video) by Minew Shewa Tube 3 years ago 4 minutes, 19 seconds 5,497 views",Minew Shewa Entertainment,5497,5514,17
1971,"Oromo Music : Bini Gadda (Sabboontuu)- New Ethiopian Oromo Music 2018(Official Video) by Minew Shewa Tube 3 years ago 6 minutes, 2 seconds 3,436 views",Minew Shewa Entertainment,3436,3437,1
1972,"Oromo Music : Girmaa Imaanaa (Oromoon Qeerransa) - New Ethiopian Oromo Music 2018(Official Video) by Minew Shewa Tube 3 years ago 5 minutes, 53 seconds 6,865 views",Minew Shewa Entertainment,6865,6868,3
1973,"Ethiopian Music : Shumet Andarge ሹመት አንዳርጌ (ወሎዬ ናት) - New Ethiopian Music 2018(Official Video) by Minew Shewa Tube 3 years ago 5 minutes, 17 seconds 20,432 views",Minew Shewa Entertainment,20432,20452,20
1974,"Ethiopian Music : Sami Acts (Purpose) Ft Ruth Samson - New Ethiopian Music 2018(Official Video) by Minew Shewa Tube 3 years ago 4 minutes, 14 seconds 3,385 views",Minew Shewa Entertainment,3385,3385,0
1975,"Ethiopian Music : Abeselom Behonegn አቤሴሎም ቢሆነኝ (ኢትዮጵያ) - New Ethiopian Music 2018(Official Video) by Minew Shewa Tube 3 years ago 6 minutes, 39 seconds 34,813 views",Minew Shewa Entertainment,34813,34822,9
1976,"Oromo Music : Boorrii Daammotaa (Gadaan bulla) - New Ethiopian Oromo Music 2018(Official Video) by Minew Shewa Tube 3 years ago 6 minutes, 27 seconds 6,505 views",Minew Shewa Entertainment,6505,6517,12
1977,"Oromo Music : Keebar Nagaash (Haleel ofirraa) - New Ethiopian Oromo Music 2018(Official Video) by Minew Shewa Tube 3 years ago 5 minutes, 12 seconds 6,027 views",Minew Shewa Entertainment,6027,6029,2
1978,"Oromo Music : Kadiijjaa Haajjii (Tank You Qeerroo) - New Ethiopian Music 2018(Official Video) by Minew Shewa Tube 3 years ago 5 minutes, 36 seconds 168,423 views",Minew Shewa Entertainment,168423,168465,42
1979,"Oromo music : Badhaatu Abbuu (Jajjabee) - New Ethiopian Oromo Music 2018(Official Video) by Minew Shewa Tube 3 years ago 6 minutes, 5 seconds 868,686 views",Minew Shewa Entertainment,868686,869864,1178
1980,"Ethiopian Music : Zera Abreham ዘራ አብርሃም (በርታ ልቤ) - New Ethiopian Music 2018(Official Video) by Minew Shewa Tube 3 years ago 4 minutes, 26 seconds 4,968 views",Minew Shewa Entertainment,4968,4971,3
1981,"Oromo Music : Baraayyuu Jamaamaa (Qeerroon Oromoo) - New Ethiopian Music 2018(Official Video) by Minew Shewa Tube 3 years ago 5 minutes, 19 seconds 5,264 views",Minew Shewa Entertainment,5264,5268,4
1982,"Ethiopian Music : Alemayehu Teferi አለማየሁ ተፈሪ (ግባ በለው) - New Ethiopian Music 2018(Official Video) by Minew Shewa Tube 3 years ago 5 minutes, 48 seconds 13,403 views",Minew Shewa Entertainment,13403,13406,3
1983,"Ethiopian music : Merkeb/መርከብ ባርያጋብር (ቦኒቷ) ft. ሊያ ቦኒቷ ሴሞን Lil Pac ያንኪ New Tigrigna hip hop 2018 by Minew Shewa Tube 3 years ago 5 minutes, 44 seconds 582,135 views",Minew Shewa Entertainment,582135,583143,1008
1984,"Oromo Music : Taakkalaa Gudaa (Aadaan Dararree) - New Ethiopian Music 2018(Official Video) by Minew Shewa Tube 3 years ago 5 minutes, 51 seconds 188,689 views",Minew Shewa Entertainment,188689,189132,443
1985,"Ethiopian Music : Merikokeb Seme መሪኮከብ ስሜ (የሰው ልጅ ምኞቱ) - New Ethiopian Music 2018(Official Video) by Minew Shewa Tube 3 years ago 4 minutes, 5 seconds 7,727 views",Minew Shewa Entertainment,7727,7733,6
1986,"Oromo Music : Boggaalaa Asanuu (Shamamee)- New Ethiopian Music 2018(Official Video) by Minew Shewa Tube 3 years ago 7 minutes, 14 seconds 85,762 views",Minew Shewa Entertainment,85762,86263,501
1987,"Ethiopian Music : Ermias Sophia ኤርምያስ ሶፍያ (ያንቺው ተብዬ) - New Ethiopian Music 2018(Official Video) by Minew Shewa Tube 3 years ago 4 minutes, 51 seconds 7,799 views",Minew Shewa Entertainment,7799,7799,0
1988,"Ethiopian Music : Samuel Yitayale ሳሙኤል ይታያል (ጠበለሌ) - New Ethiopian Music 2018(Official Video) by Minew Shewa Tube 3 years ago 6 minutes, 23 seconds 18,925 views",Minew Shewa Entertainment,18925,18977,52
1989,"Bahrudin Mustapha (Boorrii Daamootaa) - New Ethiopian Oromo Music 2018(Official Video) by Minew Shewa Tube 3 years ago 6 minutes, 21 seconds 3,406 views",Minew Shewa Entertainment,3406,3408,2
1990,"Ethiopian Music : Nati (Cheb Cheb) ሳተናው ናቲ (ቸብ ቸብ) New Ethiopian Hip Hop Music 2018(Official Video) by Minew Shewa Tube 3 years ago 3 minutes, 54 seconds 6,965 views",Minew Shewa Entertainment,6965,6973,8
1991,"Ethiopian Music : Sami Acts (Kingdom) - New Ethiopian Music 2018(Official Video) by Minew Shewa Tube 3 years ago 3 minutes, 5 seconds 5,086 views",Minew Shewa Entertainment,5086,5089,3
1992,"Ethiopian music : Maartaa Garramuu (Ilma Abbaa Gadaa) New Ethiopian Oromo Music 2018(Official Video) by Minew Shewa Tube 3 years ago 4 minutes, 29 seconds 10,877 views",Minew Shewa Entertainment,10877,10884,7
1993,"Dereje WoldeSemayat (Wede Mata) ደረጀ ወልደሰማያት (ወደ ማታ) New Ethiopian Music 2018 Official Video by Minew Shewa Tube 3 years ago 4 minutes, 32 seconds 5,072 views",Minew Shewa Entertainment,5072,5076,4
1994,"Ethiopian Music : Bethelhem Aklilu ቤተልሄም አክሊሉ (አላይም ተከፍተህ)- New Ethiopian Music 2018(Official Video) by Minew Shewa Tube 3 years ago 5 minutes, 8 seconds 1,894,484 views",Minew Shewa Entertainment,1894484,1897300,2816
1995,"Oromo Music: Taaddasa Fixee (Xaafiin Quchuuchattee) - New Ethiopian Oromo Music 2018(Official Video) by Minew Shewa Tube 3 years ago 6 minutes, 44 seconds 241,927 views",Minew Shewa Entertainment,241927,245073,3146
1996,"Ethiopian Music : Asteraw Kebede አስጠራው  ከበደ (የአማራይቱ) - New Ethiopian Music 2018(Official Video) by Minew Shewa Tube 3 years ago 5 minutes, 38 seconds 144,569 views",Minew Shewa Entertainment,144569,144593,24
1997,"Ethiopian Music : Kenni (ለምን) - New Ethiopian Music 2018(Official Video) by Minew Shewa Tube 3 years ago 4 minutes 11,600 views",Minew Shewa Entertainment,11600,11631,31
1998,"Ethiopian Music : Ammarraa Nugusee (Himi Murtii) - New Ethiopian Oromo Music 2018(Official Video) by Minew Shewa Tube 3 years ago 4 minutes, 59 seconds 11,129 views",Minew Shewa Entertainment,11129,11135,6
1999,"New Ethiopian Music 2018 : Ahmed Teshome (Dinbi)Meret YaleSew አህመድ ተሾመ(ዲንቢ)መሬት ያለሰው Official vIdeo by Minew Shewa Tube 3 years ago 5 minutes, 22 seconds 4,403,539 views",Minew Shewa Entertainment,4403539,4417436,13897
2000,"Ethiopian Music : Gelaneh Abebe (NaNaye) ገላነህ አበበ (ናናዬ) - New Ethiopian Music 2018(Official Video) by Minew Shewa Tube 3 years ago 5 minutes, 51 seconds 373,139 views",Minew Shewa Entertainment,373139,373280,141
2001,"Ethiopian Music : Yabu Jc (Zemeta Outro) ያቡ (ዝምታ) - New Ethiopian Music 2018(Official Video) by Minew Shewa Tube 3 years ago 2 minutes, 24 seconds 2,188 views",Minew Shewa Entertainment,2188,2190,2
2002,"Ethiopian Music : Yabu Jc (Yene Milat) ያቡ (የኔ ምላት) - New Ethiopian Music 2018(Official Video) by Minew Shewa Tube 3 years ago 4 minutes, 45 seconds 2,165 views",Minew Shewa Entertainment,2165,2167,2
2003,"Ethiopian Music : Yabu Jc (Kene Lela Ft Dave Ahadu) - New Ethiopian Music 2018 (Official Video) by Minew Shewa Tube 3 years ago 4 minutes, 11 seconds 3,789 views",Minew Shewa Entertainment,3789,3798,9
2004,"Ethiopian Music: Fiixee Aleks (Foollee with Reeggee)- New Ethiopian Oromo Music 2018(Official Video) by Minew Shewa Tube 3 years ago 5 minutes, 36 seconds 17,341 views",Minew Shewa Entertainment,17341,17390,49
2005,"Ethiopian Music : Teferi Wudneh ተፈሪ ውድነህ (የጎጃም ጉብል) - New Ethiopian Music 2018(Official Video) by Minew Shewa Tube 3 years ago 4 minutes, 45 seconds 22,079 views",Minew Shewa Entertainment,22079,22087,8
2006,"Ethiopian Poetry : ደምሰው መርሻ (የእውራን ጦርነት) - New Ethiopian Poetry 2018(Official Video) by Minew Shewa Tube 3 years ago 4 minutes, 46 seconds 2,122 views",Minew Shewa Entertainment,2122,2123,1
2007,"Ethiopian Music : Temesgen Tirngo ተመስገን ትርንጎ (ኢትዮጵያዬ) - New Ethiopian Poetry 2018(Official Video) by Minew Shewa Tube 3 years ago 2 minutes, 19 seconds 6,571 views",Minew Shewa Entertainment,6571,6571,0
2008,"Ethiopian Music: Elsa Endeshaw (Shemunaye) ኤልሳ እንደሻው (ሸሙናዬ) New Ethiopian Music 2018(Official Video) by Minew Shewa Tube 3 years ago 6 minutes, 46 seconds 23,916 views",Minew Shewa Entertainment,23916,23941,25
2009,"Ethiopian Music : Sami Acts (Acts) - New Ethiopian Music 2018(Official Video) by Minew Shewa Tube 3 years ago 3 minutes, 34 seconds 2,665 views",Minew Shewa Entertainment,2665,2669,4
2010,"Ethiopian Music :Yabu Jc (Kuru Habesha) Ft  Syco David  - New Ethiopian Music 2018(Official Video) by Minew Shewa Tube 3 years ago 5 minutes, 4 seconds 2,910 views",Minew Shewa Entertainment,2910,2911,1
2011,"Ethiopian Music: Yabu Jc (Addis Ababa)ft  KalAb (አዲስ አበባ) New Ethiopian Music 2018(Official Video) by Minew Shewa Tube 3 years ago 4 minutes, 12 seconds 2,343 views",Minew Shewa Entertainment,2343,2348,5
2012,"Ethiopian Music : Yabu Jc (Kene Wey Kante) ያቡ (ከኔ ወይ ካንተ) - New Ethiopian Music 2018(Official Video) by Minew Shewa Tube 3 years ago 4 minutes, 12 seconds 1,254 views",Minew Shewa Entertainment,1254,1254,0
2013,"Ethiopian Music : Yabu JC - (1990 Intro)- New Ethiopian Music 2018(Official Video) by Minew Shewa Tube 3 years ago 2 minutes, 30 seconds 1,824 views",Minew Shewa Entertainment,1824,1827,3
2014,"Ethiopian Music: Filla Bella ft Sheme (Ney Zemede) ነይ ዘመዴ- New Ethiopian Music 2018(Official Video) by Minew Shewa Tube 3 years ago 3 minutes, 55 seconds 13,455 views",Minew Shewa Entertainment,13455,13462,7
2015,"Hayleyesus Feyssa (Ma Beye Litrash) ኃይለየሱስ ፈይሳ (ማ ብዬ ልጥራሽ)- New Ethiopian Music 2018(Official Album) by Minew Shewa Tube 3 years ago 4 minutes, 19 seconds 230,816 views",Minew Shewa Entertainment,230816,231444,628
2016,"Ethiopian music: Hayleyesus Feyssa ኃይለየሱስ ፈይሳ (እንዳንቀር ተራርቀን)New Ethiopian Music 2018(Official Album) by Minew Shewa Tube 3 years ago 5 minutes, 28 seconds 338,667 views",Minew Shewa Entertainment,338667,340429,1762
2017,"Hayleyesus Feyssa (Yiqir Beyalew) ኃይለየሱስ ፈይሳ (ይቅር ብያለው) - New Ethiopian Music 2018(Official Album) by Minew Shewa Tube 3 years ago 7 minutes, 17 seconds 615,722 views",Minew Shewa Entertainment,615722,628838,13116
2018,"Ethiopian music: Hayleyesus Feyssa (Eruq) ኃይለየሱስ ፈይሳ (እሩቅ) New Ethiopian Music 2018(Official Album) by Minew Shewa Tube 3 years ago 5 minutes, 31 seconds 103,048 views",Minew Shewa Entertainment,103048,103317,269
2019,"Ethiopian music: Hayleyesus Feyssa ኃይለየሱስ ፈይሳ (የአዲስ ቀን ፀሀይ) New Ethiopian Music 2018(Official Album) by Minew Shewa Tube 3 years ago 5 minutes, 41 seconds 181,803 views",Minew Shewa Entertainment,181803,182265,462
2020,"Ethiopian music: Hayleyesus Feyssa(Salayesh)ኃይለየሱስ ፈይሳ(ሳላይሽ)New Ethiopian Music 2018(Official music) by Minew Shewa Tube 3 years ago 4 minutes, 52 seconds 1,161,809 views",Minew Shewa Entertainment,1161809,1169943,8134
2021,"Hayleyesus Feyssa (Maal Tatte) ኃይለየሱስ ፈይሳ (ማልታቴ) - New Ethiopian Music 2018(Official Video) by Minew Shewa Tube 3 years ago 5 minutes, 14 seconds 255,697 views",Minew Shewa Entertainment,255697,256401,704
2022,"Ethiopian Music: Martha Samuel (Tikuru Kenechu) ማርታ ሳሙኤል (ጥቁሩ ከነጩ) New Ethiopian Music 2018. by Minew Shewa Tube 3 years ago 4 minutes, 59 seconds 6,433 views",Minew Shewa Entertainment,6433,6436,3
2023,"Ethiopian Music : Amsalu Shumeye አምሳሉ ሹምዬ (ልምጣ እንደተዋናይ) - New Ethiopian Music 2018(Official Video) by Minew Shewa Tube 3 years ago 5 minutes, 44 seconds 9,506 views",Minew Shewa Entertainment,9506,9539,33
2024,"Ethiopian music Hayleyesus Feyssa (Aderahen)ኃይለየሱስ ፈይሳ(አደራህን)New Ethiopian Music 2018 Official Album by Minew Shewa Tube 3 years ago 6 minutes, 3 seconds 450,231 views",Minew Shewa Entertainment,450231,452474,2243
2025,"Ethiopian Music Hayleyesus Feyssa (Ayneye) ኃይለየሱስ ፈይሳ (አይንዬ)New Ethiopian Music 2018(Official Album) by Minew Shewa Tube 3 years ago 7 minutes, 31 seconds 211,020 views",Minew Shewa Entertainment,211020,211536,516
2026,"Ethiopian music Hayleyesus Feyssa(Emelalehu)ኃይለየሱስ ፈይሳ(እምላለሁ)New Ethiopian Music 2018 Official Album by Minew Shewa Tube 3 years ago 5 minutes, 17 seconds 702,238 views",Minew Shewa Entertainment,702238,704968,2730
2027,"Ethiopian music Hayleyesus Feyssa (Maderen)ኃይለየሱስ ፈይሳ(ማደሬን) New Ethiopian Music 2018(Official Album) by Minew Shewa Tube 3 years ago 5 minutes, 28 seconds 175,635 views",Minew Shewa Entertainment,175635,176084,449
2028,"Hayleyesus Feyssa (Yemariam Menged) ኃይለየሱስ ፈይሳ (የማርያም መንገድ) New Ethiopian Music 2018(Official Album) by Minew Shewa Tube 3 years ago 6 minutes, 22 seconds 237,006 views",Minew Shewa Entertainment,237006,237821,815
2029,"Ethiopian Music Hayleyesus Feyssa (Beleke) ኃይለየሱስ ፈይሳ(በልኬ) New Ethiopian Music 2018(Official Video) by Minew Shewa Tube 3 years ago 5 minutes, 41 seconds 424,682 views",Minew Shewa Entertainment,424682,426456,1774
2030,"Ethiopian Music: Dev Lee  ዴቭ ሊ (አይዞህ ያገሬ ልጅ)- New Ethiopian Music 2018(Official Video) by Minew Shewa Tube 3 years ago 4 minutes, 36 seconds 3,095 views",Minew Shewa Entertainment,3095,3095,0
2031,"Ethiopian Music : Yabu Jc (Hulet Alem) ያቡ (ሁለት ዓለም)- New Ethiopian Music 2018(Official Video) by Minew Shewa Tube 3 years ago 4 minutes, 34 seconds 3,632 views",Minew Shewa Entertainment,3632,3634,2
2032,"Ethiopian Music : Ayana Tsegaye (Maahibuubaa) - New Ethiopian Oromo Music 2018(Official Video) by Minew Shewa Tube 3 years ago 4 minutes, 44 seconds 5,165 views",Minew Shewa Entertainment,5165,5173,8
2033,"Ethiopian Music: Mykey Shewa (Wushetam) ሚኪ ሸዋ (ውሸታም) - New Ethiopian Music 2018(Official Video) by Minew Shewa Tube 3 years ago 4 minutes, 32 seconds 16,403 views",Minew Shewa Entertainment,16403,16441,38
2034,"Ethiopian Music :Suraphel Tegegn (Hohe) ሱራፌል ተገኝ (ሆሄ) - New Ethiopian Music 2018(Official Video) by Minew Shewa Tube 3 years ago 4 minutes, 55 seconds 5,661 views",Minew Shewa Entertainment,5661,5661,0
2035,"Ethiopian Music : Mikyas Bini (Lomiye) ሚክያስ ቢኒ (ሎምዬ) - New Ethiopian Music 2018(Official Video) by Minew Shewa Tube 3 years ago 4 minutes, 30 seconds 21,085 views",Minew Shewa Entertainment,21085,21139,54
2036,"Ethiopian Music :Abraham Taye (Bitayut) አብርሃም ታየ (ብታዩት)  - New Ethiopian Music 2018(Official Video) by Minew Shewa Tube 3 years ago 6 minutes, 20 seconds 9,486 views",Minew Shewa Entertainment,9486,9488,2
2037,"Ethiopian Music : Sami Acts (Mr President)- New Ethiopian Music 2018(Official Video) by Minew Shewa Tube 3 years ago 4 minutes, 50 seconds 3,129 views",Minew Shewa Entertainment,3129,3130,1
2038,"Ethiopian Music : Solomon Asalif ሰለሞን አሳልፍ (ፍቅር የወሎ ልጅ) - New Ethiopian Music 2018(Official Video) by Minew Shewa Tube 3 years ago 4 minutes, 55 seconds 29,841 views",Minew Shewa Entertainment,29841,29957,116
2039,"Ethiopian Music : Dan Admasu ዳን አድማሱ (ከፍቶሽ እንዳላይ) - New Ethiopian Music 2018(Official Video) by Minew Shewa Tube 3 years ago 6 minutes, 6 seconds 232,575 views",Minew Shewa Entertainment,232575,233945,1370
2040,"Ethiopian Music : Bayissa Taye (Oromya) - New Ethiopian Oromo Music 2018(Official Video) by Minew Shewa Tube 3 years ago 6 minutes, 53 seconds 4,483 views",Minew Shewa Entertainment,4483,4491,8
2041,"Ethiopian Music: Biru Dagu (Dungo Qasbsise) - New Ethiopian Oromo Music 2018(Official Video) by Minew Shewa Tube 3 years ago 5 minutes, 39 seconds 3,314 views",Minew Shewa Entertainment,3314,3316,2
2042,"Ethiopian Music: Habtamu Tilahun | ሃብታሙ ጥላሁን (ፍቅርሽ ጎትቶኛል) | New Ethiopian Music 2018(Official Video) by Minew Shewa Tube 3 years ago 5 minutes, 17 seconds 12,814 views",Minew Shewa Entertainment,12814,12822,8
2043,"አበበ ወርቁ (ለካስ ዲሞክራሲ / ተይው እንተወው) - New Ethiopian Poem 2018(Official Video) by Minew Shewa Tube 3 years ago 3 minutes, 17 seconds 2,315 views",Minew Shewa Entertainment,2315,2317,2
2044,"Ethiopian Music : Muler Man (Qal Alegn) ሙለር ማን (ቃል አለኝ) - New Ethiopian Music 2018(Official Video) by Minew Shewa Tube 3 years ago 5 minutes, 15 seconds 9,869 views",Minew Shewa Entertainment,9869,9874,5
2045,"Ethiopian Music :Jambo Jote (Belba)  - New Ethiopian Oromo Music 2018(Official Video) by Minew Shewa Tube 3 years ago 6 minutes, 55 seconds 9,436,258 views",Minew Shewa Entertainment,9436258,9489950,53692
2046,"Ethiopian Music: Mahder Fekadu ማህደር ፈቃዱ (ወይ ውበት) - New Ethiopian Music 2018(Official Video) by Minew Shewa Tube 3 years ago 4 minutes, 11 seconds 9,642 views",Minew Shewa Entertainment,9642,9645,3
2047,"Ethiopian Music :Gaarummaa Huundee (Nooruu Yaa Malka) - New Ethiopian Music 2018(Official Video) by Minew Shewa Tube 3 years ago 6 minutes, 26 seconds 10,470 views",Minew Shewa Entertainment,10470,10475,5
2048,"Ethiopian Music : Meri Amanuel (Tutu) መሪ አማኑኤል (ቱቱ) - New Ethiopian Music 2018(Official Video) by Minew Shewa Tube 3 years ago 5 minutes, 40 seconds 3,307 views",Minew Shewa Entertainment,3307,3311,4
2049,"Ethiopian Music : Alemayehu Dolla (Gamo Gofa Nawu) - New Ethiopian Music 2018(Official Video) by Minew Shewa Tube 3 years ago 4 minutes, 35 seconds 15,344 views",Minew Shewa Entertainment,15344,15400,56
2050,"Ethiopian Music :Kabbadaa Girmaa (Beellamni si haa gahu) - New Ethiopian Music 2018(Official Video) by Minew Shewa Tube 3 years ago 7 minutes, 22 seconds 6,278 views",Minew Shewa Entertainment,6278,6289,11
2051,"Ethiopian Music : Agenche Zewdu (Gondar) አግንቸ ዘዉዱ (ጎንደር) - New Ethiopian Music 2018(Official Video) by Minew Shewa Tube 3 years ago 5 minutes, 45 seconds 55,363 views",Minew Shewa Entertainment,55363,55399,36
2052,"Oromo Music : Fayyissaa Suphaa (Odaa Guddaa) - New Ethiopian Music 2018(Official Video) by Minew Shewa Tube 3 years ago 5 minutes, 31 seconds 18,525 views",Minew Shewa Entertainment,18525,18553,28
2053,"Ethiopian Music : Habtamu Bere (Awdamet) ሃብታሙ በሬ (አዉዳመት) - New Ethiopian Music 2018(Official Video) by Minew Shewa Tube 3 years ago 5 minutes, 49 seconds 7,097 views",Minew Shewa Entertainment,7097,7108,11
2054,"Ethiopian Music : Ek Mule (እረፉ) - New Ethiopian Music 2018(Official Video) by Minew Shewa Tube 3 years ago 5 minutes, 57 seconds 3,444 views",Minew Shewa Entertainment,3444,3450,6
2055,"Ethiopian Music :Yabu Jc (Atawkem) አታውቅም - New Ethiopian Music 2018(Official Video) by Minew Shewa Tube 3 years ago 3 minutes, 55 seconds 4,126 views",Minew Shewa Entertainment,4126,4129,3
2056,"Ethiopian Music : Kenfe Demisse ክንፈ ደምሴ (እኖርንያ) - New Ethiopian Music 2018(Official Video) by Minew Shewa Tube 3 years ago 5 minutes, 39 seconds 183,946 views",Minew Shewa Entertainment,183946,184595,649
2057,"Ethiopian Music : Biruk Delelegn (Emushu) Wey Tobiyayie - New Ethiopian Music 2018(Official Video) by Minew Shewa Tube 3 years ago 7 minutes, 17 seconds 5,350 views",Minew Shewa Entertainment,5350,5359,9
2058,"Ethiopian Music : Yabu Jc (Yene Shega) የኔ ሸጋ - New Ethiopian Music 2018(Official Video) by Minew Shewa Tube 3 years ago 3 minutes, 52 seconds 3,720 views",Minew Shewa Entertainment,3720,3729,9
2059,"Ethiopian Music : Yabu Jc Genezeb (ገንዘብ) Ft  Barak - New Ethiopian Music 2018(Official Video) by Minew Shewa Tube 3 years ago 3 minutes, 33 seconds 4,253 views",Minew Shewa Entertainment,4253,4256,3
2060,"Ethiopian Music :Yabu Jc (Gudegna Nat) (ጉደኛ ናት) Ft Kal Ab - New Ethiopian Music 2018(Official Video) by Minew Shewa Tube 3 years ago 3 minutes, 56 seconds 5,202 views",Minew Shewa Entertainment,5202,5218,16
2061,"Ethiopian Music : Sileshi Kebede ስለሺ ከበደ (እወድሻለው) - New Ethiopian Music 2018(Official Video) by Minew Shewa Tube 3 years ago 5 minutes, 6 seconds 8,164 views",Minew Shewa Entertainment,8164,8165,1
2062,"Ethiopian Music : Dani G 4 Life (ደስ) - New Ethiopian Music 2018(Official Video) by Minew Shewa Tube 3 years ago 4 minutes, 39 seconds 6,557 views",Minew Shewa Entertainment,6557,6562,5
2063,"Ethiopian Music : Ab Beta ኤቢ ቤታ (እንደ መንታዬ) - New Ethiopian Music 2018(Official Video) by Minew Shewa Tube 3 years ago 3 minutes, 58 seconds 4,035 views",Minew Shewa Entertainment,4035,4039,4
2064,"Ethiopian Music : Ethio Mambo ft Havijah (ሺ ቀበሌ) - New Ethiopian Music 2018(Official Video) by Minew Shewa Tube 3 years ago 3 minutes, 49 seconds 3,292 views",Minew Shewa Entertainment,3292,3293,1
2065,"Ethiopian Music : Fish B ft Hune (እቱ Monliza) - New Ethiopian Music 2018(Official Video) by Minew Shewa Tube 3 years ago 4 minutes, 41 seconds 7,414 views",Minew Shewa Entertainment,7414,7418,4
2066,"Ethiopian Music : Sami Acts (አንድ ሳንቲም) - New Ethiopian Music 2018(Official Video) by Minew Shewa Tube 3 years ago 5 minutes 8,180 views",Minew Shewa Entertainment,8180,8186,6
2067,"Ethiopian Music : Alemayehu Mola አለማየሁ ሞላ (ጀግናው የሃገሬ ሰው) - New Ethiopian Music 2018(Official Video) by Minew Shewa Tube 3 years ago 4 minutes, 24 seconds 6,245 views",Minew Shewa Entertainment,6245,6246,1
2068,"Ethiopian Music:  ላመስግን ፀጋው ""አማረባት ያሉሽ""  Lamesgen Tesgaw ""Amarebat Yalush"" New Ethiopian Music 2018. by Minew Shewa Tube 3 years ago 6 minutes, 3 seconds 32,233 views",Minew Shewa Entertainment,32233,32242,9
2069,"Ethiopian Music: Tewodros Tadesse (Guadaye) ቴዎድሮስ ታደሰ (ጓዳዬ) New Ethiopian Music 2018(Official Video) by Minew Shewa Tube 3 years ago 5 minutes, 45 seconds 55,555 views",Minew Shewa Entertainment,55555,55581,26
2070,"Ethiopian Music :  Abel Tarekegn (Melaye) አቤል ታረቀኝ (መላዬ) - New Ethiopian Music 2018(Official Video) by Minew Shewa Tube 3 years ago 5 minutes, 19 seconds 243,805 views",Minew Shewa Entertainment,243805,243919,114
2071,"Oromo Music : Darajjee Ababba (Obsuu Dadhabee) - New Ethiopian Oromo Music 2018(Official Video) by Minew Shewa Tube 3 years ago 4 minutes, 27 seconds 9,184 views",Minew Shewa Entertainment,9184,9206,22
2072,"Ethiopian Music: Wendesen, Milkyas, Aster, Ibrahim, Nuri - New Ethiopian Music 2018(Official Video) by Minew Shewa Tube 3 years ago 6 minutes, 55 seconds 8,183 views",Minew Shewa Entertainment,8183,8188,5
2073,"Ethiopian Music : Biru Degu (Jalali Umama) - New Ethiopian Oromo Music 2018(Official Video) by Minew Shewa Tube 3 years ago 5 minutes, 27 seconds 7,104 views",Minew Shewa Entertainment,7104,7108,4
2074,"Ethiopian Music Betelehem Wondwosen ቤቴልሄም ወንድዎሰን (ናልኝ) - New Ethiopian Music 2018 (Official Video) by Minew Shewa Tube 3 years ago 5 minutes, 16 seconds 11,457 views",Minew Shewa Entertainment,11457,11479,22
2075,"Ethiopian Music : Wendesen Belay ወንደሰን በላይ (ወላንሳየ) - New Ethiopian Music 2018(Official Video) by Minew Shewa Tube 3 years ago 6 minutes, 10 seconds 63,540 views",Minew Shewa Entertainment,63540,63559,19
2076,"Ethiopian Music : Yonadab Worku ዮናዳብ ወርቁ (ሰልፍ ወጣሁልሽ) - New Ethiopian Music 2018(Official Video) by Minew Shewa Tube 3 years ago 6 minutes, 28 seconds 9,099 views",Minew Shewa Entertainment,9099,9104,5
2077,"Ethiopian Music : Asrebeb Tadege አስረበብ ታደገ (አውዳመቱ ይድመቅ)- New Ethiopian Music 2018(Official Video) by Minew Shewa Tube 3 years ago 5 minutes, 51 seconds 17,412 views",Minew Shewa Entertainment,17412,17419,7
2078,"Ethiopian Music: Darajjee Shuumii (Qeerrotu Beeka Karaa) - New Ethiopian Music 2018(Official Video) by Minew Shewa Tube 3 years ago 6 minutes, 50 seconds 101,875 views",Minew Shewa Entertainment,101875,102265,390
2079,"Ethiopian Music : Demere Legesse ደመረ ለገሰ ""ኢትዮጵያ"" - New Ethiopian Music 2018(Official Video) by Minew Shewa Tube 3 years ago 6 minutes, 25 seconds 114,866 views",Minew Shewa Entertainment,114866,114950,84
2080,"Ethiopian Music : አቤጋ ዮሃንስ (ዋሮሞ) Abega Yohanis (Waromo) - New Ethiopian Music 2018(Official Video) by Minew Shewa Tube 3 years ago 5 minutes, 25 seconds 6,124 views",Minew Shewa Entertainment,6124,6127,3
2081,"Ethiopian Music : Nani Aramede ናኒ አራምዴ ""እሰይ እሰይ"" New Ethiopian Holiday Music 2018 (Official Video) by Minew Shewa Tube 3 years ago 5 minutes, 40 seconds 19,397 views",Minew Shewa Entertainment,19397,19402,5
2082,"Ethiopian Music : Magartuu Geetuu (Yaa Obsaa Koo) - New Oromo Music 2018 (Official Video) by Minew Shewa Tube 3 years ago 6 minutes, 55 seconds 62,508 views",Minew Shewa Entertainment,62508,62574,66
2083,"Ethiopian Music : Sydney Salmon (Chika) ሲድን ሰለሞን (ጭቃ) - New Ethiopian Music 2018(Official Video) by Minew Shewa Tube 3 years ago 5 minutes, 4 seconds 9,133 views",Minew Shewa Entertainment,9133,9168,35
2084,"Ethiopian Music : Eelsaa Nugusee (Gaagura Koo) - New Ethiopian Oromo Music 2018(Official Video) by Minew Shewa Tube 3 years ago 6 minutes, 43 seconds 1,772,549 views",Minew Shewa Entertainment,1772549,1777416,4867
2085,"Ethiopian Music : Nata Mes ናታ መስ (ወይኔ) - New Ethiopian Music  2018 (Official Video) by Minew Shewa Tube 3 years ago 4 minutes, 39 seconds 13,875 views",Minew Shewa Entertainment,13875,13894,19
2086,"Ethiopian Music : Addis Degefaw አዲስ ደገፋው (አላይም ሌላ) - New Ethiopian Music 2018 (Official Video) by Minew Shewa Tube 3 years ago 4 minutes, 24 seconds 8,191 views",Minew Shewa Entertainment,8191,8198,7
2087,"Ethiopian Music: Jonana ft Tedi Raga & Ermi  (Senebabeta) - New Ethiopian Music 2018(Official Video) by Minew Shewa Tube 3 years ago 5 minutes, 6 seconds 8,664 views",Minew Shewa Entertainment,8664,8668,4
2088,"Ethiopian Music : Abdiiket Abdii (Dr Abiy Ahmed) - New Ethiopian Music 2018(Official Video) by Minew Shewa Tube 3 years ago 4 minutes, 24 seconds 9,917 views",Minew Shewa Entertainment,9917,9923,6
2089,"Ethiopian Music : Endalew Sitotaw እንዳለው ስጦታው (ልበ ኩሩ) - New Ethiopian Music 2018(Official Video) by Minew Shewa Tube 3 years ago 6 minutes, 29 seconds 574,959 views",Minew Shewa Entertainment,574959,575924,965
2090,"Ethiopian Music : Yemar Tesfaye (Brurey) የማር ተስፋይ (ብሩረይ) - New Ethiopian Music 2018(Official Video) by Minew Shewa Tube 3 years ago 4 minutes, 37 seconds 4,373 views",Minew Shewa Entertainment,4373,4376,3
2091,"Ethiopian Music: Biru Degu (Quba qubeellaa) - New Ethiopian Music 2018(Official Video) by Minew Shewa Tube 3 years ago 3 minutes, 28 seconds 10,554 views",Minew Shewa Entertainment,10554,10555,1
2092,"Ethiopian Music : በቃሉ ባንቴ (ቺርቤዋ) - New Ethiopian Music 2018(Official Video) by Minew Shewa Tube 3 years ago 5 minutes, 10 seconds 10,095 views",Minew Shewa Entertainment,10095,10101,6
2093,"Ethiopian Music : Asnaku Sisay (Nalign) አስናቁ ሲሳይ (ናልኝ) - New Ethiopian Music 2018(Official Video) by Minew Shewa Tube 3 years ago 4 minutes, 51 seconds 19,136 views",Minew Shewa Entertainment,19136,19165,29
2094,"Ethiopian Music : Getish Mamo ጌትሽ ማሞ Tekebel 4 (ተቀበል አራት) - New Ethiopian Music 2018(Official Video) by Minew Shewa Tube 3 years ago 7 minutes, 35 seconds 4,557,639 views",Minew Shewa Entertainment,4557639,4567614,9975
2095,"ደምሴ ተካ ፣ አንዳለም አያሌው ፣ ኤፍሬም ወዳጅ እና ቴድሮስ ጀምበር (ተመችቶናል) New Ethiopian Music 2018(Official Video) by Minew Shewa Tube 3 years ago 5 minutes, 17 seconds 34,587 views",Minew Shewa Entertainment,34587,34599,12
2096,"Ethiopian Music : Kabbadaa Eebbisaa (Abbaa Gadaa) - New Ethiopian Oromo Music 2018(Official Video) by Minew Shewa Tube 3 years ago 5 minutes, 46 seconds 15,781 views",Minew Shewa Entertainment,15781,15802,21
2097,"Ethiopian Music : Maruf Maelstrom (Feta) ማሩፍ (ፈታ) - New Ethiopian Music 2018(Official Video) by Minew Shewa Tube 3 years ago 4 minutes, 59 seconds 7,400 views",Minew Shewa Entertainment,7400,7406,6
2098,"Ethiopian Music : ቢንያም መንግሥቴ (ደርባ ሸማ) - New Ethiopian Music 2018(Official Video) by Minew Shewa Tube 3 years ago 4 minutes, 58 seconds 5,845 views",Minew Shewa Entertainment,5845,5845,0
2099,"Ethiopian Music : Roobeeraa Amaanuu (Asammareeto) - New Ethiopian Oromo Music 2018(Official Video) by Minew Shewa Tube 3 years ago 5 minutes, 51 seconds 22,107 views",Minew Shewa Entertainment,22107,22218,111
2100,"Ethiopian Music : Dan Admasu (4 kilo) ዳን አድማሱ (4 ኪሎ) - New Ethiopian Music 2018(Official Video) by Minew Shewa Tube 3 years ago 8 minutes, 39 seconds 1,376,903 views",Minew Shewa Entertainment,1376903,1386035,9132
2101,"Ethiopian Music: Nega Mandefro ነጋ ማንደፍሮ (ጓዳዬ ነሽ) - New Ethiopian Music 2018(Official Video) by Minew Shewa Tube 3 years ago 6 minutes, 27 seconds 66,175 views",Minew Shewa Entertainment,66175,66188,13
2102,"Ethiopian Music: ሰዋለም ደምሌ (ምድረ ገነት) - New Ethiopian Music 2018(Official Video) by Minew Shewa Tube 3 years ago 6 minutes, 26 seconds 9,371 views",Minew Shewa Entertainment,9371,9387,16
2103,"Ethiopian Music: Yared Tibebu ያሬድ ጥበቡ (አንድ በሉልኝ) - New Ethiopian Music 2018(Official Video) by Minew Shewa Tube 3 years ago 5 minutes, 13 seconds 51,059 views",Minew Shewa Entertainment,51059,51498,439
2104,"Ethiopian Music: Ashenafi Kebede (Yene) አሸናፊ ከበደ (የኔ) - New Ethiopian Music 2018(Official Video) by Minew Shewa Tube 3 years ago 4 minutes, 33 seconds 21,973 views",Minew Shewa Entertainment,21973,22048,75
2105,"Ethiopian Music : G-Bela X Hope T (Neyema) - New Ethiopian Music 2018(Official Video) by Minew Shewa Tube 3 years ago 5 minutes, 17 seconds 9,125 views",Minew Shewa Entertainment,9125,9141,16
2106,"Ethiopian Music: F-Rick ft. Messi (Bitama) - New Ethiopian Music 2018(Official Video) by Minew Shewa Tube 3 years ago 5 minutes, 32 seconds 6,832 views",Minew Shewa Entertainment,6832,6832,0
2107,"Alemayehu Mola አለማየሁ ሞላ (ሁሌ ለምናለው ሰላምን ወድጄ) - New Ethiopian Music 2018(Official Video) by Minew Shewa Tube 3 years ago 5 minutes, 38 seconds 19,177 views",Minew Shewa Entertainment,19177,19183,6
2108,"Ethiopian Music: Semeon Geremew (Feker) ስምኦን ገረመው (ፍቅር) - New Ethiopian Music 2018(Official Video) by Minew Shewa Tube 3 years ago 5 minutes, 26 seconds 5,176 views",Minew Shewa Entertainment,5176,5180,4
2109,"Ethiopian Music: Seenaa Mulugeta (Yoonaa) - New Ethiopian Oromo Music 2018(Official Video) by Minew Shewa Tube 3 years ago 6 minutes, 51 seconds 5,673 views",Minew Shewa Entertainment,5673,5688,15
2110,"Ethiopian Music: Yapi Mapi ft Tamrat Amare (Ayni Wari) - New Ethiopian Music 2018(Official Video) by Minew Shewa Tube 3 years ago 4 minutes, 42 seconds 81,909 views",Minew Shewa Entertainment,81909,82016,107
2111,"Ethiopian Music: Habtamu Zinabe ሃብታሙ ዝናቤ (ሆኜ አይናፋር) - New Ethiopian Music 2018(Official Video) by Minew Shewa Tube 3 years ago 5 minutes, 22 seconds 4,732 views",Minew Shewa Entertainment,4732,4734,2
2112,"Ethiopian Music: Mihret Teshome(Demer) ምህረት ተሾመ (ደምር!!!) - New Ethiopian Music 2018(Official Video) by Minew Shewa Tube 3 years ago 6 minutes, 21 seconds 8,075 views",Minew Shewa Entertainment,8075,8078,3
2113,"Ethiopian Music: Mafi Kassa ማፊ ካሳ (መልካም አዲስ ዓመት)  - New Ethiopian Music 2018(Official Video) by Minew Shewa Tube 3 years ago 5 minutes, 14 seconds 6,300 views",Minew Shewa Entertainment,6300,6301,1
2114,"Ethiopian Music: Abenezer Samuel & Upon  - New Ethiopian Music 2018(Official Video) by Minew Shewa Tube 3 years ago 3 minutes, 41 seconds 39,676 views",Minew Shewa Entertainment,39676,39733,57
2115,"Ethiopian Music: ራሄል ፀጋዬ ፣ እየሩሳሌም በየነ እና አልአዛር ዘለቀ(አንድነት) New Ethiopian Music 2018(Official Video) by Minew Shewa Tube 3 years ago 5 minutes, 20 seconds 6,972 views",Minew Shewa Entertainment,6972,6982,10
2116,"Ethiopian Music: Mulubrhan Fiseha (Wari-Wedizom) ዋሪ ወዲ'ዞም (መተዓዛዘቢ) - New Ethiopian Music 2018. by Minew Shewa Tube 3 years ago 6 minutes, 10 seconds 682,971 views",Minew Shewa Entertainment,682971,684242,1271
2117,"Ethiopian Music : Hana - DaDa & Upon (Habesha) - New Ethiopian Music 2018(Official Video) by Minew Shewa Tube 3 years ago 3 minutes, 42 seconds 34,919 views",Minew Shewa Entertainment,34919,34953,34
2118,"Ethiopian Music: ታድዮስ አበበ (ዘታድያን) ቀይ ባህርን እናልፋለን - New Ethiopian Music 2018(Official Video) by Minew Shewa Tube 3 years ago 5 minutes, 48 seconds 3,784 views",Minew Shewa Entertainment,3784,3786,2
2119,"Ethiopian Music: Mesay Zeleke መሳይ ዘለቀ (ተስፋ እናደርጋለን) - New Ethiopian Music 2018(Official Video) by Minew Shewa Tube 3 years ago 4 minutes, 37 seconds 3,155 views",Minew Shewa Entertainment,3155,3155,0
2120,"Ethiopian Music: Efrem Tadesse ኤፍሬም ታደሰ (ንሰላም ንዘምር) - New Ethiopian Music 2018(Official Video) by Minew Shewa Tube 3 years ago 8 minutes, 5 seconds 4,335 views",Minew Shewa Entertainment,4335,4337,2
2121,"Ethiopian Music: Tsegaw Bekele (Blene) ፀጋው በቀለ (ብሌኔ) - New Ethiopian Music 2018(Official Video) by Minew Shewa Tube 3 years ago 5 minutes, 20 seconds 15,283 views",Minew Shewa Entertainment,15283,15297,14
2122,"Ethiopian Music: Baba (Iwedshalew) ባባ (እወድሻለው)  - New Ethiopian Music 2018(Official Video) by Minew Shewa Tube 3 years ago 3 minutes, 46 seconds 8,821 views",Minew Shewa Entertainment,8821,8828,7
2123,"Ethiopian Music : አለማየሁ ሞላ (አይዞህ ያገሬ ሰው አባይን ጨርሰው)  - New Ethiopian Music 2018(Official Video) by Minew Shewa Tube 3 years ago 7 minutes 9,857 views",Minew Shewa Entertainment,9857,9859,2
2124,"Ethiopian Music: Tomy+ ft Bul Bul (She don't like) - New Ethiopian Music 2018(Official Video) by Minew Shewa Tube 3 years ago 4 minutes, 58 seconds 12,527 views",Minew Shewa Entertainment,12527,12642,115
2125,"Ethiopian Music: አብርሃም አየለ (የኔ ቆንጆ ኑሪ በእኔ አለም ኩሪ) - New Ethiopian Music 2018(Official Video) by Minew Shewa Tube 3 years ago 5 minutes, 1 second 269,556 views",Minew Shewa Entertainment,269556,269916,360
2126,"Ethiopian Music: Besufikad Tibebu (Blene) በሱፍቃድ ጥበቡ (ብሌኔ) - New Ethiopian Music 2018(Official Video) by Minew Shewa Tube 3 years ago 4 minutes, 10 seconds 8,603 views",Minew Shewa Entertainment,8603,8609,6
2127,"Ethiopian Music : ሀፍቶም ገብረሚካኤል ""ትግራዋይነት"" Haftom G/Michael New Ethiopian music 2018 (Official video) by Minew Shewa Tube 3 years ago 4 minutes, 52 seconds 403,778 views",Minew Shewa Entertainment,403778,404075,297
2128,"Ethiopian Music: Bitew Dawit ቢተው ዳዊት (ሀገሬ ኢትዮጵያ) - New Ethiopian Music 2018(Official Video) by Minew Shewa Tube 3 years ago 5 minutes, 44 seconds 8,852 views",Minew Shewa Entertainment,8852,8861,9
2129,"Ethiopian Music: Betty Betta (Nalign) ቤቲ ቤታ (ናልኝ) - New Ethiopian Music 2018 (Official Video) by Minew Shewa Tube 3 years ago 5 minutes, 14 seconds 7,216 views",Minew Shewa Entertainment,7216,7218,2
2130,"Ethiopian Music: Sidney Salmon (Abay)- New Ethiopian Reggae Music 2018(Official Video) by Minew Shewa Tube 3 years ago 5 minutes, 28 seconds 13,367 views",Minew Shewa Entertainment,13367,13392,25
2131,"Ethiopian Music : Molalign Meselu ሞላልኝ መሰሉ (ወለላየ) - New Ethiopian Music 2018(Official Video) by Minew Shewa Tube 3 years ago 4 minutes, 51 seconds 20,298 views",Minew Shewa Entertainment,20298,20316,18
2132,"Ethiopian Music: Sydney Salmon (Abay) - New Ethiopian Reggae Music Coming Soon by Minew Shewa Tube 3 years ago 33 seconds 2,772 views",Minew Shewa Entertainment,2772,2774,2
2133,"Abarraa Beegii (Gadaa Kee Cimsi Ammallee)- New Ethiopian Oromo Music 2018(Official Video) by Minew Shewa Tube 3 years ago 7 minutes, 3 seconds 55,752 views",Minew Shewa Entertainment,55752,55871,119
2134,"Ethiopian Music: Jon Alpha (Johnatan) Afro Dance - New Ethiopian Music 2018(Official Video) by Minew Shewa Tube 3 years ago 5 minutes, 14 seconds 7,345 views",Minew Shewa Entertainment,7345,7354,9
2135,"Ethiopian Music: Tina Anagaw ቲና አናጋው (እምቢየው) - New Ethiopian Music 2018(Official Video) by Minew Shewa Tube 3 years ago 6 minutes, 32 seconds 24,803 views",Minew Shewa Entertainment,24803,24808,5
2136,"Ethiopian Music: Aklilu Amdemichael አክሊሉ አምደሚካኤል (አንድ ነን)- New Ethiopian Music 2018(Official Video) by Minew Shewa Tube 3 years ago 5 minutes, 34 seconds 13,486 views",Minew Shewa Entertainment,13486,13491,5
2137,"Ethiopian Music: Yosef Fisseha ዮሴፍ ፍሰሃ (የለም) - New Ethiopian Music 2018(Official Video) by Minew Shewa Tube 3 years ago 4 minutes, 29 seconds 7,365 views",Minew Shewa Entertainment,7365,7368,3
2138,"Ethiopian Music: Abebe Yitbarek አበበ ይትባረክ (ኢትዮጵያዊነት) - New Ethiopian Music 2018(Official Video) by Minew Shewa Tube 3 years ago 4 minutes, 40 seconds 16,306 views",Minew Shewa Entertainment,16306,16337,31
2139,"Ethiopian Music: Meaza Abebe (Fano) መዓዛ አበበ (ፋኖ)-New Ethiopian Music 2018(Official Video) by Minew Shewa Tube 3 years ago 4 minutes, 37 seconds 18,275 views",Minew Shewa Entertainment,18275,18295,20
2140,"Ethiopian Music: Egnatan (Min libelish) ኤግናታን (ምን ልበልሽ)- New Ethiopian Music 2018(Official Video) by Minew Shewa Tube 3 years ago 5 minutes, 41 seconds 6,378 views",Minew Shewa Entertainment,6378,6384,6
2141,"Ethiopian Music: Ephrem H/Michael ኤፍሬም ሃበተሚካኤል (የምን ሞናሊዛ) - New Ethiopian Music 2018(Official Video) by Minew Shewa Tube 3 years ago 5 minutes, 21 seconds 18,361 views",Minew Shewa Entertainment,18361,18365,4
2142,"Ethiopian Music: Hailemarkos Beyene ኃ/ማርቆስ በየነ (እንዳንለያይ) - New Ethiopian Music 2018(Official Video) by Minew Shewa Tube 3 years ago 6 minutes, 13 seconds 7,711 views",Minew Shewa Entertainment,7711,7712,1
2143,"Ethiopian Music: Semme Hola (Yene Konjo) - ሰሜ ሆላ (የኔ ቆንጆ) New Ethiopian Music 2018(Official Video) by Minew Shewa Tube 3 years ago 5 minutes, 1 second 16,632 views",Minew Shewa Entertainment,16632,16644,12
2144,"Ethiopian Music: Muluberhan Abeje ሙሉብርሃን አበጀ (የፍቅር እሳት) - New Ethiopian Music 2018(Official Video) by Minew Shewa Tube 3 years ago 7 minutes, 33 seconds 12,260 views",Minew Shewa Entertainment,12260,12266,6
2145,"Ethiopian Music: Sabboonaa (Gootawwan Keenya) - New Ethiopian Music 2018(Official Video) by Minew Shewa Tube 3 years ago 6 minutes, 55 seconds 79,738 views",Minew Shewa Entertainment,79738,79759,21
2146,"Ethiopian Music: Tmnit Kiros ትምኒት ኪሮስ (አሸንዳ ዕንባቦየ) - New Ethiopian Music 2018(Official Video) by Minew Shewa Tube 3 years ago 6 minutes, 36 seconds 153,957 views",Minew Shewa Entertainment,153957,154008,51
2147,"Ethiopian Music: Ephrem Habtemichael ኤፍሬም ሃብተሚካኤል (ሀገሬ) - New Ethiopian Music 2018(Official Video) by Minew Shewa Tube 3 years ago 6 minutes, 24 seconds 10,829 views",Minew Shewa Entertainment,10829,10835,6
2148,"Ethiopian Music: Nati Tsegaye (Eshi Bey) ናቲ ፀጋዬ (እሺ በይ) - New Ethiopian Music 2018(Official Video) by Minew Shewa Tube 3 years ago 4 minutes, 31 seconds 10,786 views",Minew Shewa Entertainment,10786,10794,8
2149,"Ethiopian Music: ቤል ሳም | አሌክሳንደር | ሀን (በኢትዮ - ኤርትራ) - New Ethiopian Music 2018(Official Video) by Minew Shewa Tube 3 years ago 5 minutes, 13 seconds 59,063 views",Minew Shewa Entertainment,59063,59067,4
2150,"Ethiopian Music: Abu Teneshu - Aabbuu Xeneshuu (Maal Jetta) New Ethiopian Music 2018(Official Video) by Minew Shewa Tube 3 years ago 6 minutes, 49 seconds 10,126 views",Minew Shewa Entertainment,10126,10138,12
2151,"Ethiopian Music፡ Jamill Abduu (Gufuun nu Hindaangessu) - New Ethiopian Music 2018(Official Video) by Minew Shewa Tube 3 years ago 6 minutes, 27 seconds 9,423 views",Minew Shewa Entertainment,9423,9427,4
2152,"Ethiopian Music: Egna Nen Ethiopia - እኛ ነን ኢትዮጵያ - New Ethiopian Music 2018(Official Video) by Minew Shewa Tube 3 years ago 4 minutes, 38 seconds 62,913 views",Minew Shewa Entertainment,62913,62921,8
2153,"Ethiopian Music: መስፍን በቀለ (አይሆንም)- (ደመላሽ ቁ2) የመስፍን በቀለ ሕልም ከአምስት ዓመት በኋላ እውን ሆነ Ethiopian Music 2018 by Minew Shewa Tube 3 years ago 6 minutes, 7 seconds 132,528 views",Minew Shewa Entertainment,132528,132627,99
2154,"Ethiopian Music: Salih Soud (Anchin Bicha) ሳልህ (አንቺን ብቻ) - New Ethiopian Music 2018(Official Video) by Minew Shewa Tube 3 years ago 5 minutes, 24 seconds 3,505 views",Minew Shewa Entertainment,3505,3505,0
2155,"Ethiopian Music: Haftom Molla (Tesfa) ሃፍቶም ሞላ (ተስፋ)  - New Ethiopian Music 2018(Official Video) by Minew Shewa Tube 3 years ago 4 minutes, 42 seconds 20,670 views",Minew Shewa Entertainment,20670,20691,21
2156,"Ethiopian Music:Efrem Tadesse ኤፍሬም ታደሰ (ሓዝለይ ቆጸራ)New Ethiopian & Eritrean Music 2018(Official Video) by Minew Shewa Tube 3 years ago 4 minutes, 38 seconds 36,905 views",Minew Shewa Entertainment,36905,36918,13
2157,"Ethiopian Music: Anteneh Tesfaye አንተነህ ተስፋዬ (ወዲህ በል) - New Ethiopian Music 2018(Official Video) by Minew Shewa Tube 3 years ago 6 minutes, 23 seconds 2,996,948 views",Minew Shewa Entertainment,2996948,3019213,22265
2158,"Ethiopian Music: ሞላ | ዮሐንስ | ፍሬ | መቅደስ (በጎ) - New Ethiopian Music 2018(Official Video) by Minew Shewa Tube 3 years ago 4 minutes, 24 seconds 9,490 views",Minew Shewa Entertainment,9490,9500,10
2159,"Ethiopian Music : Henok Meseret  ሄኖክ መሰረት (ኢትዮጵያዬ) - New Ethiopian Music 2018(Official Video) by Minew Shewa Tube 3 years ago 5 minutes, 37 seconds 30,952 views",Minew Shewa Entertainment,30952,30962,10
2160,"Ethiopian Music: Melek Makavelli (Jegna) መለክ ማክያቬልሊ (ጀግና) - New Ethiopian Music 2018(Official Video) by Minew Shewa Tube 3 years ago 5 minutes, 5 seconds 9,904 views",Minew Shewa Entertainment,9904,9907,3
2161,"Ethiopian Music: Smizz Mayle ስሚዝ ማይሌ (ሰም እና ወርቅ) - New Ethiopian Music 2018(Official Video) by Minew Shewa Tube 3 years ago 4 minutes, 18 seconds 27,868 views",Minew Shewa Entertainment,27868,27876,8
2162,"Ethiopian Music: Leul Sisay (kerehu enji) ልዑል ሢሣይ (ቀረሁ እንጂ) New Ethiopian Music 2018(Official Video) by Minew Shewa Tube 3 years ago 5 minutes, 46 seconds 530,846 views",Minew Shewa Entertainment,530846,533875,3029
2163,"Hawwii H Qananii ft Will Black Diamond (Africa) - New Ethiopian Music 2018(Official Video) by Minew Shewa Tube 3 years ago 4 minutes, 58 seconds 66,824 views",Minew Shewa Entertainment,66824,67055,231
2164,"Ethiopian music: Tsehaye Yohannes ፀሃዬ ዮሃንስ ማን እንደ እናት ማን እንደ ሀገር Ethiopian Music 2018 Official Video by Minew Shewa Tube 3 years ago 6 minutes, 46 seconds 3,581,309 views",Minew Shewa Entertainment,3581309,3612740,31431
2165,"Ethiopian Music: Abinet Shiferaw (Piassa) አብነት ሽፈራው (ፒያሳ) - New Ethiopian Music 2018(Official Video) by Minew Shewa Tube 3 years ago 5 minutes, 23 seconds 13,743 views",Minew Shewa Entertainment,13743,13758,15
2166,"Ethiopian Music: Mubarak Aba Gidi (Kuullee Oromiyaa) - New Ethiopian Music 2018(Official Video) by Minew Shewa Tube 3 years ago 6 minutes, 6 seconds 17,859 views",Minew Shewa Entertainment,17859,17880,21
2167,"Ethiopian Music: TGOD - Tesfa (ተስፋ) - New Ethiopian Music 2018(Official Video) by Minew Shewa Tube 3 years ago 4 minutes, 55 seconds 6,173 views",Minew Shewa Entertainment,6173,6182,9
2168,"Ethiopian Music: Shambel Belayneh ሻምበል በላይነህ ‘’እንደመር’’ Enedemer New Ethiopian music 2018 video. by Minew Shewa Tube 3 years ago 5 minutes, 38 seconds 263,238 views",Minew Shewa Entertainment,263238,263379,141
2169,"Dangerous Crossings Music Video - Yemen by Minew Shewa Tube 3 years ago 5 minutes, 25 seconds 10,542 views",Minew Shewa Entertainment,10542,10555,13
2170,"Ethiopian Music: Solomon Hailu ሰለሞን ኃይሉ (እያዩ መናፈቅ)  - New Ethiopian Music 2018(Official Video) by Minew Shewa Tube 3 years ago 6 minutes, 7 seconds 25,044 views",Minew Shewa Entertainment,25044,25054,10
2171,"Ethiopian Music: Asge Dendasho አስጌ ደንዳሾ (አርባምንጬፔ ሶዶ) - New Ethiopian Music 2018(Official Video) by Minew Shewa Tube 3 years ago 5 minutes, 20 seconds 91,726 views",Minew Shewa Entertainment,91726,91760,34
2172,"Ethiopian Music: Mafi Kassa ማፊ ካሳ (የፍቅርን ሰባኪ) - New Ethiopian Music 2018(Official Video) by Minew Shewa Tube 3 years ago 5 minutes, 30 seconds 37,081 views",Minew Shewa Entertainment,37081,37128,47
2173,"Ethiopian New Music: Tsilat Gezmu (Meriyo) ፅላት ገዝሙ (መሪዮ) - New Ethiopian Music 2018(Official Video) by Minew Shewa Tube 3 years ago 5 minutes, 24 seconds 68,343 views",Minew Shewa Entertainment,68343,68598,255
2174,"Ethiopian Music: Tsilat Gezmu ፅላት ገዝሙ (ና መሪዮ) - New Ethiopian Music 2018(Coming Soon Video) by Minew Shewa Tube 3 years ago 47 seconds 18,740 views",Minew Shewa Entertainment,18740,18758,18
2175,"Ethiopian Music: Dany Dance (Merkama) ዳኒ ዳንስ (መርካማ) - New Ethiopian Music 2018(Official Video) by Minew Shewa Tube 3 years ago 5 minutes, 41 seconds 29,069 views",Minew Shewa Entertainment,29069,29132,63
2176,"Ethiopian Music: Meskerem Girma መስከረም ግርማ (የቅኔ ተማሪ) - New Ethiopian Music 2018(Official Video) by Minew Shewa Tube 3 years ago 6 minutes, 23 seconds 19,448 views",Minew Shewa Entertainment,19448,19455,7
2177,"Ethiopian Music: Tesfahun Yebrishlij ተስፋሁን የብርሽ ልጅ (ኑና እንደመር)- Ethiopian Music 2018(Official Video) by Minew Shewa Tube 3 years ago 4 minutes, 15 seconds 25,362 views",Minew Shewa Entertainment,25362,25394,32
2178,"Ethiopian Music: Nehemiya Yo (Zim atbey) ነኸምያ (ዝም አትበይ)  - New Ethiopian Music 2018(Official Video) by Minew Shewa Tube 3 years ago 3 minutes, 38 seconds 19,413 views",Minew Shewa Entertainment,19413,19433,20
2179,"Ethiopian Music: Selamawit Teare ሰላማዊት ተአረ (ወለላዬ) - New Ethiopian Music 2018(Official Video) by Minew Shewa Tube 3 years ago 5 minutes, 13 seconds 39,694 views",Minew Shewa Entertainment,39694,39700,6
2180,"Ethiopian Music: Leul Sisay  ልዑል ሲሳይ(ቀረሁአንጂ) - New Ethiopian Music 2018(Coming Soon Video) by Minew Shewa Tube 3 years ago 1 minute, 4 seconds 17,557 views",Minew Shewa Entertainment,17557,17571,14
2181,"Ethiopian Music: Hareg Dagnew ሓረግ ዳኘው (ከወድኣኪ'የ ኣይትበለኒ)  - New Ethiopian Music 2018(Official Video) by Minew Shewa Tube 3 years ago 4 minutes, 37 seconds 9,399 views",Minew Shewa Entertainment,9399,9409,10
2182,"Ethiopian Music: Jano Band singing ኢትዮጵያ ሀገሬ live from Meskel Square - New Ethiopian Music 2018 by Minew Shewa Tube 3 years ago 53 seconds 17,908 views",Minew Shewa Entertainment,17908,17910,2
2183,"Ethiopian Music: መስፍን በቀለ ለጠቅላይ ሚኒስተር ዶ/ር አብይ አሀመድ የዘፈነለት ነጠላ ዜማ( የሰላም መሪ) New Ethiopian Music 2018. by Minew Shewa Tube 3 years ago 5 minutes, 12 seconds 789,971 views",Minew Shewa Entertainment,789971,790032,61
2184,"Ethiopian Music: Abela Asefa (አቤላ) ""አንድ እናት አንድ ሃገር"" New Ethiopian Music 2018(Official Video) by Minew Shewa Tube 3 years ago 5 minutes, 55 seconds 120,299 views",Minew Shewa Entertainment,120299,120335,36
2185,"Ethiopian Music: Shime (Ataregiewm) ሺሜ ሜሽ (ዳሙ) (አታረጊውም) - New Ethiopian Music 2018(Official Video) by Minew Shewa Tube 3 years ago 4 minutes, 14 seconds 42,169 views",Minew Shewa Entertainment,42169,42298,129
2186,"Ethiopian Music: Hewan(ሔዋን) - Adagn - አዳኝ (Jano Band) - Ethiopian Music 2018(Official Concert Video) by Minew Shewa Tube 3 years ago 5 minutes, 23 seconds 82,550 views",Minew Shewa Entertainment,82550,82755,205
2187,"Ethiopian Music: Berhanu Chala ብርሃኑ ጫላ (እንዲሻለኝ) - New Ethiopian Music 2018(Official Video) by Minew Shewa Tube 3 years ago 5 minutes, 59 seconds 40,788 views",Minew Shewa Entertainment,40788,40803,15
2188,"Ethiopian Music: Moges Ababu (Ferejina) ሞገስ አባቡ (ፍረጂና) - New Ethiopian Music 2018(Official Video) by Minew Shewa Tube 3 years ago 5 minutes, 21 seconds 119,453 views",Minew Shewa Entertainment,119453,119594,141
2189,"Ethiopian Music: DJ ጂ YE Amilteshal (አምልጠሻል) - New Ethiopian Music 2018(Official Video) by Minew Shewa Tube 3 years ago 5 minutes, 40 seconds 12,603 views",Minew Shewa Entertainment,12603,12612,9
2190,"Ethiopian Music: Belachew Tilahun - በላቸው ጥላሁን (አለምን በጄ) - New Ethiopian Music 2018(Official Video) by Minew Shewa Tube 3 years ago 4 minutes, 50 seconds 20,603 views",Minew Shewa Entertainment,20603,20621,18
2191,"Ethiopian Music: George ft. Sulamatif (Fetari) ፈጣሪ - New Ethiopian Music 2018(Official Video) by Minew Shewa Tube 3 years ago 5 minutes, 5 seconds 10,445 views",Minew Shewa Entertainment,10445,10447,2
2192,"Ethiopian music: Hailu ኃይሉ Yinegal ይነጋል -(Jano Band) - Ethiopian Music 2018(Official Concert Video) by Minew Shewa Tube 3 years ago 6 minutes, 1 second 105,661 views",Minew Shewa Entertainment,105661,105983,322
2193,"Ethiopian Music: Hana Shenkute ሃና ሸንቁጤ (አለው በለኝ) - New Ethiopian Music 2018(Official Video) by Minew Shewa Tube 3 years ago 6 minutes, 2 seconds 193,026 views",Minew Shewa Entertainment,193026,193311,285
2194,"Ethiopian Oromo music: Rabbirraa Guutamaa fi Lataa Tolaa (Fiqaaduu) Foollee -New Oromo Music 2018 by Minew Shewa Tube 3 years ago 8 minutes, 35 seconds 51,712 views",Minew Shewa Entertainment,51712,51725,13
2195,"Ethiopian Music: Mesay Bekele (Haneye) መሳይ በቀለ (ሃንዬ) - New Ethiopian Music 2018(Official Video) by Minew Shewa Tube 3 years ago 5 minutes, 19 seconds 33,537 views",Minew Shewa Entertainment,33537,33544,7
2196,"Ethiopian Music: Maritu Legesse (Ambassel) ማሪቱ ለገሰ (አማባሰል)- New Album coming soon! by Minew Shewa Tube 3 years ago 2 minutes, 35 seconds 52,082 views",Minew Shewa Entertainment,52082,52152,70
2197,"Ethiopian music: Ermias Kahsay (kokobey)ኤርምያስ ካህሳይ (ኮኾበይ) New Ethiopian Music 2018(Official Video) by Minew Shewa Tube 3 years ago 5 minutes, 11 seconds 87,539 views",Minew Shewa Entertainment,87539,87551,12
2198,"Halle (ሃሌ) - Gara Sir - ጋራ ስር  (Jano Band) - Ethiopian Music 2018(Official Concert Video) by Minew Shewa Tube 3 years ago 5 minutes, 19 seconds 242,291 views",Minew Shewa Entertainment,242291,243023,732
2199,"Ethiopian Music: Daniel Masresha - Akana ዳንኤል ማስረሻ - አካና - New Ethiopian Music 2018(Official Video) by Minew Shewa Tube 3 years ago 6 minutes, 43 seconds 162,190 views",Minew Shewa Entertainment,162190,162580,390
2200,"Jano Band: Dibekulu (ዲበኩሉ) Tiz Alegn (ትዝ አለኝ) - Ethiopian Music 2018(Official Concert Video) by Minew Shewa Tube 3 years ago 7 minutes, 2 seconds 62,597 views",Minew Shewa Entertainment,62597,62697,100
2201,"Ethiopian Music : Yapi Mapi Endei - ያፒ ማፒ እንድዒ - New Hip Hop Ethiopian Music 2018(Official Video) by Minew Shewa Tube 3 years ago 6 minutes, 34 seconds 212,148 views",Minew Shewa Entertainment,212148,212548,400
2202,"Ethiopian Music : Tamrat Desta ለታምራት ደስታ መታሰቢያ ሃይለየሱስ ፈይሳና ልጁ የሰሩት መዚቃ - New Ethiopian Music 2018 by Minew Shewa Tube 3 years ago 4 minutes, 27 seconds 86,190 views",Minew Shewa Entertainment,86190,86268,78
2203,"Ethiopian Music:Tadese Mekete ታደሰ መከተ ፀላም New Ethiopian Music 2018(Official Video) by Minew Shewa Tube 3 years ago 4 minutes, 53 seconds 310,565 views",Minew Shewa Entertainment,310565,312015,1450
2204,"Ethiopian Music: Trhas Tareke (Bel Wusedeni) - ትርሓስ ታረቀ (በል ውሰደኒ) - New Ethiopian Music 2018 by Minew Shewa Tube 3 years ago 5 minutes, 13 seconds 2,722,186 views",Minew Shewa Entertainment,2722186,2727773,5587
2205,"Abdoo Badhaasoo (Abbaa Dhibbaa) - New Ethiopian Oromo Music 2018(Official Video) by Minew Shewa Tube 3 years ago 6 minutes, 57 seconds 180,226 views",Minew Shewa Entertainment,180226,180593,367
2206,"Ethiopian Music : Semon ft Merkeb Bonitua (Asmategna) - ሴሞን እና መርከብ ቦኒቷ (አስማተኛ) - (Official Video) by Minew Shewa Tube 3 years ago 6 minutes, 11 seconds 186,560 views",Minew Shewa Entertainment,186560,186645,85
2207,"Semon ft Merkeb Bonitua (Asmategna) Promo Video by Minew Shewa Tube 3 years ago 49 seconds 7,109 views",Minew Shewa Entertainment,7109,7109,0
2208,"Saron Damte (Qonjo) - ሳሮን ዳምጤ (ቆንጆ) - New Ethiopian Music 2018(Official Video) by Minew Shewa Tube 3 years ago 5 minutes, 2 seconds 13,619 views",Minew Shewa Entertainment,13619,13631,12
2209,"Fitawurari Menehen new  ፊታውራሪ ምንህን ነው - Ethiopian New Music 2018(Official Video) by Minew Shewa Tube 3 years ago 5 minutes, 32 seconds 10,806 views",Minew Shewa Entertainment,10806,10808,2
2210,"Addislewet Girma - Mela (አዲስለውጥ ግርማ -  መላ) - Ethiopian New Music 2018(Official Video) by Minew Shewa Tube 3 years ago 4 minutes, 33 seconds 37,942 views",Minew Shewa Entertainment,37942,37946,4
2211,"Jano Band Music Video (Coming Soon) - Ethiopian Music 2018(Official Concert Video) by Minew Shewa Tube 3 years ago 1 minute, 59 seconds 4,805 views",Minew Shewa Entertainment,4805,4810,5
2212,"Abebaw Abebe ft. Ras Seyoum - Hilm Alegn -(ሕልም አለኝ ) - Ethiopian New Music 2018(Official Video) by Minew Shewa Tube 3 years ago 4 minutes, 23 seconds 8,648 views",Minew Shewa Entertainment,8648,8663,15
2213,"Ethiopian music Melaku Bireda (Tenber) መላኩ ቢረዳ (ትነብር) - New Ethiopian Music 2018(Official Video) by Minew Shewa Tube 3 years ago 5 minutes, 5 seconds 20,742 views",Minew Shewa Entertainment,20742,20793,51
2214,"Maebel Tadese ማዕበል ታደሰ - Ati Shikorey ኣቲ ሽኮረይ - New Ethiopian Music 2018(Official Video) by Minew Shewa Tube 3 years ago 5 minutes, 30 seconds 11,269 views",Minew Shewa Entertainment,11269,11275,6
2215,"Habesh Music Fest Promo Video by Minew Shewa Tube 3 years ago 1 minute 3,785 views",Minew Shewa Entertainment,3785,3785,0
2216,"Fikru Arage (ፍቅሩ አራጌ) - Kana ቃና - New Ethiopian Music 2018(Official Video) by Minew Shewa Tube 3 years ago 5 minutes 647,206 views",Minew Shewa Entertainment,647206,648003,797
2217,"Tesfaye Asefa (ተስፋዬ አሰፋ) - Ethiopia (ኢትዮጵያ) -  New Ethiopian Music 2018(Official Video) by Minew Shewa Tube 3 years ago 5 minutes, 39 seconds 17,264 views",Minew Shewa Entertainment,17264,17268,4
2218,"Keyanew - (ያራዳ ጨዋታ) ያቺ ሴት እንቁ ናት - New Ethiopian Music 2018 (Official Music Video ) by Minew Shewa Tube 3 years ago 3 minutes, 57 seconds 12,693 views",Minew Shewa Entertainment,12693,12697,4
2219,"Sura E & Sura H - (Reha) ሱራ ኢ እና ሱራ ኤች (ረሃ) by Minew Shewa Tube 3 years ago 4 minutes, 49 seconds 4,315 views",Minew Shewa Entertainment,4315,4317,2
2220,"Winta Teferi  (Salasibew new) | ዊንታ ተፈሪ (ሳላስበው ነው) - New Ethiopian Music 2018(Official Video) by Minew Shewa Tube 3 years ago 5 minutes, 2 seconds 31,771 views",Minew Shewa Entertainment,31771,31774,3
2221,"Tariku Sisay (Shenkore) - ታሪኩ ሲሳይ (ሸንኮሬ) - New Ethiopian Music 2018(Official Video) by Minew Shewa Tube 3 years ago 5 minutes, 24 seconds 329,229 views",Minew Shewa Entertainment,329229,329320,91
2222,"Winta Teferi (Christina Sweet) - (Salasbew New) | ዊንታ ተፈሪ - (ሳላስበው ነው) - Promo Video by Minew Shewa Tube 3 years ago 21 seconds 6,087 views",Minew Shewa Entertainment,6087,6088,1
2223,"Mykey Shewa Wushetam ማይኪ ሸዋ ውሸታም - New Ethiopian Music 2018(Official Video) by Minew Shewa Tube 3 years ago 4 minutes, 51 seconds 303,648 views",Minew Shewa Entertainment,303648,304523,875
2224,"Ethiopian music: Zenawi Hailemariam(Hanitey)ዜናዊ ሃይለማርያም ሃኒተይ New Ethiopian Music 2018 Official Video by Minew Shewa Tube 3 years ago 4 minutes, 41 seconds 467,326 views",Minew Shewa Entertainment,467326,468883,1557
2225,"mykey shewa promo video (ሚኪ ሸዋ) by Minew Shewa Tube 3 years ago 42 seconds 6,883 views",Minew Shewa Entertainment,6883,6885,2
2226,"Zenawi H/Mariam (Hanitey) ዜናዊ ሃይለማርያም (ሃኒተይ) by Minew Shewa Tube 3 years ago 44 seconds 7,554 views",Minew Shewa Entertainment,7554,7565,11
2227,"Ablex (arif aychekulem) አብሌክስ አሪፍ አይቸኩልም - New Ethiopian Music 2018 (Official Video) by Minew Shewa Tube 3 years ago 3 minutes, 47 seconds 61,425 views",Minew Shewa Entertainment,61425,61529,104
2228,"Elias Daniel - Amrobshal (ኤልያስ ዳንኤል - አምሮብሻል) - New Ethiopian Music 2018(Official Video) by Minew Shewa Tube 3 years ago 3 minutes, 58 seconds 14,507 views",Minew Shewa Entertainment,14507,14508,1
2229,"Dagazu Q (ዳጋዙ)  Tewugn Tewugn (ተዉኝ ተዉኝ) - New Ethiopian Music 2018 (Official Video) by Minew Shewa Tube 3 years ago 3 minutes, 42 seconds 13,837 views",Minew Shewa Entertainment,13837,13843,6
2230,"ለታምራት ደስታ - Mesfin Bekele (Mastawesha) መስፍን በቀለ (ማስታወሻ) by Minew Shewa Tube 3 years ago 2 minutes, 30 seconds 35,520 views",Minew Shewa Entertainment,35520,35530,10
2231,"ታደሰ መከተ (የኛማ ሙሽራ) Tadese Mekete (Yegnama Mushera) - New Ethiopian Wedding Music 2018(Official Video) by Minew Shewa Tube 3 years ago 13 minutes, 25 seconds 2,787,340 views",Minew Shewa Entertainment,2787340,2804392,17052
2232,"Tadese Mekete ታደሰ መከተ - Shinet ሽነት - New Ethiopian Music 2018(Official Video) by Minew Shewa Tube 3 years ago 6 minutes, 3 seconds 341,252 views",Minew Shewa Entertainment,341252,342784,1532
2233,"Tadese Mekete ታደሰ መከተ - Anchihoye አንቺሆዬ - New Ethiopian Music 2018(Official Video) by Minew Shewa Tube 3 years ago 10 minutes, 41 seconds 277,822 views",Minew Shewa Entertainment,277822,278940,1118
2234,"Tadese Mekete  ታደሰ መከተ - ደስ ያለው ቢኖር - New Ethiopian Music 2018(Official Video) by Minew Shewa Tube 3 years ago 5 minutes, 38 seconds 639,340 views",Minew Shewa Entertainment,639340,642494,3154
2235,"Tadese Mekete  ታደሰ መከተ - Hayloga  ሃይሎጋ - New Ethiopian Wedding Music 2018(Official Video) by Minew Shewa Tube 3 years ago 5 minutes, 53 seconds 625,205 views",Minew Shewa Entertainment,625205,628760,3555
2236,"Tadese Mekete  ታደሰ መከተ - Yalem የዓለም - New Ethiopian Music 2018(Official Video) by Minew Shewa Tube 3 years ago 3 minutes, 37 seconds 284,947 views",Minew Shewa Entertainment,284947,286270,1323
2237,"Tadese Mekete  ታደሰ መከተ - Mushiraye ጊዜ ለኩሉ - New Ethiopian Music 2018(Official Video) by Minew Shewa Tube 3 years ago 6 minutes, 52 seconds 222,908 views",Minew Shewa Entertainment,222908,223825,917
2238,"Tadese Mekete  ታደሰ መከተ - Aynuma አይኑማ - New Ethiopian Music 2018(Official Video) by Minew Shewa Tube 3 years ago 7 minutes, 36 seconds 376,016 views",Minew Shewa Entertainment,376016,377264,1248
2239,"Tadese Mekete  ታደሰ መከተ - yebete zemedu  የቤተ ዘመዱ - New Ethiopian Wedding Music 2018(Official Video) by Minew Shewa Tube 3 years ago 6 minutes, 14 seconds 247,831 views",Minew Shewa Entertainment,247831,248951,1120
2240,"Wendwesen ayehugn wenditwa by Minew Shewa Tube 3 years ago 3 minutes, 47 seconds 10,188 views",Minew Shewa Entertainment,10188,10190,2
2241,"Haymi  ሃይሚ - ላንተ ነው Lante New - New Ethiopian Music 2018(Official Video) by Minew Shewa Tube 3 years ago 3 minutes, 24 seconds 46,046 views",Minew Shewa Entertainment,46046,46075,29
2242,"Dj Dave  ዲጄ ዴቭ - Misha Misho ሚሻ ሚሾ  - New Ethiopian Music 2018(Official Video) by Minew Shewa Tube 3 years ago 3 minutes, 52 seconds 9,586 views",Minew Shewa Entertainment,9586,9602,16
2243,"Tadese Mekete  ታደሰ መከተ - Enkwan Aderesen እንኳን አደረሰን  - New Ethiopian Music 2018(Official Video) by Minew Shewa Tube 3 years ago 4 minutes, 28 seconds 1,329,598 views",Minew Shewa Entertainment,1329598,1332608,3010
2244,"ወይኔሽት ብርሃነ Woinshet Berhane - ታሃራሪ ላስት   - New Ethiopian Music 2018(Official Video) by Minew Shewa Tube 3 years ago 5 minutes, 15 seconds 11,746 views",Minew Shewa Entertainment,11746,11749,3
2245,"Hayleyesus Feyssa - ኃይለየሱስ ፈይሳ - Maal Tatte ማልታቴ - New Ethiopian Music 2018(Official Video) by Minew Shewa Tube 3 years ago 5 minutes, 2 seconds 1,199,342 views",Minew Shewa Entertainment,1199342,1211488,12146
2246,"Ethiopian music : Wubet Mekonnen - Ney Tolo(ነይ ቶሎ) - New Ethiopian Music 2018(Official Video) by Minew Shewa Tube 3 years ago 6 minutes, 48 seconds 334,110 views",Minew Shewa Entertainment,334110,334253,143
2247,"Ethiopian Music: Sinte Man - Endalay - New Ethiopian Music 2018(Official Video) by Minew Shewa Tube 3 years ago 4 minutes, 18 seconds 9,858 views",Minew Shewa Entertainment,9858,9862,4
2248,"Bujustar - Shaliwaya Konso - New Ethiopian Music 2018(Official Video) by Minew Shewa Tube 3 years ago 5 minutes, 4 seconds 17,867 views",Minew Shewa Entertainment,17867,18071,204
2249,"Fikaaduu Kidaanuu - Aarra Jennaan Boruu Jettee - New Ethiopian Music 2018(Official Video) by Minew Shewa Tube 3 years ago 4 minutes, 49 seconds 162,456 views",Minew Shewa Entertainment,162456,162486,30
2250,"Kuni - Agabaye(አጋባይ) - New Ethiopian Music 2018(Official Video) by Minew Shewa Tube 3 years ago 4 minutes, 24 seconds 9,823 views",Minew Shewa Entertainment,9823,9874,51
2251,"Mikaya Behailu - Wegen(ወገን) - New Ethiopian Music 2018(Official Video) by Minew Shewa Tube 3 years ago 5 minutes, 17 seconds 17,857 views",Minew Shewa Entertainment,17857,17910,53
2252,"Mikaya Behailu - Kabkhuna(ካብኩህና) - New Ethiopian Music 2018(Official Video) by Minew Shewa Tube 3 years ago 4 minutes, 55 seconds 60,395 views",Minew Shewa Entertainment,60395,60541,146
2253,"Mikaya Behailu - Enena Ante(እኔና አንተ) - New Ethiopian Music 2018(Official Video) by Minew Shewa Tube 3 years ago 7 minutes, 32 seconds 276,040 views",Minew Shewa Entertainment,276040,277438,1398
2254,"Mikaya Behailu - Akeme Sew(አቅሜ ሰው) - New Ethiopian Music 2018(Official Video) by Minew Shewa Tube 3 years ago 3 minutes, 38 seconds 87,855 views",Minew Shewa Entertainment,87855,88235,380
2255,"Mikaya Behailu - Hagere(ሀገሬ) - New Ethiopian Music 2018(Official Video) by Minew Shewa Tube 3 years ago 5 minutes, 27 seconds 94,961 views",Minew Shewa Entertainment,94961,95309,348
2256,"Temsegen Arega - Haye Bel(ሃየ በል) - New Ethiopian Music 2018(Official Video) by Minew Shewa Tube 3 years ago 5 minutes, 53 seconds 15,917 views",Minew Shewa Entertainment,15917,15924,7
2257,"Selam Mitiku - Ko Siini - New Ethiopian Oromo Music 2018(Official Video) by Minew Shewa Tube 3 years ago 4 minutes, 59 seconds 10,338 views",Minew Shewa Entertainment,10338,10358,20
2258,"Isaac Kidanemariam - Tefelalina(ተፈላሊና) - New Ethiopian Music 2018(Official Video) by Minew Shewa Tube 3 years ago 5 minutes, 15 seconds 11,328 views",Minew Shewa Entertainment,11328,11332,4
2259,"Mesenbet Semachew -  Kena Bel Ken Ale(ቀና በል ቀን አለ) - New Ethiopian Music 2018(Official Video) by Minew Shewa Tube 3 years ago 5 minutes 6,597 views",Minew Shewa Entertainment,6597,6601,4
2260,"Mohammed Raju - Selameta(ሰላምታ) - New Ethiopian Music 2018(Official Video) by Minew Shewa Tube 3 years ago 4 minutes, 47 seconds 6,021 views",Minew Shewa Entertainment,6021,6023,2
2261,"JAMMY Tribute to Haile Episode 1 by Minew Shewa Tube 3 years ago 3 minutes, 28 seconds 3,769 views",Minew Shewa Entertainment,3769,3772,3
2262,"Sisay Alemu - Fiker Dagnaw(ፍቅር ዳኛው) - New Ethiopian Music 2018(Official Video) by Minew Shewa Tube 3 years ago 5 minutes, 36 seconds 24,284 views",Minew Shewa Entertainment,24284,24302,18
2263,"Semegn Zegeye - Fera Teba(ፈራ ተባ) - New Ethiopian Music 2018(Official Video) by Minew Shewa Tube 3 years ago 5 minutes, 23 seconds 9,642 views",Minew Shewa Entertainment,9642,9646,4
2264,"Tihut Ahmed - Yene Keremt(የኔ ክረምት) - New Ethiopian Music 2018(Official Video) by Minew Shewa Tube 3 years ago 3 minutes, 52 seconds 10,116 views",Minew Shewa Entertainment,10116,10118,2
2265,"Beweket Setegn - Melanew(መላነው) - New Ethiopian Music 2018(Official Video) by Minew Shewa Tube 3 years ago 5 minutes, 19 seconds 39,020 views",Minew Shewa Entertainment,39020,39106,86
2266,"Wubeshet Niguse - Nelfe(ነለፍ) - New Ethiopian Music 2018(Official Video) by Minew Shewa Tube 3 years ago 4 minutes, 53 seconds 3,276 views",Minew Shewa Entertainment,3276,3277,1
2267,"Ethiopian Music : Tibebe Adferes ጥበበ አደፍርስ (ቀሰቀሰኝ ፍቅርሽ) New Ethiopian Music 2018 Official Video by Minew Shewa Tube 3 years ago 5 minutes, 44 seconds 816,657 views",Minew Shewa Entertainment,816657,817008,351
2268,"Workalamahu Girma - Tergagi(ተረጋጊ) - New Ethiopian Music 2018(Official Video) by Minew Shewa Tube 3 years ago 4 minutes, 39 seconds 4,018 views",Minew Shewa Entertainment,4018,4024,6
2269,"Abebaw Getachew Ft. Jiregna shiferaw - Kuratua(ኩራቷ) - New Ethiopian Music 2018(Official Video) by Minew Shewa Tube 3 years ago 4 minutes, 57 seconds 8,354 views",Minew Shewa Entertainment,8354,8375,21
2270,"Wondu woyesa & Amare Sonko - Ottana - New Ethiopian Music 2018(Official Video) by Minew Shewa Tube 3 years ago 5 minutes, 39 seconds 6,007 views",Minew Shewa Entertainment,6007,6015,8
2271,"Shumet Andarge - Menuanesh(ምኗነሽ) - New Ethiopian Music 2018(Official Video) by Minew Shewa Tube 3 years ago 5 minutes, 47 seconds 64,238 views",Minew Shewa Entertainment,64238,64242,4
2272,"Kifle Wosene - Umelgela(ኡመልጌላ) - New Ethiopian Music 2018(Official Video) by Minew Shewa Tube 3 years ago 4 minutes, 11 seconds 3,857 views",Minew Shewa Entertainment,3857,3896,39
2273,"Ethiopia Esayas - Na Wede(ና ውዴ) - New Ethiopian Music 2018(Official Video) by Minew Shewa Tube 3 years ago 5 minutes, 33 seconds 108,769 views",Minew Shewa Entertainment,108769,108791,22
2274,"Tsegaye Mengesha - Enjalegn(እንጃልኝ) - New Ethiopian Music 2018(Official Video) by Minew Shewa Tube 3 years ago 5 minutes, 32 seconds 16,923 views",Minew Shewa Entertainment,16923,16931,8
2275,"Fasikaw Andargie - Ye Sew Eda(የሰው እዳ) - New Ethiopian Music 2018(Official Video) by Minew Shewa Tube 3 years ago 5 minutes, 14 seconds 6,569 views",Minew Shewa Entertainment,6569,6574,5
2276,"Agare Lagassa - Waal Barbaana - New Ethiopian Music 2018(Official Video) by Minew Shewa Tube 3 years ago 5 minutes, 5 seconds 3,152 views",Minew Shewa Entertainment,3152,3155,3
2277,"Moflix Ft. Dave - Weyeyet(ውይይት) - New Ethiopian Music 2018(Official Video) by Minew Shewa Tube 3 years ago 4 minutes, 35 seconds 5,651 views",Minew Shewa Entertainment,5651,5651,0
2278,"Yordanos Gebrekidan - Ruhena(ሩሕና) - New Ethiopian Music 2018(Official Video by Minew Shewa Tube 3 years ago 5 minutes, 25 seconds 22,821 views",Minew Shewa Entertainment,22821,22866,45
2279,"Fantahun Girma - Selame(ሰላሜ) - New Ethiopian Music 2018(Official Video) by Minew Shewa Tube 3 years ago 3 minutes, 42 seconds 24,089 views",Minew Shewa Entertainment,24089,24113,24
2280,"Oromo music :Desalegn  Bekema - Asimba(አሲምባ) - New Ethiopian Oromo Music 2018(Official Video) by Minew Shewa Tube 3 years ago 5 minutes, 31 seconds 688,504 views",Minew Shewa Entertainment,688504,689739,1235
2281,"Dere Hab - Asebeshalhu - New Ethiopian Music 2018(Official Video) by Minew Shewa Tube 3 years ago 4 minutes, 11 seconds 10,561 views",Minew Shewa Entertainment,10561,10579,18
2282,"Fano - Yewebdar(የውብዳር) - New Ethiopian Music 2018(Official Video) by Minew Shewa Tube 3 years ago 3 minutes 29,470 views",Minew Shewa Entertainment,29470,29501,31
2283,"Tizazu Beteru - Degageme(ደጋግሜ) - New Ethiopian Music 2018(Official Video) by Minew Shewa Tube 3 years ago 4 minutes, 58 seconds 4,417 views",Minew Shewa Entertainment,4417,4426,9
2284,"Tizazu Beteru - Hagern(ሀገሬን) - New Ethiopian Music 2018(Official Video) by Minew Shewa Tube 3 years ago 5 minutes, 37 seconds 7,128 views",Minew Shewa Entertainment,7128,7138,10
2285,"Mulat Araya - Hji Grm - Ethiopian Music 2018(Official Video) by Minew Shewa Tube 3 years ago 7 minutes, 25 seconds 42,217 views",Minew Shewa Entertainment,42217,42224,7
2286,"Tebeyen Yigezaw - Metahu Tereteche(መጣሁ ተረትቼ) - Ethiopian Music 2018(Official Video) by Minew Shewa Tube 3 years ago 5 minutes, 18 seconds 21,151 views",Minew Shewa Entertainment,21151,21179,28
2287,"Roobbaa Dhaddacha - Kooyii Jalalaa - Ethiopian Music 2018(Official Video) by Minew Shewa Tube 3 years ago 4 minutes, 33 seconds 3,557 views",Minew Shewa Entertainment,3557,3561,4
2288,"Ashenafi Mubarek - Ney Demo(ነይ ደሞ) - New Ethiopian Music 2018(Official Video) by Minew Shewa Tube 4 years ago 4 minutes, 58 seconds 10,022 views",Minew Shewa Entertainment,10022,10039,17
2289,"Dj Dulas ft. Dagy Lion - Hello Africa - New Ethiopian Music 2018(Official Video) by Minew Shewa Tube 4 years ago 4 minutes, 28 seconds 7,599 views",Minew Shewa Entertainment,7599,7606,7
2290,"Genet Wase - Shemunmun(ሽሙንሙን) - New Ethiopian Music 2018(Official Video) by Minew Shewa Tube 4 years ago 6 minutes, 4 seconds 3,656 views",Minew Shewa Entertainment,3656,3662,6
2291,"Lij Kasesh - Molashew(ሞላሽው) - Ethiopian Music 2018(Official Video) by Minew Shewa Tube 4 years ago 4 minutes, 50 seconds 7,869 views",Minew Shewa Entertainment,7869,7870,1
2292,"Elias Getachew - Bel Yazat(በል ያዛት) - Ethiopian Music 2018(Official Video) by Minew Shewa Tube 4 years ago 4 minutes, 21 seconds 13,877 views",Minew Shewa Entertainment,13877,13890,13
2293,"Yohannes Feleke - Abichu - New Ethiopian Music 2018(Official Video) by Minew Shewa Tube 4 years ago 5 minutes, 27 seconds 9,301 views",Minew Shewa Entertainment,9301,9371,70
2294,"Desalew Mola - Gojam Agew Midir(ጎጃም አገው) - Ethiopian Music 2018(Official Video) by Minew Shewa Tube 4 years ago 6 minutes, 43 seconds 80,841 views",Minew Shewa Entertainment,80841,80919,78
2295,"Tesfaye Yenewe - Tatmeshal(ታትመሻል) - Ethiopian Music 2018(Official Video) by Minew Shewa Tube 4 years ago 5 minutes, 40 seconds 8,551 views",Minew Shewa Entertainment,8551,8556,5
2296,"Wubanchi Amare - Yeduk Lijoch(የዱክ ልጆች) - Ethiopian Music 2018(Official Video) by Minew Shewa Tube 4 years ago 5 minutes, 32 seconds 7,060 views",Minew Shewa Entertainment,7060,7064,4
2297,"Alemu Geta - Ambel Jera(አምቤል ጄራ) - Ethiopian Music 2018(Official Video) by Minew Shewa Tube 4 years ago 5 minutes, 6 seconds 10,249 views",Minew Shewa Entertainment,10249,10255,6
2298,"Abel Zeru - Fiyori(ፊዮሪ) - New Ethiopian Music 2018(Official Video) by Minew Shewa Tube 4 years ago 4 minutes, 11 seconds 28,258 views",Minew Shewa Entertainment,28258,28356,98
2299,"Abiselom Tsegaye Ft. Minyahil Tadele - Melaye(መላዬ) - Ethiopian Music 2018(Official Video) by Minew Shewa Tube 4 years ago 4 minutes, 28 seconds 10,657 views",Minew Shewa Entertainment,10657,10714,57
2300,"workneh Asrat - Twedaje(ተወዳጅ) - Ethiopian Music 2018(Official Video) by Minew Shewa Tube 4 years ago 5 minutes, 48 seconds 90,714 views",Minew Shewa Entertainment,90714,90772,58
2301,"Kepaso Daygo - Hip Hop(ሂፕ ሀፕ) - Ethiopian Music 2018(Official Video) by Minew Shewa Tube 4 years ago 4 minutes 78,848 views",Minew Shewa Entertainment,78848,79201,353
2302,"Birhanu Taye (Medanite) ብርሃኑ ታዬ(መዳኒቴ) - New Ethiopian Music 2018(Official Video) by Minew Shewa Tube 4 years ago 5 minutes, 9 seconds 202,443 views",Minew Shewa Entertainment,202443,202703,260
2303,"Tsehaye Kinfe - Mare(መኣር) - Ethiopian Music 2018(Official Video) by Minew Shewa Tube 4 years ago 6 minutes, 18 seconds 56,003 views",Minew Shewa Entertainment,56003,56017,14
2304,"Samri - Wekyanosu(ውቅያኖሱ) - Ethiopian Music 2018(Official Video) by Minew Shewa Tube 4 years ago 5 minutes, 25 seconds 29,683 views",Minew Shewa Entertainment,29683,29719,36
2305,"Abebaw Abebe - Yager Yalehe(ያገር ያለህ) - Ethiopian Music 2018(Official Video) by Minew Shewa Tube 4 years ago 5 minutes, 18 seconds 13,790 views",Minew Shewa Entertainment,13790,13797,7
2306,"JAMMY as Donald Trump - (Official Video 2018) by Minew Shewa Tube 4 years ago 4 minutes, 47 seconds 9,925 views",Minew Shewa Entertainment,9925,9927,2
2307,"Bety Beta - Yefikir Kaba(የፍቅር ካባ) - Ethiopian Music 2018(Official Video) by Minew Shewa Tube 4 years ago 4 minutes, 55 seconds 53,348 views",Minew Shewa Entertainment,53348,53384,36
2308,"Asni Raga - Haysi - Ethiopian Music 2018(Official Video) by Minew Shewa Tube 4 years ago 4 minutes, 55 seconds 12,169 views",Minew Shewa Entertainment,12169,12170,1
2309,"Ab Man - Melke Becha(መልክ ብቻ) - Ethiopian Music 2018(Official Video) by Minew Shewa Tube 4 years ago 3 minutes, 50 seconds 6,929 views",Minew Shewa Entertainment,6929,6931,2
2310,"Ethiopian music: Derejaw Habete - Baso(ባሶ) - Ethiopian Music 2018(Official Video) by Minew Shewa Tube 4 years ago 6 minutes, 6 seconds 376,868 views",Minew Shewa Entertainment,376868,377173,305
2311,"Habtamu Taddesse(Sancho) - Konjo(ቆንጆ) - Ethiopian Music 2018(Official Video) by Minew Shewa Tube 4 years ago 3 minutes, 49 seconds 40,304 views",Minew Shewa Entertainment,40304,40323,19
2312,"Ethiopian music: Merewa Choir - Negeru Endet New(ነገሩ እንዴት ነው) - Ethiopian Music 2018(Official Video) by Minew Shewa Tube 4 years ago 5 minutes, 14 seconds 1,097,405 views",Minew Shewa Entertainment,1097405,1099246,1841
2313,"Young Same,Tarik Thug & Moch Thug FT. Bitaniya - Kene Erekesh - Ethiopian Music 2018(Official Video) by Minew Shewa Tube 4 years ago 4 minutes, 16 seconds 14,426 views",Minew Shewa Entertainment,14426,14426,0
2314,"Michael Belayneh - Sike Eshegnishalehu(ስቄ እሸኝሻለሁ) - Ethiopian Music 2018(Official Video) by Minew Shewa Tube 4 years ago 5 minutes, 49 seconds 17,012 views",Minew Shewa Entertainment,17012,17057,45
2315,"Sami Dan &  Maki X UPON -Ye Fikirachin Ken [የፍቅራችን ቀን ] (UPON MIX) (Lyrics Video) by Minew Shewa Tube 4 years ago 4 minutes, 41 seconds 11,540 views",Minew Shewa Entertainment,11540,11570,30
2316,"Yared Negu And Miki Gonderegna - Shege The Making Final 2018(Official Video) by Minew Shewa Tube 4 years ago 10 minutes 16,051 views",Minew Shewa Entertainment,16051,16065,14
2317,"Ethiopian music: Binu Solomon - Ewedeshalhu(እወድሻለሁ) - NewEthiopian Music 2018(Official Video) by Minew Shewa Tube 4 years ago 4 minutes, 56 seconds 517,633 views",Minew Shewa Entertainment,517633,518544,911
2318,"MuluHabet Ayalew - Temcheshign(ተመቸሺኝ) - Ethiopian Music 2018(Official Video) by Minew Shewa Tube 4 years ago 5 minutes, 36 seconds 29,002 views",Minew Shewa Entertainment,29002,29003,1
2319,"Yared Mesfin - Letebek Wereta(ልጠብቅ ወረታ) - Ethiopian Music 2018(Official Video) by Minew Shewa Tube 4 years ago 5 minutes, 11 seconds 147,941 views",Minew Shewa Entertainment,147941,148058,117
2320,"Awwal Abduu - KA'II - Ethiopian Oromo Music 2018(Official Video) by Minew Shewa Tube 4 years ago 4 minutes, 30 seconds 25,065 views",Minew Shewa Entertainment,25065,25286,221
2321,"Ethiopian music: leul berhe - Weyzero Hana(ወይዘሮ ሃና) - New Ethiopian Music 2018(Official Video) by Minew Shewa Tube 4 years ago 6 minutes, 43 seconds 64,216 views",Minew Shewa Entertainment,64216,64225,9
2322,"Abraham Kasahun -  Kantan(ካንታን) - Ethiopian Music 2018(Official Video) by Minew Shewa Tube 4 years ago 5 minutes, 34 seconds 30,656 views",Minew Shewa Entertainment,30656,30694,38
2323,"Ratheesh R.Chandran - Yalfal(ያልፋል) - Ethiopian Music 2018(Official Video) by Minew Shewa Tube 4 years ago 4 minutes, 10 seconds 84,266 views",Minew Shewa Entertainment,84266,84276,10
2324,"Banchiamlak Mekonnen - Chewa(ጨዋ) - Ethiopian Music 2018(Official Video) by Minew Shewa Tube 4 years ago 4 minutes, 38 seconds 14,402 views",Minew Shewa Entertainment,14402,14406,4
2325,"Dj Yo Ft. Hasset Blata - Melishiwe(መልሺው) - Ethiopian Music 2018(Official Video) by Minew Shewa Tube 4 years ago 3 minutes, 51 seconds 24,455 views",Minew Shewa Entertainment,24455,24463,8
2326,"Tsegay Solomon(T IBEX) - Limitless Love - Ethiopian Music 2018(Official Video) by Minew Shewa Tube 4 years ago 4 minutes, 51 seconds 13,541 views",Minew Shewa Entertainment,13541,13578,37
2327,"Endashaw Mengistu - Fikera Sitara(ፍቅሬ ስጣራ) - Ethiopian Music 2018(Official Video) by Minew Shewa Tube 4 years ago 4 minutes, 21 seconds 27,195 views",Minew Shewa Entertainment,27195,27203,8
2328,"Merhatsdk - Etye(እትዬ) - Ethiopian Music 2018(Official Video) by Minew Shewa Tube 4 years ago 4 minutes, 44 seconds 24,450 views",Minew Shewa Entertainment,24450,24452,2
2329,"Solomon Gebremichael - Tsilaley(ፅላለይ) - Ethiopian Music 2018(Official Video) by Minew Shewa Tube 4 years ago 5 minutes, 49 seconds 59,137 views",Minew Shewa Entertainment,59137,59171,34
2330,"Magie - Desta Seto(ደስታ ሰቶ) - Ethiopian Music 2018(Despacito Amaric Cover Official Video) by Minew Shewa Tube 4 years ago 4 minutes, 41 seconds 560,129 views",Minew Shewa Entertainment,560129,561102,973
2331,"Ethiopian Music: Aweke Abebe - Tikesat Tikesat(ጥቀሳት ጥቀሳት) - Ethiopian Music 2018(Official Video) by Minew Shewa Tube 4 years ago 5 minutes, 17 seconds 17,597 views",Minew Shewa Entertainment,17597,17628,31
2332,"Ethiopian music : Mieraf Assefa - Agul(አጉል) - Ethiopian Music 2018(Official Video) by Minew Shewa Tube 4 years ago 5 minutes, 29 seconds 2,008,736 views",Minew Shewa Entertainment,2008736,2010585,1849
2333,"kahasay Tsegaye - Emuashiteye(እሟሺተይ) - Ethiopian Music 2018(Official Video) by Minew Shewa Tube 4 years ago 4 minutes, 49 seconds 67,871 views",Minew Shewa Entertainment,67871,67886,15
2334,"Oromo music: Meseret Girma - Simalee - Ethiopian Oromo Music 2018(Official Video) by Minew Shewa Tube 4 years ago 4 minutes, 23 seconds 41,124 views",Minew Shewa Entertainment,41124,41162,38
2335,"Kiberom Haftu(KB) - Ayechelem(አይችልም) - Ethiopian Music 2018(Official Video) by Minew Shewa Tube 4 years ago 4 minutes, 3 seconds 19,282 views",Minew Shewa Entertainment,19282,19286,4
2336,"Baayisaa Asmaraa - Baareduu Oromiyaa - Ethiopian Oromo Music 2018(Official Video) by Minew Shewa Tube 4 years ago 3 minutes, 52 seconds 12,065 views",Minew Shewa Entertainment,12065,12091,26
2337,"Bazu Man (Ye Dejen Lej) - Ameseginalhu(አመሰግናለሁ) - Ethiopian Music 2018(Official Video) by Minew Shewa Tube 4 years ago 4 minutes, 56 seconds 45,288 views",Minew Shewa Entertainment,45288,45330,42
2338,"Ethiopian Music : Ahadu - Asina Genaye (Feat. Stif Lion, Jahphate, Beferdu, Ezra, Kuki, Haileab) by Minew Shewa Tube 4 years ago 4 minutes, 26 seconds 142,582 views",Minew Shewa Entertainment,142582,143112,530
2339,"Girum Shemeles  - Adey(አደይ) - Ethiopian Music 2018(Official Video) by Minew Shewa Tube 4 years ago 4 minutes, 39 seconds 23,897 views",Minew Shewa Entertainment,23897,23907,10
2340,"Kenny Allen - Belu Ene Desset(በሉ እንደሰት) - Ethiopian Music 2018(Official Video) by Minew Shewa Tube 4 years ago 4 minutes, 37 seconds 18,458 views",Minew Shewa Entertainment,18458,18480,22
2341,"Abush Zeleke - Bayneges Minew(ባይነገስ ምንነው) - Ethiopian Music 2018(Official Video) by Minew Shewa Tube 4 years ago 5 minutes, 39 seconds 523,507 views",Minew Shewa Entertainment,523507,523573,66
2342,"Ethiopian music: Winta Birhane - Yeblo(ይበሎ) - Ethiopian Music 2018(Official Video) by Minew Shewa Tube 4 years ago 6 minutes, 12 seconds 2,917,159 views",Minew Shewa Entertainment,2917159,2919484,2325
2343,"Ethiopian music: Yeshi Birhane - Selel Beleley(ሰለል በለለይ) - Ethiopian Music(Official Video) by Minew Shewa Tube 4 years ago 6 minutes, 12 seconds 1,743,477 views",Minew Shewa Entertainment,1743477,1746808,3331
2344,"Sewayehu Zewede - Wachibe(ዋቺቤ) - Ethiopian Music(Official Video) by Minew Shewa Tube 4 years ago 4 minutes, 55 seconds 9,649 views",Minew Shewa Entertainment,9649,9650,1
2345,"Nibret Gebreab - Biserash(ቢሰራሽ) - Ethiopian Music(Official Video) by Minew Shewa Tube 4 years ago 5 minutes, 44 seconds 101,849 views",Minew Shewa Entertainment,101849,101864,15
2346,"Ethiopian music: Kinfe Teklay Abea Enahalkume(ኣብኣ እናሃላኩሜ) Ethiopian Tigiregna Music(Official Video) by Minew Shewa Tube 4 years ago 6 minutes, 8 seconds 423,650 views",Minew Shewa Entertainment,423650,423800,150
2347,"Tekele Hafte - Helaweye(ህላወይ) - Ethiopian Tigrigna Music(Official Video) by Minew Shewa Tube 4 years ago 5 minutes, 2 seconds 9,492 views",Minew Shewa Entertainment,9492,9492,0
2348,"Khord - Give Me Love - Ethiopian Music(Official Video) by Minew Shewa Tube 4 years ago 3 minutes, 45 seconds 16,428 views",Minew Shewa Entertainment,16428,16428,0
2349,"Ethiopian music : Ya Lij - Weyehulesh(ወየሁልሽ) - Ethiopian New Music(Official Video) by Minew Shewa Tube 4 years ago 4 minutes, 48 seconds 98,205 views",Minew Shewa Entertainment,98205,98276,71
2350,"Mikaya Behailu - Yelibe Mugit(የልቤ ሙግት) - Ethiopian Music(Official Video) by Minew Shewa Tube 4 years ago 5 minutes, 38 seconds 173,781 views",Minew Shewa Entertainment,173781,174062,281
2351,"Ethiopian music: Helen Tesfaye - Kuhulay(ኩሕላይ) - Ethiopian Tigrigna Music(Official Video) by Minew Shewa Tube 4 years ago 4 minutes, 56 seconds 200,222 views",Minew Shewa Entertainment,200222,200435,213
2352,"Milkii Girmaa - Ashaa - Ethiopian Oromo Music(Official Video) by Minew Shewa Tube 4 years ago 5 minutes, 9 seconds 17,450 views",Minew Shewa Entertainment,17450,17601,151
2353,"Tigrigna music :Teklu Yohannes - Gashaye Temtsea ala(ጋሻይ ትመፅእ ኣላ) - Ethio & Eritrean Tigrigna Music by Minew Shewa Tube 4 years ago 7 minutes, 9 seconds 123,561 views",Minew Shewa Entertainment,123561,123568,7
2354,"Tesfaye Taye - Dawuro(ዳውሮ) - Ethiopian Music(Official Video) by Minew Shewa Tube 4 years ago 5 minutes, 33 seconds 28,671 views",Minew Shewa Entertainment,28671,28860,189
2355,"The Jammy Show Teaser (Official Video) by Minew Shewa Tube 4 years ago 1 minute, 13 seconds 3,176 views",Minew Shewa Entertainment,3176,3176,0
2356,"Ketii Aschalew (Bareedakoo) - New Ethiopian Oromo Music 2018(Official Video) by Minew Shewa Tube 4 years ago 4 minutes, 53 seconds 133,447 views",Minew Shewa Entertainment,133447,134015,568
2357,"Ashenafi Solomone Ft.Temu - Agegnetoshal(አግኝቶሻል) - Ethiopian Music(Official Video) by Minew Shewa Tube 4 years ago 3 minutes, 30 seconds 10,122 views",Minew Shewa Entertainment,10122,10125,3
2358,"Tgist Melaku(Betty) - Befelga(በፍለጋ) - Ethiopian Music (Official Video) by Minew Shewa Tube 4 years ago 4 minutes, 9 seconds 5,265 views",Minew Shewa Entertainment,5265,5273,8
2359,"Ethiopian music : Haftom G/Michael - Welelaaton(ወለላኣተን) - Ethiopian Tigrigna Music (Official Video) by Minew Shewa Tube 4 years ago 4 minutes, 57 seconds 2,027,415 views",Minew Shewa Entertainment,2027415,2028248,833
2360,"Ethiopian music : Nhatty Man -Ande Yibeltal Kemeto(አንድ ይበልጣል ከመቶ) -Ethiopian Music (Official Video) by Minew Shewa Tube 4 years ago 4 minutes, 27 seconds 241,869 views",Minew Shewa Entertainment,241869,242128,259
2361,"Almnhe Semnhe - Yemjemriyaye(የመጀመርያዬ) - New Ethiopian Music 2017(Official Video) by Minew Shewa Tube 4 years ago 3 minutes, 50 seconds 19,005 views",Minew Shewa Entertainment,19005,19015,10
2362,"New Album:- Nhatty Man - ናቲ ማን - Coming Soon... by Minew Shewa Tube 4 years ago 2 minutes, 23 seconds 52,815 views",Minew Shewa Entertainment,52815,52850,35
2363,"Asaffaa Yaadasaa - Otuma Jirruu - New Ethiopian Oromo Music 2017(Official Video) by Minew Shewa Tube 4 years ago 5 minutes, 11 seconds 10,137 views",Minew Shewa Entertainment,10137,10149,12
2364,"King Teddy - Mogna Mogne(ሞኛ ሞኜ) - New Ethiopian Music 2017(Official Audio) by Minew Shewa Tube 4 years ago 4 minutes 7,478 views",Minew Shewa Entertainment,7478,7487,9
2365,"King Teddy - Demke(ደመቀ) - New Ethiopian Music 2017(Official Audio) by Minew Shewa Tube 4 years ago 4 minutes, 10 seconds 8,171 views",Minew Shewa Entertainment,8171,8177,6
2366,"King Teddy - Guaro Le Guaro(ጓሮ ለጓሮ) - New Ethiopian Music 2017(Official Audio) by Minew Shewa Tube 4 years ago 3 minutes, 4 seconds 5,007 views",Minew Shewa Entertainment,5007,5010,3
2367,"King Teddy - Lejenete(ልጅነቴ) - New Ethiopian Music 2017(Official Audio) by Minew Shewa Tube 4 years ago 4 minutes, 29 seconds 5,310 views",Minew Shewa Entertainment,5310,5314,4
2368,"King Teddy - Shekor Ethiopia(ሽኮር ኢትዮጲያ) - New Ethiopian Music 2017(Official Audio) by Minew Shewa Tube 4 years ago 4 minutes, 12 seconds 13,995 views",Minew Shewa Entertainment,13995,14001,6
2369,"King Teddy - Ayeno(ዓይኖ) - New Ethiopian Music 2017(Official Audio) by Minew Shewa Tube 4 years ago 3 minutes, 39 seconds 6,554 views",Minew Shewa Entertainment,6554,6558,4
2370,"King Teddy - Selele Beli(ሰለል በሊ) - New Ethiopian Music 2017(Official Audio) by Minew Shewa Tube 4 years ago 4 minutes, 22 seconds 7,093 views",Minew Shewa Entertainment,7093,7099,6
2371,"King Teddy - Addis Hiyewet(አዲስ ህይወት) - New Ethiopian Music 2017(Official Audio) by Minew Shewa Tube 4 years ago 3 minutes, 59 seconds 7,270 views",Minew Shewa Entertainment,7270,7271,1
2372,"King Teddy - Denk Fetur(ድንቅ ፍጡር) - New Ethiopian Music 2017(Official Audio) by Minew Shewa Tube 4 years ago 4 minutes, 59 seconds 6,397 views",Minew Shewa Entertainment,6397,6398,1
2373,"King Teddy - Unite(ዩናይት) - New Ethiopian Music 2017(Official Audio) by Minew Shewa Tube 4 years ago 4 minutes, 53 seconds 3,568 views",Minew Shewa Entertainment,3568,3569,1
2374,"King Teddy - Er Tew(እረ ተው) - New Ethiopian Music 2017(Official Audio) by Minew Shewa Tube 4 years ago 4 minutes, 36 seconds 9,929 views",Minew Shewa Entertainment,9929,9936,7
2375,"Ethiopian music : Elsaa Nugusee - Tuulamarraan - New Ethiopian Oromo Music 2017(Official Video) by Minew Shewa Tube 4 years ago 5 minutes, 24 seconds 5,242,627 views",Minew Shewa Entertainment,5242627,5278345,35718
2376,"King Teddy - Demaye(ደማዬ) - New Ethiopian Music 2017(Official Audio) by Minew Shewa Tube 4 years ago 4 minutes, 46 seconds 21,135 views",Minew Shewa Entertainment,21135,21145,10
2377,"King Teddy - Alme(አለሜ) - New Ethiopian Music 2017(Official Audio) by Minew Shewa Tube 4 years ago 5 minutes, 5 seconds 21,019 views",Minew Shewa Entertainment,21019,21027,8
2378,"King Teddy - Desta(ደስታ) - New Ethiopian Music 2017(Official Audio) by Minew Shewa Tube 4 years ago 4 minutes, 19 seconds 13,972 views",Minew Shewa Entertainment,13972,13975,3
2379,"Mebrat Nigussie - Liben Setehu(ልቤን ሰተሁ) - New Ethiopian Music 2017 (Official Video) by Minew Shewa Tube 4 years ago 3 minutes, 56 seconds 4,443 views",Minew Shewa Entertainment,4443,4448,5
2380,"Ethiopian music : Henok Abebe - Ema Enate(እማ(እናቴ) - New Ethiopian Music 2017(Official Video) by Minew Shewa Tube 4 years ago 6 minutes, 28 seconds 1,110,486 views",Minew Shewa Entertainment,1110486,1113865,3379
2381,"3G - Gualiya Gebre(ጓል ኣያ ገብረ) - New Ethiopian Tigrigna Music 2017(Official Video) by Minew Shewa Tube 4 years ago 5 minutes, 40 seconds 100,159 views",Minew Shewa Entertainment,100159,100194,35
2382,"Thomas Mekonen - Mete'abity(መተዓቢተይ) - New Ethiopian Music 2017(Official Video) by Minew Shewa Tube 4 years ago 5 minutes, 44 seconds 22,881 views",Minew Shewa Entertainment,22881,22885,4
2383,"kifle Wosene - Warstere - New Ethiopian Music 2017(Official Video) by Minew Shewa Tube 4 years ago 5 minutes, 14 seconds 37,075 views",Minew Shewa Entertainment,37075,37349,274
2384,"Zenbe Tesfaye - Genteya(ገነት'ያ) - New Ethiopian Music 2017(Official Video) by Minew Shewa Tube 4 years ago 4 minutes, 48 seconds 12,829 views",Minew Shewa Entertainment,12829,12832,3
2385,"Ethiopian music ; Nazerit Hailemariam - Nama(ናማ) - New Ethiopian Music 2017(Official Video) by Minew Shewa Tube 4 years ago 4 minutes, 56 seconds 42,188 views",Minew Shewa Entertainment,42188,42205,17
2386,"Ittiiqaa Tafarii - Didi Didi - New Oromo Music 2017(Official Video) by Minew Shewa Tube 4 years ago 7 minutes, 16 seconds 65,895 views",Minew Shewa Entertainment,65895,66209,314
2387,"Ittiiqaa Tafarii - Kiyyoo Jaalalaa - New Oromo Music 2017(Official Video) by Minew Shewa Tube 4 years ago 6 minutes, 53 seconds 343,559 views",Minew Shewa Entertainment,343559,345719,2160
2388,"Ittiiqaa Tafarii - Loomiitoo - New Oromo Music 2017(Official Video) by Minew Shewa Tube 4 years ago 4 minutes, 43 seconds 98,724 views",Minew Shewa Entertainment,98724,99081,357
2389,"Ittiiqaa Tafarii - Dura Bahaa - New Oromo Music 2017(Official Video) by Minew Shewa Tube 4 years ago 5 minutes, 59 seconds 69,455 views",Minew Shewa Entertainment,69455,69695,240
2390,"Ittiiqaa Tafarii - Ishururuu - New Oromo Music 2017(Official Video) by Minew Shewa Tube 4 years ago 5 minutes, 30 seconds 328,397 views",Minew Shewa Entertainment,328397,330586,2189
2391,"Ittiiqaa Tafarii - Kaadhimatoo - New Oromo Music 2017(Official Video) by Minew Shewa Tube 4 years ago 5 minutes, 59 seconds 170,874 views",Minew Shewa Entertainment,170874,171715,841
2392,"Ittiiqaa Tafarii - Oromummaa - New Oromo Music 2017(Official Video by Minew Shewa Tube 4 years ago 5 minutes, 59 seconds 21,872 views",Minew Shewa Entertainment,21872,21887,15
2393,"Ittiiqaa Tafarii - Leencicha Sanyii Leencaa - New Oromo Music 2017(Official Video) by Minew Shewa Tube 4 years ago 6 minutes 48,825 views",Minew Shewa Entertainment,48825,49104,279
2394,"Rita Adere - Destaye(ደስታዬ) - New Ethiopian Music 2017(Official Video) by Minew Shewa Tube 4 years ago 3 minutes, 22 seconds 7,110 views",Minew Shewa Entertainment,7110,7115,5
2395,"Tsegay Solomon (T  IBEX) - Hello Mekelle - New Ethiopian Music 2017(Official Video) by Minew Shewa Tube 4 years ago 4 minutes, 37 seconds 8,823 views",Minew Shewa Entertainment,8823,8872,49
2396,"Endriyas Kelifa - Yeayene Abeba(የአይኔ አበባ) - New Ethiopian Music 2017(Official Video) by Minew Shewa Tube 4 years ago 4 minutes, 9 seconds 9,535 views",Minew Shewa Entertainment,9535,9536,1
2397,"Ethiopian music : Abebe kefeni - Anasiiweyaa - New Ethiopian Oromo Music 2017(Official Video) by Minew Shewa Tube 4 years ago 4 minutes, 42 seconds 1,490,801 views",Minew Shewa Entertainment,1490801,1494564,3763
2398,"New Album - Smizz Mayle - Yesheto Maza(የሽቶ ማዓዛ) - New Ethiopian Music 2017(Official Audio) by Minew Shewa Tube 4 years ago 5 minutes, 22 seconds 6,594 views",Minew Shewa Entertainment,6594,6598,4
2399,"Jah Lude Ft. Toms Music - Eshi Beyign(እሺ በይኝ) - New Ethiopian Music 2017(Official Video) by Minew Shewa Tube 4 years ago 4 minutes, 12 seconds 35,099 views",Minew Shewa Entertainment,35099,35115,16
2400,"Tesfatsiyon G/Meskele  - Hedagi Hedagi(ሕዳጊ ሕዳጊ) - New Ethiopian Music 2017(Official Video) by Minew Shewa Tube 4 years ago 7 minutes, 19 seconds 138,917 views",Minew Shewa Entertainment,138917,139131,214
2401,"Getamesay Kebede - Sechign Mela(ሰጪኝ መላ) - New Ethiopian Music 2017(Official Video) by Minew Shewa Tube 4 years ago 5 minutes, 39 seconds 21,406 views",Minew Shewa Entertainment,21406,21411,5
2402,"Asfaw Eshetu - Yazegnma(ያዢኝማ) - New Ethiopian Music 2017(Official Video) by Minew Shewa Tube 4 years ago 4 minutes, 54 seconds 27,132 views",Minew Shewa Entertainment,27132,27136,4
2403,"Ethiopian music: Yared Negu - Zelelaye(ዘለላዬ) - New Ethiopian Music 2017(Official Video) by Minew Shewa Tube 4 years ago 4 minutes, 39 seconds 15,057,623 views",Minew Shewa Entertainment,15057623,15093825,36202
2404,"Comedian Tomas - Setgerf Tawerawalhe(ስትገረፍ ታወራዋለህ) - New Ethiopian Music 2017(Official Video) by Minew Shewa Tube 4 years ago 4 minutes, 33 seconds 1,990,895 views",Minew Shewa Entertainment,1990895,2001719,10824
2405,"Awet Tadese - Entayeleyo(እንታይለዮ) - New Ethiopian Music 2017(Official Video) by Minew Shewa Tube 4 years ago 4 minutes, 49 seconds 12,623 views",Minew Shewa Entertainment,12623,12625,2
2406,"Embeba Mengestu Ft. Ketsenat Negusun - Bahelachn(ባህላችን) - New Ethiopian Music 2017(Official Video) by Minew Shewa Tube 4 years ago 5 minutes, 50 seconds 46,899 views",Minew Shewa Entertainment,46899,46902,3
2407,"Nani Getachew - Sesekelegn(ሰሰቅልኝ) - New Ethiopian Music 2017(Official Video) by Minew Shewa Tube 4 years ago 4 minutes, 40 seconds 27,036 views",Minew Shewa Entertainment,27036,27042,6
2408,"Justice - Yemegnushal(ይመኙሻል) - New Ethiopian Music 2017(Official Video) by Minew Shewa Tube 4 years ago 4 minutes, 24 seconds 6,790 views",Minew Shewa Entertainment,6790,6790,0
2409,"Lemlem Lijalem - Anteye(አንተዬ) - New Ethiopian Music 2017(Official Video) by Minew Shewa Tube 4 years ago 4 minutes, 40 seconds 36,708 views",Minew Shewa Entertainment,36708,36746,38
2410,"Saba Mulegeta - Tseyemun(ፀይሙን) - New Ethiopian Music 2017(Official Video) by Minew Shewa Tube 4 years ago 4 minutes, 58 seconds 88,172 views",Minew Shewa Entertainment,88172,88235,63
2411,"Ethiopian music: Amanuel Yemane - Nigerewa(ንገርዋ) - New Ethiopian Music 2017(Official Video) by Minew Shewa Tube 4 years ago 4 minutes, 58 seconds 11,058,452 views",Minew Shewa Entertainment,11058452,11096257,37805
2412,"Tegegnework Tadese  - Yene Alem(የኔ አለም) - New Ethiopian Music 2017(Official Video) by Minew Shewa Tube 4 years ago 5 minutes, 16 seconds 11,797 views",Minew Shewa Entertainment,11797,11805,8
2413,"Kepaso Daygo - Echi Set(እቺ ሴት) - New Ethiopian Music 2017(Official Video) by Minew Shewa Tube 4 years ago 3 minutes, 31 seconds 4,540 views",Minew Shewa Entertainment,4540,4546,6
2414,"Ethiopian music Danieal Haileselassie - Efey Wari(ዒፈይ ዋሪ) - New Ethiopian Music 2017(Official Video) by Minew Shewa Tube 4 years ago 6 minutes, 2 seconds 127,419 views",Minew Shewa Entertainment,127419,127518,99
2415,"Ethiopian music : Sami Go - Shashemene(ሻሸመኔ) - New Ethiopian Oromo Music 2017(Official Video) by Minew Shewa Tube 4 years ago 4 minutes, 36 seconds 3,769,258 views",Minew Shewa Entertainment,3769258,3781815,12557
2416,"Kassahun Zewedu(Abush Alem) - Gelagelechign(ገላገለችኝ) - New Ethiopian Music 2017(Official Video) by Minew Shewa Tube 4 years ago 5 minutes, 29 seconds 10,604 views",Minew Shewa Entertainment,10604,10618,14
2417,"Ethiopian music: Esubalew Yetayew(የሺ) - Tertaye(ትርታዬ) - New Ethiopian Music 2017(Official Video) by Minew Shewa Tube 4 years ago 4 minutes, 50 seconds 8,929,409 views",Minew Shewa Entertainment,8929409,8949639,20230
2418,"Raskey - Arada(አራዳ) - New Ethiopian Music 2017(Official Video) by Minew Shewa Tube 4 years ago 4 minutes, 14 seconds 28,913 views",Minew Shewa Entertainment,28913,28927,14
2419,"Ethiopian music : Ephrem Altaseb - Benegerkush(በነገርኩሽ) - New Ethiopian Music 2017(Official Video) by Minew Shewa Tube 4 years ago 4 minutes, 49 seconds 3,450,590 views",Minew Shewa Entertainment,3450590,3467586,16996
2420,"Chale Atinafu - Tewedaje (ተወዳጅ) - New Ethiopian Music 2017(Official Video) by Minew Shewa Tube 4 years ago 5 minutes, 32 seconds 31,797 views",Minew Shewa Entertainment,31797,31820,23
2421,"Adane Mola - Hawawashe(ሀዋዋሼ) - New Ethiopian Oromo Music 2017(Official Video) by Minew Shewa Tube 4 years ago 5 minutes, 13 seconds 7,504 views",Minew Shewa Entertainment,7504,7509,5
2422,"Asmamaw Adugna Ft. Yohans Roba - ኦይቻ(Oyecha) - New Ethiopian Music 2017(Official Video) by Minew Shewa Tube 4 years ago 5 minutes, 20 seconds 9,775 views",Minew Shewa Entertainment,9775,9780,5
2423,"Desalegn addisu  - Shelmign(ሸልሚኝ) - New Ethiopian Music 2017(Official Video) by Minew Shewa Tube 4 years ago 5 minutes, 14 seconds 203,725 views",Minew Shewa Entertainment,203725,203768,43
2424,"Tesfahun Yeberesh Lij  - Sewedelesh(ስወድልሽ) - New Ethiopian Music 2017(Official Video) by Minew Shewa Tube 4 years ago 5 minutes, 37 seconds 7,999 views",Minew Shewa Entertainment,7999,8001,2
2425,"Yohannes Mulugeta (ጆኒ) - Melegna(መለኛ) - New Ethiopian Music 2017(Official Video) by Minew Shewa Tube 4 years ago 5 minutes, 20 seconds 50,014 views",Minew Shewa Entertainment,50014,50083,69
2426,"Ethiopian music: Yapi Mapi Ft. JoJo - Ethiopia(ኢትዮጲያ) - New Ethiopian Music 2017(Official Video) by Minew Shewa Tube 4 years ago 5 minutes, 54 seconds 218,819 views",Minew Shewa Entertainment,218819,218998,179
2427,"Ethiopian music : Halima Abdurahman - Esay(እሰይ) - New Ethiopian Music 2017(Official Video) by Minew Shewa Tube 4 years ago 6 minutes, 4 seconds 767,095 views",Minew Shewa Entertainment,767095,768275,1180
2428,"Teshale Mekonnen - Gonder Tize Alegn(ጎንደር ትዝ አለኝ) - New Ethiopian Music 2017(Official Video) by Minew Shewa Tube 4 years ago 5 minutes, 6 seconds 60,082 views",Minew Shewa Entertainment,60082,60131,49
2429,"Kenaw Zewedu - Endetmegnhu(እንደተመኘሁ) - New Ethiopian Music 2017(Official Video) by Minew Shewa Tube 4 years ago 5 minutes, 17 seconds 56,210 views",Minew Shewa Entertainment,56210,56214,4
2430,"Lil Pac - Tama Lele - New Ethiopian Music 2017(Official Video) by Minew Shewa Tube 4 years ago 3 minutes, 50 seconds 29,782 views",Minew Shewa Entertainment,29782,29856,74
2431,"Werku Yeshaw - Adi-Bena(አዲ-ቤና) - New Ethiopian Music 2017(Official Video) by Minew Shewa Tube 4 years ago 5 minutes, 42 seconds 9,251 views",Minew Shewa Entertainment,9251,9253,2
2432,"Fiker Tesfaye - Techawechilegn(ተጫወቺልኝ) - New Ethiopian Music 2017(Official Video) by Minew Shewa Tube 4 years ago 4 minutes, 23 seconds 18,930 views",Minew Shewa Entertainment,18930,18938,8
2433,"Zerihun Demissie - Hanasa(ሓናሳ) - New Ethiopian Music 2017(Official Video) by Minew Shewa Tube 4 years ago 5 minutes, 37 seconds 9,445 views",Minew Shewa Entertainment,9445,9619,174
2434,"Eyuel Asefa - Lela Endalay(ሌላ እንዳላይ) - New Ethiopian Music 2017(Official Video) by Minew Shewa Tube 4 years ago 4 minutes, 16 seconds 22,234 views",Minew Shewa Entertainment,22234,22246,12
2435,"Alphaz - 700 Mistoch - New Ethiopian Music 2017(Official Video) by Minew Shewa Tube 4 years ago 4 minutes, 26 seconds 16,230 views",Minew Shewa Entertainment,16230,16234,4
2436,"Kwaja Tesfay - kesmr eyu - New Ethiopian Music 2017(Official Video) by Minew Shewa Tube 4 years ago 6 minutes, 6 seconds 4,325 views",Minew Shewa Entertainment,4325,4333,8
2437,"Mehret Abreha (Besak Yigelale) ምህረት አብርሃ (በሳቅ ይገላል) - New Ethiopian Music 2017(Official Video) by Minew Shewa Tube 4 years ago 4 minutes, 44 seconds 10,604 views",Minew Shewa Entertainment,10604,10610,6
2438,"Yared Fikresilase - Nafkote(ናፍቆቴ) - New Ethiopian Music 2017(Official Video) by Minew Shewa Tube 4 years ago 5 minutes, 59 seconds 8,300 views",Minew Shewa Entertainment,8300,8313,13
2439,"Tiruwerk Ayele - Gojam(ጎጃም) - New Ethiopian Music 2017(Official Video) by Minew Shewa Tube 4 years ago 4 minutes, 17 seconds 222,012 views",Minew Shewa Entertainment,222012,222382,370
2440,"Bini Banks  - Ye Habesha Lij(የ ሀበሻ ልጅ) - New Ethiopian Music 2017(Official Video) by Minew Shewa Tube 4 years ago 3 minutes, 3 seconds 6,435 views",Minew Shewa Entertainment,6435,6442,7
2441,"Tsegaye Dejene - Kelelesh(ከሌለሽ) - New Ethiopian Music 2017(Official Video) by Minew Shewa Tube 4 years ago 4 minutes, 3 seconds 20,317 views",Minew Shewa Entertainment,20317,20323,6
2442,"Ethiopian music: Sami Dan - Hayal(ሃያል) - New Ethiopian Music 2017(Official Video) by Minew Shewa Tube 4 years ago 4 minutes, 31 seconds 3,813,271 views",Minew Shewa Entertainment,3813271,3824609,11338
2443,"Kenaw Zewedu - Kemkeme Ney(ከመከሜ ነይ) - New Ethiopian Music 2017(Official Video) by Minew Shewa Tube 4 years ago 5 minutes, 37 seconds 117,745 views",Minew Shewa Entertainment,117745,117817,72
2444,"Hachalu Hundessa  - Jirra - New Ethiopian Oromo Music 2017(Official Video) by Minew Shewa Tube 4 years ago 8 minutes, 20 seconds 253,755 views",Minew Shewa Entertainment,253755,257415,3660
2445,"Ethiopian music: Kassahun Taye - Gonder(ጎንደር) - New Ethiopian Music 2017(Official Video) by Minew Shewa Tube 4 years ago 6 minutes, 42 seconds 6,550,526 views",Minew Shewa Entertainment,6550526,6591009,40483
2446,"Samuel Seneshaw(Sam Yerom) - Sekaram(ሰካራም) - New Ethiopian Music 2017(Official Video) by Minew Shewa Tube 4 years ago 4 minutes, 29 seconds 59,596 views",Minew Shewa Entertainment,59596,59702,106
2447,"Abraham Hagos - Aleku Beli(አለኍ በሊ) - New Ethiopian Music 2017(Official Video) by Minew Shewa Tube 4 years ago 4 minutes, 24 seconds 15,323 views",Minew Shewa Entertainment,15323,15334,11
2448,"Habtamu Hasen - Yemhlaye Nesh(የምህላዬ ነሽ) - New Ethiopian Music 2017(Official Video) by Minew Shewa Tube 4 years ago 3 minutes, 22 seconds 7,666 views",Minew Shewa Entertainment,7666,7673,7
2449,"Enate Birhanu - Yaamuchaa Rejee - New Ethiopian Oromo Music 2017(Official Video) by Minew Shewa Tube 4 years ago 4 minutes, 8 seconds 18,159 views",Minew Shewa Entertainment,18159,18166,7
2450,"Junta & Nati - Abo Temechign(አቦ ተመቺኝ) - New Ethiopian Music 2017(Official Video) by Minew Shewa Tube 4 years ago 3 minutes, 55 seconds 7,552 views",Minew Shewa Entertainment,7552,7565,13
2451,"Ethiopian music : Demsash Ashber - Berley(ብርለይ) - New Ethiopian Music 2017(Official Video) by Minew Shewa Tube 4 years ago 5 minutes, 56 seconds 294,918 views",Minew Shewa Entertainment,294918,295080,162
2452,"Haftom Gebremichael - Lebeyna Ayent(ልበይና ዓይነት) - New Ethiopian Music 2017(Official Video) by Minew Shewa Tube 4 years ago 5 minutes, 40 seconds 146,228 views",Minew Shewa Entertainment,146228,146249,21
2453,"Tiruwerk Ayele - Yewelo Lej(የወሎ ልጅ) - New Ethiopian Music 2017(Official Video) by Minew Shewa Tube 4 years ago 5 minutes, 13 seconds 519,368 views",Minew Shewa Entertainment,519368,520162,794
2454,"Sami Getu - Ayhonem(አይሆንም) - New Ethiopian Music 2017(Official Video) by Minew Shewa Tube 4 years ago 5 minutes, 52 seconds 128,221 views",Minew Shewa Entertainment,128221,128233,12
2455,"Muse Nebiyu - Adi Fekri(ዓዲ ፍቕሪ) - New Ethiopian Music 2017(Official Video) by Minew Shewa Tube 4 years ago 6 minutes, 23 seconds 20,607 views",Minew Shewa Entertainment,20607,20609,2
2456,"Eritbu Agegnehu(Sol) - Addis Abeba(አዲስ አበባ) - New Ethiopian Music 2017(Official Video) by Minew Shewa Tube 4 years ago 5 minutes, 53 seconds 16,346 views",Minew Shewa Entertainment,16346,16356,10
2457,"Melkamu Yohanse - Gojamew(ጎጃሜው) - New Ethiopian Music 2017(Official Video) by Minew Shewa Tube 4 years ago 5 minutes, 19 seconds 28,919 views",Minew Shewa Entertainment,28919,28928,9
2458,"Haymanot Almu  - Salawek Ene(ሳላውቅ እኔ) - New Ethiopian Music 2017(Official Video) by Minew Shewa Tube 4 years ago 5 minutes, 10 seconds 24,430 views",Minew Shewa Entertainment,24430,24433,3
2459,"Behailu Lema(Baya) - Corbagna(ኮርባኛ) - New Ethiopian Music 2017(Official Video) by Minew Shewa Tube 4 years ago 4 minutes, 14 seconds 8,016 views",Minew Shewa Entertainment,8016,8019,3
2460,"Kefiyalew Tigabu - Tizalegn(ትዛለኝ) - New Ethiopian Music 2017(Official Video) by Minew Shewa Tube 4 years ago 4 minutes, 29 seconds 55,472 views",Minew Shewa Entertainment,55472,55489,17
2461,"Abereham Ayle - Tezta(ትዝታ) - New Ethiopian Music 2017(Official Video) by Minew Shewa Tube 4 years ago 5 minutes, 36 seconds 35,147 views",Minew Shewa Entertainment,35147,35155,8
2462,"Oromo music : Ittiiqaa Tafarii - Jabana Roorroo - New Oromo Music 2017(Official Video) by Minew Shewa Tube 4 years ago 8 minutes, 39 seconds 1,789,755 views",Minew Shewa Entertainment,1789755,1796574,6819
2463,"Abraraw Melaku - Bale Tarik Negn(ባለ ታሪክ ነኝ) - New Ethiopian Music 2017(Official Video) by Minew Shewa Tube 4 years ago 4 minutes, 13 seconds 22,514 views",Minew Shewa Entertainment,22514,22521,7
2464,"Shimellis Abbaabbuu - Huursii Loli - New Ethiopian Music 2017(Official Video) by Minew Shewa Tube 4 years ago 5 minutes, 49 seconds 19,374 views",Minew Shewa Entertainment,19374,19386,12
2465,"Elsa Andarge Ft.Felke Honga - Meskela(መስቀላ) - New Ethiopian Music 2017(Official Video) by Minew Shewa Tube 4 years ago 4 minutes, 44 seconds 4,418 views",Minew Shewa Entertainment,4418,4420,2
2466,"Fike Burshea - Yilekos Chebo(ይለኮስ ችቦ) - New Ethiopian Music 2017(Official Video) by Minew Shewa Tube 4 years ago 5 minutes, 35 seconds 3,250 views",Minew Shewa Entertainment,3250,3252,2
2467,"Ethiopian music: Hayleyesus Feyssa - Ayneye(አይንዬ) - New Ethiopian Music 2017(Official Video) by Minew Shewa Tube 4 years ago 7 minutes, 12 seconds 11,621,953 views",Minew Shewa Entertainment,11621953,11676383,54430
2468,"Ethiopian music: Ethio Man - Andegnaye - (አንደኛዬ) - New Ethiopian Music 2017(Official Video) by Minew Shewa Tube 4 years ago 5 minutes, 17 seconds 137,176 views",Minew Shewa Entertainment,137176,137200,24
2469,"Ethiopian music: Ayanaw Terualem - Amen(አሜን) - New Ethiopian Music 2017(Official Video) by Minew Shewa Tube 4 years ago 5 minutes, 30 seconds 75,036 views",Minew Shewa Entertainment,75036,75056,20
2470,"Ethiopian music : Robel Assefa - KalKidan(ቃልኪዳን) - New Ethiopian Music 2017(Official Video) by Minew Shewa Tube 4 years ago 5 minutes, 47 seconds 85,927 views",Minew Shewa Entertainment,85927,85960,33
2471,"Andinet Ali - Monaliziya(ሞናሊዚያ) - New Ethiopian Music 2017(Official Video) by Minew Shewa Tube 4 years ago 4 minutes, 36 seconds 7,179 views",Minew Shewa Entertainment,7179,7181,2
2472,"Endeshaw Negash - Awedamet(አውዳመት) - New Ethiopian Music 2017(Official Video) by Minew Shewa Tube 4 years ago 5 minutes, 3 seconds 8,122 views",Minew Shewa Entertainment,8122,8209,87
2473,"Oromo music: Dammituu Onnataa - Godaanisa - New Ethiopian Music 2017(Official Video) by Minew Shewa Tube 4 years ago 6 minutes 77,463 views",Minew Shewa Entertainment,77463,77506,43
2474,"Ayanaw Terualem - Eta Fanta(እጣ ፋንታ) - New Ethiopian Music 2017(Official Video) by Minew Shewa Tube 4 years ago 5 minutes, 16 seconds 34,482 views",Minew Shewa Entertainment,34482,34494,12
2475,"Sisay Dida(Adis) - Enka(እንካ) - New Ethiopian Music 2017(Official Video) by Minew Shewa Tube 4 years ago 3 minutes, 56 seconds 17,350 views",Minew Shewa Entertainment,17350,17363,13
2476,"Ethiopian music : Cha Cha X Upon - Swedat(ስወዳት) - New Ethiopian Music 2017(Official Lyrics Video) by Minew Shewa Tube 4 years ago 3 minutes, 50 seconds 379,432 views",Minew Shewa Entertainment,379432,379712,280
2477,"Say - Hagere(ሀገሬ) - New Ethiopian Music 2017(Official Video) by Minew Shewa Tube 4 years ago 4 minutes, 13 seconds 5,798 views",Minew Shewa Entertainment,5798,5804,6
2478,"Tesfaldet Zeru - Haza(ሓዛ) - New Ethiopian Music 2017(Official Video) by Minew Shewa Tube 4 years ago 3 minutes, 56 seconds 3,930 views",Minew Shewa Entertainment,3930,3931,1
2479,"Samuel G/Her - Demika Abebakumye(ደሚቃ ኣበባኁም'የ) - New Ethiopian Music 2017(Official Video) by Minew Shewa Tube 4 years ago 4 minutes, 16 seconds 6,832 views",Minew Shewa Entertainment,6832,6834,2
2480,"Esubalew Yetayew(የሺ) - Mare Mare(ማሬ ማሬ) - New Ethiopian Music 2017[ Official Audio ] by Minew Shewa Tube 4 years ago 3 minutes, 49 seconds 150,822 views",Minew Shewa Entertainment,150822,150994,172
2481,"Esubalew Yetayew(የሺ) - Samenat(ሳምናት) - New Ethiopian Music 2017[ Official Audio ] by Minew Shewa Tube 4 years ago 4 minutes, 3 seconds 237,129 views",Minew Shewa Entertainment,237129,237352,223
2482,"Esubalew Yetayew(የሺ) - Tekus(ተኩስ) - New Ethiopian Music 2017[ Official Audio ] by Minew Shewa Tube 4 years ago 3 minutes, 44 seconds 228,368 views",Minew Shewa Entertainment,228368,228949,581
2483,"Esubalew Yetayew(የሺ) - Photo Yinageral(ፎቶ ይናገራል) - New Ethiopian Music 2017[ Official Audio ] by Minew Shewa Tube 4 years ago 4 minutes, 3 seconds 1,062,983 views",Minew Shewa Entertainment,1062983,1066711,3728
2484,"Esubalew Yetayew(የሺ) - Ategudel Kise(አትጉደል ኪሴ) - New Ethiopian Music 2017[ Official Audio ] by Minew Shewa Tube 4 years ago 4 minutes, 40 seconds 911,991 views",Minew Shewa Entertainment,911991,913413,1422
2485,"Ethiopian music: Solomon Haile - Des Yebelino(ደስ ይብለኒ'ሎ) - New Ethiopian Music 2017(Official Video) by Minew Shewa Tube 4 years ago 6 minutes, 10 seconds 9,073,671 views",Minew Shewa Entertainment,9073671,9104829,31158
2486,"Esubalew Yetayew(የሺ) - Zefen Mamokiya Aydelm - New Ethiopian Music 2017[ Official Audio ] by Minew Shewa Tube 4 years ago 4 minutes, 3 seconds 898,093 views",Minew Shewa Entertainment,898093,898625,532
2487,"Esubalew Yetayew(የሺ) - Godanaw Mulu(ጎዳናው ሙሉ) - New Ethiopian Music 2017[ Official Audio ] by Minew Shewa Tube 4 years ago 4 minutes 520,934 views",Minew Shewa Entertainment,520934,521612,678
2488,"Esubalew Yetayew(የሺ) - Tew(ተው) - New Ethiopian Music 2017[ Official Audio ] by Minew Shewa Tube 4 years ago 5 minutes, 3 seconds 3,804,377 views",Minew Shewa Entertainment,3804377,3808176,3799
2489,"Esubalew Yetayew(የሺ) - Endeweyen(እንደወይን) - New Ethiopian Music 2017[ Official Audio ] by Minew Shewa Tube 4 years ago 3 minutes, 29 seconds 1,048,107 views",Minew Shewa Entertainment,1048107,1050814,2707
2490,"Esubalew Yetayew(የሺ) - Kayene Atefim(ከአይኔ አትጠፊም) - New Ethiopian Music 2017[ Official Audio ] by Minew Shewa Tube 4 years ago 6 minutes, 19 seconds 3,724,517 views",Minew Shewa Entertainment,3724517,3728552,4035
2491,"Esubalew Yetayew(የሺ) - Degmo Demo(ደግሞ ደሞ) - New Ethiopian Music 2017[ Official Audio ] by Minew Shewa Tube 4 years ago 4 minutes, 3 seconds 1,116,544 views",Minew Shewa Entertainment,1116544,1118526,1982
2492,"Esubalew Yetayew(የሺ) - Yetem Yemchegnal(የትም ይመቸኛል) - New Ethiopian Music 2017[ Official Audio ] by Minew Shewa Tube 4 years ago 4 minutes, 3 seconds 2,982,258 views",Minew Shewa Entertainment,2982258,2985579,3321
2493,"Esubalew Yetayew(የሺ) - Heyaw Sem(ህያው ስም) - New Ethiopian Music 2017[ Official Audio ] by Minew Shewa Tube 4 years ago 4 minutes, 7 seconds 421,989 views",Minew Shewa Entertainment,421989,422389,400
2494,"Tesfalem Tefera - Esay(ኣሰይ) - New Ethiopian Music 2017(Official Video) by Minew Shewa Tube 4 years ago 5 minutes, 6 seconds 19,710 views",Minew Shewa Entertainment,19710,19714,4
2495,"Gezahegn Israel - Sawiya Lomiyo(ሳውያ ሎሚዮ) - New Ethiopian Music 2017(Official Video) by Minew Shewa Tube 4 years ago 4 minutes, 45 seconds 8,133 views",Minew Shewa Entertainment,8133,8135,2
2496,"Hayleyesus Feyssa - Ayneye(አይንዬ) - New Ethiopian Music Teaser Clip 2017 (Official Video) by Minew Shewa Tube 4 years ago 40 seconds 25,772 views",Minew Shewa Entertainment,25772,25777,5
2497,"Abel Almaz - Dimplua(ዲምፕሏ) - New Ethiopian Music 2017(Official Video) by Minew Shewa Tube 4 years ago 5 minutes, 5 seconds 31,670 views",Minew Shewa Entertainment,31670,31713,43
2498,"Ethiopian music: Woynat Addisu - Adey(አደይ) - New Ethiopian Music 2017(Official Video) by Minew Shewa Tube 4 years ago 3 minutes, 49 seconds 30,518 views",Minew Shewa Entertainment,30518,30531,13
2499,"Ethiopian music: Hagos Takele - Adehemay(ዓድህማይ) - New Ethiopian Music 2017(Official Video) by Minew Shewa Tube 4 years ago 6 minutes, 46 seconds 341,789 views",Minew Shewa Entertainment,341789,341922,133
2500,"Mila Afro Ft. Deva - Konjo Nat(ቆንጆ ናት) - New Ethiopian Music 2017(Official Video) by Minew Shewa Tube 4 years ago 4 minutes, 1 second 7,644 views",Minew Shewa Entertainment,7644,7655,11
2501,"Ethiopian music : Ayalew Nigussie(YaYu) Temelesh(ተመለሽ) - New Ethiopian Music 2017(Official Video) by Minew Shewa Tube 4 years ago 6 minutes, 46 seconds 5,155,923 views",Minew Shewa Entertainment,5155923,5179333,23410
2502,"Thomas Mekonen - Rehus Bale(ርሑስ በዓል) - New Ethiopian Music 2017(Official Video) by Minew Shewa Tube 4 years ago 6 minutes, 46 seconds 70,962 views",Minew Shewa Entertainment,70962,70965,3
2503,"Ethiopian music: Maditu Weday - Warehabul(ወረሀቡል) - New Ethiopian Music 2017(Official Video) by Minew Shewa Tube 4 years ago 6 minutes, 8 seconds 4,138,730 views",Minew Shewa Entertainment,4138730,4160847,22117
2504,"Serkalem Worku - Yet Dersehal(የት ደርሰሀል) - New Ethiopian Music 2017(Official Video) by Minew Shewa Tube 4 years ago 6 minutes, 46 seconds 92,826 views",Minew Shewa Entertainment,92826,92840,14
2505,"አደይ አዲስ ዓመት አዲስ ተስፋ - Ethiopian Movie - Adey Adis Amet Adis Tesfa - New Ethiopian Movie  2017 by Minew Shewa Tube 4 years ago 15 minutes 3,937 views",Minew Shewa Entertainment,3937,3938,1
2506,"Haftom Z/Tsion  - Tisbkti Ehi(ፅብቅቲ) - New Ethiopian Music 2017(Official Video) by Minew Shewa Tube 4 years ago 6 minutes, 46 seconds 97,230 views",Minew Shewa Entertainment,97230,98081,851
2507,"Micky Hasset - Menore(መኖሬ) - New Ethiopian Music 2017(Official Video) by Minew Shewa Tube 4 years ago 5 minutes, 35 seconds 22,495 views",Minew Shewa Entertainment,22495,22540,45
2508,"Yiftusera Zerihun - Weyenaye(ወይናዬ) - New Ethiopian Music 2017(Official Video) by Minew Shewa Tube 4 years ago 5 minutes, 27 seconds 9,670 views",Minew Shewa Entertainment,9670,9671,1
2509,"Jimi Man - Be Aman Alesh Wey(በአማን አለሽ ወይ) - New Ethiopian Music 2017(Official Video) by Minew Shewa Tube 4 years ago 5 minutes, 48 seconds 20,265 views",Minew Shewa Entertainment,20265,20268,3
2510,"Ethiopian music: Senedu Alee - Amalaye(አማላይ) - New Ethiopian Music 2017(Official Video) by Minew Shewa Tube 4 years ago 6 minutes, 23 seconds 733,833 views",Minew Shewa Entertainment,733833,737889,4056
2511,"New Album:- Esubalew Yetayew(የሺ) - Tertaye(ትርታዬ)Coming Soon... by Minew Shewa Tube 4 years ago 1 minute, 6 seconds 30,821 views",Minew Shewa Entertainment,30821,30828,7
2512,"Ethiopian music: Desta Berhe - Zawuney(ዛውነይ) - New Ethiopian Music 2017(Official Video) by Minew Shewa Tube 4 years ago 5 minutes, 27 seconds 171,524 views",Minew Shewa Entertainment,171524,171881,357
2513,"Wave Slassian - Axum(አክሱም) - New Ethiopian Music 2017(Official Video) by Minew Shewa Tube 4 years ago 5 minutes, 15 seconds 104,673 views",Minew Shewa Entertainment,104673,104866,193
2514,"Ethiopian music: Alemeye Getachew - Ya Lela Yehe Lela(ያሌላ... ይሄ ሌላ...) - New Ethiopian Music 2017 by Minew Shewa Tube 4 years ago 8 minutes, 33 seconds 3,881,784 views",Minew Shewa Entertainment,3881784,3889289,7505
2515,"Habtamu Tedela - Yemame Nat(የማም ናት) - New Ethiopian Music 2017(Official Video) by Minew Shewa Tube 4 years ago 5 minutes, 32 seconds 187,733 views",Minew Shewa Entertainment,187733,187823,90
2516,"Feleke Kassa - Achaye(አቻዬ) - New Ethiopian Music 2017(Official Video) by Minew Shewa Tube 4 years ago 5 minutes, 30 seconds 32,434 views",Minew Shewa Entertainment,32434,32452,18
2517,"Mastewal Admasu - Na Monani(ና ሞናኒ) - New Ethiopian Music 2017(Official Video) by Minew Shewa Tube 4 years ago 5 minutes, 34 seconds 134,435 views",Minew Shewa Entertainment,134435,134842,407
2518,"Tsegabu Teshale - LeyLey(ለይለይ) - New Ethiopian Music 2017(Official Video) by Minew Shewa Tube 4 years ago 7 minutes, 12 seconds 812,237 views",Minew Shewa Entertainment,812237,813345,1108
2519,"Samuel Mengistu - Nekahu(ነቃሁ) - New Ethiopian Music 2017(Official Video) by Minew Shewa Tube 4 years ago 5 minutes, 5 seconds 64,678 views",Minew Shewa Entertainment,64678,64715,37
2520,"Ethiopian music: Meaza Yohannes - Leymuno(ለይሙኖ ) - New Ethiopian Music 2017(Official Video) by Minew Shewa Tube 4 years ago 5 minutes, 30 seconds 1,328,435 views",Minew Shewa Entertainment,1328435,1330370,1935
2521,"New Album:- Esubalew Yetayew(የሺ) - Tertaye(ትርታዬ) - New Ethiopian Music 2017(Official Video) by Minew Shewa Tube 4 years ago 3 minutes, 48 seconds 2,354,652 views",Minew Shewa Entertainment,2354652,2355307,655
2522,"Dawit Nega - Wesida Mizan(ወሲዳ ሚዛን) - New Ethiopian Music 2017(Official Video) by Minew Shewa Tube 4 years ago 7 minutes, 18 seconds 180,549 views",Minew Shewa Entertainment,180549,180652,103
2523,"Yelma Shewa - HoYa HoYe(ሆያ ሆዬ) - New Ethiopian Music 2017(Official Video) by Minew Shewa Tube 4 years ago 4 minutes, 55 seconds 266,425 views",Minew Shewa Entertainment,266425,266538,113
2524,"Gizachew Solomon - BenaManaDeya(ብናማና ድያ) - New Ethiopian Music 2017(Official Video) by Minew Shewa Tube 4 years ago 5 minutes, 5 seconds 45,395 views",Minew Shewa Entertainment,45395,45512,117
2525,"Ujulu Tera Ft. Solomon Beyene - Obarancho - New Ethiopian Music 2017(Official Video) by Minew Shewa Tube 4 years ago 4 minutes, 59 seconds 20,458 views",Minew Shewa Entertainment,20458,20462,4
2526,"Ethiopian music : Rahel Haile - Wereha Hizeya - (ወረኻ ሒዘያ) - New Ethiopian Music 2017(Official Video) by Minew Shewa Tube 4 years ago 6 minutes, 54 seconds 1,476,364 views",Minew Shewa Entertainment,1476364,1478676,2312
2527,"Netsanet Getachew - Ayehonelegn(አይሆንልኝ) - New Ethiopian Music 2017(Official Video) by Minew Shewa Tube 4 years ago 5 minutes, 5 seconds 223,601 views",Minew Shewa Entertainment,223601,223670,69
2528,"Wabi Eshete - Wase Letra(ዋስ ልጥራ) - New Ethiopian Music 2017(Official Video) by Minew Shewa Tube 4 years ago 4 minutes, 54 seconds 35,176 views",Minew Shewa Entertainment,35176,35225,49
2529,"Liya Mohamode - Ante Memher(አንተ መምህር) - New Ethiopian Music 2017(Official Video) by Minew Shewa Tube 4 years ago 3 minutes, 41 seconds 10,726 views",Minew Shewa Entertainment,10726,10730,4
2530,"DJ Same - Kebetebata Wetate(ቀበጥባጣ ወጣት) - New Ethiopian Music 2017(Official Video) by Minew Shewa Tube 4 years ago 5 minutes, 5 seconds 71,495 views",Minew Shewa Entertainment,71495,72021,526
2531,"Ethiopian music: Markos Fikru - Eroro(እሮሮ) - New Ethiopian Music 2017(Official Video) by Minew Shewa Tube 4 years ago 5 minutes, 41 seconds 701,960 views",Minew Shewa Entertainment,701960,703797,1837
2532,"Esa G - Zerafe Lebe(ዘራፍ ልቤ) - New Ethiopian Music 2017(Official Video) by Minew Shewa Tube 4 years ago 5 minutes, 25 seconds 52,538 views",Minew Shewa Entertainment,52538,52543,5
2533,"Sami Dan - Ewenet(እውነት) - New Ethiopian Music 2017(Official Video) by Minew Shewa Tube 4 years ago 4 minutes, 51 seconds 17,514 views",Minew Shewa Entertainment,17514,17535,21
2534,"Ethiopian music: Nathan - Ke Tilant Zare(ከትላንተ ዛሬ ) - New Ethiopian Music 2017(Official Video) by Minew Shewa Tube 4 years ago 3 minutes, 47 seconds 132,272 views",Minew Shewa Entertainment,132272,132298,26
2535,"Demeke Bitew - Gonderye(ጎንደርዬ) - New Ethiopian Music 2017(Official Video) by Minew Shewa Tube 4 years ago 5 minutes, 15 seconds 105,285 views",Minew Shewa Entertainment,105285,105508,223
2536,"Shemels Mersha,Kuch Getu,Habtamu Mamo,Kasahun Melaku - Helo Helalo - New Ethiopian Music 2017 by Minew Shewa Tube 4 years ago 6 minutes, 8 seconds 16,540 views",Minew Shewa Entertainment,16540,16558,18
2537,"Hewan Arega - Adis Ken(አዲስ ቀን) - New Ethiopian Music 2017(Official Video) by Minew Shewa Tube 4 years ago 6 minutes, 57 seconds 26,090 views",Minew Shewa Entertainment,26090,26099,9
2538,"Yalew Anelye - Baytewar(ባይተዋር) - New Ethiopian Music 2017(Official Video) by Minew Shewa Tube 4 years ago 4 minutes, 52 seconds 50,886 views",Minew Shewa Entertainment,50886,50958,72
2539,"Abenet Demissie - Dendena Lebe(ደንድና ልቤ) - New Ethiopian Music 2017(Official Video) by Minew Shewa Tube 4 years ago 4 minutes, 3 seconds 117,273 views",Minew Shewa Entertainment,117273,117393,120
2540,"Ethiopian music : Dawit Nega - Zewidero(ዘዊደሮ) - New Ethiopian Music 2017(Official Video) by Minew Shewa Tube 4 years ago 7 minutes, 39 seconds 7,811,642 views",Minew Shewa Entertainment,7811642,7820389,8747
2541,"Mekdes G/Maryam - Hama Yotiyo(ሀማ ዮቲዮ) - New Ethiopian Music 2017(Official Video) by Minew Shewa Tube 4 years ago 4 minutes, 36 seconds 267,864 views",Minew Shewa Entertainment,267864,269244,1380
2542,"Ethiopian music : Maramawit Ageze - Weyene Gude(ወይኔ ጉዴ) - New Ethiopian Music 2017(Official Video) by Minew Shewa Tube 4 years ago 5 minutes, 6 seconds 3,827,970 views",Minew Shewa Entertainment,3827970,3830701,2731
2543,"Fekerte Mawecha - Demo Na(ደሞ ና) - New Ethiopian Music 2017(Official Video) by Minew Shewa Tube 4 years ago 4 minutes, 39 seconds 15,340 views",Minew Shewa Entertainment,15340,15344,4
2544,"Gashaw Misganaw - Hmera(ህምራ) - New Ethiopian Music 2017(Official Video) by Minew Shewa Tube 4 years ago 5 minutes, 38 seconds 58,481 views",Minew Shewa Entertainment,58481,58515,34
2545,"Agerenesh Meweded - Abet Webet(አቤት ውበት) - New Ethiopian Music 2017(Official Video) by Minew Shewa Tube 4 years ago 4 minutes, 17 seconds 26,130 views",Minew Shewa Entertainment,26130,26138,8
2546,"Natnael Tesfaye - Dancha(ዳንቻ) - New Ethiopian Music 2017(Official Video) by Minew Shewa Tube 4 years ago 5 minutes, 30 seconds 35,188 views",Minew Shewa Entertainment,35188,35200,12
2547,"Ethiopian music : Birhanu Taye - Mela Beyign(መላ በይኝ) - New Ethiopian Music 2017(Official Video) by Minew Shewa Tube 4 years ago 5 minutes, 19 seconds 1,916,818 views",Minew Shewa Entertainment,1916818,1919699,2881
2548,"Mseret Getachew - Ye Welo Lej(የወሎ ልጅ) - New Ethiopian Music 2017(Official Video) by Minew Shewa Tube 4 years ago 4 minutes, 57 seconds 42,138 views",Minew Shewa Entertainment,42138,42159,21
2549,"Eyobe Yenew - Bambazuka(ባምባዙካ) - New Ethiopian Music 2017(Official Video) by Minew Shewa Tube 4 years ago 4 minutes, 53 seconds 8,874 views",Minew Shewa Entertainment,8874,8881,7
2550,"Yohannes Fenta - Gonder(ጎንደር) - New Ethiopian Music 2017(Official Video) by Minew Shewa Tube 4 years ago 4 minutes, 55 seconds 9,251 views",Minew Shewa Entertainment,9251,9263,12
2551,"Eyerusalem Suzi - Na Belut(ና በሉት ) - New Ethiopian Music 2017(Official Video) by Minew Shewa Tube 4 years ago 4 minutes, 46 seconds 10,627 views",Minew Shewa Entertainment,10627,10630,3
2552,"Row B Ft. Elizabeth - Echlewalehu(እችለዋለሁ) - New Ethiopian Music 2017(Official Video) by Minew Shewa Tube 4 years ago 4 minutes, 34 seconds 8,076 views",Minew Shewa Entertainment,8076,8078,2
2553,"Tadelo Bolede(Bareye) - Lelas Aleleshm(ሌላስ አልልሽም) - New Ethiopian Music 2017(Official Video) by Minew Shewa Tube 4 years ago 5 minutes, 3 seconds 41,516 views",Minew Shewa Entertainment,41516,41520,4
2554,"workaferawu kebede - biromo - New Ethiopian Music 2017(Official Video) by Minew Shewa Tube 4 years ago 5 minutes, 1 second 17,727 views",Minew Shewa Entertainment,17727,17731,4
2555,"Samson Tafesse - Wanaw Tena New(ዋናው ጤና ነው) - New Ethiopian Music 2017(Official Video) by Minew Shewa Tube 4 years ago 5 minutes 15,397 views",Minew Shewa Entertainment,15397,15409,12
2556,"Tedi Etege Ft. Ethio Mambo - Yetadelkush(የታደልኩሽ) - New Ethiopian Music 2017(Official Video) by Minew Shewa Tube 4 years ago 5 minutes, 5 seconds 5,931 views",Minew Shewa Entertainment,5931,5933,2
2557,"Lej Wendale Werku - Manew Yalew Kasan Gondere - New Ethiopian Music 2017(Official Video) by Minew Shewa Tube 4 years ago 4 minutes, 58 seconds 33,006 views",Minew Shewa Entertainment,33006,33016,10
2558,"Daanieel Angessaa - 911 - New Ethiopian Music 2017(Official Video) by Minew Shewa Tube 4 years ago 5 minutes, 59 seconds 6,980 views",Minew Shewa Entertainment,6980,6985,5
2559,"Temsegen Kasu - Destaye Nesh(ደስታዬ ነሽ) - New Ethiopian Music 2017(Official Video) by Minew Shewa Tube 4 years ago 4 minutes, 42 seconds 465,536 views",Minew Shewa Entertainment,465536,465707,171
2560,"Alehegn Demas - Zeb Leder Wey(ዘብ ልደር ወይ) - New Ethiopian Music 2017(Official Video) by Minew Shewa Tube 4 years ago 5 minutes, 23 seconds 29,137 views",Minew Shewa Entertainment,29137,29162,25
2561,"Michael Melaku (Mike) - Enateye(እናትዬ) - New Ethiopian Music 2017(Official Video) by Minew Shewa Tube 4 years ago 4 minutes, 50 seconds 71,186 views",Minew Shewa Entertainment,71186,71248,62
2562,"Adugna Merga - Sumamalee - New Ethiopian Music 2017(Official Video) by Minew Shewa Tube 4 years ago 5 minutes, 10 seconds 23,085 views",Minew Shewa Entertainment,23085,23097,12
2563,"Maramawit Ageze - Leben Melesew(ልቤን መልሰው) - New Ethiopian Music 2017(Official Video) by Minew Shewa Tube 4 years ago 4 minutes, 39 seconds 365,173 views",Minew Shewa Entertainment,365173,365262,89
2564,"Mekuanent Melesse  - Yemar Weha(የማር ውሃ) - New Ethiopian Music 2017(Official Video) by Minew Shewa Tube 4 years ago 5 minutes, 36 seconds 68,610 views",Minew Shewa Entertainment,68610,68635,25
2565,"Habetamu Bere - Muluye(ሙሉዬ) - New Ethiopian Music 2017(Official Video) by Minew Shewa Tube 4 years ago 4 minutes, 51 seconds 197,561 views",Minew Shewa Entertainment,197561,197576,15
2566,"Lemelem Kassahun - Shew Elem Shew(ሽው እልም ሽው) - New Ethiopian Music 2017(Official Video) by Minew Shewa Tube 4 years ago 3 minutes, 24 seconds 10,650 views",Minew Shewa Entertainment,10650,10657,7
2567,"Teklit Teame - Aydelenye(አይደልንየ) - New Ethiopian Music 2017(Official Video) by Minew Shewa Tube 4 years ago 5 minutes, 9 seconds 10,341 views",Minew Shewa Entertainment,10341,10341,0
2568,"Kasahun Wendemu - Demo Endegena(ደሞ እንደገና) - New Ethiopian Music 2017(Official Video) by Minew Shewa Tube 4 years ago 5 minutes, 24 seconds 27,524 views",Minew Shewa Entertainment,27524,27533,9
2569,"Ephrem Elias - Tete Faya(ቴቴ ፋያ) - New Ethiopian Music 2017(Official Video) by Minew Shewa Tube 4 years ago 4 minutes, 21 seconds 22,503 views",Minew Shewa Entertainment,22503,22541,38
2570,"Funny Part :- Hab Engidaw - Aliwedim(አልወድም) - New Ethiopian Music by Minew Shewa Tube 4 years ago 1 minute, 1 second 65,837 views",Minew Shewa Entertainment,65837,65851,14
2571,"Dawit Kebede - Weelliissaa - New Ethiopian Music 2017(Official Video) by Minew Shewa Tube 4 years ago 5 minutes 6,495 views",Minew Shewa Entertainment,6495,6500,5
2572,"Werku Andualem - Yekochal(ይቆጫል) - New Ethiopian Music 2017(Official Video) by Minew Shewa Tube 4 years ago 7 minutes, 30 seconds 114,157 views",Minew Shewa Entertainment,114157,114310,153
2573,"Tesfanesh Kebede - Na Hule(ና ሁሌ) - New Ethiopian Music 2017(Official Video) by Minew Shewa Tube 4 years ago 5 minutes, 29 seconds 76,877 views",Minew Shewa Entertainment,76877,76884,7
2574,"Muluken Taju - Alchlbet(አልችልበት) - New Ethiopian Music 2017(Official Video) by Minew Shewa Tube 4 years ago 3 minutes, 28 seconds 5,881 views",Minew Shewa Entertainment,5881,5887,6
2575,"Hab Engidaw - Aliwedim(አልወድም) - New Ethiopian Music 2017(Official Video) by Minew Shewa Tube 4 years ago 6 minutes, 31 seconds 3,003,586 views",Minew Shewa Entertainment,3003586,3005888,2302
2576,"Asrat Dola  - Boncho Sunta(ቦንቾ ሱንታ) - New Ethiopian Music 2017(Official Video) by Minew Shewa Tube 4 years ago 3 minutes, 58 seconds 26,335 views",Minew Shewa Entertainment,26335,26370,35
2577,"Habtamu Ashagere - Web Alem Alem(ውብ አለም አለም) - New Ethiopian Music 2017(Official Video) by Minew Shewa Tube 4 years ago 6 minutes 72,014 views",Minew Shewa Entertainment,72014,72041,27
2578,"Tatek Tamerat - MaMa(ማማ) - New Ethiopian Music 2017(Official Video) by Minew Shewa Tube 4 years ago 3 minutes, 54 seconds 10,366 views",Minew Shewa Entertainment,10366,10374,8
2579,"Kenaw zewedu - Men Tewabe(ምን ትዋብ) - New Ethiopian Music 2017(Official Video) by Minew Shewa Tube 4 years ago 6 minutes, 3 seconds 55,333 views",Minew Shewa Entertainment,55333,55343,10
2580,"Mekuanent Kasahun Ft. Demeke Bitew - Awi Wageda(አዊ ዋግዳ) - New Ethiopian Music 2017(Official Video) by Minew Shewa Tube 4 years ago 5 minutes, 25 seconds 437,425 views",Minew Shewa Entertainment,437425,437839,414
2581,"Yetbarek Bezabhe - Welo Tadeleshal(ወሎ ታድለሻል) - New Ethiopian Music 2017(Official Video) by Minew Shewa Tube 4 years ago 5 minutes, 28 seconds 37,253 views",Minew Shewa Entertainment,37253,37298,45
2582,"Tsehay Welde - Kememe(ቅመሜ) - New Ethiopian Music 2017(Official Video) by Minew Shewa Tube 4 years ago 5 minutes, 11 seconds 17,505 views",Minew Shewa Entertainment,17505,17508,3
2583,"Markachew Belachew(Mark) - Yematersa(የማትረሳ) - New Ethiopian Music 2017(Official Video) by Minew Shewa Tube 4 years ago 5 minutes, 16 seconds 78,533 views",Minew Shewa Entertainment,78533,78546,13
2584,"Ratheesh R.chandran - Yene liyu(የኔ ልዩ ) - New Ethiopian Music 2017(Official Video) by Minew Shewa Tube 4 years ago 5 minutes, 16 seconds 34,046 views",Minew Shewa Entertainment,34046,34052,6
2585,"Habtamu Fekadu - Na Belew(ና በለው) - New Ethiopian Music 2017(Official Video) by Minew Shewa Tube 4 years ago 5 minutes, 30 seconds 208,513 views",Minew Shewa Entertainment,208513,208710,197
2586,"Nathan - Dabes Dabs(ዳበስ ዳበስ) - New Ethiopian Music 2017(Official Video) by Minew Shewa Tube 4 years ago 5 minutes, 22 seconds 1,622,311 views",Minew Shewa Entertainment,1622311,1624422,2111
2587,"Leule Alemu - Moa Anbesa(ሞዓ አንበሳ) - New Ethiopian Music 2017(Official Video) by Minew Shewa Tube 4 years ago 3 minutes, 54 seconds 5,370 views",Minew Shewa Entertainment,5370,5375,5
2588,"Habetamu Mekonene - Enetarek(እንታረቅ) - New Ethiopian Music 2017(Official Video) by Minew Shewa Tube 4 years ago 4 minutes, 7 seconds 18,818 views",Minew Shewa Entertainment,18818,18922,104
2589,"Kalab Girma - Chewa Nesh(ጨዋ ነሽ) - New Ethiopian Music 2017(Official Video) by Minew Shewa Tube 4 years ago 6 minutes, 1 second 36,005 views",Minew Shewa Entertainment,36005,36014,9
2590,"Metages Alebachew - Kene Lene(ከኔ ለኔ) - New Ethiopian Music 2017(Official Video) by Minew Shewa Tube 4 years ago 5 minutes, 20 seconds 18,247 views",Minew Shewa Entertainment,18247,18256,9
2591,"Zerihun Tesfaye - Hememe(ህመሜ) - New Ethiopian Music 2017(Official Video) by Minew Shewa Tube 4 years ago 4 minutes, 58 seconds 22,019 views",Minew Shewa Entertainment,22019,22026,7
2592,"Kebur W/Giyorgis - Kbur New Gojam(ክቡር ነው ጎጃም) - New Ethiopian Music 2017(Official Video) by Minew Shewa Tube 4 years ago 5 minutes, 54 seconds 155,476 views",Minew Shewa Entertainment,155476,155664,188
2593,"Zeynuu Mahbuub - Bareedduu Kamisee(ባሬዱ ከሚሴ) - New Ethiopian Music 2017(Official Video) by Minew Shewa Tube 4 years ago 5 minutes, 12 seconds 12,151 views",Minew Shewa Entertainment,12151,12160,9
2594,"Zelalem (Henzo) Ft. Netsanet Melkamu  - Shibo(ሺቦ) - New Ethiopian Music 2017(Official Video) by Minew Shewa Tube 4 years ago 3 minutes, 15 seconds 7,069 views",Minew Shewa Entertainment,7069,7087,18
2595,"Abenet Girma - Yarebiya Duneya(ያረቢያ ዱንያ) - New Ethiopian Music 2017(Official Video) by Minew Shewa Tube 4 years ago 7 minutes 1,833,130 views",Minew Shewa Entertainment,1833130,1855107,21977
2596,"Babby Ragga Ft. Mekdes Alebachew - Yigermal(ይገርማል) - New Ethiopian Music 2017(Official Video) by Minew Shewa Tube 4 years ago 4 minutes, 4 seconds 57,719 views",Minew Shewa Entertainment,57719,57726,7
2597,"Fantanesh Mekonene - Shekerkere(ሽቅርቅሬ) - New Ethiopian Music 2017(Official Video) by Minew Shewa Tube 4 years ago 6 minutes, 34 seconds 323,187 views",Minew Shewa Entertainment,323187,323330,143
2598,"Seble Tekle - Kalen(ቃሌን) - New Ethiopian Music 2017(Official Video) by Minew Shewa Tube 4 years ago 4 minutes, 8 seconds 76,429 views",Minew Shewa Entertainment,76429,76438,9
2599,"Gedefaw Arega - Awi Embiteta(አዊ እምቢቴታ) - New Ethiopian Music 2017(Official Video) by Minew Shewa Tube 4 years ago 6 minutes, 31 seconds 26,057 views",Minew Shewa Entertainment,26057,26115,58
2600,"Menbere T/Selase - Des Yelale(ደስ ይላል) - New Ethiopian Music 2017(Official Video) by Minew Shewa Tube 4 years ago 4 minutes, 57 seconds 20,979 views",Minew Shewa Entertainment,20979,20985,6
2601,"Kasahun Seid - Yewelo Lij(የወሎ ልጅ) - New Ethiopian Music 2017(Official Video) by Minew Shewa Tube 4 years ago 5 minutes, 49 seconds 542,118 views",Minew Shewa Entertainment,542118,542717,599
2602,"Guade Shegaw - Zem Atebeye(ዝም አትበይ) - New Ethiopian Music 2017(Official Video) by Minew Shewa Tube 4 years ago 5 minutes, 13 seconds 42,485 views",Minew Shewa Entertainment,42485,42500,15
2603,"Demeke Bitew - Eweye Ewa(እውይ እዋ) - New Ethiopian Music 2017(Official Video) by Minew Shewa Tube 4 years ago 7 minutes, 52 seconds 79,561 views",Minew Shewa Entertainment,79561,79711,150
2604,"Bemnet Eri Ft  Eyobed - Kasebkubet(ካሰብኩበት) - New Ethiopian Music 2017(Official Video) by Minew Shewa Tube 4 years ago 3 minutes, 16 seconds 16,137 views",Minew Shewa Entertainment,16137,16148,11
2605,"Asne Abate - Tri Tri(ቲሪ ቲሪ) - New Ethiopian Music 2017(Official Video) by Minew Shewa Tube 4 years ago 3 minutes, 42 seconds 33,668 views",Minew Shewa Entertainment,33668,33787,119
2606,"Berhanu Werke - Bedemena(በደመና) - New Ethiopian Music 2017 (Official Video) by Minew Shewa Tube 4 years ago 5 minutes, 27 seconds 81,188 views",Minew Shewa Entertainment,81188,81336,148
2607,"Misekir Awel - Elohe(ኤሎሄ) - New Ethiopian Music 2017 (Official Audio) by Minew Shewa Tube 4 years ago 7 minutes, 52 seconds 23,798 views",Minew Shewa Entertainment,23798,23860,62
2608,"Getahun Assefa - Ayezohe(አይዞህ) - New Ethiopian Music 2017 (Official Video) by Minew Shewa Tube 4 years ago 6 minutes, 6 seconds 13,701 views",Minew Shewa Entertainment,13701,13708,7
2609,"Asgegnew Ashko (Asge) - Nudare Gamo Gofa(ኑደሬ ጋሞ ጎፋ) - New Ethiopian Music 2017 (Official Video) by Minew Shewa Tube 4 years ago 5 minutes, 25 seconds 233,339 views",Minew Shewa Entertainment,233339,233643,304
2610,"Jordan & Bek Ge'ez - Ande Laye(አንድ ላይ) - New Ethiopian Music 2017(Official Video) by Minew Shewa Tube 4 years ago 4 minutes, 31 seconds 4,941 views",Minew Shewa Entertainment,4941,4945,4
2611,"Jordan & Bek Ge'ez Ft Mike,Eyobed & Manetseta - Kegna(ከኛ) - New Ethiopian Music 2017(Official Video) by Minew Shewa Tube 4 years ago 3 minutes, 19 seconds 6,407 views",Minew Shewa Entertainment,6407,6414,7
2612,"Sisaye Melese - Eyabebech Metach(እያበበች መጣች) - New Ethiopian Music 2017(Official Video) by Minew Shewa Tube 4 years ago 5 minutes, 39 seconds 128,263 views",Minew Shewa Entertainment,128263,128273,10
2613,"Tesfanesh Kebede - Mahay Tahay - New Somali Music 2017(Official Video) by Minew Shewa Tube 4 years ago 5 minutes, 35 seconds 82,721 views",Minew Shewa Entertainment,82721,83234,513
2614,"Kedamawi Mogese - Kora Bey(ኮራ በይ) - New Ethiopian Music 2017(Official Video) by Minew Shewa Tube 4 years ago 5 minutes, 34 seconds 24,685 views",Minew Shewa Entertainment,24685,24692,7
2615,"Feta Arega - Berzaza(በርዛዛ) - New Ethiopian Music 2017(Official Video) by Minew Shewa Tube 4 years ago 5 minutes, 35 seconds 42,352 views",Minew Shewa Entertainment,42352,42355,3
2616,"Lil Yomo - Eshi Ateyim Ende(እሺ አትይም እንዴ) - New Ethiopian Music 2017(Official Video) by Minew Shewa Tube 4 years ago 5 minutes, 10 seconds 24,185 views",Minew Shewa Entertainment,24185,24190,5
2617,"Melkamu Shmels - Ye Gojamua Konjo(የጎጃሟ ቆንጆ) - New Ethiopian Music 2017(Official Video) by Minew Shewa Tube 4 years ago 5 minutes, 33 seconds 8,190 views",Minew Shewa Entertainment,8190,8198,8
2618,"Beza Mulugeta - Agul KulKul(አጉል ኩል ኩል) - New Ethiopian Music 2017(Official Video) by Minew Shewa Tube 4 years ago 5 minutes, 10 seconds 18,735 views",Minew Shewa Entertainment,18735,18746,11
2619,"Ras Seyoume - Catch A Judgement - New Ethiopian Music 2017(Official Video) by Minew Shewa Tube 4 years ago 4 minutes, 17 seconds 3,888 views",Minew Shewa Entertainment,3888,3890,2
2620,"Misganaw Mekonen - Eweye Beye(እውይ በይ) - New Ethiopian Music 2017(Official Video) by Minew Shewa Tube 4 years ago 5 minutes, 39 seconds 86,755 views",Minew Shewa Entertainment,86755,86781,26
2621,"Senait Eshetu - Fekir Kus Aydelm(ፍቅር ቁስ አይደለም) - New Ethiopian Music 2017(Official Video) by Minew Shewa Tube 4 years ago 3 minutes, 44 seconds 12,536 views",Minew Shewa Entertainment,12536,12536,0
2622,"Tsegaye G/Meskel(Abilo) - Neyema(ነይማ) - New Ethiopian Music 2017(Official Video) by Minew Shewa Tube 4 years ago 6 minutes, 1 second 64,943 views",Minew Shewa Entertainment,64943,64950,7
2623,"Kasahun Seid - Borena(ቦረና) - New Ethiopian Music 2017(Official Video) by Minew Shewa Tube 4 years ago 6 minutes, 26 seconds 277,509 views",Minew Shewa Entertainment,277509,279055,1546
2624,"Miki Lule - Teka Gerena(ተካ ገረና) - New Ethiopian Music 2017(Official Video) by Minew Shewa Tube 4 years ago 4 minutes, 35 seconds 14,878 views",Minew Shewa Entertainment,14878,14878,0
2625,"Ethiopian Music ; Bisrat Alemayhu - Benafkot(በናፍቆት) - New Ethiopian Music 2017(Official Video) by Minew Shewa Tube 4 years ago 4 minutes, 41 seconds 25,086 views",Minew Shewa Entertainment,25086,25108,22
2626,"Eskender Zerihun - Ye Ayen Fiker(የአይን ፍቅር) - New Ethiopian Music 2017(Official Video) by Minew Shewa Tube 4 years ago 4 minutes, 17 seconds 9,668 views",Minew Shewa Entertainment,9668,9679,11
2627,"Ethiopian music ; Beti Ethiopia - Ke Ayene(ከአይኔ) - New Ethiopian Music 2017(Official Video) by Minew Shewa Tube 4 years ago 4 minutes, 40 seconds 64,317 views",Minew Shewa Entertainment,64317,64324,7
2628,"Asechalew Feten & Yelfashewa Ejegu - Adewa(አደዋ) - New Ethiopian Music 2017(Official Video) by Minew Shewa Tube 5 years ago 4 minutes, 9 seconds 10,771 views",Minew Shewa Entertainment,10771,10852,81
2629,"Alemayhu Chafako - Bali Helele(ባሊሄሌሌ) - New Ethiopian Music 2017(Official Video) by Minew Shewa Tube 5 years ago 5 minutes, 45 seconds 240,542 views",Minew Shewa Entertainment,240542,244410,3868
2630,"Mulualem Takele & Ephrem Amare - Teshenfiyalhu(ተሸንፊያለሁ) - New Ethiopian Music 2017(Official Audio) by Minew Shewa Tube 5 years ago 4 minutes, 47 seconds 40,549 views",Minew Shewa Entertainment,40549,40586,37
2631,"Dere Mak - And Alegn Yemelat(አንድ አለኝ የምላት) - New Ethiopian Music 2017(Official Video) by Minew Shewa Tube 5 years ago 6 minutes, 22 seconds 68,610 views",Minew Shewa Entertainment,68610,68628,18
2632,"Ujulu Fera & kifele Wosene - Nyangatom(ንያንጋቶም) - New Ethiopian Music 2017(Official Video) by Minew Shewa Tube 5 years ago 4 minutes, 11 seconds 22,233 views",Minew Shewa Entertainment,22233,22374,141
2633,"Amarech Alemu(Ami) - Nama(ናማ) - New Ethiopian Music 2017(Official Video) by Minew Shewa Tube 5 years ago 5 minutes, 24 seconds 101,852 views",Minew Shewa Entertainment,101852,101899,47
2634,"Kasahun Wendmu - Degemo Endegena(ደግሞ እንደገና) - New Ethiopian Music 2017(Official Video) by Minew Shewa Tube 5 years ago 5 minutes, 32 seconds 42,364 views",Minew Shewa Entertainment,42364,42376,12
2635,"Abel Abera & Hana Asmamaw - Lantika(ላንቲካ) - New Ethiopian Music 2017(Official Video) by Minew Shewa Tube 5 years ago 5 minutes, 42 seconds 66,415 views",Minew Shewa Entertainment,66415,66435,20
2636,"Getahun Ketema(Gech) - Yamegnal(ያመኛል) - New Ethiopian Music 2017(Official Video) by Minew Shewa Tube 5 years ago 4 minutes, 6 seconds 45,172 views",Minew Shewa Entertainment,45172,45189,17
2637,"Tariku Kasahun - Tew Geba Hagerhe(ተው ግባ ሀገርህ) - New Ethiopian Music 2017(Official Video) by Minew Shewa Tube 5 years ago 5 minutes, 27 seconds 28,129 views",Minew Shewa Entertainment,28129,28132,3
2638,"Rezen Beyen(Rezi) - Maraki(ማራኪ) - New Ethiopian Music 2017(Official Video) by Minew Shewa Tube 5 years ago 5 minutes, 13 seconds 70,487 views",Minew Shewa Entertainment,70487,70495,8
2639,"Desalegn Derse(Merewa) - Shemunemun(ሽሙንሙን) - New Ethiopian Music 2017(Official Video) by Minew Shewa Tube 5 years ago 5 minutes, 34 seconds 22,405 views",Minew Shewa Entertainment,22405,22423,18
2640,"Mesert Sheferaw - Yalanchi(ያላቺ) - New Ethiopian Music 2017(Official Video) by Minew Shewa Tube 5 years ago 4 minutes, 30 seconds 15,806 views",Minew Shewa Entertainment,15806,15807,1
2641,"Eth Mambo - Masaw Lay(ማሳው ላይ) - New Ethiopian Music 2017(Official Video) by Minew Shewa Tube 5 years ago 4 minutes, 33 seconds 10,680 views",Minew Shewa Entertainment,10680,10681,1
2642,"Mihrteab Albel - Yedegoch Ager(የደጎቹ አገር) - New Ethiopian Music 2017(Official Video) by Minew Shewa Tube 5 years ago 5 minutes, 50 seconds 23,220 views",Minew Shewa Entertainment,23220,23229,9
2643,"Tigist Gulete(Yeshi) - Nalegn(ናልኝ) - New Ethiopian Music 2017(Official Video) by Minew Shewa Tube 5 years ago 4 minutes, 7 seconds 80,050 views",Minew Shewa Entertainment,80050,80074,24
2644,"Tesfanesh Kbede - Na Hule(ና ሁሌ) - New Ethiopian Music 2017(Official Video) by Minew Shewa Tube 5 years ago 5 minutes, 40 seconds 53,470 views",Minew Shewa Entertainment,53470,53492,22
2645,"Asne Abate - Male(ማሌ) - New Ethiopian Music 2017(Official Video) by Minew Shewa Tube 5 years ago 4 minutes, 30 seconds 166,847 views",Minew Shewa Entertainment,166847,168924,2077
2646,"Semir Hasen (LaLa) - Suk Suke(ሱክ ሱኬ) - New Ethiopian Music 2017(Official Video) by Minew Shewa Tube 5 years ago 3 minutes, 45 seconds 13,370 views",Minew Shewa Entertainment,13370,13379,9
2647,"Birahne Tefera - Been Mee Deem - New Afaan Oromo Music 2017(Official Video) by Minew Shewa Tube 5 years ago 4 minutes, 52 seconds 142,784 views",Minew Shewa Entertainment,142784,143042,258
2648,"Tadiyos Abaye - Gumeta(ጉምታ) - New Ethiopian Music 2017(Official Video) by Minew Shewa Tube 5 years ago 6 minutes, 17 seconds 10,844 views",Minew Shewa Entertainment,10844,10854,10
2649,"Fasil Tesfay - Mereba(መረባ) - New Ethiopian Music 2017(Official Video) by Minew Shewa Tube 5 years ago 6 minutes, 3 seconds 352,225 views",Minew Shewa Entertainment,352225,352609,384
2650,"Hirut Negesue - Ferahugn(ፈራሁኝ) - New Ethiopian Music 2017(Official Video) by Minew Shewa Tube 5 years ago 5 minutes, 40 seconds 11,508 views",Minew Shewa Entertainment,11508,11516,8
2651,"Yeterfwork Kindie (Yeti) - Tunan(ቱናን) - New Ethiopian Music 2017(Official Video) by Minew Shewa Tube 5 years ago 4 minutes, 50 seconds 16,924 views",Minew Shewa Entertainment,16924,16933,9
2652,"Sentayehu Delele - Tolo Neye - (ቶሎ ነይ) - New Ethiopian Music 2017(Official Video) by Minew Shewa Tube 5 years ago 6 minutes, 17 seconds 296,913 views",Minew Shewa Entertainment,296913,296982,69
2653,"Kalab Girma - Akale Webe(አካሌ ውቤ) - New Ethiopian Music 2017(Official Video) by Minew Shewa Tube 5 years ago 3 minutes, 38 seconds 23,501 views",Minew Shewa Entertainment,23501,23507,6
2654,"Daniel Tadese - Gena Ewedeshalhu(ገና እወድሻለሁ ) - New Ethiopian Music 2017(Official Audio) by Minew Shewa Tube 5 years ago 5 minutes, 9 seconds 47,314 views",Minew Shewa Entertainment,47314,47363,49
2655,"Lense Lemessa(Meeti) - Naafkotu(ናፍኮቱ) - New Afaan Oromo Music 2017(Official Video) by Minew Shewa Tube 5 years ago 5 minutes, 6 seconds 104,794 views",Minew Shewa Entertainment,104794,104858,64
2656,"Yared Mekonen - Semeshn Salanesa(ስምሽን ሳላነሳ) - New Ethiopian Music 2017(Official Video) by Minew Shewa Tube 5 years ago 4 minutes, 59 seconds 13,822 views",Minew Shewa Entertainment,13822,13824,2
2657,"Melese Bayu - Mamaye(ማማዬ) - New Ethiopian Music 2017(Official Video) by Minew Shewa Tube 5 years ago 4 minutes, 32 seconds 9,597 views",Minew Shewa Entertainment,9597,9601,4
2658,"Daniel Masresha - Eshi Beyign(እሺ በይኝ) - New Ethiopian Music 2017(Official Video) by Minew Shewa Tube 5 years ago 6 minutes, 41 seconds 174,437 views",Minew Shewa Entertainment,174437,174572,135
2659,"Umer Ali - Zemuye(ዘሙዬ) - New Ethiopian Music 2017(Official Video) by Minew Shewa Tube 5 years ago 5 minutes, 5 seconds 348,590 views",Minew Shewa Entertainment,348590,350174,1584
2660,"Mister Yonas - NaNa Konjeye(ናና ቆንጅዬ) - New Ethiopian Music 2017(Official Video) by Minew Shewa Tube 5 years ago 3 minutes, 57 seconds 14,189 views",Minew Shewa Entertainment,14189,14197,8
2661,"Mulugeta Arega - YemanNat(የማንናት) - New Ethiopian Music 2017(Official Video) by Minew Shewa Tube 5 years ago 4 minutes, 39 seconds 90,497 views",Minew Shewa Entertainment,90497,90508,11
2662,"Ras Biruk Barky - Guragigna(ጉራግኛ) - New Ethiopian Music 2017(Official Video) by Minew Shewa Tube 5 years ago 3 minutes, 50 seconds 20,510 views",Minew Shewa Entertainment,20510,20520,10
2663,"Ethiopian Music :Alemeye Getachew Weyene Alemeye (ወይኔ አለምዬ) New Ethiopian Music 2017(Official Video) by Minew Shewa Tube 5 years ago 5 minutes, 38 seconds 5,190,285 views",Minew Shewa Entertainment,5190285,5198049,7764
2664,"Ethiopian: Merga Assefa - Kolfi(ኮልፊ) - New Ethiopian Music 2017(Official Video) by Minew Shewa Tube 5 years ago 3 minutes, 41 seconds 10,608 views",Minew Shewa Entertainment,10608,10622,14
2665,"FIE BE/M-21/RUK/V-GO/MARSAHL-E - Hawassa New Bete - New Ethiopian Music 2017(Official Video) by Minew Shewa Tube 5 years ago 4 minutes, 37 seconds 113,839 views",Minew Shewa Entertainment,113839,113948,109
2666,"Ethiopian - Melese Kasahun - Hemre Bikule zeyo - New Ethiopian Music 2017(Official Video) by Minew Shewa Tube 5 years ago 6 minutes, 12 seconds 213,808 views",Minew Shewa Entertainment,213808,214255,447
2667,"Ethiopian - Haymanot Matebu - Lebesh(ልብሽ) - New Ethiopian Music 2017(Official Video) by Minew Shewa Tube 5 years ago 5 minutes, 21 seconds 62,599 views",Minew Shewa Entertainment,62599,62608,9
2668,"Ethiopian - Mekdes Negatu - Sew Ale(ሰው አለ) - New Ethiopian Music 2017(Official Video) by Minew Shewa Tube 5 years ago 3 minutes, 34 seconds 15,862 views",Minew Shewa Entertainment,15862,15869,7
2669,"Ethiopian - Yaanneet Dinquu - Baasi Gumaa - New Ethiopian Music 2017(Official Video) by Minew Shewa Tube 5 years ago 4 minutes, 43 seconds 68,691 views",Minew Shewa Entertainment,68691,68736,45
2670,"Ethiopian - Alem kebede - Akelaletew(አቀላለጠው) - New Ethiopian Music 2017(Official Video) by Minew Shewa Tube 5 years ago 5 minutes, 44 seconds 48,935 views",Minew Shewa Entertainment,48935,48993,58
2671,"Ethiopian - Abebe Kefeni - Yalechbet(ያለችበት) - New Ethiopian Music 2017(Official Video) by Minew Shewa Tube 5 years ago 6 minutes, 8 seconds 25,920 views",Minew Shewa Entertainment,25920,25976,56
2672,"Ethiopian - Selam Ewnetu - Gomelale(ጐምላሌ) - New Ethiopian Music 2017(Official Video) by Minew Shewa Tube 5 years ago 6 minutes, 22 seconds 227,120 views",Minew Shewa Entertainment,227120,227287,167
2673,"Ethiopian - Berihun Demele - Balanbarua(ባላንባሯ) - New Ethiopian Music 2017(Official Video) by Minew Shewa Tube 5 years ago 6 minutes, 17 seconds 356,453 views",Minew Shewa Entertainment,356453,356956,503
2674,"Ethiopian - Mekdes Girma - Yedero Gize(የድሮ ግዜ) - New Ethiopian Music 2016(Official Video) by Minew Shewa Tube 5 years ago 4 minutes, 58 seconds 83,664 views",Minew Shewa Entertainment,83664,83721,57
2675,"Ethiopian - kuluberhan Abebe - BahirDar(ባህርዳር) - New Ethiopian Music 2016(Official Video) by Minew Shewa Tube 5 years ago 5 minutes, 3 seconds 32,334 views",Minew Shewa Entertainment,32334,32352,18
2676,"Ethiopian music - Yetayew Ande - Bebelay(በበላይ) - New Ethiopian Music 2016(Official Video) by Minew Shewa Tube 5 years ago 6 minutes, 32 seconds 44,560 views",Minew Shewa Entertainment,44560,44578,18
2677,"Ethiopian music - Yohannes Girma (ጆኒ) - Megen Ene(መገን እኔ) - New Ethiopian Music 2016(Official Video) by Minew Shewa Tube 5 years ago 4 minutes, 49 seconds 2,445,951 views",Minew Shewa Entertainment,2445951,2458756,12805
2678,"Ethiopian - Tariku 80 & Bini Dana - Wefe komech | ወፌ ቆመች - New Ethiopian Music 2016(Official Video) by Minew Shewa Tube 5 years ago 5 minutes, 6 seconds 115,695 views",Minew Shewa Entertainment,115695,115759,64
2679,"Ethiopian - Misikir Tilahun - Neha Neha | ነሀ ነሀ - New Ethiopian Music 2016(Official Video) by Minew Shewa Tube 5 years ago 4 minutes, 36 seconds 18,507 views",Minew Shewa Entertainment,18507,18545,38
2680,"Ethiopian - Yemiwedih Husien - Zekri | ዘክሪ - New Ethiopian Music 2016(Official Video) by Minew Shewa Tube 5 years ago 5 minutes, 55 seconds 19,698 views",Minew Shewa Entertainment,19698,19762,64
2681,"Ethiopian - Umer Ali - Zemuye | ዘሙዬ - New Ethiopian Music 2016(Official Video) by Minew Shewa Tube 5 years ago 6 minutes, 35 seconds 1,232,303 views",Minew Shewa Entertainment,1232303,1248498,16195
2682,"Ethiopian Music: Asgegnew Ashko (Asge) Bale Robe | ባሌ ሮቤ - New Ethiopian Music 2017(Official Video) by Minew Shewa Tube 5 years ago 5 minutes, 1 second 2,897,311 views",Minew Shewa Entertainment,2897311,2911484,14173
2683,"Ethiopian - Demeke Bitew - Tilili | ቲሊሊ - New Ethiopian Music 2016(Official Video) by Minew Shewa Tube 5 years ago 6 minutes, 29 seconds 73,846 views",Minew Shewa Entertainment,73846,73999,153
2684,"Ethiopian - Ermias Terefe (Bilbile) - Kotume | ኮቱሜ - New Ethiopian Music 2016(Official Video) by Minew Shewa Tube 5 years ago 4 minutes, 43 seconds 21,598 views",Minew Shewa Entertainment,21598,21621,23
2685,"Rahel Haile,Getachew H/Mariam,Tesfaye Taye,Feleke Maru - Hagere | ሀገሬ - New Ethiopian Music 2016 by Minew Shewa Tube 5 years ago 8 minutes, 32 seconds 120,065 views",Minew Shewa Entertainment,120065,120111,46
2686,"Ethiopian Music : Maditu Weday (Eshkem) ማዲቱ ወዳይ(እሽክም) - New Ethiopian Music 2016(Official Video) by Minew Shewa Tube 5 years ago 6 minutes, 15 seconds 6,748,696 views",Minew Shewa Entertainment,6748696,6770311,21615
2687,"Ethiopian music - Wendesen Maru Yekertan Bezema(ይቅርታን በዜማ) -New Ethiopian Music 2016(Official Video) by Minew Shewa Tube 5 years ago 4 minutes, 40 seconds 17,562 views",Minew Shewa Entertainment,17562,17597,35
2688,"Ethiopian - Teketo Amede - Yetal Yetal(የታል የታል) - New Ethiopian Music 2016(Official Video) by Minew Shewa Tube 5 years ago 4 minutes, 51 seconds 40,682 views",Minew Shewa Entertainment,40682,40696,14
2689,"Ethiopian - Muluka Adill - Ante Welela(አንተ ወለላ) - New Ethiopian Music 2016(Official Video) by Minew Shewa Tube 5 years ago 5 minutes, 45 seconds 24,966 views",Minew Shewa Entertainment,24966,25042,76
2690,"Ethiopian - Aster Welde - Jenn Aweyern(ጀንን አወይርነ) - New Ethiopian Music 2016(Official Video) by Minew Shewa Tube 5 years ago 5 minutes, 52 seconds 906,715 views",Minew Shewa Entertainment,906715,915399,8684
2691,"Ethiopian - Buju Star - Chu Chu Male (ቹቹ ማሌ)- New Ethiopian Music 2016(Official Video) by Minew Shewa Tube 5 years ago 4 minutes, 35 seconds 13,411 views",Minew Shewa Entertainment,13411,13454,43
2692,"Ethiopian - Solo Da l Kids Dancing - Shima(ሺማ) - New Ethiopian Music 2016(Official Video) by Minew Shewa Tube 5 years ago 4 minutes, 9 seconds 549,124 views",Minew Shewa Entertainment,549124,549687,563
2693,"Ethiopian Music: Mekuanent Melese (Hagere) ሙኳንንት መለሰ (ሀገሬ) New Ethiopian Music 2016(Official Video) by Minew Shewa Tube 5 years ago 6 minutes, 14 seconds 1,496,924 views",Minew Shewa Entertainment,1496924,1498794,1870
2694,"Ethiopian - Mekdes Negatu - Gudu Endayefela(ጉዱ እንዳይፈላ) - New Ethiopian Music 2016(Official Video) by Minew Shewa Tube 5 years ago 5 minutes, 20 seconds 37,723 views",Minew Shewa Entertainment,37723,37743,20
2695,"Ethiopian - Kidist Haylu - Tolo (ቶሎ) - New Ethiopian Music 2016(Official Video) by Minew Shewa Tube 5 years ago 4 minutes, 21 seconds 31,911 views",Minew Shewa Entertainment,31911,31937,26
2696,"Ethiopian music- Senedu Alee - Seladari(ስላዳሪ) - New Ethiopian Music 2016(Official Video) by Minew Shewa Tube 5 years ago 9 minutes, 2 seconds 1,940,385 views",Minew Shewa Entertainment,1940385,1942043,1658
2697,"Ethiopian - Zele Waliya ft Zewedu - Leyu Setota(ልዩ ስጦታ) - New Ethiopian Music 2016(Official Video) by Minew Shewa Tube 5 years ago 5 minutes, 16 seconds 4,255 views",Minew Shewa Entertainment,4255,4260,5
2698,"Ethiopian - Ashu Mune - Yemerbesh (ይመርብሽ) - New Ethiopian Music 2016(Official Video) by Minew Shewa Tube 5 years ago 5 minutes, 41 seconds 926,262 views",Minew Shewa Entertainment,926262,927542,1280
2699,"Ethiopian - Yetariksew Tadesse(Yod) - welelaye(ወለላዬ) - New Ethiopian Music 2016(Official Video) by Minew Shewa Tube 5 years ago 5 minutes, 40 seconds 72,117 views",Minew Shewa Entertainment,72117,72136,19
2700,"Ethiopian - Milkii Abbaa Namaa - Uffannaa Aadaan - New Ethiopian Music 2016(Official Video) by Minew Shewa Tube 5 years ago 5 minutes, 34 seconds 7,369 views",Minew Shewa Entertainment,7369,7386,17
2701,"Ethiopian - Samson Tafese - Wanaw Tena New(ዋናው ጤና ነው) - New Ethiopian Music 2016(Official Video) by Minew Shewa Tube 5 years ago 5 minutes 14,458 views",Minew Shewa Entertainment,14458,14492,34
2702,"Ethiopian - Kebur Abaye - Sedereye(ሰደርዬ) - New Ethiopian Music 2016(Official Video) by Minew Shewa Tube 5 years ago 7 minutes, 19 seconds 848,784 views",Minew Shewa Entertainment,848784,849530,746
2703,"Ethiopian - Tariku 80 Shele - Ale (አለ) - New Ethiopian Music 2016(Official Audio Music) by Minew Shewa Tube 5 years ago 4 minutes, 30 seconds 12,940 views",Minew Shewa Entertainment,12940,12951,11
2704,"Ethiopian - Zerihun Tesfaye - Amsegenalhu (አመሰግናለሁ) - New Ethiopian Music 2016(Official Video) by Minew Shewa Tube 5 years ago 5 minutes, 25 seconds 23,035 views",Minew Shewa Entertainment,23035,23047,12
2705,"Hayemanot Abreham ft.Eyerusalem Yizezew - Hememe(ህመሜ) - New Ethiopian Music 2016(Official Video) by Minew Shewa Tube 5 years ago 3 minutes, 10 seconds 73,708 views",Minew Shewa Entertainment,73708,73733,25
2706,"Ethiopian - Nahom Haile - Betera (በተራ) - New Ethiopian Music 2016(Official Music Video) by Minew Shewa Tube 5 years ago 4 minutes, 40 seconds 37,250 views",Minew Shewa Entertainment,37250,37264,14
2707,"Ethiopian - Endriyas Kelifa - Wede Gede - New Ethiopian Music 2016(Official Video) by Minew Shewa Tube 5 years ago 5 minutes, 3 seconds 46,987 views",Minew Shewa Entertainment,46987,47006,19
2708,"Ethiopian - Ahmed Legase - Embualele (እምቧለሌ) - New Ethiopian Music 2016(Official Music Video) by Minew Shewa Tube 5 years ago 5 minutes, 20 seconds 72,904 views",Minew Shewa Entertainment,72904,72941,37
2709,"Tokichaw ft.BujuStar  - MetoMokoPolo - New Ethiopian Music 2016(Official Video) by Minew Shewa Tube 5 years ago 4 minutes, 30 seconds 35,643 views",Minew Shewa Entertainment,35643,35719,76
2710,"Yedenekachew Mekonene ft. Eyerusalem Abereham - Seme Nesh - New Ethiopian Music 2016(Official Video) by Minew Shewa Tube 5 years ago 4 minutes, 21 seconds 2,296,152 views",Minew Shewa Entertainment,2296152,2296958,806
2711,"Ethiopian - Cirstina Melkamu - Melamed - New Ethiopian Music 2016(Official Music Video) by Minew Shewa Tube 5 years ago 5 minutes, 52 seconds 287,747 views",Minew Shewa Entertainment,287747,287830,83
2712,"Ethiopian - Azalech Abate - Hulume Hagere(ሁሉም ሀገሬ) - New Ethiopian Music 2016(Official Music Video) by Minew Shewa Tube 5 years ago 4 minutes, 28 seconds 153,955 views",Minew Shewa Entertainment,153955,154083,128
2713,"Ethiopian - Zemdekun Asefa - Mewededen(መውደዴን) - New Ethiopian Music 2016(Official Music Video) by Minew Shewa Tube 5 years ago 5 minutes, 40 seconds 71,549 views",Minew Shewa Entertainment,71549,71572,23
2714,"Ethiopian - Bedlu Esayas(Cream) - Ererere (ኧረረረ..) - New Ethiopian Music 2016(Official Music Video) by Minew Shewa Tube 5 years ago 4 minutes, 19 seconds 143,901 views",Minew Shewa Entertainment,143901,144191,290
2715,"Nati Hayle (pis) - Tadeye - New Ethiopian Music 2016(Official Music Video) by Minew Shewa Tube 5 years ago 5 minutes, 30 seconds 60,914 views",Minew Shewa Entertainment,60914,60944,30
2716,"Ethiopian - Fasil Tesfay - Cheschaso (ችስቻሶ) - New Ethiopian Music 2016(Official Music Video) by Minew Shewa Tube 5 years ago 6 minutes, 20 seconds 999,056 views",Minew Shewa Entertainment,999056,1000306,1250
2717,"Michael Guyassa (Mico) - Ahun Ahunema (አሁን አሁንማ) - New Ethiopian Music 2016(Official Music Video) by Minew Shewa Tube 5 years ago 6 minutes 51,256 views",Minew Shewa Entertainment,51256,51296,40
2718,"Amanuel Agegnehu X Abel Agegnehu - WaKelaRa - New Ethiopian Hip Hop Music 2016(official video) by Minew Shewa Tube 5 years ago 5 minutes, 34 seconds 130,757 views",Minew Shewa Entertainment,130757,131242,485
2719,"Meshesha Nekatibeb - Cheye Bababelate (ችዬ ባባብላት) - New Ethiopian Music 2016(Official Music Audio) by Minew Shewa Tube 5 years ago 5 minutes, 20 seconds 14,224 views",Minew Shewa Entertainment,14224,14227,3
2720,"Mekuanent Kasahun - Sarewe - New Ethiopian Music 2016 (Official Video) by Minew Shewa Tube 5 years ago 5 minutes, 15 seconds 136,386 views",Minew Shewa Entertainment,136386,136818,432
2721,"Marta Getachew - Asham Asham (አሻም አሻም) - New Ethiopian Music 2016 (Official Video) by Minew Shewa Tube 5 years ago 5 minutes, 44 seconds 85,070 views",Minew Shewa Entertainment,85070,85149,79
2722,"Ethiopian Music: Berhan Mola - Sende Debelku (ስንዴ ድብልቁ) - New Ethiopian Music 2016 (Official Video) by Minew Shewa Tube 5 years ago 6 minutes, 5 seconds 2,240,345 views",Minew Shewa Entertainment,2240345,2240849,504
2723,"Belay Melesie - Ethio Europe - New Ethiopian Music 2016 (Official Music audio) by Minew Shewa Tube 5 years ago 5 minutes, 25 seconds 3,309 views",Minew Shewa Entertainment,3309,3309,0
2724,"Kassahun Taye - Gojam Gerageru (ጎጃም ገራገሩ) - New Ethiopian Music 2016 (Official Music Video) by Minew Shewa Tube 5 years ago 5 minutes, 22 seconds 345,388 views",Minew Shewa Entertainment,345388,345871,483
2725,"Ethiopian music : Yayu  Nigussie - Yekbresh Enku - (የከበርሸ እንቁ) - New Ethiopian Music 2016. by Minew Shewa Tube 5 years ago 5 minutes, 51 seconds 334,311 views",Minew Shewa Entertainment,334311,334429,118
2726,"Frehiwot Sleshi - Telewetkebegn  - (Official Music Video) - New Ethiopian Music 2016 by Minew Shewa Tube 5 years ago 5 minutes, 36 seconds 62,927 views",Minew Shewa Entertainment,62927,62938,11
2727,"Ermi Toronto/NEY LEBLESH/ - New Ethiopian Music 2016(Official Music Audio) by Minew Shewa Tube 5 years ago 5 minutes, 24 seconds 26,083 views",Minew Shewa Entertainment,26083,26083,0
2728,"Alemeye Getachew -Weyene Alemeye (ወይኔ አለምዬ)- New Ethiopian Music 2016(Official Music Audio) by Minew Shewa Tube 5 years ago 4 minutes, 56 seconds 995,393 views",Minew Shewa Entertainment,995393,995689,296
2729,"Yared Teshale - Kirb Naw - New Ethiopian Music 2016 (Official Video) by Minew Shewa Tube 5 years ago 7 minutes, 13 seconds 16,012 views",Minew Shewa Entertainment,16012,16014,2
2730,"Michael Melaku (Mike)-Dera -New Ethiopian Music (Official Video) by Minew Shewa Tube 5 years ago 4 minutes, 41 seconds 9,839 views",Minew Shewa Entertainment,9839,9842,3
2731,"Ethiopian - Kaleabe Zelalem - Ney Ney/ነይ ነይ/ - New Ethiopian Music 2016(Official Video) by Minew Shewa Tube 5 years ago 4 minutes, 39 seconds 946,693 views",Minew Shewa Entertainment,946693,948368,1675
2732,"Bezuayhu Demesse-DEREBABA (ደርባባ) - New Ethiopian Music 2016(Official Audio) by Minew Shewa Tube 5 years ago 5 minutes, 17 seconds 95,529 views",Minew Shewa Entertainment,95529,95574,45
2733,"Teferi tesefaye/ Neyena Lasayesh / New Ethiopian Music 2016(Official Video) by Minew Shewa Tube 5 years ago 5 minutes, 15 seconds 470,263 views",Minew Shewa Entertainment,470263,470684,421
2734,"Yergalem W/yohannes /kako/ft, Samigo,  DENE  (ዴኔ)-New Ethiopian Music 2016 (Official Video) by Minew Shewa Tube 5 years ago 4 minutes, 26 seconds 447,475 views",Minew Shewa Entertainment,447475,450062,2587
2735,"Habte Abreham - Metadela(መታደሌ) -New Ethiopian Music 2016 (Official Video) by Minew Shewa Tube 5 years ago 5 minutes, 57 seconds 29,979 views",Minew Shewa Entertainment,29979,29984,5
2736,"Demeke Bitew - Awi Lagneta (አዊ ላኜታ)-New Ethiopian Music 2016 (Official Video) by Minew Shewa Tube 5 years ago 4 minutes, 21 seconds 140,007 views",Minew Shewa Entertainment,140007,140723,716
2737,"Minew Shewa Tube ( Official Video ) by Minew Shewa Tube 5 years ago 11 seconds 4,308 views",Minew Shewa Entertainment,4308,4309,1
2738,"Lekatit 11 German 2022 ለካቲት 11 መበል 47 በዓል ልደት ኣብ ጀርመን by MTV HABESHA 2 days ago 3 minutes, 43 seconds 1,371 views",MTV HABESHA,1371,1974,603
2739,"ዶ/ር ቴድሮስ ኣድሓኖም ዋና ዳይሬክተር ውድብ ጥዕና ዓለም  _ ህዝባዊያ ኢና ተዓወቲ ኢና by MTV HABESHA 2 weeks ago 10 minutes, 21 seconds 14,994 views",MTV HABESHA,14994,15553,559
2740,"Girmay Tesfay _ Hantin Hantin | ሓንትን ሓትን Tigray Music lekatit ለካቲት by MTV HABESHA 2 weeks ago 5 minutes 2,185 views",MTV HABESHA,2185,2269,84
2741,"Sisay Hishe_ Raiy  |ራእይ New Tigray Music Congratulations Dr Tedros by MTV HABESHA 1 month ago 5 minutes 11,900 views",MTV HABESHA,11900,12123,223
2742,"Bahta Gebrehiwot _ Ay Tigray Endo |ኣይ ትግራይ እንዶTigray Music @MTV HABESHA by MTV HABESHA 1 month ago 4 minutes, 50 seconds 8,024 views",MTV HABESHA,8024,8151,127
2743,"ምስ ኣፅዋሮም ውህብቶ ሙሩካት ካብ TDF ን TMH ናይ ሳልሳይ ዓመቱ by MTV HABESHA 1 month ago 11 seconds 58,461 views",MTV HABESHA,58461,58496,35
2744,"Tigray Music Humera _ ሑመራ humera city video with music 2022 by MTV HABESHA 1 month ago 5 minutes, 35 seconds 12,457 views",MTV HABESHA,12457,12561,104
2745,"Frankfurt Tigray Restaurant & bar ትግራይ ሬስቶራንት Adresse Speyerer Straße 6-8 Frankfurt am Main by MTV HABESHA 2 months ago 2 minutes, 46 seconds 3,647 views",MTV HABESHA,3647,3664,17
2746,"ጀነራል ምግበይ ሃይለ _ ኩሉ መሬት ትግራይ ዓደይ እዩ ኣበይ ተወሊደ ኣይኮነን ዘገድሰኒ !! by MTV HABESHA 2 months ago 5 minutes, 40 seconds 24,505 views",MTV HABESHA,24505,24905,400
2747,"TDF & OLAF In Frankfurt Demonstration Dec 3-12-2021 by MTV HABESHA 2 months ago 2 minutes, 46 seconds 3,025 views",MTV HABESHA,3025,3050,25
2748,"Mesfin Berhanu _ Hdri Alena ሕድሪ ኣለና Tigray New Music 2021 by MTV HABESHA 3 months ago 6 minutes, 15 seconds 16,448 views",MTV HABESHA,16448,16926,478
2749,"Tigray Music Tdf _ Mentaki Thlef Hiwetna | ምእንታኪ ትሕለፍ ሂወትና by MTV HABESHA 4 months ago 4 minutes, 44 seconds 2,992 views",MTV HABESHA,2992,3004,12
2750,"Eyasu Berhe _ Belay Wedey _ በላይ ወደይ by MTV HABESHA 4 months ago 9 minutes, 58 seconds 2,096 views",MTV HABESHA,2096,2126,30
2751,"ኣያ ሓወኒ መዓር ኣፉ ኣዲስ ኣበባሓሊፉ by MTV HABESHA 4 months ago 36 seconds 1,965 views",MTV HABESHA,1965,2026,61
2752,"#BREAKING: The Ethiopian regime has launched a second round of Air-Strikes, targeting civilians by MTV HABESHA 4 months ago 1 minute, 26 seconds 6,389 views",MTV HABESHA,6389,6401,12
2753,"ተግባር ምፅናት ትግራይ ማሕበረ ሰብ ዓለም ክፈልጦ ኣብ ምግባር ገና ዘይተዛዘመ ገዛ ዕዩ እዩ ክብል ተጋዳላይ ጌታቸው ረዳ ገሊፁ !! by MTV HABESHA 4 months ago 1 minute, 9 seconds 2,796 views",MTV HABESHA,2796,2831,35
2754,"TDF ካብ ግምባር እብ ሓፂር ግዜ ሙሉእ ዓወት ከምፅእ ብ ዕቱብ እንዳ ሰርሐ ይርከብ by MTV HABESHA 4 months ago 31 seconds 5,662 views",MTV HABESHA,5662,5668,6
2755,"Danait - Mampa -Mk_Boy -Yoni _ Bqeltsmna | ብ ቕልፅምና ! New Tigray Music 2021 by MTV HABESHA 4 months ago 4 minutes, 6 seconds 5,544 views",MTV HABESHA,5544,5579,35
2756,"New Tigray Music _ Natey Hizbey |ሰራዊት ትግራይ ኣርሚ 4 ባህሊ ፈንቅል _ ናተይ ህዝበይ by MTV HABESHA 4 months ago 6 minutes, 49 seconds 61,045 views",MTV HABESHA,61045,62085,1040
2757,"Girmay Haileselassie Lbna Gezakum |ልብና ገዛኩም Tigray Music TPLF by MTV HABESHA 4 months ago 7 minutes, 13 seconds 44,421 views",MTV HABESHA,44421,44617,196
2758,"Nguse Abadi _ wrurey | ውሩረይ  ካብ ግምባር by MTV HABESHA 5 months ago 10 minutes, 33 seconds 50,255 views",MTV HABESHA,50255,50927,672
2759,"Hiluf Alemu - Nebar Selesom | ሰለሶም  New Tigray Music 2021 by MTV HABESHA 5 months ago 9 minutes, 26 seconds 83,937 views",MTV HABESHA,83937,84969,1032
2760,"Mulugeta Kahsay (Wedi romit) _ Ane N Tigray | ኣነ ንትግራይ by MTV HABESHA 5 months ago 8 minutes, 1 second 24,506 views",MTV HABESHA,24506,24683,177
2761,"Birganu Mache _ Nekikumna ነኪእኩምና New Tigray Music 2014 by MTV HABESHA 5 months ago 10 minutes, 31 seconds 113,489 views",MTV HABESHA,113489,114726,1237
2762,"Mizan Tesfay _ Tigraye Welelo | ትግራየ ወለሎ New music video by MTV HABESHA 5 months ago 5 minutes, 53 seconds 23,365 views",MTV HABESHA,23365,23501,136
2763,"kidane wedi ale _ Menfes | መንፈስ New Tigray Music 2014 t.c by MTV HABESHA 5 months ago 11 minutes, 28 seconds 47,515 views",MTV HABESHA,47515,47942,427
2764,"Nguse abadi - Chlay | ጭላይ Tigray New Music video 2014 t.c by MTV HABESHA 5 months ago 6 minutes, 18 seconds 105,939 views",MTV HABESHA,105939,108253,2314
2765,"Hiluf Alemu - Nebar Tegadalay | ነባር ተጋዳላይ New Tigray Music 2021 by MTV HABESHA 5 months ago 6 minutes, 4 seconds 49,632 views",MTV HABESHA,49632,50523,891
2766,"መግለፂ ዋና ኣዘዝቲ ሰራዊት ትግራይ by MTV HABESHA 5 months ago 14 minutes, 50 seconds 17,079 views",MTV HABESHA,17079,17198,119
2767,"መስቀልን ኢሮብን ካብ ባሕሪ ብ ጭልፋ by MTV HABESHA 5 months ago 10 minutes, 15 seconds 5,770 views",MTV HABESHA,5770,5779,9
2768,"ነፃነትና ብስረና by MTV HABESHA 5 months ago 16 seconds 6,089 views",MTV HABESHA,6089,6227,138
2769,"Mezgebe Asay _ kleal bele | ክለዓል በለ Tdf Tigray Music ካብ ግምባር by MTV HABESHA 5 months ago 14 minutes, 2 seconds 29,513 views",MTV HABESHA,29513,29745,232
2770,"ሻዕብያ ኣብ ቃልሲ ዓፋኒ ኔሩ ሕጂ እውን ዓፋኒ እዩ .. President of Tigray Dr Debretsion by MTV HABESHA 5 months ago 4 minutes, 41 seconds 33,362 views",MTV HABESHA,33362,33390,28
2771,"Solomon Tesfay (Wedi Rama) _ Astem | ኣስጥም Tigray Music TDF by MTV HABESHA 5 months ago 8 minutes, 55 seconds 110,839 views",MTV HABESHA,110839,111167,328
2772,"ወዲ ወረደ ወግዒ ክልተ ወለዶ እዚ ዘሎ ወለዶ ምስቲ ናይቀደም ከመይ ትገልፆ ? #tdf by MTV HABESHA 5 months ago 4 minutes, 14 seconds 15,220 views",MTV HABESHA,15220,15247,27
2773,"General Megbey a ጀነራል ምግበይ ሃይለ ብዛዕባ መኸተ ህዝቢ ትግራይ by MTV HABESHA 5 months ago 52 minutes 32,941 views",MTV HABESHA,32941,33585,644
2774,"TDF ፀላእቱ እንዳ ደርዓመ _ ትግራዋይ በዓል ስረ ሳላካ እንድየ ከቢረ by MTV HABESHA 5 months ago 1 minute, 12 seconds 48,803 views",MTV HABESHA,48803,48815,12
2775,"Shishay Birhan _ Mebae Selam | መባእ ሰላም - ሺሻይ ብርሃነ by MTV HABESHA 5 months ago 7 minutes, 41 seconds 8,131 views",MTV HABESHA,8131,8234,103
2776,"Abraham Gebremedhin ምስጋና ክላሽ ኣልዒሎ ከም ድሌትና ክንዛረብን ክንፅሕፍን ዝገበርኩምና by MTV HABESHA 6 months ago 59 seconds 24,479 views",MTV HABESHA,24479,24486,7
2777,"ፍሉይ ሓይልዋይ  TDF Tigray military force in amhara region by MTV HABESHA 6 months ago 2 minutes, 32 seconds 8,110 views",MTV HABESHA,8110,8143,33
2778,"Girmay Haileselassie _ Gobezay | ጎበዛይ New Tigray TDf Music 2021 by MTV HABESHA 6 months ago 5 minutes, 50 seconds 37,353 views",MTV HABESHA,37353,37497,144
2779,"Abebe Araya _ Meles Gedfkana ba |ገዲፍካና ባ  Tigray Music by MTV HABESHA 6 months ago 7 minutes, 5 seconds 16,417 views",MTV HABESHA,16417,16484,67
2780,"New Tigray Music Tdf _ በሎም ኣብ ኣምሓራ ክልል ክእትው እንከለው ምክልካል ትግራይ _ በሎም by MTV HABESHA 6 months ago 6 minutes, 37 seconds 106,902 views",MTV HABESHA,106902,106980,78
2781,"TDF  In Lalibela ሰውእ ተጋዳላይ ስዩም መስፍን _ትግራይ መሰረት ኢትዮጵያ እያ!! by MTV HABESHA 6 months ago 4 minutes, 26 seconds 8,207 views",MTV HABESHA,8207,8210,3
2782,"Amanuel yemane In Sudan  ፍቅሪ ህዝቢ ካብዚ ዝዓቢ የለን ደቂ ህዝቢ by MTV HABESHA 6 months ago 30 seconds 7,590 views",MTV HABESHA,7590,7597,7
2783,"ስውእ ተጋዳላይ ስዩም መስፍን _ ኦዶ ትግራይ ጠሊምካ ኣበይ ክእቶ , ኣይንምብርከክን !! by MTV HABESHA 7 months ago 5 minutes, 8 seconds 16,253 views",MTV HABESHA,16253,16266,13
2784,"Brhane Haile _ ktgrem Eya Alem | ክትግረም 'ያ ዓለም by MTV HABESHA 7 months ago 7 minutes, 32 seconds 85,184 views",MTV HABESHA,85184,85230,46
2785,"TDF TIGRAY መናእሰይ ትግራይ እብ መዐለሚ ቦታ _ ሃለዋትናን ድሕንነትና ብቕልፅምና _ ብቡዙሕ ቁፅርታት መናእሰይ ናብ ሜዳ ይወርዱ by MTV HABESHA 7 months ago 2 minutes, 24 seconds 84,306 views",MTV HABESHA,84306,84331,25
2786,"Abrham Gebremedhin _ Ambesa Bereka | እምበሳ በረካ by MTV HABESHA 7 months ago 5 minutes, 8 seconds 18,145 views",MTV HABESHA,18145,18187,42
2787,"1. July 2021 by MTV HABESHA 8 months ago 16 seconds 276,648 views",MTV HABESHA,276648,276965,317
2788,"Mulu Gebrewahid _ Mekelle |መቀለ Tigray Music ሰነ 21/2013 by MTV HABESHA 8 months ago 5 minutes, 33 seconds 50,152 views",MTV HABESHA,50152,50375,223
2789,"Girmay Haileselassie _ Melaml Tigray |መላምል ትግራይ  TDF MUSIC by MTV HABESHA 8 months ago 6 minutes, 32 seconds 246,017 views",MTV HABESHA,246017,248665,2648
2790,"Ephrem Amare ft Haftom Gebremichael | Gomida  | ጎሚዳ _ coming Soon by MTV HABESHA 8 months ago 24 seconds 5,308 views",MTV HABESHA,5308,5311,3
2791,"ገጣሚ ውቅያኖስ ጉዑሽ _ ተኣመን ወሎዶይ by MTV HABESHA 8 months ago 4 minutes, 43 seconds 3,453 views",MTV HABESHA,3453,3456,3
2792,"Eyasu Berhe _ Bahrna | ባሕርና Tigray Music Weyane Old Music by MTV HABESHA 8 months ago 6 minutes, 52 seconds 12,039 views",MTV HABESHA,12039,12141,102
2793,"TIGRAY NATIONAL SONG 2021 Frankfurt German ህብቢ ኢዩ ሓይልና ተዓወቲ ኢና by MTV HABESHA 8 months ago 3 minutes, 6 seconds 2,241 views",MTV HABESHA,2241,2243,2
2794,"ANITA AMAN Thank you for your voice For the voiceless people of Tigray 💛❤ by MTV HABESHA 8 months ago 2 minutes, 19 seconds 1,876 views",MTV HABESHA,1876,1897,21
2795,"ዶክተር ደብረፅዩን ብዛዕባ ድጅታል ወያነ ወይ ድማ ድጅታል ገድሊ ክንብሎ ንክእል ! by MTV HABESHA 8 months ago 2 minutes, 47 seconds 31,024 views",MTV HABESHA,31024,31026,2
2796,"Nguse Abadi _ Ashemuna | ኣሸሙና New Tigray Music by MTV HABESHA 9 months ago 11 minutes, 49 seconds 184,559 views",MTV HABESHA,184559,185997,1438
2797,"Dawit Nega _ Ykono | ይኮኖ Coming soon by MTV HABESHA 9 months ago 45 seconds 7,804 views",MTV HABESHA,7804,7920,116
2798,"New Tigray Music _Tegaru Tegaru | ተጋሩ ተጋሩ 2013 by MTV HABESHA 9 months ago 6 minutes, 44 seconds 5,284 views",MTV HABESHA,5284,5290,6
2799,"ምህለላ እብ ትግራይ _ ካብ ህፃን እሳብ ዓብይ ፈጣሪ ፀሎትና ይስመዐና by MTV HABESHA 9 months ago 3 minutes, 15 seconds 7,042 views",MTV HABESHA,7042,7102,60
2800,"Rahel haile _Selam mengesi | ሰላም መንገሲTigray Music by MTV HABESHA 9 months ago 1 minute, 59 seconds 13,341 views",MTV HABESHA,13341,13373,32
2801,"እብ ባድመ ዝነበረ ከብድካ ዘሕርር እዩ  ኢስያስ እፈወርቂ by MTV HABESHA 9 months ago 3 minutes, 12 seconds 3,023 views",MTV HABESHA,3023,3047,24
2802,"Metsae Gebrekidan _ Weledo Terekebwo | ወለዶ ተረከብዋ New Tigray Music Video by MTV HABESHA 9 months ago 5 minutes, 6 seconds 16,314 views",MTV HABESHA,16314,16322,8
2803,"ሓበን ህዝቡ ጎበዛይ ኣምበሳ ቆልዓ ትግራይ ካብ ሓራ መሬት by MTV HABESHA 9 months ago 4 minutes, 55 seconds 5,895 views",MTV HABESHA,5895,5901,6
2804,"Tsegaleule Hailemariam Miela | ሜላ  New Tigray Music video by MTV HABESHA 9 months ago 5 minutes, 45 seconds 29,160 views",MTV HABESHA,29160,29167,7
2805,"ምክልካል ትግራይ ካብ ሓራ መሬት ትግራይ by MTV HABESHA 10 months ago 2 minutes, 12 seconds 20,957 views",MTV HABESHA,20957,20969,12
2806,"New Tigray Music Cover Zeragit Sdrana Derqi  | ዘራጊት ስድራና ድርቂ 2021 by MTV HABESHA 10 months ago 4 minutes, 50 seconds 20,688 views",MTV HABESHA,20688,20740,52
2807,"""መልእኽቲ መንግስቲ ትግራይ ን ኣብ ትግራይ ዘሎ ሰራዊት ኤርትራ"" by MTV HABESHA 10 months ago 1 minute, 45 seconds 3,060 views",MTV HABESHA,3060,3062,2
2808,"Mizan Tesfay _ Hizbawi | ህዝባዊ New Tigray Music 2013 by MTV HABESHA 10 months ago 6 minutes, 7 seconds 43,349 views",MTV HABESHA,43349,43360,11
2809,"Mulugeta kahsay (Wedi romit )ካብ በረካታት ትግራይ by MTV HABESHA 10 months ago 1 minute, 16 seconds 50,869 views",MTV HABESHA,50869,50898,29
2810,"Awet Brhane (Awicho Bright) Hzbi Tigray ህዝቢ ትግራይ New Tigrigna (Official Vedio Music) 2021 by MTV HABESHA 10 months ago 4 minutes, 44 seconds 6,488 views",MTV HABESHA,6488,0,-6488
2811,"Johan Haftu _  Tigray Zemenkieyu | ትግራይ ዘመንኪ'ዩ New Tigray Music 2021 by MTV HABESHA 10 months ago 3 minutes, 53 seconds 54,932 views",MTV HABESHA,54932,54968,36
2812,"Tsegaleule Hailemariam _ Serawit Awet | ሰራዊት ዓወት New Tigray Music 2021 by MTV HABESHA 10 months ago 6 minutes, 38 seconds 15,904 views",MTV HABESHA,15904,15919,15
2813,"Tigray Keyenti Music Alena | እለና by MTV HABESHA 11 months ago 5 minutes 8,537 views",MTV HABESHA,8537,8547,10
2814,"Fiseha Gebel _ Wen elni alo ane | ውን ኢልኒ 'ሎ እነ  Tigray Music Gedli by MTV HABESHA 11 months ago 7 minutes, 36 seconds 30,920 views",MTV HABESHA,30920,31382,462
2815,"እቲ ንብዓትክን ንብዓትና እቲ ቓንዛክን ቓንዛና እዩ :: March 14-03-2021 by MTV HABESHA 11 months ago 1 minute, 58 seconds 4,008 views",MTV HABESHA,4008,4008,0
2816,"Hailay Gebreanenia _Gedin eyu | ግድን'ዩ New Tigray Tigrigna Music by MTV HABESHA 11 months ago 5 minutes, 45 seconds 23,969 views",MTV HABESHA,23969,23980,11
2817,"Solomon Haile - Amora (እሞራ) TIGRAY Tigrigna Lyrics Music first Album by MTV HABESHA 1 year ago 6 minutes, 28 seconds 438,949 views",MTV HABESHA,438949,441981,3032
2818,"Girmay Tesfay _ Awet N Hafash | ዓወት ንሓፋሽ New Tigray Music 2021 by MTV HABESHA 1 year ago 5 minutes, 17 seconds 25,938 views",MTV HABESHA,25938,25958,20
2819,"Girmay Haileselassie _ Hrer Ybelu | ሕርር ይበሉ New Tigray Music 2021 by MTV HABESHA 1 year ago 6 minutes, 32 seconds 585,506 views",MTV HABESHA,585506,586227,721
2820,"Mizan Tesfay _ Terebareb Nmekete | ተረባረብ ንመከተ | New Tigray Music 2021 by MTV HABESHA 1 year ago 6 minutes, 15 seconds 62,837 views",MTV HABESHA,62837,62884,47
2821,"Sintayehu Amha _ Belu Nwfer | በሉ ንውፈር New Tigray Tigrigna Music 2021 by MTV HABESHA 1 year ago 5 minutes, 55 seconds 100,331 views",MTV HABESHA,100331,100475,144
2822,"Ze Amane Girmay _ Embi Bel | እምቢ በል Tigray Tigrigna Music by MTV HABESHA 1 year ago 6 minutes, 1 second 286,568 views",MTV HABESHA,286568,287050,482
2823,"Abebe Araya _ Ezi Eyu Mot | እዚ እዩ ሞት Tigray Tigrigna Music by MTV HABESHA 1 year ago 6 minutes, 33 seconds 98,820 views",MTV HABESHA,98820,98966,146
2824,"Rahel Haile & Solomon Bayre _ Newihn Merirn | ነዊሕን መሪርን Tigrigna Music 2021 by MTV HABESHA 1 year ago 4 minutes, 53 seconds 135,494 views",MTV HABESHA,135494,135552,58
2825,"Abebe Araya _Kurex Belo |ቁረፅ በሎ Tigray Music by MTV HABESHA 1 year ago 7 minutes, 8 seconds 129,231 views",MTV HABESHA,129231,129555,324
2826,"Ataklti Hailemikael _Tigray | ትግራይ official Video by MTV HABESHA 1 year ago 6 minutes, 44 seconds 5,559 views",MTV HABESHA,5559,5590,31
2827,"Negasi Semere _ Ayzkern do Elkayo | እይዝከርንዶ ኢልካዩ Tigrigna Music by MTV HABESHA 1 year ago 6 minutes, 56 seconds 7,343 views",MTV HABESHA,7343,7369,26
2828,"Tesfay Mehari (fihira) Meseley Zbele Tigraweay | መስለይ ዝበለ ትግራዋይ by MTV HABESHA 1 year ago 6 minutes, 42 seconds 169,525 views",MTV HABESHA,169525,169807,282
2829,"Washington Dc Tigray ..እብድፋዓም ዓልል by MTV HABESHA 1 year ago 2 minutes, 54 seconds 2,913 views",MTV HABESHA,2913,2915,2
2830,"Abraham Gebremdhin _ Tigray | ትግራይ Tigray Music 2013 #istandwithtigray by MTV HABESHA 1 year ago 4 minutes, 2 seconds 192,595 views",MTV HABESHA,192595,193036,441
2831,"Hluf Alemu _ Aybelnando | እይበልናንዶ Tigray Music 2020 by MTV HABESHA 1 year ago 5 minutes, 5 seconds 158,953 views",MTV HABESHA,158953,159043,90
2832,"Ethiopia  Eritrea & sudan war to Tigray 2020 Tplf power by MTV HABESHA 1 year ago 6 minutes, 34 seconds 69,748 views",MTV HABESHA,69748,69786,38
2833,"Ashenafi Gebrekidan (metsi) _ Heyab | ህያብ Tigrigna Music (official Video) by MTV HABESHA 1 year ago 6 minutes, 19 seconds 7,842 views",MTV HABESHA,7842,7874,32
2834,"Ephrem Amare _ Tewelide Tigray | ተወሊደ ንትግራይ New live consort Music 2013 by MTV HABESHA 1 year ago 4 minutes, 34 seconds 30,175 views",MTV HABESHA,30175,30223,48
2835,"Kiros Alemayhu _Tigray Adey | ትግራይ ዓደይ Tigrigna Music by MTV HABESHA 1 year ago 6 minutes, 43 seconds 33,118 views",MTV HABESHA,33118,33248,130
2836,"Gzachew Solomon _ Lorhama | ሎርሃማ New Tigriga Music (official Video ) Music by MTV HABESHA 1 year ago 5 minutes, 43 seconds 10,508 views",MTV HABESHA,10508,10660,152
2837,"Desta Berhe _ Yeqleleley | የቕልለለይ Ethiopian Tigrigna Music Video by MTV HABESHA 1 year ago 5 minutes, 32 seconds 27,420 views",MTV HABESHA,27420,27638,218
2838,"Assefa Gebremichael - Ygedeni | ይገደኒ Ethiopian Tigrigna Music videoclip by MTV HABESHA 1 year ago 6 minutes, 20 seconds 27,721 views",MTV HABESHA,27721,28725,1004
2839,"Desta berhe _ የቕልለለይ coming soon by MTV HABESHA 1 year ago 48 seconds 3,397 views",MTV HABESHA,3397,3409,12
2840,"Kuflomey Vs Mahi _Asmeretey | እስመረተይ Comedy by MTV HABESHA 1 year ago 2 minutes, 6 seconds 1,696 views",MTV HABESHA,1696,1703,7
2841,"Temesgen Zegeye _ Endatekonena | እንዳ ተቆነና Ethiopian Tigrigna Music by MTV HABESHA 1 year ago 5 minutes, 30 seconds 6,170 views",MTV HABESHA,6170,6204,34
2842,"Meles Zenawi _ 8ይ ዓመት ዝክሪ by MTV HABESHA 1 year ago 5 minutes, 10 seconds 1,584 views",MTV HABESHA,1584,1586,2
2843,"Merhawit Tume_ Manta Lbi | ማንታ ልቢ Ethiopian Tigrigna Music by MTV HABESHA 1 year ago 6 minutes, 24 seconds 83,388 views",MTV HABESHA,83388,84990,1602
2844,"Weynshet Berhe _ Hkofeni | ሕቆፈኒ Tigrigna Music by MTV HABESHA 1 year ago 5 minutes, 10 seconds 3,040 views",MTV HABESHA,3040,3043,3
2845,"Mulubrhan Fisseha ( Wari ) _ Neski Ewe | ንስኺ እወ Tigrigna Music by MTV HABESHA 1 year ago 5 minutes, 4 seconds 113,461 views",MTV HABESHA,113461,115785,2324
2846,"Tiemtu Gebrehiwet _ Lwamey | ልዋመይ Tigray Tigrigna Music by MTV HABESHA 1 year ago 5 minutes, 41 seconds 15,963 views",MTV HABESHA,15963,16030,67
2847,"Amanuel Yemane  ft tiemtu gebrehiwot _ Sdet | ስደት  ን እብ የመንን ሱዕድን ዘለው እሕዋትና by MTV HABESHA 1 year ago 5 minutes, 54 seconds 27,554 views",MTV HABESHA,27554,27567,13
2848,"Rahel Haile _ Mizan Tesfay _ Zemen & brhanemeskel New Tigrigna Music _ Day |ዳይ (official Audio) by MTV HABESHA 1 year ago 6 minutes, 58 seconds 23,312 views",MTV HABESHA,23312,23438,126
2849,"Tigist Alene _ Way Fkri | ዋይ ፍቅሪ (official Audio) by MTV HABESHA 1 year ago 6 minutes, 15 seconds 94,408 views",MTV HABESHA,94408,96848,2440
2850,"Kidane Wedi ale _ Aytkohali | እይትኮሓሊ Tigrigna Music (official Audio) by MTV HABESHA 1 year ago 6 minutes, 44 seconds 22,801 views",MTV HABESHA,22801,22826,25
2851,"Solomon bayre (wedibayre) _ dka | ድካ Ethiopian Music (official Audio) by MTV HABESHA 1 year ago 4 minutes, 42 seconds 6,491 views",MTV HABESHA,6491,6529,38
2852,"Desta Abreha _ Edagahamus | ዕዳጋ ሓሙሰይ Tigrigna Music lyrics by MTV HABESHA 1 year ago 6 minutes, 12 seconds 152,821 views",MTV HABESHA,152821,154838,2017
2853,"Helen Teklay _ ft Merkeb bonitwa dancing by MTV HABESHA 2 years ago 57 seconds 10,453 views",MTV HABESHA,10453,10475,22
2854,"Amir Dawid _ Mflelay | ምፍልላይ Tigriga Music lyrics by MTV HABESHA 2 years ago 6 minutes, 55 seconds 48,884 views",MTV HABESHA,48884,51089,2205
2855,"Fryat Yemane Wedding ፍርያትየማነ _ Geat Video by MTV HABESHA 2 years ago 3 minutes, 45 seconds 340,583 views",MTV HABESHA,340583,340824,241
2856,"Fryat Yemane wedding photo #ፍርያት የማነ by MTV HABESHA 2 years ago 5 minutes, 28 seconds 5,514 views",MTV HABESHA,5514,5527,13
2857,"Geat Fryat Yemane _ Wedding Programm ገዓት by MTV HABESHA 2 years ago 6 minutes, 31 seconds 10,224 views",MTV HABESHA,10224,10268,44
2858,"Fryat Yemane wedding by MTV HABESHA 2 years ago 5 minutes, 17 seconds 119,330 views",MTV HABESHA,119330,119388,58
2859,"Girmay Atsbeha _ Ane kefikir Meseley / እነ ከፍቅር መስለይ Tigrigamusic 1990 (official Audio) Music lyrics by MTV HABESHA 2 years ago 7 minutes, 16 seconds 13,587 views",MTV HABESHA,13587,14033,446
2860,"Amanuel Mekonnen _ Abela | እቤላ Tigrigamusic 1990s by MTV HABESHA 2 years ago 6 minutes, 34 seconds 4,473 views",MTV HABESHA,4473,4487,14
2861,"Eyasu Berhe  _ Embatat | እምባታት Tigriga Music (OfficialAudio) by MTV HABESHA 2 years ago 4 minutes, 29 seconds 28,019 views",MTV HABESHA,28019,28241,222
2862,"Trhas Tareke _ kobeley Album Nonstop New Ethiopian Music 2019 (official Audio) by MTV HABESHA 2 years ago 1 hour, 13 minutes 11,923 views",MTV HABESHA,11923,11987,64
2863,"Gzachew Solomon _ Adey | ዓደይ New Tigriga Music (official Audio) Music lyrics by MTV HABESHA 2 years ago 6 minutes, 24 seconds 335,432 views",MTV HABESHA,335432,339165,3733
2864,"Haftom (wedirama) _ Semhaley | ስምሃለይ New Tigrigamusic 2019 Music lyrics by MTV HABESHA 2 years ago 5 minutes, 30 seconds 66,601 views",MTV HABESHA,66601,68247,1646
2865,"Tamrat Amare _ Meneyutehatati |መን እዩ ተሓታቲ Tigrigamusic lyrics 2019 by MTV HABESHA 2 years ago 6 minutes, 18 seconds 71,590 views",MTV HABESHA,71590,72971,1381
2866,"Ngsti hayelom _ Abey / እበይ Ethiopian Music audio by MTV HABESHA 2 years ago 6 minutes, 30 seconds 22,231 views",MTV HABESHA,22231,22588,357
2867,"Wedi Gezahey _ Naki Eya | ንዓኪ'ያ NEW Ethiopian Music 2019 by MTV HABESHA 2 years ago 6 minutes, 1 second 4,881 views",MTV HABESHA,4881,4892,11
2868,"Eyerusalam Amde _ Aytbelenihaftey | እይትበለኒ ሓፍተይ Ethiopian New Music (official Audio) 2019 by MTV HABESHA 2 years ago 4 minutes, 30 seconds 122,576 views",MTV HABESHA,122576,123466,890
2869,"Selam Abraha _ Elshaday | ኤልሻዳይ New Ethiopian Music (official Audio) by MTV HABESHA 2 years ago 7 minutes, 42 seconds 17,283 views",MTV HABESHA,17283,17812,529
2870,"Abraham sira _ Bgdey Khazleki | ብግደይ ክሓዝለኪ New Ethiopian Music (official Audio) 2019 by MTV HABESHA 2 years ago 5 minutes, 49 seconds 3,913 views",MTV HABESHA,3913,3919,6
2871,"Mizan Tesfay _ Meraki / ዳሃይ መርዓኪ New Ethiopian Music lyrics 2019 by MTV HABESHA 2 years ago 6 minutes, 22 seconds 125,379 views",MTV HABESHA,125379,127381,2002
2872,"Yemane Gebremichael (wedi afro) _ keyda | ከይዳ Tigray Music Tigriga (official Audio) 2019 by MTV HABESHA 2 years ago 6 minutes, 27 seconds 120,627 views",MTV HABESHA,120627,123779,3152
2873,"Ataklti Hailemichael _ weyno / ወይኖ New Ethiopian Music 2019 lyrics by MTV HABESHA 2 years ago 6 minutes, 27 seconds 44,472 views",MTV HABESHA,44472,44851,379
2874,"Eden Gebreslassie _Jeganu Tegaru | ጀጋኑ ተጋሩ New Tigray Music 2019 (official Audio) by MTV HABESHA 2 years ago 5 minutes, 46 seconds 165,939 views",MTV HABESHA,165939,166150,211
2875,"Mulugeta Kahsay ( wediromit ) _ Sdet / ስደት New Ethiopian Music 2019 ly by MTV HABESHA 2 years ago 6 minutes, 11 seconds 148,272 views",MTV HABESHA,148272,154610,6338
2876,"Tirhas Tareke _Oromay | ኦሮማይ New Ethiopian Music (official Audio) by MTV HABESHA 2 years ago 6 minutes, 54 seconds 123,874 views",MTV HABESHA,123874,124874,1000
2877,"Dawit Nega _ Endaamena | እንዳእመና New Tigriga Music (official Audio) 2019 by MTV HABESHA 2 years ago 7 minutes, 5 seconds 101,158 views",MTV HABESHA,101158,102814,1656
2878,"Hiluf Alemu _ Nsa | ንሳ New Ethiopian Music (official Audio) 2019 by MTV HABESHA 2 years ago 7 minutes, 43 seconds 126,402 views",MTV HABESHA,126402,128533,2131
2879,"Melaku Ngusu _ Weq Bele Lbey / ወቅ በለ ልበይ New Ethiopian Music lyrics 2019 by MTV HABESHA 2 years ago 6 minutes, 15 seconds 5,063 views",MTV HABESHA,5063,5114,51
2880,"Almaz Gebreslassie _ Aydeln | እይደልን Ethiopian Music (official Audio) by MTV HABESHA 2 years ago 6 minutes, 34 seconds 25,895 views",MTV HABESHA,25895,26155,260
2881,"Tirhas Tareke _ Deselkani | ደስ ኢልካኒ New Ethiopian Music 2019 (official Audio) 2019 by MTV HABESHA 2 years ago 6 minutes, 4 seconds 12,610 views",MTV HABESHA,12610,12651,41
2882,"Genet Yemane _ Shdenay / ሽደናይ New Ethiopian Music lyrics 2019 by MTV HABESHA 2 years ago 6 minutes, 33 seconds 77,837 views",MTV HABESHA,77837,79897,2060
2883,"Abrehet Abdu _ Berawrey | በራውረይ New Ethiopian Music (official Audio) lyrics by MTV HABESHA 2 years ago 7 minutes, 8 seconds 84,588 views",MTV HABESHA,84588,85725,1137
2884,"Eyob Belay _ Momona / ሞሞና New Ethiopian Music (official Audio) 2019 by MTV HABESHA 2 years ago 6 minutes, 36 seconds 4,262 views",MTV HABESHA,4262,4309,47
2885,"Amir Dawud _ Tigray Adey | ትግራይ ዓደይ (official Audio) New Ethiopian Music by MTV HABESHA 2 years ago 5 minutes, 25 seconds 27,611 views",MTV HABESHA,27611,27948,337
2886,"Dawit Nega _ kber Temesgen | ክበር ተመስገን New Ethiopian Mezmur (official Audio) 2019 by MTV HABESHA 2 years ago 5 minutes, 9 seconds 78,296 views",MTV HABESHA,78296,78347,51
2887,"Mulubrhan Fshaye (Wari) _ Afkirkikale | እፍቂርኪ ካልእ New Ethiopian Music (official Audio) 2019 by MTV HABESHA 2 years ago 6 minutes, 30 seconds 99,649 views",MTV HABESHA,99649,101514,1865
2888,"Zemen Alemseged _Gual Hagereseb | ጋል ሃገረስብ New Ethiopian Music (official Audio) 2019 by MTV HABESHA 2 years ago 7 minutes 28,553 views",MTV HABESHA,28553,28605,52
2889,"Ashu Bella _ Aythazuley | እይትሓዙለይ New Ethiopian Music (official Audio) lyrics 2019 by MTV HABESHA 2 years ago 7 minutes, 7 seconds 20,144 views",MTV HABESHA,20144,21236,1092
2890,"Brhane Haile _ Fetyeki ele /ፈትየኪ ኢለ New Ethopian New Music 2019 lyrics by MTV HABESHA 2 years ago 4 minutes, 39 seconds 21,111 views",MTV HABESHA,21111,21371,260
2891,"Trhas Tareke _ Snflall /ስንፍላል New Ethiopian Music lyrics 2019 by MTV HABESHA 2 years ago 5 minutes, 48 seconds 136,898 views",MTV HABESHA,136898,137210,312
2892,"Asefa Gebremichael _ Maskay / ማስቃይ New Ethiopian Music lyrics 2019 by MTV HABESHA 2 years ago 5 minutes, 10 seconds 7,996 views",MTV HABESHA,7996,8054,58
2893,"Kalayu Tadese _ Bingo / ቢንጎ New Ethiopian Music lyrics 2019 by MTV HABESHA 2 years ago 5 minutes, 50 seconds 45,261 views",MTV HABESHA,45261,46009,748
2894,"Selamawit Yohannes _ Berawrey | በራውረይ  New Ethiopian Music 2019 live performance Mekelle by MTV HABESHA 2 years ago 3 minutes, 54 seconds 47,123 views",MTV HABESHA,47123,47147,24
2895,"Rahel Haile _ Meare / መዓር New Ethiopian Music lyrics 2019 by MTV HABESHA 2 years ago 5 minutes, 43 seconds 53,002 views",MTV HABESHA,53002,53250,248
2896,"Gadion Danial _ Menor Feraw / መኖር ፈራው New Ethiopian Music audio 2019 by MTV HABESHA 2 years ago 6 minutes, 11 seconds 76,762 views",MTV HABESHA,76762,78285,1523
2897,"Meseret _ Gedamey /ገዳመይ Ethiopian Music lyrics 2019 by MTV HABESHA 2 years ago 5 minutes, 34 seconds 15,541 views",MTV HABESHA,15541,15769,228
2898,"Sntayehu Amha _ Baga /ብእጋ New Ethiopian Music lyrics. by MTV HABESHA 2 years ago 6 minutes, 35 seconds 102,994 views",MTV HABESHA,102994,104319,1325
2899,"Eden Gebreslassie _ Selila / ስሊላ New Ethiopian Music by MTV HABESHA 2 years ago 4 minutes, 31 seconds 57,857 views",MTV HABESHA,57857,58426,569
2900,"Mulgeta Fkaden (wedifkaden) _ Zalambesa / ዛላምበሳ New Ethiopian Music by MTV HABESHA 2 years ago 7 minutes, 57 seconds 27,852 views",MTV HABESHA,27852,28492,640
2901,"Helen Fsha _ Ftwey / ፍቱወይ New Ethiopian Music ly by MTV HABESHA 2 years ago 6 minutes, 15 seconds 52,168 views",MTV HABESHA,52168,52924,756
2902,"Fana Negash _ Aman B Aman / እማን ብእማን New Ethiopian Music 2019 lyrics by MTV HABESHA 2 years ago 6 minutes, 27 seconds 34,371 views",MTV HABESHA,34371,34605,234
2903,"Brhane _ Suzi / ሱዚ New Ethiopian Audio Music 2019 by MTV HABESHA 2 years ago 5 minutes, 19 seconds 66,035 views",MTV HABESHA,66035,66859,824
2904,"Aziz Hagos _ Ruba Tekeze / ሩባ ተከዘ Ethiopian Music lyrics 2019 by MTV HABESHA 2 years ago 8 minutes, 12 seconds 164,880 views",MTV HABESHA,164880,168320,3440
2905,"Mesfn Brhanu _Gena / ገና ገና New Ethiopian Music by MTV HABESHA 2 years ago 5 minutes, 18 seconds 72,111 views",MTV HABESHA,72111,72734,623
2906,"Adey Gebremichael _ Aytdendneni / እይትደንድነኒ New Ethiopian Music lyrics by MTV HABESHA 2 years ago 6 minutes, 22 seconds 25,137 views",MTV HABESHA,25137,25372,235
2907,"Haftom Gebremichael _ Amen / እሜን New Ethiopian Music lyrics by MTV HABESHA 2 years ago 5 minutes, 32 seconds 28,093 views",MTV HABESHA,28093,28246,153
2908,"Eden Gebreselassie _ Mehazay / መሓዛይ New Ethiopian Music by MTV HABESHA 2 years ago 6 minutes, 9 seconds 115,358 views",MTV HABESHA,115358,116104,746
2909,"Ephrem Amare _ Mamaye /ማማየ / New Ethiopian Music (official audio) 2019 by MTV HABESHA 2 years ago 3 minutes, 23 seconds 965,385 views",MTV HABESHA,965385,968301,2916
2910,"Yohannes Bayre (Wedi Bayru) - Hin Hin ( ሕን ሕን ) New Tigrigna Music 2022 (Official Video) by Nabana Entertainment 12 days ago 5 minutes, 35 seconds 74,985 views",Nabana Entertainment,74985,82868,7883
2911,"Yohannes Bayre (Wedi Bayru) - Hin Hin ( ሕን ሕን  ) New Tigrigna Music 2022 (Official Video) by Nabana Entertainment 1 month ago 5 minutes, 21 seconds 126,118 views",Nabana Entertainment,126118,146779,20661
2912,"Abreham Gebremdhin - ከዓ ጀመረ ህዝቢ ትግራይ ኣብርሃም ገብረመድህን - New Tigrigna Music 2022 - [ Official Music ] by Nabana Entertainment 1 month ago 4 minutes, 2 seconds 37,846 views",Nabana Entertainment,37846,38881,1035
2913,"Abraham Gebremedhin & Eden G/Selassie - ሳላ ደቅኺ | Sala dekiki - New Tigrigna Music 2022 by Nabana Entertainment 1 month ago 5 minutes, 17 seconds 48,683 views",Nabana Entertainment,48683,51461,2778
2914,"Eden Gebreselassie Jeganu Tegaru ( ጀጋኑ ተጋሩ ) New Tigrigna (Official Music ) 2022 by Nabana Entertainment 1 month ago 5 minutes, 42 seconds 28,103 views",Nabana Entertainment,28103,29975,1872
2915,"Abraham Gebremedhin & Eden G/Selassie ሽምዓ ሃገር | Shima Hager |  - New Tigrigna Music 2022 by Nabana Entertainment 1 month ago 5 minutes, 35 seconds 103,073 views",Nabana Entertainment,103073,108370,5297
2916,"Abreham Gebremdhin - Beal Kuada ኣብርሃም ገብረመድህን ባዓል ኳዳ-New Tigrigna Music 2022 -[Official Music Video] by Nabana Entertainment 1 month ago 6 minutes, 39 seconds 422,852 views",Nabana Entertainment,422852,462320,39468
2917,"Abreham Gebremdhin - Beal Kuada ኣብርሃም ገብረመድህን ባዓል ኳዳ - New Tigrigna Music 2022 - [ Official Music ] by Nabana Entertainment 2 months ago 6 minutes, 33 seconds 668,506 views",Nabana Entertainment,668506,690990,22484
2918,"Eden Gebreselasie Goblel - ጎብለል - New Tigrigna Music Video 2021 (Official Music Video) by Nabana Entertainment 3 months ago 5 minutes, 40 seconds 1,310,679 views",Nabana Entertainment,1310679,1384063,73384
2919,"Eden Gebreselasie Goblel - ጎብለል - New Tigrigna Music Video Tiktok challenge  2021 by Nabana Entertainment 3 months ago 2 minutes, 36 seconds 182,864 views",Nabana Entertainment,182864,183829,965
2920,"Eden Gebreselasie Goblel - ጎብለል - New Tigrigna Music Video Coming soon  2021 by Nabana Entertainment 3 months ago 3 minutes, 45 seconds 147,138 views",Nabana Entertainment,147138,147464,326
2921,"Eden Gebreselasie - ቅያና - ኤደን ገብረስላሴ - New Tigrigna Music (Official Video) by Nabana Entertainment 2 years ago 5 minutes, 33 seconds 1,740,608 views",Nabana Entertainment,1740608,1744564,3956
2922,"Meselu Fantahun - መሰሉ ፋንታሁን - ወርቅ አልማዝ - Werq Almaz Non Stop Music Album 2022 (Official Video) by Nahom Records Inc 21 hours ago 45 minutes 8,979 views",Nahom Records,8979,30231,21252
2923,"Ashenafi Legesse - Mayaye - አሸናፊ ለገሰ - ማያየ - New Ethiopian Muisc 2022 (Official Video) by Nahom Records Inc 4 days ago 4 minutes, 18 seconds 38,562 views",Nahom Records,38562,64490,25928
2924,"Hailye Tadesse - Ethiopia Amlak - ሃይልዬ ታደሰ - የኢትዮጵያ አምላክ - New Ethiopian Music 2022 (Official Video) by Nahom Records Inc 5 days ago 5 minutes, 12 seconds 37,356 views",Nahom Records,37356,47729,10373
2925,"Lastarock - Ewen Yihonal - እዉን ይሆናል - ላስታሮክ - New Ethiopian Music 2022 (Official Video) by Nahom Records Inc 6 days ago 3 minutes, 51 seconds 18,041 views",Nahom Records,18041,20544,2503
2926,"Amani - ft gildo kassa - Libe Wedoshal -  ልቤ ወዶሻል - New Ethiopian Music 2022 (Official Video) by Nahom Records Inc 7 days ago 4 minutes, 6 seconds 83,627 views",Nahom Records,83627,133326,49699
2927,"Tariku Gankisi - Hayse Hayse - ታሪኩ ጋንኪሲ - ሃይሴ ሃይሴ - Ethiopian Music Video 2022 (Official Video) by Nahom Records Inc 10 days ago 4 minutes, 55 seconds 565,051 views",Nahom Records,565051,671988,106937
2928,"Meselu Fantahun - Yantes Neger - መሰሉ ፋንታሁን - ያንተስ ነገር - New Ethiopian Music 2022 (Official Video) by Nahom Records Inc 11 days ago 6 minutes, 10 seconds 299,967 views",Nahom Records,299967,378578,78611
2929,"Desalegne Teshale - Ft.Jalud Awel - Yene - ደሳለኝ ተሻለ - የኔ - New Ethiopian Music 2022 (Official Video) by Nahom Records Inc 12 days ago 4 minutes, 41 seconds 128,469 views",Nahom Records,128469,150076,21607
2930,"Selamnesh zemene - Belayewa - ሰላምነሽ ዘመነ - በላዬዋ - New Ethiopian Music 2022 (Official Video) by Nahom Records Inc 13 days ago 5 minutes, 24 seconds 43,320 views",Nahom Records,43320,46425,3105
2931,"Yonas Gizaw - Ture New - ዮናስ ግዛው - ጡር ነዉ - New Ethiopian Music 2022 (Official Video) by Nahom Records Inc 2 weeks ago 4 minutes, 12 seconds 44,153 views",Nahom Records,44153,47342,3189
2932,"Mekdes Melese - Yamootii - መቅደስ መለሰ - New Ethiopian Oromo Music Video 2022 (Official Video) by Nahom Records Inc 2 weeks ago 4 minutes, 37 seconds 74,304 views",Nahom Records,74304,88228,13924
2933,"Temesgen Gebregziabher - Kebad - ተመስገን ገ/እግዚአብሔር - New Ethiopian Music Video 2022 (Official Video) by Nahom Records Inc 2 weeks ago 4 minutes, 41 seconds 885,000 views",Nahom Records,885000,1077224,192224
2934,"Sami Art -Tetalahu  Kerase - ሳሚ አርት - ተጣላሁ ከራሴ - New Ethiopian Music Video 2022 (Official Video) by Nahom Records Inc 2 weeks ago 5 minutes, 20 seconds 22,331 views",Nahom Records,22331,22992,661
2935,"Rediet Mulugeta - Liben Atfetnew - ረድኤት ሙሉጌታ - ልቤን አትፈትነው - New Ethiopian Music 2021 (Official Video by Nahom Records Inc 3 weeks ago 4 minutes, 21 seconds 110,683 views",Nahom Records,110683,115901,5218
2936,"Gedion Daniel - Emu Yayne - ጌዲዮን ዳንኤል - እሙ ያይኔ - New Ethiopian Music 2022 (Official Video) by Nahom Records Inc 3 weeks ago 4 minutes, 38 seconds 240,383 views",Nahom Records,240383,276179,35796
2937,"LUL 2G - Amalay - ልዑል 2ጂ - አማላይ - New Ethiopian Music 2022 (official Video) by Nahom Records Inc 3 weeks ago 3 minutes, 39 seconds 28,936 views",Nahom Records,28936,30374,1438
2938,"Dawit Firew Hailu - Non Stop Beautiful Relaxing Instrumental Music 2022 (Official Video) by Nahom Records Inc 1 month ago 28 minutes 9,043 views",Nahom Records,9043,9238,195
2939,"Tesfaye Taye And Akililu Yohannes - Daraaro bifom - ተስፋዬ ታዬና - አክሊሉ ዮሐንስ - New Ethiopian Music 2022 by Nahom Records Inc 1 month ago 5 minutes, 30 seconds 8,949 views",Nahom Records,8949,9435,486
2940,"Miskir Awel - Yikir Yikir - ምስክር አወል - ይቅር ይቅር - New Ethiopian Music 2022 (Official Video) by Nahom Records Inc 1 month ago 5 minutes, 20 seconds 483,290 views",Nahom Records,483290,537766,54476
2941,"Yidnekachew Birahanu - Lemalelesh - ይድነቃቸው ብርሃኑ - ልማልልሽ - New Ethiopian Music 2022 (Official Video) by Nahom Records Inc 1 month ago 5 minutes, 38 seconds 577,720 views",Nahom Records,577720,612191,34471
2942,"Liya Girma _ Jegnaye - ሊያ ግርማ - ጀግናዬ - New Ethiopian Music 2022 (Official Video) by Nahom Records Inc 1 month ago 4 minutes, 27 seconds 101,738 views",Nahom Records,101738,107656,5918
2943,"Gizachew Teshome - Endet Serat - ግዛቸዉ ተሾመ - እንዴት ሰራት - New Ethiopian Music 2022 (Official Video) by Nahom Records Inc 1 month ago 5 minutes, 25 seconds 1,071,507 views",Nahom Records,1071507,1314156,242649
2944,"Lemlem Hailemicheal - Lebego New - ለምለም ኃይለሚካኤል - ለበጎነው - New Ethiopian Music 2022 (Official Video) by Nahom Records Inc 1 month ago 5 minutes 827,653 views",Nahom Records,827653,880846,53193
2945,"Seada Tesfaye - Zoro Zoro - ሰኢዳ ተስፋዬ - ዞሮ ዞሮ - New Ethiopian Music 2022 (Official Video) by Nahom Records Inc 1 month ago 4 minutes, 46 seconds 254,917 views",Nahom Records,254917,279764,24847
2946,"Hayemanot girma Music Full Album - Jalele - ሃይማኖት ግርማ - ጃለሌ - Non Stop Ethiopian Music by Nahom Records Inc 1 month ago 1 hour, 5 minutes 17,479 views",Nahom Records,17479,18036,557
2947,"Ethiopian Music: Weg Ayech -Mule Root - Ujulu Fera - Mafi Afro - Worku Shewile - New Ethiopian Music by Nahom Records Inc 1 month ago 5 minutes, 11 seconds 32,933 views",Nahom Records,32933,33881,948
2948,"Selamnesh Zenebe - Min Honkibign - ሰላምነሽ ዘመነ - ምን ሆንክብኝ - Ethiopian Music 2022 (Official Video) by Nahom Records Inc 1 month ago 4 minutes, 6 seconds 11,954 views",Nahom Records,11954,12403,449
2949,"Dawit Ferew Hailu - Fikir Kegna Endayleyen - ዳዊት ፍሬው - New Ethiopian Instrumental Music Video 2022 by Nahom Records Inc 1 month ago 4 minutes, 32 seconds 2,863 views",Nahom Records,2863,2905,42
2950,"Yirdaw Tenaw - Wey Arada - ይርዳው ጤናው - ወይ አራዳ - Ethiopian Music 2022 (Official Video) by Nahom Records Inc 1 month ago 7 minutes, 47 seconds 46,138 views",Nahom Records,46138,50822,4684
2951,"Dawit Firew - Teyikesh Tereji - ዳዊት ፍሬው - ጠይቀሽ ተረጂ - New Ethiopian Instrumental Music Video 2022 by Nahom Records Inc 1 month ago 4 minutes, 45 seconds 4,087 views",Nahom Records,4087,4158,71
2952,"Dawit Firew - Fikre Mechem Alresashim - ዳዊት ፍሬዉ  - New Ethiopian Instrumental Music Video 2022 by Nahom Records Inc 1 month ago 2 minutes, 57 seconds 3,294 views",Nahom Records,3294,3315,21
2953,"Dawit Firew - Lehulum Gizewin - ዳዊት ፍሬዉ ሃይሉ - ለሁሉም ግዜውን - New Ethiopian Music 2022 (Official Video) by Nahom Records Inc 1 month ago 8 minutes, 51 seconds 3,059 views",Nahom Records,3059,3100,41
2954,"Dawit Firew - Anchim Endelela - ዳዊት ፍሬዉ ሃይሉ - አንቺም እንደሌላ - New Ethiopian Music 2022 (Official Video) by Nahom Records Inc 1 month ago 4 minutes, 42 seconds 5,631 views",Nahom Records,5631,5681,50
2955,"Olirra Taarikuu - Etiyophiya - ኦልእራ ታሪኩ - ኢትዮዽያ - New Ethiopian Oromo Music 2022 (Official Video) by Nahom Records Inc 1 month ago 5 minutes, 28 seconds 5,545 views",Nahom Records,5545,5716,171
2956,"Addis Gurmessa - Min Kal Alegn - አዲስ ጉርሜሳ - ምን ቃል አለኝ - New ethiopian Music 2022 (Official video) by Nahom Records Inc 1 month ago 5 minutes, 21 seconds 104,769 views",Nahom Records,104769,110560,5791
2957,"Dawit Firew Hailu - Lomi Biwerewir & Fikrishina Fikre - ዳዊት ፍሬዉ ሃይሉ - Instrumental Music 2022 by Nahom Records Inc 1 month ago 3 minutes, 40 seconds 4,427 views",Nahom Records,4427,4460,33
2958,"Dawit Firew - Astawisalehu & Almaz Enku Mesay - ዳዊት ፍሬዉ ሃይሉ - Ethiopian Instrumental Music 2022 by Nahom Records Inc 1 month ago 3 minutes, 35 seconds 3,822 views",Nahom Records,3822,3867,45
2959,"Fantish Bekele - Maninete - ፋንትሽ በቀለ - ማንነቴ - New Ethiopian Music 2022 (Official Video) by Nahom Records Inc 1 month ago 6 minutes, 7 seconds 99,070 views",Nahom Records,99070,104013,4943
2960,"Alula G/Amlack - Yaw Negn - አሉላ ገ/አምላክ - ያው ነኝ New Ethiopian Music 2022 (Official Video) by Nahom Records Inc 1 month ago 4 minutes, 23 seconds 30,672 views",Nahom Records,30672,32097,1425
2961,"Fitsum Gebretsadik - Amerere Ende - ፍፁም ገብረፃዲቅ - አመረረ እንዴ - New Ethiopian Music 2022 (Official Video by Nahom Records Inc 1 month ago 4 minutes, 7 seconds 31,700 views",Nahom Records,31700,32229,529
2962,"Hanan Abdu - Agraw - ሃናን አብዱ - አግራው - New Ethiopian Music 2022 (Official Video) by Nahom Records Inc 1 month ago 6 minutes, 46 seconds 982,431 views",Nahom Records,982431,1056619,74188
2963,"Ziggy  Zaga - Wede Hager Bet - ዚጊ ዛጋ - ወደ ሃገር ቤት- New Ethiopian Music 2022 (Official Video) by Nahom Records Inc 1 month ago 5 minutes, 11 seconds 52,514 views",Nahom Records,52514,53381,867
2964,"Selamnesh Zemene - Tiragn - ሰላምነሽ ዘመነ - ጥራኝ - Ethiopian Music 2022 by Nahom Records Inc 1 month ago 6 minutes, 44 seconds 31,246 views",Nahom Records,31246,31906,660
2965,"Birhanu Tezera - Yet Ale - ብርሃኑ ተዘራ - የት አለ - New Ethiopian Music 2022 (Official Video) by Nahom Records Inc 1 month ago 4 minutes 18,344 views",Nahom Records,18344,18465,121
2966,"Tesfaye Taye - Eyebel - ተስፋዬ ታዬ - እየበል - New Ethiopian Music 2022 (Official Video) by Nahom Records Inc 2 months ago 5 minutes, 33 seconds 21,622 views",Nahom Records,21622,21870,248
2967,"Elias Tebabel - Enqwan Mtatehu - ኤልያስ ተባበል - እንኳን መጣሁ - New Ethiopian Music 2021 (Official Video) by Nahom Records Inc 2 months ago 4 minutes, 49 seconds 65,050 views",Nahom Records,65050,65891,841
2968,"Mafi leul - Alemewa - ማፊ ልዑል - አለሜዋ - New Ethiopian Music 2021 (Official Video) by Nahom Records Inc 2 months ago 4 minutes, 40 seconds 116,966 views",Nahom Records,116966,119630,2664
2969,"Melat Addis - Tewat - ሜላት አዲስ - ተዋት New Ethiopian Music 2021 (Official Video) by Nahom Records Inc 2 months ago 4 minutes, 17 seconds 40,242 views",Nahom Records,40242,40497,255
2970,"Mezmur Yohannes - Desasaw Gojo - መዝሙር ዮሃንስ - ደሳሳው ጎጆ - Ethiopian Music 2021 by Nahom Records Inc 2 months ago 5 minutes, 6 seconds 13,136 views",Nahom Records,13136,13353,217
2971,"Meselu Fantahun - Jemeregn - መሰሉ ፋንታሁን - ጀመረኝ - Ethiopian Muisc 2021 by Nahom Records Inc 2 months ago 6 minutes 25,291 views",Nahom Records,25291,25556,265
2972,"Kasaye Mideksa - Eta tetatalu - ካሳዬ ሚደክሳ - እጣ ተጣጣሉ - New Ethiopian Music 2021 (Official Video) by Nahom Records Inc 2 months ago 4 minutes, 12 seconds 12,402 views",Nahom Records,12402,12503,101
2973,"Various Ethiopian Artist - Alehugn Wegene - አለሁ ለወገኔ - New Ethiopian Music 2021 (Official Video) by Nahom Records Inc 2 months ago 5 minutes, 32 seconds 37,246 views",Nahom Records,37246,37550,304
2974,"Tigist Belachew - Yene Afarya - ትግስት በላቸው - የኔ አፋርያ - New Ethiopian Music 2021 (Official Video) by Nahom Records Inc 2 months ago 4 minutes, 43 seconds 53,778 views",Nahom Records,53778,55442,1664
2975,"Ethiopian Artists In North America - Meleyoeh Asferi - መለዮህ አስፈሪ - New Ethiopian Music Video 2021 by Nahom Records Inc 2 months ago 5 minutes, 19 seconds 28,400 views",Nahom Records,28400,28527,127
2976,"Elias Gizachew - Bebandiraw Eyemale - ኤልያስ ግዛቸው - በባንዲራው እየማለ - New Ethiopian Afar Music 2021 by Nahom Records Inc 2 months ago 4 minutes, 55 seconds 11,875 views",Nahom Records,11875,12125,250
2977,"Selamnesh Zemene - Bayew Bayew - ሰላምነሽ ዘመነ - ባየው ባየው - Ethiopian Music Video 2021 by Nahom Records Inc 2 months ago 5 minutes, 29 seconds 14,437 views",Nahom Records,14437,14652,215
2978,"Birhan Wubaye - Hulem Kef Yilal - ብርሃን ውባዬ - ሁሌም ከፍ ይላል - New Ethiopian Music 2021 (Official Video) by Nahom Records Inc 2 months ago 5 minutes, 27 seconds 56,422 views",Nahom Records,56422,56907,485
2979,"Gete Anley - Hagere -ጌቴ አንለይ  - ሃገሬ - Ethiopian Music Video 2021 by Nahom Records Inc 2 months ago 6 minutes, 33 seconds 34,406 views",Nahom Records,34406,35077,671
2980,"Yosef Mersha - Hagere - ዮሴፍ መርሻ - ሃገሬ  - New Ethiopian Music 2021 (Official Video) by Nahom Records Inc 2 months ago 4 minutes, 54 seconds 23,770 views",Nahom Records,23770,23893,123
2981,"Falmata Buta and Zinnaash Lilee - Shaboo Yaasi - New Ethiopian Oromo Music 2021 (Official Video) by Nahom Records Inc 2 months ago 6 minutes, 13 seconds 39,635 views",Nahom Records,39635,40745,1110
2982,"Sintayehu Tilahun - Hagere - ስንታየሁ ጥላሁን - ሃገሬ - Ethiopian music 2021 by Nahom Records Inc 2 months ago 6 minutes, 33 seconds 17,824 views",Nahom Records,17824,17994,170
2983,"Elias Tebabel - Benat Hager Qeld Yelem - ኤልያስ ተባበል - በናት ሃገር ቀልድ የለም - New Ethiopian Music 2021 by Nahom Records Inc 2 months ago 5 minutes, 57 seconds 83,065 views",Nahom Records,83065,83604,539
2984,"Abdi Jemal - Marat - አብዲ ጀማል - ማራት - New Ethiopian Music 2021 (Official Video) by Nahom Records Inc 2 months ago 4 minutes, 25 seconds 32,989 views",Nahom Records,32989,33155,166
2985,"Tadele Roba - Ethiopia Tikdem - ታደለ ሮባ - ኢትዮጵያ ትቅደም - New Ethiopian Music 2021 (Official Video) by Nahom Records Inc 2 months ago 6 minutes, 24 seconds 273,764 views",Nahom Records,273764,276135,2371
2986,"Amsale Mitike - Atinekakugn - አምሳለ ምትኬ - አትነካኩኝ - Ethiopian Music 2021 by Nahom Records Inc 2 months ago 7 minutes, 8 seconds 235,032 views",Nahom Records,235032,236648,1616
2987,"Selamnesh Zemene - Yegonder Lij - ሰላምነሽ ዘመነ - የጎንደር ልጅ - Ethiopian Music 2021 by Nahom Records Inc 2 months ago 6 minutes, 20 seconds 40,412 views",Nahom Records,40412,40851,439
2988,"Mezmur Yohannes - Atfri - መዝሙር ዮሃንስ - አትፍሪ - Ethiopian Music 2021 by Nahom Records Inc 2 months ago 1 minute, 1 second 7,153 views",Nahom Records,7153,7197,44
2989,"Selamnesh Zemene - Korahu - ሰላምነሽ ዘመነ - ኮራሁ - Ethiopian Music 2021 by Nahom Records Inc 3 months ago 5 minutes, 29 seconds 18,989 views",Nahom Records,18989,19136,147
2990,"Selamnesh Zemene - Etsub Dink (Wello) - ሰላምነሽ ዘመነ - እፁብ ድንቅ (ወሎ) - Ethiopian Muisc 2021 by Nahom Records Inc 3 months ago 7 minutes, 6 seconds 15,347 views",Nahom Records,15347,15521,174
2991,"Meselu Fantahun - Demo Na Na - መሰሉ ፋንታሁን - ደሞ ናና - Ethiopian Music 2021 by Nahom Records Inc 3 months ago 5 minutes, 16 seconds 47,907 views",Nahom Records,47907,49247,1340
2992,"Selamnesh Zemene - Zena Bel Zena - ሰላምነሽ ዘመነ - ዘና በል ዘና - Ethiopian Music 2021 by Nahom Records Inc 3 months ago 6 minutes, 33 seconds 40,597 views",Nahom Records,40597,41504,907
2993,"Meselu Fantahun - Jemeregn - መሰሉ ፋንታሁን - ጀመረኝ - Ethiopian Music 2021 by Nahom Records Inc 3 months ago 6 minutes 134,417 views",Nahom Records,134417,139802,5385
2994,"Meselu Fantahun - Man Baderesegn -  መሰሉ ፋንታሁን - ማን ባደረሰኝ - Ethiopian Music 2021 by Nahom Records Inc 3 months ago 4 minutes, 53 seconds 88,023 views",Nahom Records,88023,90995,2972
2995,"Non  Stop - Best Of Nahom's Selections - የናሆም ምርጥ ስብስቦች - Ethiopian Muisc 2021 by Nahom Records Inc 3 months ago 51 minutes 6,700 views",Nahom Records,6700,6737,37
2996,"Meselu Fantahun - Agul - መሰሉ ፋንታሁን - አጉል - Ethiopian Music Video 2021 by Nahom Records Inc 3 months ago 5 minutes, 29 seconds 247,316 views",Nahom Records,247316,254981,7665
2997,"Meselu Fantahun - Yayeh Sew - መሰሉ ፋንታሁን - ያየህ ሰው - Ethiopian Muisc 2021 by Nahom Records Inc 3 months ago 5 minutes, 16 seconds 81,709 views",Nahom Records,81709,84558,2849
2998,"Meselu Fantahun - Minew Mekatel - መሰሉ ፋንታሁን - ምነው መቃጠል - Ethiopian Music 2021 by Nahom Records Inc 3 months ago 5 minutes, 19 seconds 121,020 views",Nahom Records,121020,124886,3866
2999,"Girma Tefera - Ethiopiaye - ግርማ ተፈራ - ኢትዮጵያዬ - New Ethiopian Music 2021 (Official Video) by Nahom Records Inc 3 months ago 6 minutes, 8 seconds 272,385 views",Nahom Records,272385,275648,3263
3000,"Meselu Fantahun - Eski Lanesasah - መሰሉ ፋንታሁን - እስኪ ላነሳሳህ - Ethiopian Music 2021 by Nahom Records Inc 3 months ago 5 minutes, 22 seconds 118,710 views",Nahom Records,118710,121371,2661
3001,"Damtew Ayele - Awdamet - ዳምጠው አየለ - አውዳመት - Ethiopian Music 2021 by Nahom Records Inc 3 months ago 5 minutes, 2 seconds 3,095 views",Nahom Records,3095,3153,58
3002,"Meselu Fantahun - Yane - መሰሉ ፋንታሁን - ያኔ - Ethiopian Music 2021 by Nahom Records Inc 3 months ago 5 minutes, 58 seconds 164,809 views",Nahom Records,164809,168018,3209
3003,"Mezmur Yohannes - Ale Neger - መዝሙር ዮሃንስ - አለ ነገር - Ethiopian music 2021 by Nahom Records Inc 3 months ago 6 minutes, 22 seconds 33,651 views",Nahom Records,33651,34147,496
3004,"Birhanu Tezera - Man Alegn - ብርሃኑ ተዘራ - ማን አለኝ - Ethiopian Music 2021 by Nahom Records Inc 3 months ago 4 minutes, 53 seconds 13,830 views",Nahom Records,13830,13977,147
3005,"Damtew Ayele - Welelaye - ዳምጠዉ አየለ - ወለላዬ - Ethiopian Music 2021 by Nahom Records Inc 3 months ago 5 minutes, 24 seconds 6,005 views",Nahom Records,6005,6146,141
3006,"Meselu Fantahun - Werk Almaz - መሰሉ ፋንታሁን - ወርቅ አልማዝ - Ethiopian music Video 2021 by Nahom Records Inc 3 months ago 4 minutes, 31 seconds 200,130 views",Nahom Records,200130,203745,3615
3007,"Ayalew Mesfin - Hager Sitithara - አያሌዉ መስፍን - ሀገር ስትጣራ - New Ethiopian Music 2021 (Official Video) by Nahom Records Inc 3 months ago 5 minutes, 25 seconds 27,309 views",Nahom Records,27309,27520,211
3008,"Mezmur Yohannes - Che Beyign  - መዝሙር ዮሃንስ - ቼ በይኝ - Ethiopian Muisc by Nahom Records Inc 3 months ago 3 minutes, 16 seconds 6,946 views",Nahom Records,6946,7073,127
3009,"Yohannes Tafesse - Hageren Atnqwat - ዮሐንስ ታፈሰ - ሀገሬን አትንኳት - New Ethiopia Music 2021(Official Video) by Nahom Records Inc 3 months ago 4 minutes, 17 seconds 10,025 views",Nahom Records,10025,10127,102
3010,"Birhanu Tezera - Shalom - ብርሃኑ ተዘራ - ሻሎም - Ethiopian Muisc 2021 by Nahom Records Inc 3 months ago 4 minutes, 54 seconds 7,632 views",Nahom Records,7632,7688,56
3011,"Mezmur Yohanesse - Hager Yfredibign - መዝሙር ዮሐንስ - ሃገር ይፍረደኝ - Ethiopian Music by Nahom Records Inc 3 months ago 4 minutes, 31 seconds 12,159 views",Nahom Records,12159,12187,28
3012,"Damtew Ayele - Minjar - ዳመጠዉ አየለ - ምንጃር - Ethiopian Music 2021 by Nahom Records Inc 3 months ago 6 minutes, 46 seconds 7,181 views",Nahom Records,7181,7384,203
3013,"Mohaamad Ibraahim - Shirgigaate - መሃመድ ኢብራሂም - Ethiopian Oromo Music 2021 by Nahom Records Inc 3 months ago 8 minutes, 30 seconds 3,696 views",Nahom Records,3696,3709,13
3014,"Damtew Ayele - Temesgen Elalehu - ዳምጠዉ አየለ - ተመስገን እላለሁ - Ethiopian Muisc 2021 by Nahom Records Inc 3 months ago 5 minutes, 36 seconds 4,817 views",Nahom Records,4817,4890,73
3015,"Birhanu Tezera - Tirunet - ብርሃኑ ተዘራ - ጥሩነት - Ethiopian Music 2021 by Nahom Records Inc 3 months ago 4 minutes, 34 seconds 13,285 views",Nahom Records,13285,13378,93
3016,"Mohaamad Ibraahim - Galaana - መሃመድ ኢብራሒም - Ethiopian Oromo Muisc by Nahom Records Inc 3 months ago 10 minutes, 10 seconds 4,526 views",Nahom Records,4526,4540,14
3017,"Haymanot Girma - Hon Biye - ሃይማኖት ግርማ - ሆን ብዬ - Ethiopian music 2021 by Nahom Records Inc 3 months ago 4 minutes, 46 seconds 15,271 views",Nahom Records,15271,15433,162
3018,"Damtew Ayele - Yewelo Lij - ዳምጠዉ አየለ - የወሎ ልጅ - Ethiopian Music by Nahom Records Inc 3 months ago 5 minutes, 24 seconds 9,997 views",Nahom Records,9997,10298,301
3019,"Mohaamad Ibraahim (Xawiil) - Yoomuma - መሃመድ ኢብራሂም - Ethiopian Oromo Music by Nahom Records Inc 3 months ago 6 minutes, 1 second 3,275 views",Nahom Records,3275,3294,19
3020,"Haymanot Girma - Hamama - ሃይማኖት ግርማ - ኤሀማማ - Ethiopia Music by Nahom Records Inc 3 months ago 4 minutes, 52 seconds 8,785 views",Nahom Records,8785,8861,76
3021,"Mohaamad Ibraahim (Xawiil) - Mee Yomiin Si'arka - መሃመድ ኢብራሒም - Ethiopian Oromo Music by Nahom Records Inc 3 months ago 7 minutes 2,956 views",Nahom Records,2956,2969,13
3022,"Haymanot Girma  Amen - ሃይማኖት ግርማ - አሜን - Ethiopian Music by Nahom Records Inc 3 months ago 5 minutes, 45 seconds 12,112 views",Nahom Records,12112,12187,75
3023,"Damtew Ayele - Yene Mar - ዳምጠዉ አየለ - የኔ ማር - Ethiopian Music by Nahom Records Inc 3 months ago 6 minutes, 33 seconds 8,187 views",Nahom Records,8187,8307,120
3024,"Mohaamad Ibrahim - Naf Jacel Halelay - መሃመድ ኢብራሒም - Ethiopian Oromo Music by Nahom Records Inc 4 months ago 7 minutes, 16 seconds 2,652 views",Nahom Records,2652,2689,37
3025,"Non Stop - Piano Music 24/7: Focus, Study Music, Meditation, Relaxing Music, By Tigest Ejigu by Nahom Records Inc 4 months ago 1 hour, 3 minutes 3,345 views",Nahom Records,3345,3437,92
3026,"Haymanot Girma Alsemagn Ale - ሃይማኖት ግርማ - አልሰማኝ አለ - Ethiopian Music by Nahom Records Inc 4 months ago 4 minutes, 59 seconds 31,534 views",Nahom Records,31534,31806,272
3027,"Mohaammad Ibraahim (Xawil) - Jeedo - መሃመድ ኢብራሒም (ጠዊል) - Ethiopian Oromo Music by Nahom Records Inc 4 months ago 4 minutes, 42 seconds 2,780 views",Nahom Records,2780,2812,32
3028,"Haymanot Girma - Yemalkeyrew - ሃይማኖት ግርማ  - የማልቀይረዉ - Ethiopian Music by Nahom Records Inc 4 months ago 4 minutes, 43 seconds 48,683 views",Nahom Records,48683,53585,4902
3029,"Birhanu Tezera - Ekoralehu Enji (Lafonte)- ብርሃኑ ተዘራ (ላፎንቴ) - እኮራለሁ እንጂ- Ethiopian Music by Nahom Records Inc 4 months ago 4 minutes, 18 seconds 12,740 views",Nahom Records,12740,12799,59
3030,"Tewodros Samuel - Yinesa - ቴዎድሮስ ሳሙኤል - ይነሳ - New Ethiopian Music Video 2021 (Official Video) by Nahom Records Inc 4 months ago 6 minutes, 11 seconds 34,617 views",Nahom Records,34617,35374,757
3031,"Haymanot Girma - Efoy - ሃይማኖት ግርማ - እፎይ - Ethiopian Music by Nahom Records Inc 4 months ago 6 minutes, 27 seconds 17,540 views",Nahom Records,17540,17838,298
3032,"Damtew Ayele - Areberebe - ዳምጠዉ አየለ - አረበረበ - Ethiopian Traditional Music by Nahom Records Inc 4 months ago 6 minutes, 26 seconds 7,808 views",Nahom Records,7808,7961,153
3033,"Mohaammad Ibraahim - Jimmitti - መሐመድ ኢብራሒም - Ethiopian Music by Nahom Records Inc 4 months ago 5 minutes, 36 seconds 3,801 views",Nahom Records,3801,3821,20
3034,"Haymanot Girma Megera Weger - ሃይማኖት ግርማ - መገራ ወገር - Ethiopian Music by Nahom Records Inc 4 months ago 5 minutes, 28 seconds 21,000 views",Nahom Records,21000,21148,148
3035,"Mohaammad Ibraahim - Jaalala Dhugaa - መሐመድ ኢብራሒም - Ethiopian Oromo Music by Nahom Records Inc 4 months ago 6 minutes, 37 seconds 5,114 views",Nahom Records,5114,5173,59
3036,"Haymanot Girma - Jalele - ሃይማኖት ግርማ - ጃለሌ - Ethiopian Music by Nahom Records Inc 4 months ago 5 minutes, 2 seconds 28,530 views",Nahom Records,28530,28676,146
3037,"Gete Aniley Melkish Aybeltishim - ጌቴ አንለይ - መልክሽ አይበልጥም - Ethiopian Music by Nahom Records Inc 4 months ago 6 minutes, 20 seconds 15,520 views",Nahom Records,15520,15803,283
3038,"Enyew Fancho - Weleba - እንየዉ ፋንጮ - ወለባ - New Ethiopian Music 2021(Official Video) by Nahom Records Inc 4 months ago 3 minutes, 58 seconds 547,727 views",Nahom Records,547727,571614,23887
3039,"Hebist Tiruneh - Qere Ende - ህብስት ጥሩነህ - ቀረ እንዴ - New Ethiopian Music 2021 (Official Video) by Nahom Records Inc 4 months ago 4 minutes, 56 seconds 990,899 views",Nahom Records,990899,1018127,27228
3040,"Kirubel Gebremikael - Teresasan Wey - ኪሩቤል ገብረሚካኤል -ተረሳሳን - New Ethiopian Music 2021 (Official Video by Nahom Records Inc 4 months ago 6 minutes, 13 seconds 61,203 views",Nahom Records,61203,61757,554
3041,"Haymanot Girma - Ebdi New - ሃይማኖት ግርማ - እብድ ነዉ - Ethiopia Muisc by Nahom Records Inc 4 months ago 5 minutes, 29 seconds 28,216 views",Nahom Records,28216,28421,205
3042,"Mezmur Yohannes  - Aregedech Midir - መዝሙር ዮሐንስ - አረገደች ምድ - Ethiopian Music by Nahom Records Inc 4 months ago 7 minutes, 26 seconds 8,867 views",Nahom Records,8867,8931,64
3043,"Non Stop - Best Of Tigest Ejigu Instrumental Music - With Popular and Traditional Melodies by Nahom Records Inc 4 months ago 56 minutes 8,692 views",Nahom Records,8692,8732,40
3044,"Raki Solomon - Tolo Na - ራኪ ሰለሞን - ቶሎ ና - New Ethiopian Music 2021 (Official Video) by Nahom Records Inc 4 months ago 5 minutes, 43 seconds 271,264 views",Nahom Records,271264,273857,2593
3045,"Maki Kb - Denegete - ማኪ ኬቢ - ደነገጠ - New Ethiopian Music 2021 (Official Video) by Nahom Records Inc 4 months ago 4 minutes, 15 seconds 4,073,711 views",Nahom Records,4073711,4200079,126368
3046,"Yared Belay - Siyamrebsh Degmo - ያሬድ በላይ - ሲያምርብሽ ደግሞ - New Ethiopian Music 2021 (Official Video) by Nahom Records Inc 4 months ago 6 minutes, 5 seconds 42,788 views",Nahom Records,42788,42918,130
3047,"Haymanot Girma - Alalewima - ሃይማኖት ግርማ - አላለዉማ - Ethiopian Muisc 2021 by Nahom Records Inc 4 months ago 5 minutes, 46 seconds 94,075 views",Nahom Records,94075,94542,467
3048,"Mezmur Yohannes - Lgnetie - መዝሙር ዮሃንስ - ልጅነቴ - Ethiopian Music by Nahom Records Inc 4 months ago 7 minutes, 3 seconds 6,532 views",Nahom Records,6532,6585,53
3049,"Haymanot Girma  - Addis Aba - ሐይማኖት ግርማ - አዲስ አባ - Ethiopian Muisc 2021 by Nahom Records Inc 4 months ago 5 minutes, 22 seconds 87,074 views",Nahom Records,87074,87383,309
3050,"Gete Aniley  -Tamash Bechereka - ጌቴ አንለይ - ታማሽ በጨረቃ - New Ethiopian Muisc 2021 by Nahom Records Inc 4 months ago 5 minutes, 53 seconds 25,199 views",Nahom Records,25199,25349,150
3051,"Haymanot Girma - Bechebeta - ሃይማኖት ግርማ - በጨበጣ - New Ethiopian Muisc 2021 by Nahom Records Inc 4 months ago 4 minutes, 46 seconds 114,668 views",Nahom Records,114668,115434,766
3052,"Mohaammad Ibraahim - Hin Yaadini - መሐመድ ኢብራሒም - New Ethiopian Oromo Music by Nahom Records Inc 4 months ago 5 minutes, 29 seconds 6,677 views",Nahom Records,6677,6690,13
3053,"Mafi Afro - Amenat Libe - ማፊ አፍሮ - አመናት ልቤ - New Ethiopian Muisc 2021 (Official Video) by Nahom Records Inc 4 months ago 4 minutes, 34 seconds 1,633,209 views",Nahom Records,1633209,1688364,55155
3054,"Fantish Bekele - Eshururu - ፋንትሽ በቀለ - እሹሩሩ - New Ethiopian Music 2021 (Official Video) by Nahom Records Inc 5 months ago 6 minutes, 25 seconds 445,538 views",Nahom Records,445538,448264,2726
3055,"Lali Habesha  - Yababolyo - ላሊ ሐበሻ - ያበቦሊዎ - New Ethiopian Music 2021 (Official Video) by Nahom Records Inc 5 months ago 5 minutes, 18 seconds 18,919 views",Nahom Records,18919,18964,45
3056,"Dagim Alemu - Fegeg Shewa - ዳግም አለሙ - ፈገግ ሸዋ - New Ethiopia Music 2021 (Official Video) by Nahom Records Inc 5 months ago 4 minutes, 49 seconds 87,464 views",Nahom Records,87464,90680,3216
3057,"Veronica Adane - Tefet Alegn - ቬሮኒካ አዳነ  - ጥፍጥ አለኝ - New Ethiopian Music 2021 (Official Video) by Nahom Records Inc 5 months ago 4 minutes 7,300,064 views",Nahom Records,7300064,7502565,202501
3058,"Fiqaaduu Asheetuu - Imaltuu - ፍቃዱ እሸቱ - ኢማልቱ - New Ethiopian Oromo Music Video 2021 (Official Video by Nahom Records Inc 5 months ago 5 minutes, 36 seconds 19,397 views",Nahom Records,19397,19530,133
3059,"Mohaammad Ibraahim - Intaly - መሃመድ ኢብራሂም -  Ethiopian Oromo Music by Nahom Records Inc 5 months ago 5 minutes, 50 seconds 12,260 views",Nahom Records,12260,12400,140
3060,"Muhabaw Alamrew and Belayinesh Asmare - Chemiruwal  - New Ethiopian Music Video 2021(Official Video) by Nahom Records Inc 5 months ago 7 minutes, 1 second 284,241 views",Nahom Records,284241,286353,2112
3061,"Mamila Lukas - Mushra Nesh Ethiopia - ሙሽራ ነሽ ኢትዮዽያ - New Ethiopian Music Video 2021(official Video) by Nahom Records Inc 5 months ago 4 minutes, 30 seconds 246,625 views",Nahom Records,246625,249572,2947
3062,"Ayalew Mesfin - Yibarek Zemenu - አያሌዉ መስፍን -ይባረክ ዘመኑ New Ethiopian Music Video 2021 (Official Video) by Nahom Records Inc 5 months ago 5 minutes, 13 seconds 111,964 views",Nahom Records,111964,112141,177
3063,"Bisrat Surafel -  Enqutatash - ብስራት ሱራፌል - እንቁጣጣሽ - New Ethiopian Music Video 2021 (Official Video) by Nahom Records Inc 5 months ago 4 minutes, 9 seconds 285,235 views",Nahom Records,285235,285669,434
3064,"Dina Anteneh - Adey - ዲና አንተነህ - አደይ - New Ethiopian Music Video 2021 (Official Video) by Nahom Records Inc 5 months ago 5 minutes, 34 seconds 349,040 views",Nahom Records,349040,349769,729
3065,"Befiyad - Endet Keremachu - በፍያድ - እንዴት ከረማችሁ - New Ethiopian Music Video 2021 (Official Video) by Nahom Records Inc 5 months ago 5 minutes, 44 seconds 111,699 views",Nahom Records,111699,111823,124
3066,"Esayas Tamrat - Bel Amen - ኢሳያስ ታምራት - በል አሜን - New Ethiopian Music Video 2021 (Official Video) by Nahom Records Inc 5 months ago 5 minutes, 21 seconds 129,901 views",Nahom Records,129901,130170,269
3067,"Mohaammad Ibraahim - habiibi (Sudaan) - መሐመድ ኢብራሒም - ሃቢቢ - New Music 2021 by Nahom Records Inc 5 months ago 5 minutes, 53 seconds 7,018 views",Nahom Records,7018,7052,34
3068,"MIskir Awel - Laf argat - ምስክር አወል - ላፍ አርጋት - New Ethiopian Music Video 2021 (Official Video) by Nahom Records Inc 5 months ago 5 minutes, 42 seconds 764,748 views",Nahom Records,764748,772816,8068
3069,"ZIGGY ZAGA AND UJULU -  Esu Lay Fezo  - እሷ ላይ ፈዞ - New Ethiopian Music Video 2021 (Official Video) by Nahom Records Inc 5 months ago 4 minutes, 7 seconds 352,383 views",Nahom Records,352383,355823,3440
3070,"Adane Darge - Minshen New - አዳነ ዳርጌ - ምንሽን ነዉ - New Ethiopian Music Video 2021 (Official Video 2021) by Nahom Records Inc 6 months ago 4 minutes, 59 seconds 125,820 views",Nahom Records,125820,128657,2837
3071,"Endalew Sitotaw - Che Belew - እንዳለው ስጦታው  -ቸ በለው - New Ethiopian Music Video 2021 (Official Video) by Nahom Records Inc 6 months ago 9 minutes, 15 seconds 148,893 views",Nahom Records,148893,155270,6377
3072,"Bekele Arega - Enteyay - New Ethiopian Music Video 2021(Official Video) by Nahom Records Inc 6 months ago 4 minutes, 45 seconds 64,316 views",Nahom Records,64316,64542,226
3073,"Zebiba Girma - Ayehu Gela -  ዘቢባ ግርማ - አየሁ ገላ - New Ethiopian Music Video 2021 (Official Video) by Nahom Records Inc 6 months ago 4 minutes, 21 seconds 2,759,968 views",Nahom Records,2759968,2792667,32699
3074,"Bob Zewge - Ni Bamekin - ቦብ ዘዉገ - ኒ ባምኪን - New Ethiopian Music Video 2021 (Official Video) by Nahom Records Inc 6 months ago 3 minutes, 36 seconds 17,301 views",Nahom Records,17301,17366,65
3075,"Banchiamlak Getnet - Fredegn - ባንቺአምላክ ጌትነት - ፍረደኝ - New Ethiopian Music Video 2021 (Official Video) by Nahom Records Inc 6 months ago 5 minutes, 19 seconds 371,575 views",Nahom Records,371575,374102,2527
3076,"Elias Teklahaymanot -Tewat Ethiopian - ተዉአት ኢትዮዽያን - New Ethiopian Music Video 2021 (Official Video) by Nahom Records Inc 6 months ago 4 minutes, 50 seconds 401,655 views",Nahom Records,401655,405130,3475
3077,"Tintag zema - Eire Teygne _ ትንታግ ዜማ - አረ ተይኝ - New Ethiopian Music Video  2021 (Official Video) by Nahom Records Inc 6 months ago 5 minutes, 39 seconds 100,616 views",Nahom Records,100616,101005,389
3078,"Abdy Jemal - Jaalalli Kee Abjudha - New Ethiopian Oromo Music Video 2021 (Official Video) by Nahom Records Inc 6 months ago 5 minutes, 3 seconds 85,123 views",Nahom Records,85123,85420,297
3079,"Sifen Addis Shumie - Demo Base - ሲፈን አዲስ -  ደሞ ባሰ - New Ethiopian Music Video 2021 (Official Video) by Nahom Records Inc 6 months ago 4 minutes, 37 seconds 110,723 views",Nahom Records,110723,111186,463
3080,"Badhaasoo A/Kadiiroo  Nabii - Ni moona - New Ethiopian Oromo Music Video 2021 (Official Video) by Nahom Records Inc 6 months ago 6 minutes, 36 seconds 25,706 views",Nahom Records,25706,26082,376
3081,"Tesfaye Tilahun - jibichaa - ተስፋዬ ጥላሁን - ጂቢቸኮ - New Ethiopian Oromo Music Video 2021(Official Video) by Nahom Records Inc 6 months ago 4 minutes, 59 seconds 31,280 views",Nahom Records,31280,31613,333
3082,"Kalkidan Yirga - Sheb  Argo - ቃልኪዳን ይርጋ - ሸብ አርጎ New Ethiopian Music Video (official Video) by Nahom Records Inc 6 months ago 4 minutes, 10 seconds 31,439 views",Nahom Records,31439,31543,104
3083,"Fasil Demoz - Cha Bel - ፋሲል ደሞዝ - ጫ በል - New Ethiopian Music 2021 (Official Video) by Nahom Records Inc 6 months ago 7 minutes, 17 seconds 1,763,419 views",Nahom Records,1763419,1782067,18648
3084,"Birhanu Tezera - Zarem Ewedishalehu - ብርሃኑ ተዘራ (ላፎንቴ)  - ዛሬም እወድሻለሁ Ethiopian Music by Nahom Records Inc 6 months ago 4 minutes, 43 seconds 41,316 views",Nahom Records,41316,41597,281
3085,"Dezry Kay - Ewedihalew - እወድሃለሁ - New South African Music Video 2021 (Official Video) by Nahom Records Inc 6 months ago 3 minutes, 36 seconds 23,046 views",Nahom Records,23046,23203,157
3086,"Yemi - Raq Raq -  የሚ - ራቅ ራቅ - New Ethiopian Music Video 2021 (Official Video) by Nahom Records Inc 7 months ago 4 minutes, 48 seconds 79,293 views",Nahom Records,79293,79946,653
3087,"Zinash Lole - Addaarroo - New Ethiopian Oromo Music Video 2021 (Official Video) by Nahom Records Inc 7 months ago 5 minutes, 20 seconds 73,944 views",Nahom Records,73944,74374,430
3088,"Eyerusalem Kelemewerk - Menagn - እየሩሳሌም ቀለመወርቅ - መናኝ - New Ethiopian Music Video 2021(Official Video by Nahom Records Inc 7 months ago 4 minutes, 59 seconds 1,101,433 views",Nahom Records,1101433,1107090,5657
3089,"Yasin Yesuf - Ere Manew - ያሲን ዩሱፍ - እረ ማነዉ - New Ethiopian Music Video 2021 (Official Video) by Nahom Records Inc 7 months ago 6 minutes, 35 seconds 18,775 views",Nahom Records,18775,18792,17
3090,"Natnael Beyene  -Tadye New - ናትናኤል በየነ - ታድዬ ነዉ - New Ethiopian Music Video 2021(Official Video) by Nahom Records Inc 7 months ago 4 minutes, 31 seconds 40,619 views",Nahom Records,40619,40939,320
3091,"Fikir Yitagesu - Sint Alebign - ፍቅር ይታገሱ - ስንት አለብኝ - New Ethiopian Music Video 2021(Official Video) by Nahom Records Inc 7 months ago 5 minutes, 21 seconds 466,112 views",Nahom Records,466112,470433,4321
3092,"Yemker Sisay - Beqtu Yazegn -  የምክር ሲሳይ - በቅጡ ያዘኝ - New Ethiopian Music 2021 (Official Video) by Nahom Records Inc 7 months ago 5 minutes, 39 seconds 29,938 views",Nahom Records,29938,30978,1040
3093,"Addunyaa Amantee - Situ Angafa - New Ethiopian Oromo Music Video 2021 (Official Video) by Nahom Records Inc 7 months ago 5 minutes, 5 seconds 72,318 views",Nahom Records,72318,72842,524
3094,"Esayas Tamrat - Eyadane Yamal - ኢሳያስ ታምራት  - እያዳነ ያማል - New Ethiopian Music 2021 (Official Video) by Nahom Records Inc 8 months ago 6 minutes, 21 seconds 1,353,440 views",Nahom Records,1353440,1381621,28181
3095,"Mnte Zays  -  Koyabo - ምንተ ዛይስ - ኮያቦ - New Ethiopian Music 2021 (Official Video) by Nahom Records Inc 8 months ago 4 minutes, 11 seconds 74,851 views",Nahom Records,74851,75058,207
3096,"ዲሽታ ጊና ኮንሠርት እና ሽልማቶች -  Dishta Gina Concert and Awards by Nahom Records Inc 8 months ago 25 minutes 70,625 views",Nahom Records,70625,70682,57
3097,"Gedion Engidawork -Yet Enawraw - ጌዲዮን እንግዳወርቅ - የት እናውራው - New Ethiopian Music 2021 (Official Video) by Nahom Records Inc 8 months ago 5 minutes, 18 seconds 24,850 views",Nahom Records,24850,24934,84
3098,"Haymanot Girma - Kezira 2 - ሃይማኖት ግርማ - ከዚራ 2 - New Ethiopian Music 2021 (Official Video) by Nahom Records Inc 8 months ago 4 minutes, 12 seconds 1,103,394 views",Nahom Records,1103394,1113484,10090
3099,"Tsebay Tadele - Yene - ፀባይ ታደለ - የኔ - New Ethiopian Music 2021 (Official Video) by Nahom Records Inc 8 months ago 4 minutes, 17 seconds 48,832 views",Nahom Records,48832,48931,99
3100,"Gete Aniley - Sertesh Atafrshiw - ጌቴ አንለይ - ሠርተሽ አታፍርሺው - New Ethiopian Music 2021 (Official Video) by Nahom Records Inc 8 months ago 5 minutes, 19 seconds 176,970 views",Nahom Records,176970,177636,666
3101,"Ashenafi Geremew - Kekenafrsh New - አሸናፊ ገረመዉ- ከከናፍርሽ ነዉ - New Ethiopian Music 2021 (Official Video) by Nahom Records Inc 8 months ago 4 minutes, 28 seconds 224,431 views",Nahom Records,224431,226047,1616
3102,"Yohana - Endelibua - ዮሐና - እንደልቧ - New Ethiopian Music 2021 (Official Video) by Nahom Records Inc 8 months ago 3 minutes, 10 seconds 385,918 views",Nahom Records,385918,388506,2588
3103,"Tade Philo- Aybalim - ታዴ ፊሎ - አይባልም - New Ethiopian Music 2021 (Official Video) by Nahom Records Inc 8 months ago 5 minutes, 24 seconds 25,219 views",Nahom Records,25219,25299,80
3104,"Kuni Tesfaye & Gildo Kassa - Elili - ኢሊሊ - New Ethiopian Music 2021 (Official Video by Nahom Records Inc 8 months ago 3 minutes, 51 seconds 437,061 views",Nahom Records,437061,440355,3294
3105,"Fitsum Hagos - Hade Hirmetna - ሓደ ህርመትና - New Ethiopian Tigrigna Music 2021 (Official Video) by Nahom Records Inc 9 months ago 4 minutes, 27 seconds 12,677 views",Nahom Records,12677,12717,40
3106,"Andualem Getachew - Ewedishalew - አንዱዓለም ጌታቸው - እወድሻለው - New Ethiopian Music 2021 (Official Video) by Nahom Records Inc 9 months ago 5 minutes, 14 seconds 72,018 views",Nahom Records,72018,72340,322
3107,"Ahmed Hussein Manjus - Kiliwliw - አህመድ ሁሴን ማንጁስ - ክልውልው - New Ethiopian Music 2021 (Official Video) by Nahom Records Inc 9 months ago 5 minutes, 11 seconds 759,972 views",Nahom Records,759972,770780,10808
3108,"Birhanu Tezera - Fuwa Bilesh - ብርሃኑ ተዘራ - ፏ ብለሽ - Ethiopian Music by Nahom Records Inc 9 months ago 4 minutes, 33 seconds 21,451 views",Nahom Records,21451,21482,31
3109,"Seyumekal Gebre - Bemewdedish - ስዩመቃል ገብሬ - በመውደድሽ - New Ethiopian Music 2021 (Official Video) by Nahom Records Inc 9 months ago 5 minutes, 44 seconds 33,130 views",Nahom Records,33130,33321,191
3110,"Igitu - Tidar - እግቱ - ትዳር - New Ethiopian Music 2021 (Official Video) by Nahom Records Inc 9 months ago 4 minutes, 40 seconds 467,245 views",Nahom Records,467245,473003,5758
3111,"Yetimwork Beyene - Lefikir Zemach - የትምወርቅ በየነ - ለፍቅር ዘማች - New Ethiopian Music 2021(Official Video) by Nahom Records Inc 9 months ago 4 minutes, 44 seconds 49,914 views",Nahom Records,49914,50043,129
3112,"Halima Abdurahiman - Goraw - ሐሊማ አብዱራህማን - ጎራው - New Ethiopian Music 2021 (Official Video) by Nahom Records Inc 9 months ago 5 minutes, 27 seconds 879,135 views",Nahom Records,879135,885621,6486
3113,"Fasil Demoz - Ere Geday - ፋሲል ደሞዝ - አረ ገዳይ - Ethiopian Music by Nahom Records Inc 9 months ago 6 minutes, 44 seconds 53,377 views",Nahom Records,53377,53568,191
3114,"Esayas Tamirat - Temeles Yilegnal - ኢሣያስ ታምራት - ተመለስ ይለኛል - New Ethiopian Music 2021(Official Video) by Nahom Records Inc 9 months ago 5 minutes, 15 seconds 791,320 views",Nahom Records,791320,794493,3173
3115,"Fasil Demoz  - Cheb Cheb - ፋሲል ደሞዝ - ቸብ ቸብ - Ethiopian Music by Nahom Records Inc 9 months ago 5 minutes, 47 seconds 40,145 views",Nahom Records,40145,40516,371
3116,"Mergitu Workineh - obomboleettii - ኦቦምቦሌቲ - New Ethiopian Oromo music 2021 (Official Video) by Nahom Records Inc 9 months ago 5 minutes, 1 second 5,187,142 views",Nahom Records,5187142,5268748,81606
3117,"Debe Alemseged - Liwalibet - ደቤ አለምሠገድ - ልዋልበት - New Ethiopian Music 2021 (Official Video) by Nahom Records Inc 9 months ago 5 minutes, 35 seconds 350,591 views",Nahom Records,350591,351898,1307
3118,"Gedion Daniel - Libe Sew Yamnal - ጌድዮን ዳንኤል - ልቤ ሠው ያምናል - Ethiopian Music by Nahom Records Inc 9 months ago 5 minutes, 7 seconds 12,689 views",Nahom Records,12689,12723,34
3119,"Samon Haile Ft. Amanuel Yemane - Ajohi - አጆኺ - New Ethiopian Music 2021 (Official Video) by Nahom Records Inc 9 months ago 4 minutes, 6 seconds 175,307 views",Nahom Records,175307,175833,526
3120,"Daniel Sintayehu (Dani Magna) - Ethiop - ኢትዮጵ - New Ethiopian Music 2021 (Official Video) by Nahom Records Inc 9 months ago 6 minutes, 11 seconds 174,871 views",Nahom Records,174871,175152,281
3121,"Tamirat Desta - Tamir Yasfeligal - ታምራት ደስታ - ታምር ያስፈልጋል - Ethiopian Music by Nahom Records Inc 9 months ago 4 minutes, 52 seconds 38,177 views",Nahom Records,38177,38951,774
3122,"Fasil Demoz - Anchiye - ፋሲል ደሞዝ - አንችዬ - Ethiopian Music by Nahom Records Inc 9 months ago 7 minutes, 18 seconds 82,946 views",Nahom Records,82946,83306,360
3123,"Birhanu Tezera - Begena Legena - ብርሃኑ ተዘራ - በገና ለገና - Ethiopian Music by Nahom Records Inc 10 months ago 3 minutes, 57 seconds 18,982 views",Nahom Records,18982,19021,39
3124,"Fasil Demoz - Shashe Areferefech - ፋሲል ደሞዝ - ሻሼ አረፈረፈች - Ethiopian Music by Nahom Records Inc 10 months ago 6 minutes, 46 seconds 83,426 views",Nahom Records,83426,83728,302
3125,"Tamirat Desta - Sew Hulu - ታምራት ደስታ - ሠው ሁሉ - Ethiopian Music by Nahom Records Inc 10 months ago 4 minutes, 45 seconds 18,563 views",Nahom Records,18563,18650,87
3126,"Fasil Demoz - Kelay Kelay - ፋሲል ደሞዝ - ከላይ ከላይ - Ethiopian Music by Nahom Records Inc 10 months ago 5 minutes, 49 seconds 72,510 views",Nahom Records,72510,72736,226
3127,"Addis Gurmesa - Konjit - አዲስ ጉርሜሳ - ቆንጂት - New Ethiopian Music 2021 (Official Video) by Nahom Records Inc 10 months ago 5 minutes, 25 seconds 13,995 views",Nahom Records,13995,14043,48
3128,"Chalachew Ashenafi & Birtukan Dubale - Teymanesh - ተይማነሽ - Ethiopian Music by Nahom Records Inc 10 months ago 9 minutes, 56 seconds 30,701 views",Nahom Records,30701,30977,276
3129,"Leul Hailu - Anchi Nesh Akale - ልዑል ኃይሉ - አንቺ ነሽ አካሌ - New Ethiopian Music 2021 (Official Video) by Nahom Records Inc 10 months ago 5 minutes, 54 seconds 86,125 views",Nahom Records,86125,86459,334
3130,"Eskedar Amsalu - Ayastegnagnim - እስከዳር አምሳሉ - አያስተኛኝም - Etiopian Music by Nahom Records Inc 10 months ago 7 minutes, 19 seconds 4,348 views",Nahom Records,4348,4357,9
3131,"Feran Be Dess  - ፈራን በደስ - New Ethiopian Music 2021 (Official Video) by Nahom Records Inc 10 months ago 4 minutes, 26 seconds 11,543 views",Nahom Records,11543,11577,34
3132,"Fasil Demoz - Endia Endia Neber  - ፋሲል ደሞዝ - እንዲያ እንዲያ ነበር  - Ethiopian Music by Nahom Records Inc 10 months ago 6 minutes, 25 seconds 101,051 views",Nahom Records,101051,101907,856
3133,"Girma Gemecu - Fikrie Neyma - ግርማ ገመቹ - ፍቅሬ ነይማ - Ethiopian Music by Nahom Records Inc 10 months ago 4 minutes, 36 seconds 5,489 views",Nahom Records,5489,5522,33
3134,"Fasil Demoz - Cher Niga - ፋሲል ደሞዝ - ቸር ንጋ - Ethiopian Music by Nahom Records Inc 10 months ago 8 minutes, 10 seconds 403,280 views",Nahom Records,403280,404426,1146
3135,"Fasil Demoz - Himem Gela (Gojam) - ፋሲል ደሞዝ - ህመም ገላ (ጎጃም) - Ethiopian Music by Nahom Records Inc 10 months ago 5 minutes, 59 seconds 100,744 views",Nahom Records,100744,100946,202
3136,"Chalachew Ashenafi - Shilela -  ቻላቸው አሸናፊ - ሽለላ - Ethiopian Music by Nahom Records Inc 10 months ago 8 minutes, 35 seconds 93,091 views",Nahom Records,93091,94593,1502
3137,"Chalachew Ashenafi - Akale - ቻላቸው አሸናፊ - አካሌ - Ethiopian Music by Nahom Records Inc 10 months ago 6 minutes, 38 seconds 40,275 views",Nahom Records,40275,40596,321
3138,"Maritu and Shambel - Ambasel - ማሪቱ እና ሻምበል - አምባሠል - Ethiopian Music by Nahom Records Inc 10 months ago 8 minutes, 22 seconds 21,169 views",Nahom Records,21169,21460,291
3139,"Birtukan Dubale - Aynama - ብርቱካን ዱባለ - አይናማ - Ethiopian Music by Nahom Records Inc 10 months ago 5 minutes, 52 seconds 14,754 views",Nahom Records,14754,14858,104
3140,"Genene Haile - Hulum Behager New - ገነነ ኃይሌ - ሁሉም በሐገር ነው - New Ethiopian Music 2021 (Official Video) by Nahom Records Inc 10 months ago 5 minutes, 12 seconds 49,052 views",Nahom Records,49052,49412,360
3141,"Shambel Belayneh - Yegeterwa Konjo - ሻምበል በላይነህ - የገጠሯ ቆንጆ - Ethiopian Music by Nahom Records Inc 10 months ago 6 minutes, 25 seconds 19,415 views",Nahom Records,19415,19522,107
3142,"Tariku Gankisi - Dishta Gina - ታሪኩ ጋንካሲ - ዲሽታግና - New Ethiopian Music 2021(Official Video) by Nahom Records Inc 10 months ago 5 minutes, 44 seconds 24,147,705 views",Nahom Records,24147705,24375892,228187
3143,"Abeselom Bihonegn - Maryam - አቤሴሎም ቢሆነኝ - ማርያም - New Ethiopian Orthodox Mezmur 2021 by Nahom Records Inc 10 months ago 5 minutes, 30 seconds 24,923 views",Nahom Records,24923,25010,87
3144,"Tadesse Gebre - Tigrigna - ታደሠ ገብሬ - ትግሪኛ - New Ethiopian Music by Nahom Records Inc 10 months ago 8 minutes, 5 seconds 5,153 views",Nahom Records,5153,5166,13
3145,"Abebaw H/michael - Amra Titay - አበባው ሃ/ሚካኤል - አምራ ትታይ - New Ethiopian Music 2021 (Official Video) by Nahom Records Inc 10 months ago 5 minutes, 14 seconds 12,808 views",Nahom Records,12808,12841,33
3146,"Birtukan Dubale - Anteye - ብርቱካን ዱባለ - አንተዬ - Ethiopian Music by Nahom Records Inc 10 months ago 5 minutes, 36 seconds 49,162 views",Nahom Records,49162,50222,1060
3147,"Chalachew Ashenafi - Sekota - ቻላቸው አሸናፊ - ሠቆጣ - Ethiopian Music 2021 by Nahom Records Inc 10 months ago 5 minutes, 36 seconds 64,183 views",Nahom Records,64183,64879,696
3148,"Dawit Nega - Ajoki Tigray - ዳዊት ነጋ - ኣጆኺ ትግራይ - New Ethiopian Tigrigna Music 2021 (Official Video) by Nahom Records Inc 10 months ago 6 minutes, 48 seconds 575,149 views",Nahom Records,575149,578045,2896
3149,"Gizachew Teshome - Embign Alegn Embi - ግዛቸው ተሾመ - New Ethiopian Music 2021 (Official Video) by Nahom Records Inc 10 months ago 6 minutes, 32 seconds 875,622 views",Nahom Records,875622,902925,27303
3150,"Kichini Goa -  Anchin Kaman - ኪቺኒ ጎአ - አንቺን ከማን - New Ethiopian Music 2021 (Official Video) by Nahom Records Inc 11 months ago 3 minutes, 46 seconds 233,182 views",Nahom Records,233182,235539,2357
3151,"Chalachew Ashenafi - Hule Abeba - ቻላቸው አሸናፊ - ሁሌ አበባ - Ethiopian Music by Nahom Records Inc 11 months ago 6 minutes, 59 seconds 12,303 views",Nahom Records,12303,12368,65
3152,"Bedilu Assefa - Asham - በድሉ አሠፋ - አሻም - New Ethiopian Music 2021 (Official Video) by Nahom Records Inc 11 months ago 4 minutes, 53 seconds 8,322 views",Nahom Records,8322,8351,29
3153,"Setegn Atenaw - Derbabaw - ሠጠኝ አጠናው - ደርባባው - Ethiopian Music by Nahom Records Inc 11 months ago 8 minutes, 27 seconds 6,750 views",Nahom Records,6750,6782,32
3154,"Wendimu Jira - Yene Tizita - ወንድሙ ጅራ - የኔ ትዝታ - New Ethiopian Music 2021 (Official Video) by Nahom Records Inc 11 months ago 6 minutes, 35 seconds 1,611,711 views",Nahom Records,1611711,1624334,12623
3155,"Tsehay Amare - Borena - ፀሐይ አማረ - ቦረና - Ethiopian Music by Nahom Records Inc 11 months ago 6 minutes, 28 seconds 16,876 views",Nahom Records,16876,16975,99
3156,"Amanuel Sinishaw - Were Alebish - አማኑኤል ስንሻው - ወሬ አለብሽ - New Ethiopian Music 2021 (Official Video) by Nahom Records Inc 11 months ago 3 minutes, 59 seconds 14,190 views",Nahom Records,14190,14213,23
3157,"Wushinfir Argaw - Yabagerish Lij - ውሽንፍር አርጋው - ያባገርሽ ልጅ - Ethiopian Music by Nahom Records Inc 11 months ago 7 minutes, 5 seconds 8,333 views",Nahom Records,8333,8342,9
3158,"Veronica Adane - Tew - ቬሮኒካ አዳነ - ተው - New Ethiopian Music 2021 (Official Video) by Nahom Records Inc 11 months ago 4 minutes, 58 seconds 7,716,995 views",Nahom Records,7716995,7817560,100565
3159,"Elias Tebabal - Abejehu - ኤልያስ ተባባል - አበጀሁ - Ethiopian Music by Nahom Records Inc 11 months ago 5 minutes, 14 seconds 100,518 views",Nahom Records,100518,101866,1348
3160,"Tewodros Teferi - Argilgn Qelel - ቴዎድሮስ ተፈሪ - አርጊልኝ ቀለል - New Ethiopian Music 2021 (Official Video) by Nahom Records Inc 11 months ago 5 minutes, 26 seconds 25,942 views",Nahom Records,25942,25996,54
3161,"Woretaw Wubet - Yegojamwa Konjo - ወረታው ውበት - የጎጃሟ ቆንጆ - Ethiopian Music by Nahom Records Inc 11 months ago 5 minutes, 5 seconds 15,638 views",Nahom Records,15638,15797,159
3162,"Maritu and Shambel - Akalie Wubie - ማሪቱ እና ሻምበል - አካሌ ውቤ - Ethiopian Music by Nahom Records Inc 11 months ago 4 minutes, 17 seconds 57,913 views",Nahom Records,57913,58775,862
3163,"Eyayu Bele - Bati Bati - እያዩ በሌ - ባቲ ባቲ - Ethiopian Music by Nahom Records Inc 11 months ago 5 minutes, 8 seconds 14,878 views",Nahom Records,14878,15050,172
3164,"Birtukan Dubale - Dera New - ብርቱካን ዱባለ - ደራ ነው - Ethiopian Music by Nahom Records Inc 11 months ago 4 minutes, 25 seconds 18,534 views",Nahom Records,18534,18665,131
3165,"Chalachew Ashenafi & Birtukan Dubale - Endet Neh - እንዴት ነህ - Ethiopian Music by Nahom Records Inc 11 months ago 7 minutes, 23 seconds 44,203 views",Nahom Records,44203,44477,274
3166,"Getu Omahire - Yebichaye - ጌቱ ኦማሂሬ - የብቻዬ - Ethiopian Music by Nahom Records Inc 11 months ago 4 minutes, 59 seconds 41,126 views",Nahom Records,41126,42317,1191
3167,"Ethiopian Music: Fikadu Tizazu - Siyade - ፍቃዱ ትዛዙ - ሲያዴ - New Ethiopian Music 2021 (Official Video) by Nahom Records Inc 11 months ago 4 minutes, 17 seconds 144,586 views",Nahom Records,144586,146056,1470
3168,"Ujulu - Siqora - ኡጁሉ - ሲቆራ - New Ethiopian Music 2021 (Official Video) by Nahom Records Inc 11 months ago 4 minutes, 35 seconds 16,360 views",Nahom Records,16360,16530,170
3169,"Chalachew Ashenafi - Ehehe - ቻላቸው አሸናፊ - እህህ - Ethiopian Traditional Music by Nahom Records Inc 1 year ago 5 minutes, 50 seconds 57,838 views",Nahom Records,57838,58970,1132
3170,"Nebiyu Natan - Nafaki - ነብዩ ናታን - ናፋቂ - New Ethiopian Music 2021 (Official Video) by Nahom Records Inc 1 year ago 5 minutes, 14 seconds 14,944 views",Nahom Records,14944,14957,13
3171,"Addis Gurmesa - Fikir Bezebezen - አዲስ ጉርሜሳ - ፍቅር በዘበዘኝ - New Ethiopian Music by Nahom Records Inc 1 year ago 4 minutes, 15 seconds 10,911 views",Nahom Records,10911,10997,86
3172,"Gedion Daneal -Tiruat Beka - ጌዲዮን ዳንኤል- ጥሯት በቃ Ethiopian Music 2021 by Nahom Records Inc 1 year ago 4 minutes, 38 seconds 18,020 views",Nahom Records,18020,18167,147
3173,"Abel Mulugeta - Atikelid Behager - አቤል ሙሉጌታ - አትቀልድ በሃገር - New Ethiopian Music 2021(Official Video) by Nahom Records Inc 1 year ago 5 minutes, 36 seconds 222,327 views",Nahom Records,222327,222683,356
3174,"Girma Gemechu - Yimarkal - ግርማ ገመቹ - ይማርካል - Ethiopian Music by Nahom Records Inc 1 year ago 6 minutes, 18 seconds 8,573 views",Nahom Records,8573,8595,22
3175,"Yigzaw Belay - Zich Warch - ይግዛው በላይ - ዝጭ ውርጭ - New Ethiopian Music 2021 (Official Video) by Nahom Records Inc 1 year ago 5 minutes, 19 seconds 158,443 views",Nahom Records,158443,159601,1158
3176,"Gedion Daniel - Enie Alferam - ጌድዮን ዳንኤል - እኔ አልፈራም - Ethiopian Music by Nahom Records Inc 1 year ago 5 minutes, 55 seconds 24,497 views",Nahom Records,24497,24762,265
3177,"Tiblet Tekeste ft. Jino Awilo - Gamba - ጋምባ - New Sidamic Music 2021 (Official Video) by Nahom Records Inc 1 year ago 4 minutes, 36 seconds 12,418 views",Nahom Records,12418,12550,132
3178,"Eskedar Amsalu - Alawkim - እስከዳር አምሣሉ - አላውቅም - Ethiopian Music by Nahom Records Inc 1 year ago 5 minutes, 26 seconds 6,638 views",Nahom Records,6638,6659,21
3179,"Hewan Gebrewold - Nana - ሔዋን ገብረወልድ - ናና - New Ethiopian Music 2021 (Official Video) by Nahom Records Inc 1 year ago 3 minutes, 54 seconds 2,808,218 views",Nahom Records,2808218,2828373,20155
3180,"Amanuel Yemane - Adilatni - አማኑኤል የማን - ዓዲላትኒ - New Ethiopian Music 2021 (Official Video) by Nahom Records Inc 1 year ago 4 minutes, 41 seconds 4,163,274 views",Nahom Records,4163274,4212545,49271
3181,"yehun - Lyu Lyu - ይሁን - ልዩ ልዩ - New Ethiopian Music 2021 (Official Video) by Nahom Records Inc 1 year ago 3 minutes, 39 seconds 413,663 views",Nahom Records,413663,414805,1142
3182,"Meseret Demere - Yane Lay - መሠረት ደመረ - ያኔ ላይ - New Ethiopian Music 2021 (Official Video) by Nahom Records Inc 1 year ago 5 minutes, 8 seconds 45,140 views",Nahom Records,45140,45207,67
3183,"Maritu Legesse - Akale wube - ማሪቱ ለገሠ - አካሌ ውቤ - Ethiopian Music by Nahom Records Inc 1 year ago 5 minutes, 8 seconds 21,006 views",Nahom Records,21006,21383,377
3184,"Abinet Agonafir - Metach Lenie Bila - አብነት አጎናፍር - መጣች ለኔ ብላ - Ethiopian Music by Nahom Records Inc 1 year ago 4 minutes, 32 seconds 129,275 views",Nahom Records,129275,139174,9899
3185,"Gete Aniley - Gete Gojam - ጌቴ አንለይ - ጌቴ ጎጃም - New Ethiopian Music 2021 (Official Video) by Nahom Records Inc 1 year ago 6 minutes, 33 seconds 484,185 views",Nahom Records,484185,486805,2620
3186,"Addis Gurmesa - Chilen Malef Tiru - አዲስ ጉርሜሳ - ችለን ማለፍ ጥሩ - New Ethiopia Music 2021 by Nahom Records Inc 1 year ago 4 minutes, 47 seconds 19,456 views",Nahom Records,19456,19904,448
3187,"Hewan Legese - Wey Merkato - ሔዋን ለገሠ - ወይ መርካቶ - New Ethiopian Music 2021 (Official Video) by Nahom Records Inc 1 year ago 5 minutes, 32 seconds 94,858 views",Nahom Records,94858,95099,241
3188,"Girma Gemechu - Hanna - ግርማ ገመቹ - ሃና - Ethiopian Music by Nahom Records Inc 1 year ago 5 minutes, 23 seconds 6,284 views",Nahom Records,6284,6313,29
3189,"Ahimed Teshome -  Kurt Yategbal - አህመድ ተሾመ - ቁርጥ ያጠግባል - Ethiopian music 2021 by Nahom Records Inc 1 year ago 5 minutes, 19 seconds 15,967 views",Nahom Records,15967,16015,48
3190,"Cha Cha Sami - Agegnehu Fata (Enshoshila) - አገኘሁ ፋታ - New Ethiopian Music 2021 (Official Video) by Nahom Records Inc 1 year ago 6 minutes, 3 seconds 112,012 views",Nahom Records,112012,112295,283
3191,"Tamirat Desta - Rak kalew - ታምራት ደስታ - ራቅ ካለው - Ethiopian Music by Nahom Records Inc 1 year ago 5 minutes, 1 second 60,978 views",Nahom Records,60978,62141,1163
3192,"Fasil Demoz - Temesgen - ፋሲል ደሞዝ - ተመስገን - Ethiopian Music by Nahom Records Inc 1 year ago 4 minutes, 51 seconds 2,605 views",Nahom Records,2605,2616,11
3193,"Fitsum Tesfaye - Nigeregn - ፍፁም ተስፋዬ - ንገረኝ - New Ethiopian Music 2021 (Official Video) by Nahom Records Inc 1 year ago 5 minutes, 12 seconds 120,647 views",Nahom Records,120647,120825,178
3194,"Birtukan Dubale - Bati - ብርቱካን ዱባለ - ባቲ - Ethiopian Music by Nahom Records Inc 1 year ago 4 minutes, 48 seconds 29,836 views",Nahom Records,29836,30150,314
3195,"Tsehaye Yohannes - Tiru Ken - ፀሐዬ ዮሃንስ - ጥሩ ቀን - Ethiopian Music by Nahom Records Inc 1 year ago 5 minutes, 45 seconds 93,192 views",Nahom Records,93192,94447,1255
3196,"Henok Yitagesu - Hewane - ሔኖክ ይታገሡ - ሔዋኔ - New Ethiopian Music 2021 (Official Video) by Nahom Records Inc 1 year ago 4 minutes, 25 seconds 74,573 views",Nahom Records,74573,75356,783
3197,"Tsegaye Eshetu - Abay Negade - ፀጋዬ እሸቱ - አባይ ነጋዴ - Ethiopian Music by Nahom Records Inc 1 year ago 4 minutes, 16 seconds 11,699 views",Nahom Records,11699,11993,294
3198,"Addis Gurmesa - Talak chilota New - አዲስ ጉርሜሳ - ታላቅ ችሎታ ነው - New Ethiopian Music 2021 by Nahom Records Inc 1 year ago 4 minutes, 7 seconds 11,040 views",Nahom Records,11040,11083,43
3199,"Neway Debebe - Siwedush Eweki - ነዋይ ደበበ - ሲወዱሽ እወቂ - Ethiopian Music by Nahom Records Inc 1 year ago 7 minutes, 30 seconds 1,476,036 views",Nahom Records,1476036,1507043,31007
3200,"Damtew Ayele - Gojam Azene - ዳምጠው አየለ - ጎጃም አዘነ - Ethiopian Music by Nahom Records Inc 1 year ago 7 minutes, 7 seconds 22,590 views",Nahom Records,22590,22879,289
3201,"Millen Hailu - Tezekiruni - ሚለን ኃይሉ - ተዘኪሩኒ - New Eritrean Music 2021 (Official Video) by Nahom Records Inc 1 year ago 5 minutes, 30 seconds 3,677,950 views",Nahom Records,3677950,3704425,26475
3202,"Abinet Agonafir - yezaren - አብነት አጎናፍር - የዛሬን - Ethiopian Music by Nahom Records Inc 1 year ago 7 minutes, 3 seconds 110,891 views",Nahom Records,110891,112220,1329
3203,"Girma Tefera Kassa - Tilagn Eko Hedech - ግርማ ተፈራ ካሳ - ጥላኝ እኮ ሔደች - Ethiopian Music by Nahom Records Inc 1 year ago 3 minutes, 37 seconds 112,560 views",Nahom Records,112560,113009,449
3204,"Tigist Afework - Zeblider - ትግስት አፈወርቅ - ዘብልደር - Ethiopian Music by Nahom Records Inc 1 year ago 5 minutes, 59 seconds 22,720 views",Nahom Records,22720,23049,329
3205,"Tibebu Workye - Min Arekulish - ጥበቡ ወርቅዬ - ምን አረኩልሽ - Ethiopian Music by Nahom Records Inc 1 year ago 3 minutes, 57 seconds 16,758 views",Nahom Records,16758,16863,105
3206,"Ahimed Teshome - Echilalehu - አህመድ ተሾመ (ዲምቢ) - እችላለሁ - New Ethiopian Music 2021 by Nahom Records Inc 1 year ago 5 minutes, 11 seconds 30,058 views",Nahom Records,30058,30168,110
3207,"Amsal Mitike - Meshmonmon - አምሣለ ምትኬ - መሽሞንሞን - Ethiopian Music by Nahom Records Inc 1 year ago 5 minutes, 3 seconds 269,080 views",Nahom Records,269080,271908,2828
3208,"Elias T/Haymanot - Gum Gum - ኤልያስ ተ/ሃይማኖት - ጉም ጉም - New Ethiopian Music 2021 (Official Video) by Nahom Records Inc 1 year ago 4 minutes, 42 seconds 303,309 views",Nahom Records,303309,303717,408
3209,"Gete Aniley - Anchi Tebabreshal - ጌቴ አንለይ - አንቺ ተባብረሻል - Ethiopian Music by Nahom Records Inc 1 year ago 4 minutes, 48 seconds 13,069 views",Nahom Records,13069,13108,39
3210,"Hana Mitike - Kezih Hulu - ሀና ምትኬ - ከዚህ ሁሉ - New Ethiopian Music 2021 (Official Video) by Nahom Records Inc 1 year ago 4 minutes, 58 seconds 39,742 views",Nahom Records,39742,39853,111
3211,"Robel Mideksa - Tizitachin - ሮቤል ሚደቅሳ ( ዝናር ዜማ ) - ትዝታችን - New Ethiopian Music 2021 (Official Video) by Nahom Records Inc 1 year ago 4 minutes, 37 seconds 47,711 views",Nahom Records,47711,50300,2589
3212,"Ephrem Tamiru - Salasibew - ኤፍሬም ታምሩ - ሳላስበው - Ethiopian music by Nahom Records Inc 1 year ago 7 minutes, 19 seconds 282,889 views",Nahom Records,282889,289566,6677
3213,"Fasil Demoz - Hmim - ፋሲል ደሞዝ - ህምም - New Ethiopian Music 2021 (Official Video) by Nahom Records Inc 1 year ago 8 minutes, 31 seconds 1,996,451 views",Nahom Records,1996451,2008254,11803
3214,"Bizuayehu Demissie - Alinagerim - ብዙአየሁ ደምሴ - አልናገርም - Ethiopian Music by Nahom Records Inc 1 year ago 4 minutes, 3 seconds 36,020 views",Nahom Records,36020,36883,863
3215,"Demelash Niguse (Deme Lula) & Helen Tesfaye - Akale |አካሌ| New Ethiopian Music 2021 (Official Video) by Nahom Records Inc 1 year ago 5 minutes, 17 seconds 257,019 views",Nahom Records,257019,257613,594
3216,"Addis Gurmesa - Mela Tistegn - አዲስ ጉርሜሳ - መላ ትስጠኝ - Ethiopian Music by Nahom Records Inc 1 year ago 3 minutes, 50 seconds 30,854 views",Nahom Records,30854,31818,964
3217,"Solomon Haile - Ziriri - ሠለሞን ኃይሌ - ዚሪሪ - Ethiopian Music by Nahom Records Inc 1 year ago 5 minutes, 35 seconds 55,566 views",Nahom Records,55566,56570,1004
3218,"Tamirat Desta - Lemnie - ታምራት ደስታ - ለምኔ - Ethiopian music by Nahom Records Inc 1 year ago 4 minutes, 34 seconds 43,696 views",Nahom Records,43696,43760,64
3219,"Andupa Teshome - አንዱፓ ተሾመ - Yedmaye- Ethiopian Music by Nahom Records Inc 1 year ago 4 minutes, 52 seconds 11,179 views",Nahom Records,11179,11218,39
3220,"Seyoum Moges - Alchilim Keto - ስዩም ሞገስ - አልችልም ከቶ - Ethiopian Music by Nahom Records Inc 1 year ago 5 minutes, 36 seconds 23,328 views",Nahom Records,23328,23404,76
3221,"Tewodros Mosisa - Ye Gorebet Lij - ቴዎድሮስ ሞሲሳ - የጎረቤት ልጅ - Ethiopian Music by Nahom Records Inc 1 year ago 5 minutes, 14 seconds 35,256 views",Nahom Records,35256,36184,928
3222,"Hanan Abdu - Arkebas - ሀናን አብዱ - አርከባስ - New Ethiopian Music 2021 (Official Video) by Nahom Records Inc 1 year ago 7 minutes, 3 seconds 2,717,610 views",Nahom Records,2717610,2751125,33515
3223,"Skat Nati - Kuru - ስካት ናቲ - ኩሩ - New Ethiopian Music 2021 (Official Video) by Nahom Records Inc 1 year ago 4 minutes, 20 seconds 829,248 views",Nahom Records,829248,831573,2325
3224,"Bitsat Seyum - Basresagn - ብፅአት ስዩም - ባስረሳኝ - Ethiopian Music by Nahom Records Inc 1 year ago 6 minutes, 30 seconds 361,126 views",Nahom Records,361126,365630,4504
3225,"Samuel Mengistu & Helen Dejene - Tenefafekin - ሳሙኤል መንግስቱ - ሄለን ደጀኔ - ተነፋፈቅን - Ethiopian Music by Nahom Records Inc 1 year ago 4 minutes, 52 seconds 7,325 views",Nahom Records,7325,7353,28
3226,"Mesfin shiferaw - Ambasel - መስፍን ሽፈራው - አምባሠል - Ethiopian Music by Nahom Records Inc 1 year ago 5 minutes 11,718 views",Nahom Records,11718,11885,167
3227,"Genene Haile - Jalele - ገነነ ኃይሌ - ጃለሌ - Ethiopian Music by Nahom Records Inc 1 year ago 4 minutes, 27 seconds 4,910 views",Nahom Records,4910,4965,55
3228,"Hibist Tiruneh - Enamralen - ህብስት ጥሩነህ - እናምራለን - New Ethiopian Music 2021 (Official Video) by Nahom Records Inc 1 year ago 6 minutes 361,612 views",Nahom Records,361612,363605,1993
3229,"Bizuayehu Demissie and Jossy Gebre - Ferahuwat - ብዙአየሁ ደምሴ እና ጆሲ ገብሬ - ፈራኋት - Ethiopian Music by Nahom Records Inc 1 year ago 5 minutes, 5 seconds 24,632 views",Nahom Records,24632,24670,38
3230,"Tigist Fantahun - Mot Adeladlo - ትግስት ፋንታሁን - ሞት አደላድሎ - Ethiopian Music by Nahom Records Inc 1 year ago 5 minutes, 58 seconds 176,840 views",Nahom Records,176840,177538,698
3231,"Haileyesus feysa - Yazilgn Ketero (Askotu)  - ኃይለየሱስ ፈይሳ  - ያዥልኝ ቀጠሮ (አስኮቱ) - Ethiopian Music by Nahom Records Inc 1 year ago 6 minutes, 32 seconds 964,089 views",Nahom Records,964089,985451,21362
3232,"Endashaw kelemewerk & Etenesh wasie - Yene Alem - እንደሻው ቀለመወርቅና እቴነሽ ዋሴ - የኔ አለም - Ethiopian Music by Nahom Records Inc 1 year ago 4 minutes, 42 seconds 6,651 views",Nahom Records,6651,6687,36
3233,"Nati Haile - Lijinetwa - ናቲ ኃይሌ - ልጅነቷ - Ethiopian Music by Nahom Records Inc 1 year ago 5 minutes, 29 seconds 30,403 views",Nahom Records,30403,31011,608
3234,"Tsegaye Eshetu - Yeayne Abeba - ፀጋዬ እሸቱ - የአይኔ አበባ - Ethiopian Music by Nahom Records Inc 1 year ago 4 minutes, 35 seconds 47,836 views",Nahom Records,47836,49226,1390
3235,"Ephrem Tamiru - Konjo Lij Nesh - ኤፍሬም ታምሩ - ቆንጆ ልጅ ነሽ - Ethiopian Music by Nahom Records Inc 1 year ago 6 minutes, 13 seconds 193,524 views",Nahom Records,193524,203383,9859
3236,"Theodros Mitiku - Yewbet Emebet - ቴዎድሮስ ምትኩ - የውበት እመቤት - Ethiopian Instrumental Music by Nahom Records Inc 1 year ago 8 minutes, 32 seconds 6,556 views",Nahom Records,6556,6631,75
3237,"Ashenafi Geremew - Endalay - አሸናፊ ገረመው - እንዳላይ - New Ethiopian Music 2020 (Official video) by Nahom Records Inc 1 year ago 6 minutes, 45 seconds 319,231 views",Nahom Records,319231,320095,864
3238,"Abinet Agonafir - Lijen - አብነት አጎናፍር - ልጄን - Ethiopian Music by Nahom Records Inc 1 year ago 4 minutes, 20 seconds 95,321 views",Nahom Records,95321,98511,3190
3239,"Ahimed Teshome - Yezinabu Mata - አህመድ ተሾመ - የዝናቡ ማታ - New Ethiopian Music 2020 by Nahom Records Inc 1 year ago 6 minutes, 4 seconds 19,791 views",Nahom Records,19791,19817,26
3240,"Yohanes Girma - Enja - ዮሐንስ ግርማ - እንጃ - New Ethiopian Music 2020 (Official Video) by Nahom Records Inc 1 year ago 4 minutes, 8 seconds 128,250 views",Nahom Records,128250,128533,283
3241,"Hailu Fereja - Awey Lale Wuye - ኃይሉ ፈረጃ - አወይ ላሌ ውየ - Ethiopian Music by Nahom Records Inc 1 year ago 5 minutes, 38 seconds 23,228 views",Nahom Records,23228,23573,345
3242,"Andinet Sisay - Enkwan Marshign - አንድነት ሲሳይ - እንኳን ማርሽኝ - New Ethiopian Music 2020 (Official Video) by Nahom Records Inc 1 year ago 4 minutes, 29 seconds 26,013 views",Nahom Records,26013,26049,36
3243,"Yosef Bekele - Aselamu Alaykum - ዮሴፍ በቀለ - አሠላም አለይኩም - Ethiopian Music by Nahom Records Inc 1 year ago 5 minutes, 38 seconds 3,365 views",Nahom Records,3365,3394,29
3244,"Nati Haile - And Beyign - ናቲ ኃይሌ - አንድ በይኝ - Ethiopian music by Nahom Records Inc 1 year ago 5 minutes, 51 seconds 58,584 views",Nahom Records,58584,59700,1116
3245,"Haleluya Tekletsadik - Tetefafan - ሃሌሉያ ተክለጻዲቅ - ተጠፋፋን - New Ethiopian Music 2020 (Official Video) by Nahom Records Inc 1 year ago 5 minutes, 53 seconds 1,174,479 views",Nahom Records,1174479,1176935,2456
3246,"Tigist Afework - Anchi Hoye - ትግስትአፈወርቅ - አንቺ ሆዬ - Ethiopian Music by Nahom Records Inc 1 year ago 7 minutes, 1 second 17,468 views",Nahom Records,17468,17643,175
3247,"Bezawit zeleke - Lelitu Alnega Alegn - ቤዛዊት ዘለቀ - ሌሊቱ አልነጋ አለኝ - Ethiopian Music by Nahom Records Inc 1 year ago 5 minutes, 46 seconds 20,607 views",Nahom Records,20607,20684,77
3248,"Hibist Tiruneh - Temechitognal - ህብስት ጥሩነህ - ተመችቶኛል - Ethiopian Music by Nahom Records Inc 1 year ago 5 minutes, 13 seconds 58,147 views",Nahom Records,58147,58707,560
3249,"Honey Spice - Atgotitegn - ሃኒ ስፓይስ - አትጎትተኝ - New Ethiopian Music 2020 (Official Video) by Nahom Records Inc 1 year ago 4 minutes, 21 seconds 91,954 views",Nahom Records,91954,92222,268
3250,"Nati Haile - Ethiopia Mushiraye - ናቲ ኃይሌ - ኢትዮጵያ ሙሽራዬ - Ethiopian Music by Nahom Records Inc 1 year ago 5 minutes, 23 seconds 5,810 views",Nahom Records,5810,5842,32
3251,"Birhanu Tezera & Madingo Afework - Selam Yager Sew - ሠላም ያገር ሠው - Ethiopian Music by Nahom Records Inc 1 year ago 7 minutes, 15 seconds 14,332 views",Nahom Records,14332,14580,248
3252,"Tigist Afework - Min Yilegnal - ትግስት አፈወርቅ- ምን ይለኛል - Ethiopian Music by Nahom Records Inc 1 year ago 5 minutes, 35 seconds 18,285 views",Nahom Records,18285,18493,208
3253,"Amsale Mitike - Babajalew - አምሣለ ምትኬ - ባባጃሌው - Ethiopian Music by Nahom Records Inc 1 year ago 5 minutes, 54 seconds 12,908 views",Nahom Records,12908,13250,342
3254,"Bizuayehu Demissie - Yenie Tizita - ብዙአየሁ ደምሴ - የኔ ትዝታ - Ethiopian Music by Nahom Records Inc 1 year ago 6 minutes, 50 seconds 80,277 views",Nahom Records,80277,81205,928
3255,"Yohana - Kasat - ዮሐና - ካሣት - New Ethiopian Music 2020 (Official Video) by Nahom Records Inc 1 year ago 3 minutes, 44 seconds 2,000,212 views",Nahom Records,2000212,2011962,11750
3256,"Abeba Desalegn - Cher Werie - አበባ ደሣለኝ - ቸር ወሬ - Ethiopian music by Nahom Records Inc 1 year ago 4 minutes, 54 seconds 20,365 views",Nahom Records,20365,20485,120
3257,"Shewandagn Hailu - Enkuwan Tefetersh - ሸዋንዳኝ ኃይሉ - እንኳን ተፈጠርሽ - Ethiopian music by Nahom Records Inc 1 year ago 5 minutes, 41 seconds 14,459 views",Nahom Records,14459,14660,201
3258,"Birtukan Dubale - Enatien Adera - ብርቱካን ዱባለ - እናቴን አደራ - Ethiopian Music by Nahom Records Inc 1 year ago 4 minutes, 31 seconds 31,396 views",Nahom Records,31396,31745,349
3259,"Senait Tadesse - Kurfiyah - ሰናይት ታደሠ - ኩርፍያህ - New Ethiopian Music 2020 (Official Video) by Nahom Records Inc 1 year ago 5 minutes, 33 seconds 21,199 views",Nahom Records,21199,21262,63
3260,"Abinet Agonafir - Bay Bay - አብነት አጎናፍር - ባይ ባይ - Ethiopian Music by Nahom Records Inc 1 year ago 5 minutes, 44 seconds 131,371 views",Nahom Records,131371,137079,5708
3261,"Ephrem Tamiru - Metadel New - ኤፍሬም ታምሩ - መታደል ነው - Ethiopian Music by Nahom Records Inc 1 year ago 5 minutes, 41 seconds 525,635 views",Nahom Records,525635,549492,23857
3262,"Mikaya Behailu - Yene New - ሚካያ በኃይሉ - የኔ ነው - Ethiopian Music by Nahom Records Inc 1 year ago 3 minutes, 53 seconds 12,527 views",Nahom Records,12527,12742,215
3263,"Bisrat Garedew - Bawaj - ብስራት ጋረደው - ባዋጅ - Ethiopian Music by Nahom Records Inc 1 year ago 6 minutes, 43 seconds 10,026 views",Nahom Records,10026,10099,73
3264,"Girma Tefera - Metadelie - ግርማ ተፈራ - መታደሌ - Ethiopian Music by Nahom Records Inc 1 year ago 5 minutes, 34 seconds 26,756 views",Nahom Records,26756,27116,360
3265,"Ahimed Teshome - Banda Nesh - አህመድ ተሾመ - ባንዳ ነሽ - New Ethiopian Music 2020 by Nahom Records Inc 1 year ago 5 minutes, 18 seconds 109,960 views",Nahom Records,109960,110273,313
3266,"Fikiraddis Nekatibeb - Leul Aswededegn - ፍቅርአዲስ ነቃጥበብ - ልዑል አስወደደኝ - Ethiopian Music by Nahom Records Inc 1 year ago 5 minutes, 53 seconds 16,355 views",Nahom Records,16355,16684,329
3267,"Gete Aniley and Ziggy Zaga - Guba - ጉባ - New ethiopian Music 2020 (Official Video) by Nahom Records Inc 1 year ago 4 minutes, 43 seconds 97,550 views",Nahom Records,97550,97626,76
3268,"Addis Gurmessa - Yegeter Lomi - አዲስ ጉርሜሳ - የገጠር ሎሚ - New Ethiopian Music 2020 by Nahom Records Inc 1 year ago 4 minutes, 45 seconds 23,429 views",Nahom Records,23429,23868,439
3269,"Amsale Mitike - Alchalkum Lezare - አምሣለ ምትኬ - አልቻልኩም ለዛሬ - Ethiopian Music by Nahom Records Inc 1 year ago 5 minutes, 22 seconds 261,616 views",Nahom Records,261616,266755,5139
3270,"Tsehaye Yohannes - Yenieta - ፀሐዬ ዮሃንስ - የኔታ - Ethiopian Music by Nahom Records Inc 1 year ago 5 minutes, 36 seconds 9,392 views",Nahom Records,9392,9522,130
3271,"Hibist Tiruneh - Sebastopol - ህብስት ጥሩነህ - ሴባስቶፖል- Ethiopian Music by Nahom Records Inc 1 year ago 6 minutes, 5 seconds 71,561 views",Nahom Records,71561,71738,177
3272,"Abeba Desalegn - Yelehubetim  - አበባ ደሳለኝ - የለሁበትም - Ethiopian Music by Nahom Records Inc 1 year ago 4 minutes, 57 seconds 82,792 views",Nahom Records,82792,85275,2483
3273,"Girma Tefera - Zimitaye - ግርማ ተፈራ - ዝምታዬ - Ethiopian Music by Nahom Records Inc 1 year ago 5 minutes, 23 seconds 87,978 views",Nahom Records,87978,88407,429
3274,"Bizuayehu Demissie - Yehilme Nigist - ብዙአየሁ ደምሴ - የህልሜ ንግስት - Ethiopian Music by Nahom Records Inc 1 year ago 4 minutes, 58 seconds 649,375 views",Nahom Records,649375,665206,15831
3275,"Fasil Demoz - Bahirdar Tegegne - ፋሲል ደሞዝ - ባህርዳር ተገኘ  - Ethiopian Music by Nahom Records Inc 1 year ago 5 minutes, 5 seconds 72,019 views",Nahom Records,72019,72199,180
3276,"Neway Debebe - Ayaya - ነዋይ ደበበ - አያያ - Ethiopian Music by Nahom Records Inc 1 year ago 5 minutes, 18 seconds 10,908 views",Nahom Records,10908,12516,1608
3277,"Abinet Agonafir - Hager - አብነት አጎናፍር - ሐገር - Ethiopian Music by Nahom Records Inc 1 year ago 5 minutes, 13 seconds 21,090 views",Nahom Records,21090,21128,38
3278,"Theodros Mitiku - Turin Firi - ቴዎድሮስ ምትኩ - ጡርን ፍሪ - Ethiopian Instrumental Music by Nahom Records Inc 1 year ago 5 minutes, 37 seconds 5,725 views",Nahom Records,5725,5752,27
3279,"Maritu Legesse - Shemonmuwane - ማሪቱ ለገሠ - ሸሞንሟኔ - Ethiopian Music by Nahom Records Inc 1 year ago 5 minutes, 37 seconds 24,301 views",Nahom Records,24301,24536,235
3280,"Amsale Mitike - Lalo Bel - አምሣለ ምትኬ - ላሎ በል - Ethiopian Music by Nahom Records Inc 1 year ago 5 minutes, 44 seconds 27,764 views",Nahom Records,27764,28621,857
3281,"Tsegaye Eshetu - Sendekalama - ፀጋዬ እሸቱ - ሰንደቅአላማ - Ethiopian Music by Nahom Records Inc 1 year ago 5 minutes, 27 seconds 7,931 views",Nahom Records,7931,8066,135
3282,"Neway Debebe - Teteyaki Wass - ነዋይ ደበበ - ተጠያቂ ዋስ - Ethiopian Music by Nahom Records Inc 1 year ago 5 minutes, 43 seconds 34,967 views",Nahom Records,34967,35520,553
3283,"Ahimed Teshome - Zim Biye - አህመድ ተሾመ - ዝም ብዬ - New Ethiopian Music 2020 by Nahom Records Inc 1 year ago 4 minutes, 17 seconds 9,186 views",Nahom Records,9186,9204,18
3284,"Theodros Mitiku - Ambasel - ቴዎድሮስ ምትኩ - አምባሠል - Ethiopian Music by Nahom Records Inc 1 year ago 7 minutes, 31 seconds 4,813 views",Nahom Records,4813,4857,44
3285,"Binny Lastta - Menor Alemenor - ቢኒ ላስታ - መኖር አለመኖር - New Ethiopian Music 2020 (Official Video) by Nahom Records Inc 1 year ago 5 minutes, 7 seconds 24,227 views",Nahom Records,24227,24246,19
3286,"Genene Haile - Fikrie Hoy - ገነነ ኃይሌ - ፍቅሬ ሆይ - Ethiopian Music by Nahom Records Inc 1 year ago 4 minutes, 12 seconds 45,952 views",Nahom Records,45952,46549,597
3287,"Deme Lula - Enka Bey Enka - እንካ በይ እንካ - Ethiopian music 2020 by Nahom Records Inc 1 year ago 5 minutes, 29 seconds 4,431 views",Nahom Records,4431,4433,2
3288,"Theodros Mitiku - Begil Enena Anchi - በግል እኔና አንቺ - Ethiopian Instrumental Music by Nahom Records Inc 1 year ago 6 minutes, 35 seconds 5,004 views",Nahom Records,5004,5026,22
3289,"Nahom Records Inc. ናሆም ሬከርድስ by Nahom Records Inc 1 year ago 38 seconds 17,694 views",Nahom Records,17694,17711,17
3290,"Tibebu Workyie | Lenie Alasibim | ጥበቡ ወርቅዬ | ለኔ አላስብም | Ethiopian Music by Nahom Records Inc 1 year ago 4 minutes, 54 seconds 7,346 views",Nahom Records,7346,7390,44
3291,"Bisrat Garedew - Salamnibet - ብስራት ጋረደው - ሳላምንበት - Ethiopian Music by Nahom Records Inc 1 year ago 5 minutes, 20 seconds 21,290 views",Nahom Records,21290,21958,668
3292,"Tsehaye Yohannes - Ferahu  - ፀሃዬ ዮሃንስ - ፈራሁ - Ethiopian Music by Nahom Records Inc 1 year ago 4 minutes, 27 seconds 118,137 views",Nahom Records,118137,119629,1492
3293,"Kassahun Eshetu - Aned | አንድ | New Ethiopian Music 2020 (Official Video) by Nahom Records Inc 1 year ago 6 minutes, 2 seconds 47,146 views",Nahom Records,47146,47325,179
3294,"Ahimed Teshome - Enkilfen Telahut - አህመድ ተሾመ - እንቅልፌን ጠላሁት - New Ethiopian Music 2020 by Nahom Records Inc 1 year ago 6 minutes, 29 seconds 12,166 views",Nahom Records,12166,12221,55
3295,"Mikiyas Nigussie (Miki Lala) - Liwal |ልዋል| New Ethiopian Music 2020 (Official Video) by Nahom Records Inc 1 year ago 4 minutes, 28 seconds 307,239 views",Nahom Records,307239,308079,840
3296,"Dawit Alemayehu - Were Negari -  ዳዊት አለማየሁ - ወሬ ነጋሪ - New Ethiopian Music 2020 (Official Video) by Nahom Records Inc 1 year ago 4 minutes, 23 seconds 239,338 views",Nahom Records,239338,239696,358
3297,"Hibist Tiruneh - Wef Saynchacha - ህብስት ጥሩነህ - ወፍ ሳይንጫጫ  - Ethiopian Music by Nahom Records Inc 1 year ago 4 minutes, 47 seconds 47,522 views",Nahom Records,47522,52636,5114
3298,"Ephrem Tamiru - Kim Alyzim Banchi - ኤፍሬም ታምሩ - ቂም አልይዝም ባንቺ - Ethiopian Music by Nahom Records Inc 1 year ago 5 minutes, 43 seconds 285,742 views",Nahom Records,285742,306178,20436
3299,"Addis Gurmessa - Tizitaye - አዲስ ጉርሜሳ - ትዝታዬ - Ethiopian Music 2020 by Nahom Records Inc 1 year ago 7 minutes, 8 seconds 28,376 views",Nahom Records,28376,29086,710
3300,"Neway Debebe - Egnaw Enitarek - ነዋይ ደበበ - እኛው እንታረቅ - Ethiopian Music by Nahom Records Inc 1 year ago 5 minutes, 10 seconds 48,291 views",Nahom Records,48291,49667,1376
3301,"Girma tefera - Beniena Esua -  ግርማ ተፈራ - በኔና እሷ - Ethiopian Music by Nahom Records Inc 1 year ago 5 minutes, 9 seconds 36,454 views",Nahom Records,36454,37765,1311
3302,"Deme Lula - Tila - ደሜ ሉላ - ጥላ - Ethiopian Music 2020 by Nahom Records Inc 1 year ago 4 minutes 3,840 views",Nahom Records,3840,3845,5
3303,"Bizuayehu Demissie - Shegie - ብዙአየሁ ደምሴ - ሸጌ - Ethiopian Music by Nahom Records Inc 1 year ago 4 minutes, 42 seconds 56,256 views",Nahom Records,56256,58052,1796
3304,"Ephrem Tamiru - Negresh Nebere - ኤፍሬም ታምሩ - ነግሬሽ ነበረ - Ethiopian Music by Nahom Records Inc 1 year ago 6 minutes, 27 seconds 926,624 views",Nahom Records,926624,948703,22079
3305,"Kasahun Legese - Endih Nen - እንዲህ ነን -  New Ethiopian Music 2020 ( Official Video) by Nahom Records Inc 1 year ago 5 minutes, 12 seconds 16,662 views",Nahom Records,16662,16698,36
3306,"Abinet Agonafir - Smign - አብነት አጎናፍር - ስሚኝ - Ethiopian Music by Nahom Records Inc 1 year ago 6 minutes, 1 second 138,022 views",Nahom Records,138022,138665,643
3307,"Tamirat Desta - Siwedat - ታምራት ደስታ - ስወዳት - Ethiopian Music by Nahom Records Inc 1 year ago 4 minutes, 32 seconds 25,089 views",Nahom Records,25089,25221,132
3308,"Ahimed Teshome - Sem Kush Kam - አህመድ ተሾመ - ሴም ኩሽ ካም - New Ethiopian Music 2020 by Nahom Records Inc 1 year ago 5 minutes, 7 seconds 49,286 views",Nahom Records,49286,49312,26
3309,"Addis Gurmessa - Alemyie - አዲስ ጉርሜሳ አለምዬ - New Ethiopian Music 2020 by Nahom Records Inc 1 year ago 4 minutes, 55 seconds 10,428 views",Nahom Records,10428,10564,136
3310,"Ashenafi Geremew - Malo - አሸናፊ ገረመው - ማሎ - New Ethiopian Music 2020 (Official Video) by Nahom Records Inc 1 year ago 6 minutes, 32 seconds 103,964 views",Nahom Records,103964,104221,257
3311,"EFI - ኮ ft BUZE MAN - Seada | ሰዓዳ | - New Ethiopian Music 2020 (Official Video) by Nahom Records Inc 1 year ago 4 minutes, 38 seconds 87,635 views",Nahom Records,87635,88057,422
3312,"Tsegaye Eshtu - Abay Negade - ፀጋዬ እሸቱ - አባይ ነጋዴ - Ethiopian Music by Nahom Records Inc 1 year ago 4 minutes, 17 seconds 6,528 views",Nahom Records,6528,6560,32
3313,"Maritu Legesse - Wegenie - ማሪቱ ለገሠ - ወገኔ - Ethiopian Music by Nahom Records Inc 1 year ago 5 minutes, 5 seconds 7,997 views",Nahom Records,7997,8031,34
3314,"Samon Haile - Tetahize | ተታሒዘ - New Ethiopian Tigrigna music 2020 (Official Video) by Nahom Records Inc 1 year ago 4 minutes, 6 seconds 1,227,753 views",Nahom Records,1227753,1230813,3060
3315,"Hibist Tiruneh - Ababagn - ህብስት ጥሩነህ - አባባኝ - Ethiopian Music by Nahom Records Inc 1 year ago 6 minutes, 6 seconds 24,837 views",Nahom Records,24837,25011,174
3316,"Fikiraddis Nekatibeb - Meragn Yzo  - ፍቅርአዲስ ነቃጥበብ - መራኝ ይዞ - Ethiopian Music by Nahom Records Inc 1 year ago 5 minutes, 52 seconds 13,616 views",Nahom Records,13616,13804,188
3317,"Tamirat Desta - Fikir Serash - ታምራት ደስታ - ፍቅር ሠራሽ -Ethiopian Music by Nahom Records Inc 1 year ago 5 minutes, 10 seconds 27,082 views",Nahom Records,27082,27209,127
3318,"Ahimed Teshome - Gin Eferalehu - አህመድ ተሾመ - ግን እፈራለሁ - New Ethiopian Music 2020 by Nahom Records Inc 1 year ago 5 minutes, 18 seconds 34,031 views",Nahom Records,34031,34070,39
3319,"Esayas Tamirat - Ewnet Alegn - ኢሳያስ ታምራት - እውነት አለኝ - New Ethiopian Music 2020 (official Video) by Nahom Records Inc 1 year ago 5 minutes 569,116 views",Nahom Records,569116,570402,1286
3320,"Ahimed Teshome - Saltegbat - አህመድ ተሾመ - ሳልጠግባት - Ethiopian Music by Nahom Records Inc 1 year ago 4 minutes, 46 seconds 64,328 views",Nahom Records,64328,64443,115
3321,"Tsegaye Eshetu - Tekelekele Alu - ጸጋዬ እሸቱ - ተከለከለ አሉ - Ethiopian Music by Nahom Records Inc 1 year ago 5 minutes, 19 seconds 60,123 views",Nahom Records,60123,61497,1374
3322,"Hayleyesus Feyssa - Barsiisaa - በርሲሳ - New ethiopian Music 2020 (Official video) by Nahom Records Inc 1 year ago 6 minutes, 5 seconds 621,781 views",Nahom Records,621781,624116,2335
3323,"Emebet Negasi - Atimal - እመቤት ነጋሲ - አትማል - New Ethiopian Music 2020 (Official Video) by Nahom Records Inc 1 year ago 5 minutes, 43 seconds 691,577 views",Nahom Records,691577,693727,2150
3324,"Madingo Afework - Man Endenie - ማዲንጎ አፈወርቅ - ማን እንደኔ - Ethiopian Music by Nahom Records Inc 1 year ago 4 minutes, 37 seconds 80,090 views",Nahom Records,80090,80999,909
3325,"Fasil Demoz - Yemata Enjera - ፋሲል ደሞዝ - የማታ እንጀራ - Ethiopian music by Nahom Records Inc 1 year ago 6 minutes, 8 seconds 20,312 views",Nahom Records,20312,20383,71
3326,"Ahimed Teshome - Sher besayclu - አህመድ ተሾመ - ሽር በሳይክሉ - Ethiopian Music by Nahom Records Inc 1 year ago 5 minutes, 30 seconds 70,168 views",Nahom Records,70168,70251,83
3327,"Lemlem Hailemichael - Lalibela - ለምለም ኃ/ሚካኤል - ላሊበላ - New Ethiopian Music 2020 (Official Video) by Nahom Records Inc 1 year ago 5 minutes, 21 seconds 7,496,404 views",Nahom Records,7496404,7530545,34141
3328,"Tsegaye Eshetu - Zemnanit - ፀጋዬ እሸቱ - ዘምናኒት - Ethiopian Music by Nahom Records Inc 1 year ago 5 minutes, 43 seconds 229,051 views",Nahom Records,229051,239346,10295
3329,"Neway Debebe - Ye fikir Emebet - ነዋይ ደበበ - የፍቅር እመቤት - Ethiopian Music by Nahom Records Inc 1 year ago 5 minutes, 3 seconds 71,928 views",Nahom Records,71928,73803,1875
3330,"Hibist Tiruneh - Ysalal Bayne - ህብስት ጥሩነህ - ይሳላል ባይኔ - Ethiopian Music by Nahom Records Inc 1 year ago 5 minutes, 47 seconds 196,475 views",Nahom Records,196475,197650,1175
3331,"Addis Gurmessa - Wubetina Kunjinash - አዲስ ጉርሜሳ - ውበትና ቁንጅናሽ - Ethiopian Music by Nahom Records Inc 1 year ago 4 minutes, 1 second 50,273 views",Nahom Records,50273,51194,921
3332,"Bisrat Garedew - Salayat - ብስራት ጋረደው - ሳላያት - Ethiopian Music by Nahom Records Inc 1 year ago 6 minutes, 4 seconds 262,750 views",Nahom Records,262750,264456,1706
3333,"Maritu Legesse - Ambasel - ማሪቱ ለገሠ - አምባሠል - Ethiopian Music by Nahom Records Inc 1 year ago 7 minutes, 35 seconds 89,311 views",Nahom Records,89311,91394,2083
3334,"Ashenafi Geremew - Ziyadaye - አሸናፊ ገረመው - ዝያዳዬ - New Ethiopian Music 2020 (Official Video) by Nahom Records Inc 1 year ago 5 minutes, 11 seconds 1,406,115 views",Nahom Records,1406115,1416427,10312
3335,"Fikiraddis Nekatibeb - Tesemagn Tirunba - ፍቅር አዲስ ነቃጥበብ - ተሠማኝ ጥሩንባ - Ethiopian Music by Nahom Records Inc 1 year ago 6 minutes, 24 seconds 92,059 views",Nahom Records,92059,93220,1161
3336,"Ahimed Teshome - menem - አህመድ ተሾመ - ምንም - New Ethiopian Music 2020 by Nahom Records Inc 1 year ago 5 minutes, 32 seconds 191,175 views",Nahom Records,191175,191372,197
3337,"Addis Gurmesa - Alebign Wuletash - አዲስ ጉርሜሳ - አለብኝ ውለታሽ - New Ethiopian Music 2020 by Nahom Records Inc 1 year ago 5 minutes, 25 seconds 22,124 views",Nahom Records,22124,22458,334
3338,"Aregahegn Worash - Be Adisu Amet - አረጋኸኝ ወራሽ - በአዲሱ አመት - New Ethiopian Music 2020 (Official Video) by Nahom Records Inc 1 year ago 5 minutes, 57 seconds 569,290 views",Nahom Records,569290,572589,3299
3339,"Deme Lula -  Eyoha - ደሜ ሉላ - እዮሃ - Ethiopian Music by Nahom Records Inc 1 year ago 4 minutes, 38 seconds 4,591 views",Nahom Records,4591,4595,4
3340,"Abinet Agonafir - Ho Biye Metahu - አብነት አጎናፍር - ሆ ብዬ መጣሁ - New Ethiopian Music 2020 (Official Video) by Nahom Records Inc 1 year ago 6 minutes, 4 seconds 1,600,288 views",Nahom Records,1600288,1603976,3688
3341,"Chuchu (Tsegaw Teklu) - Betsedey - ቹቹ (ፀጋው ተክሉ) - በፀደይ - New Ethiopian Music 2020 (Official Video) by Nahom Records Inc 1 year ago 5 minutes, 5 seconds 36,870 views",Nahom Records,36870,36945,75
3342,"Bizuayehu Demissie - Eyayehuwat - ብዙአየሁ ደምሴ - እያየኋት- Ethiopian Music by Nahom Records Inc 1 year ago 3 minutes, 57 seconds 51,948 views",Nahom Records,51948,52449,501
3343,"FikirAddis Nekatibeb - Blo Blo - ፍቅርአዲስ ነቃጥበብ - ብሎ ብሎ Ethiopian Music by Nahom Records Inc 1 year ago 4 minutes, 54 seconds 80,480 views",Nahom Records,80480,80761,281
3344,"Ahimed Teshome - Ajaeb - አህመድ ተሾመ - አጃኢብ - Ethiopian Music 2020 by Nahom Records Inc 1 year ago 4 minutes, 47 seconds 35,793 views",Nahom Records,35793,35839,46
3345,"Deme Lula - Libe - ደሜ ሉላ - ልቤ - Ethiopian Music by Nahom Records Inc 1 year ago 5 minutes, 18 seconds 3,353 views",Nahom Records,3353,3357,4
3346,"Frehiwot Tizazu - Astawesegn - ፍሬህይወት ትዛዙ - አስታወሰኝ - New Ethiopian Music 2020 (Official Video) by Nahom Records Inc 1 year ago 5 minutes, 52 seconds 2,628,816 views",Nahom Records,2628816,2662003,33187
3347,"Neway Debebe - Lalkedash Kal Alebign - ነዋይ ደበበ - ላልከዳሽ ቃል አለብኝ - Ethiopian Music by Nahom Records Inc 1 year ago 5 minutes, 19 seconds 59,612 views",Nahom Records,59612,62508,2896
3348,"Addis Gurmesa - Mare gela - አዲስ ጉርሜሳ - ማሬ ገላ -  New Ethiopian Music 2020 by Nahom Records Inc 1 year ago 4 minutes, 46 seconds 16,900 views",Nahom Records,16900,17079,179
3349,"Girum Tamirat - Addis Ababa - ግሩም ታምራት - አዲስ አበባ - New Ethiopian Music 2020 (Official Video) by Nahom Records Inc 1 year ago 3 minutes, 44 seconds 50,404 views",Nahom Records,50404,50506,102
3350,"Tsehaye Yohannes - Metashilign - ፀሐዬ ዮሐንስ - መጣሽልኝ - Ethiopian Music by Nahom Records Inc 1 year ago 4 minutes, 41 seconds 46,814 views",Nahom Records,46814,47238,424
3351,"Madingo Afework - Bekagn - ማዲንጎ አፈወርቅ - በቃኝ - Ethiopian Music by Nahom Records Inc 1 year ago 5 minutes, 11 seconds 313,570 views",Nahom Records,313570,315976,2406
3352,"Abinet Agonafir  - Yetri Dewel - አብነት አጎናፍር - የጥሪ ደወል - New Ethiopian Music 2020 (Official Video) by Nahom Records Inc 1 year ago 4 minutes, 59 seconds 258,883 views",Nahom Records,258883,259118,235
3353,"Maki Kb - Behilme New - ማኪ ኬቢ - በህልሜ ነው - New Ethiopian Music 2020 (Official Video) by Nahom Records Inc 1 year ago 4 minutes, 21 seconds 554,778 views",Nahom Records,554778,566270,11492
3354,"Bizuayehu Demissie - kedamawit - ብዙአየሁ ደምሴ - ቀዳማዊት -Ethiopian Music by Nahom Records Inc 1 year ago 5 minutes, 3 seconds 14,353 views",Nahom Records,14353,14456,103
3355,"Madingo Afework - Mognu Libe - ማዲንጎ አፈወርቅ - ሞኙ ልቤ - Ethiopian Music by Nahom Records Inc 1 year ago 6 minutes, 12 seconds 117,081 views",Nahom Records,117081,117786,705
3356,"Sami Addis - Rase Liwdedish - ሳሚ አዲስ - ራሴ ልውደድሽ - New Ethiopian Music 2020 (Official Video) by Nahom Records Inc 1 year ago 4 minutes, 19 seconds 8,629 views",Nahom Records,8629,8700,71
3357,"Kassahun Taye - Megala - ካሳሁን ታዬ - መጋላ - Ethiopian Music by Nahom Records Inc 1 year ago 5 minutes, 57 seconds 10,501 views",Nahom Records,10501,10594,93
3358,"Tsehaye Yohannes - Betesfa - ፀሐዬ ዮሃንስ - በተስፋ - Ethiopian Music by Nahom Records Inc 1 year ago 5 minutes, 3 seconds 140,577 views",Nahom Records,140577,142875,2298
3359,"Abrham Weldu - Hibni - አብርሃም ወልዱ - ሂብኒ - New Ethiopian Tigrigna Music 2020 (Official Video) by Nahom Records Inc 1 year ago 4 minutes, 41 seconds 21,613 views",Nahom Records,21613,21710,97
3360,"Haggos G/Hiwot - Yhimnelo - ሃጎስ ገ/ህይወት - ይሃመነሎ - Ethiopian Tigrigna music by Nahom Records Inc 1 year ago 8 minutes, 15 seconds 13,616 views",Nahom Records,13616,13786,170
3361,"Neway Debebe - Wuletash Alebign - ነዋይ ደበበ - ውለታሽ አለብኝ - Ethiopian Music by Nahom Records Inc 1 year ago 4 minutes, 34 seconds 124,482 views",Nahom Records,124482,129858,5376
3362,"Fikremaryam Gebru - Kebad New - ፍቅረማርያም ገብሩ - ከባድ ነው - New Ethiopian Music 2020 (Official Video) by Nahom Records Inc 1 year ago 4 minutes, 41 seconds 94,915 views",Nahom Records,94915,95092,177
3363,"Girma Tefera Kassa - Man Neber - ግርማ ተፈራ ካሳ - ማን ነበር - Ethiopian Music by Nahom Records Inc 1 year ago 5 minutes, 6 seconds 17,679 views",Nahom Records,17679,17978,299
3364,"EK Mule  -  Ek ሙሌ - አበባው ከንፈሯ - New Ethiopian Music 2020 (Official Video) by Nahom Records Inc 1 year ago 3 minutes, 59 seconds 5,810 views",Nahom Records,5810,5834,24
3365,"Ephrem Tamiru - Lanchi Yansibishal - ኤፍሬም ታምሩ - ላንቺ ያንስብሻል - Ethiopian Music by Nahom Records Inc 1 year ago 6 minutes, 2 seconds 243,643 views",Nahom Records,243643,249641,5998
3366,"Bizuayehu Demissie - Eskewediyaw - ብዙአየሁ ደምሴ - እስከወዲያው - Ethiopian Music by Nahom Records Inc 1 year ago 6 minutes, 44 seconds 83,078 views",Nahom Records,83078,83733,655
3367,"Zerabruk Semaw - Athopbia - ዘርአብሩክ ሰማው - ኤትኦጵብያ - New Ethiopian music 2020 (Official Video) by Nahom Records Inc 1 year ago 6 minutes, 12 seconds 6,776 views",Nahom Records,6776,6784,8
3368,"Tamirat Desta - Keza Sefer - ታምራት ደስታ - ከዛ ሰፈር - Ethiopian Music by Nahom Records Inc 1 year ago 5 minutes, 21 seconds 10,290 views",Nahom Records,10290,10434,144
3369,"Fikiraddis Nekatibeb - And Sew - ፍቅርአዲስ - ነቃጥበብ - አንድ ሰው Ethiopian Music by Nahom Records Inc 1 year ago 8 minutes, 10 seconds 1,636,721 views",Nahom Records,1636721,1652458,15737
3370,"Maritu Legesse - Weleba - ማሪቱ ለገሠ - ወለባ - Ethiopian Music by Nahom Records Inc 1 year ago 4 minutes, 46 seconds 59,376 views",Nahom Records,59376,60385,1009
3371,"Andupa Teshome - Abay Sime Bizu - አንዱፓ ተሾመ - አባይ ስመ ብዙ - New Ethiopian music 2020 (Official Video) by Nahom Records Inc 1 year ago 5 minutes, 24 seconds 26,298 views",Nahom Records,26298,26336,38
3372,"Neway Debebe - Yalefku Endehon Banchi Mender - ነዋይ ደበበ - ያለፍኩ እንደሆን ባንቺ መንደር - Ethiopian Music by Nahom Records Inc 1 year ago 5 minutes, 20 seconds 166,899 views",Nahom Records,166899,179456,12557
3373,"Nebyu Solomon - Hulum Tiru Yhonal - ነብዩ ሰለሞን - ሁሉም ጥሩ ይሆናል - New Ethiopian music 2020 by Nahom Records Inc 1 year ago 5 minutes, 19 seconds 7,953 views",Nahom Records,7953,7970,17
3374,"Azalech Abate - leyelet - አዛለች አባተ - ለየለት - Ethiopian Music by Nahom Records Inc 1 year ago 5 minutes, 3 seconds 5,462 views",Nahom Records,5462,5471,9
3375,"Hibist Tiruneh - Min Ale Libih - ህብስት ጥሩነህ - ምን አለ ልብህ - Ethiopian Music by Nahom Records Inc 1 year ago 4 minutes, 50 seconds 71,418 views",Nahom Records,71418,72195,777
3376,"Fitsum Abere - Dewel - ፍጹም አበረ - ደወል - New Ethiopian music 2020 (Official Video) by Nahom Records Inc 1 year ago 6 minutes, 45 seconds 22,388 views",Nahom Records,22388,22430,42
3377,"Genene Haile - Singebegebilat - ገነነ ኃይሌ - ስንገበገብላት- Ethiopian Music by Nahom Records Inc 1 year ago 5 minutes, 51 seconds 114,999 views",Nahom Records,114999,116590,1591
3378,"Abinet Agonafir - chuh Chuh - አብነት አጎናፍር - ጩህ ጩህ - Ethiopian Music by Nahom Records Inc 1 year ago 6 minutes, 10 seconds 347,715 views",Nahom Records,347715,354282,6567
3379,"Haleluya Tekletsadik - Kantegar - ሃሌሉያ ተክለጻዲቅ - ካንተ ጋር - New Ethiopian music 2020 (Official Video) by Nahom Records Inc 1 year ago 4 minutes, 41 seconds 2,286,593 views",Nahom Records,2286593,2292203,5610
3380,"Tibebu Workyie - Anchima - ጥበቡ ወርቅዬ - አንቺማ - Ethiopian Music by Nahom Records Inc 1 year ago 5 minutes, 36 seconds 42,727 views",Nahom Records,42727,43156,429
3381,"Ephrem Tamiru - Mulu Gojam - ኤፍሬም ታምሩ - ሙሉ ጎጃም - Ethiopian Music by Nahom Records Inc 1 year ago 7 minutes, 7 seconds 998,189 views",Nahom Records,998189,1005847,7658
3382,"Hibist Tiruneh - Bota sitegn - ህብስት ጥሩነህ - ቦታ ስጠኝ - Ethiopian Music by Nahom Records Inc 1 year ago 5 minutes, 43 seconds 128,743 views",Nahom Records,128743,128967,224
3383,"Deme lula - Gidie new - ደሜ ሉላ -  ግዴ ነው - Ethiopian Music by Nahom Records Inc 1 year ago 5 minutes, 54 seconds 5,935 views",Nahom Records,5935,5945,10
3384,"Shewandagn hailu - Yekirtashin - ሸዋንዳኝ ሃይሉ - ይቅርታሽን -Ethiopian Music by Nahom Records Inc 1 year ago 5 minutes, 23 seconds 12,019 views",Nahom Records,12019,12159,140
3385,"Girma Tefera Kassa - Yemiwedilat - ግርማ ተፈራ ካሳ - የምወድላት - Ethiopian Music by Nahom Records Inc 1 year ago 4 minutes, 52 seconds 78,679 views",Nahom Records,78679,78984,305
3386,"KB Macha - Leleye - ኬቢ ማቻ - ለለዬ - New Ethiopian Tigrigna music 2020 (Official Video) by Nahom Records Inc 1 year ago 5 minutes, 20 seconds 22,222 views",Nahom Records,22222,22402,180
3387,"Yeshi Demelash - Ayarmegn - የሺ ደመላሽ - አያርመኝ - New Ethiopian music 2020 (Official Video) by Nahom Records Inc 1 year ago 6 minutes, 22 seconds 705,556 views",Nahom Records,705556,707189,1633
3388,"Andupa Teshome - Abay Sime Bizu - አንዱፓ ተሾመ - አባይ ስመ ብዙ - New Ethiopian music 2020 (With Lyrics) by Nahom Records Inc 1 year ago 5 minutes, 13 seconds 71,899 views",Nahom Records,71899,71979,80
3389,"Abeba Desalegn - Mayet kentu - አበባ ደሳለኝ - ማየት ከንቱ - Ethiopian Music by Nahom Records Inc 1 year ago 5 minutes, 48 seconds 231,846 views",Nahom Records,231846,232869,1023
3390,"Netsanet Melkamu - Sitikorama - ነጻነት መልካሙ - ስትኮራማ - New Ethiopian Music 2020 (Official Video) by Nahom Records Inc 1 year ago 4 minutes, 29 seconds 12,810 views",Nahom Records,12810,12878,68
3391,"Gete Aniley - Bewishet Ewket Tibeb - ጌቴ አንለይ - በውሸት እውቀት እውነት - Ethiopian Music by Nahom Records Inc 1 year ago 6 minutes, 30 seconds 5,417 views",Nahom Records,5417,5461,44
3392,"Neway Debebe - Hagere Nat Habte - ነዋይ ደበበ - ሐገሬ ናት ሐብቴ - Ethiopian music by Nahom Records Inc 1 year ago 5 minutes, 34 seconds 101,314 views",Nahom Records,101314,102772,1458
3393,"Deme Lula - Tinkish Gela - ደሜ ሉላ - ጥንቅሽ ገላ - Ethiopian Music 2020 by Nahom Records Inc 1 year ago 5 minutes, 20 seconds 4,687 views",Nahom Records,4687,4697,10
3394,"Sami Beyene - Endanchi New Mewded - ሳሚ በየነ - እንዳንቺ ነው መውደድ - New Ethiopian Music by Nahom Records Inc 1 year ago 5 minutes, 2 seconds 116,845 views",Nahom Records,116845,117668,823
3395,"Deme Lula - Ethiopia - ደሜ ሉላ - ኢትዮጵያ - New Ethioapian music 2020 by Nahom Records Inc 1 year ago 5 minutes, 19 seconds 5,475 views",Nahom Records,5475,5488,13
3396,"Zeraberuk Semaw - Temuagache - ዘርዓብሩክ ሰማው - ተሟጋቼ - New Ethiopian Music 2020 (Official Video) by Nahom Records Inc 1 year ago 4 minutes, 32 seconds 13,000 views",Nahom Records,13000,13030,30
3397,"Abreham Nigatu - Ahade Biye - አብርሀም ንጋቱ (አቡ) - አሃደ ብዬ - New Ethiopian Music 2020 (official Video) by Nahom Records Inc 1 year ago 5 minutes, 9 seconds 8,663 views",Nahom Records,8663,8680,17
3398,"Madingo Afework - Godanaw - ማዲንጎ አፈወርቅ - ጎዳናው - Ethiopian Music by Nahom Records Inc 1 year ago 5 minutes, 22 seconds 447,573 views",Nahom Records,447573,454057,6484
3399,"Gezachew Solomon-  Menafiki Gerkley - ግዛቸው ሰለሞን -መናፊቂ ጌርክለይ - New Ethiopian tigrnga Music Video 2020 by Nahom Records Inc 1 year ago 5 minutes, 44 seconds 185,062 views",Nahom Records,185062,185360,298
3400,"Sam Yerom - Min Agebagn - ሳም የሮም -  ምን አገባኝ - New Ethiopian Music 2020 (Official Video) by Nahom Records Inc 1 year ago 3 minutes, 58 seconds 6,338 views",Nahom Records,6338,6361,23
3401,"Deme Lula - Minjar - ደሜ ሉላ - ምንጃር - New Ethiopian Music 2020 by Nahom Records Inc 1 year ago 4 minutes, 52 seconds 13,680 views",Nahom Records,13680,13986,306
3402,"Ephrem Tamiru - Meshe Dehina Ederu - ኤፍሬም ታምሩ - መሸ ደህና እደሩ - Etjiopian Music by Nahom Records Inc 1 year ago 5 minutes, 25 seconds 557,838 views",Nahom Records,557838,561683,3845
3403,"Zemas - Te Genzeb - ዜማስ - ተ ገንዘብ - New Ethiopian Music 2020 (Official Video) by Nahom Records Inc 1 year ago 4 minutes, 21 seconds 109,275 views",Nahom Records,109275,109829,554
3404,"Tibebu Workiye - Alanchi Alnorim - አላንቺ አልኖርም - Ethiopian Music by Nahom Records Inc 1 year ago 5 minutes, 5 seconds 96,556 views",Nahom Records,96556,97570,1014
3405,"Birtukan Dubale - Eda - ብርቱካን ዱባለ - እዳ - Ethiopian Music by Nahom Records Inc 1 year ago 6 minutes, 19 seconds 7,592 views",Nahom Records,7592,7625,33
3406,"Hewan Gebrewold - Keminew - ሄዋን ገብረወልድ - ከምኔው - New Ethiopian Music 2020 (Official Video) by Nahom Records Inc 1 year ago 4 minutes, 58 seconds 7,576,709 views",Nahom Records,7576709,7622346,45637
3407,"Kuri Leme - Nalign - ኩሪ ለሜ - ናልኝ - New Ethiopian Music 2020 (Official Video) by Nahom Records Inc 1 year ago 4 minutes, 37 seconds 18,523 views",Nahom Records,18523,18531,8
3408,"Ethiopian Music - Tamirat Desta - Hakime Nesh - ታምራት ደስታ - ሀኪሜ ነሽ by Nahom Records Inc 1 year ago 5 minutes 302,298 views",Nahom Records,302298,304048,1750
3409,"Smizz Mayle - Anchin Bicha - አንቺን ብቻ - New Ethiopian Music 2020 (Official Video) by Nahom Records Inc 1 year ago 3 minutes, 49 seconds 5,419 views",Nahom Records,5419,5438,19
3410,"Kiros Alemayehu - Gezana - ኪሮስ አለማየሁ - ገዛና - Ethiopian Music by Nahom Records Inc 1 year ago 6 minutes, 1 second 11,589 views",Nahom Records,11589,11773,184
3411,"Madingo Afework - Wisejat - ማዲንጎ አፈወርቅ - ውሰጃት - Ethiopian Music by Nahom Records Inc 1 year ago 5 minutes, 21 seconds 878,741 views",Nahom Records,878741,888330,9589
3412,"Frehiwot Yimam - Korakora - ፍሬህይወት ይማም - ኮራኮራ - New Ethiopian Music 2020 (Official Video) by Nahom Records Inc 1 year ago 3 minutes, 51 seconds 35,333 views",Nahom Records,35333,35425,92
3413,"Fikiraddis Nekatibeb - Almotim - ፍቅርአዲስ ነቃጥበብ - አልሞትም - Ethiopian Music by Nahom Records Inc 1 year ago 5 minutes, 31 seconds 69,743 views",Nahom Records,69743,70007,264
3414,"Gizachew Teshome - Bati - ግዛቸው ተሾመ - ባቲ - Ethiopian Music by Nahom Records Inc 1 year ago 5 minutes, 52 seconds 113,821 views",Nahom Records,113821,114541,720
3415,"Girum Widu - Enidemamet - እንደማመጥ - New Ethiopian Music 2020 (Official Video) by Nahom Records Inc 1 year ago 7 minutes, 13 seconds 109,569 views",Nahom Records,109569,109683,114
3416,"Henok Abebe - Kifu atinageri - ክፉ አትናገሪ - Ethiopian Music by Nahom Records Inc 1 year ago 4 minutes, 30 seconds 17,590 views",Nahom Records,17590,18057,467
3417,"Gete Aniley - Yeqey Tiqur Teyim - ጌቴ አንለይ - የቀይ ጥቁር ጠይም - Ethiopian Music by Nahom Records Inc 1 year ago 5 minutes, 48 seconds 7,504 views",Nahom Records,7504,7538,34
3418,"Kibret Hagos - Tizita Ena Nafkot - ክብረት ሀጎስ - ትዝታና ናፍቆት - Ethiopian Music 2020 (Official Video) by Nahom Records Inc 1 year ago 4 minutes, 47 seconds 8,875 views",Nahom Records,8875,8894,19
3419,"Endeshaw Kelemework and Etenesh Wasse - Ambasel - Ethiopian Music by Nahom Records Inc 1 year ago 5 minutes, 30 seconds 5,452 views",Nahom Records,5452,5469,17
3420,"Shewandagn Hailu - Zeraf - ሸዋንዳኝ ሀይሉ - ዘራፍ - Ethiopian Music by Nahom Records Inc 1 year ago 5 minutes, 8 seconds 8,857 views",Nahom Records,8857,8890,33
3421,"Abeba Desalegn - Fikir Malet - አበባ ደሳለኝ - ፍቅር ማለት - Ethiopian Music by Nahom Records Inc 1 year ago 4 minutes, 26 seconds 302,956 views",Nahom Records,302956,303952,996
3422,"Abreham  Belayneh (Shalaye) - Amen - አብርሐም በላይነህ( ሻላዬ) - አሜን - New Music 2020 (Official Video) by Nahom Records Inc 1 year ago 5 minutes, 7 seconds 182,316 views",Nahom Records,182316,182793,477
3423,"Tamirat Desta - Enichawet - Ethiopian Music by Nahom Records Inc 1 year ago 4 minutes, 41 seconds 11,792 views",Nahom Records,11792,11910,118
3424,"Kiros Alemayehu - Selam Hawa - ሠላም ሃዋ - Ethiopian Music by Nahom Records Inc 1 year ago 5 minutes, 47 seconds 52,918 views",Nahom Records,52918,53779,861
3425,"Sinishaw Muleta - Goota Koo - ስንሻው ሙለታ - ጎተ ኮ - New Ethiopian Oromogna Music 2020 (Official Video) by Nahom Records Inc 1 year ago 6 minutes, 56 seconds 2,625,069 views",Nahom Records,2625069,2648380,23311
3426,"Halim Abdurahiman - Yene tesfa - ሐሊማ አብዱራህማን - የኔ ተስፋ - Ethiopian Music by Nahom Records Inc 1 year ago 5 minutes, 9 seconds 6,035 views",Nahom Records,6035,6055,20
3427,"Madingo Afework - Yelome Yelome - ማዲንጎ አፈወርቅ - የሎሜ የሎሜ - Ethiopian Music by Nahom Records Inc 1 year ago 5 minutes, 27 seconds 97,043 views",Nahom Records,97043,97628,585
3428,"Alula Shekne - Dabu - አሉላ ሸቅኔ - ዳቡ - New Ethiopian Music 2020 (Official Video) by Nahom Records Inc 1 year ago 4 minutes, 45 seconds 11,934 views",Nahom Records,11934,11957,23
3429,"Hailu Amerga - konjo - ቆንጆ - Ethiopian Music by Nahom Records Inc 1 year ago 4 minutes, 12 seconds 154,336 views",Nahom Records,154336,155638,1302
3430,"Leul Hailu - Addis Alem - ልዑል ኃይሉ - አዲስ አለም - New Ethiopian Music 2020 (Official Video) by Nahom Records Inc 1 year ago 3 minutes, 59 seconds 23,348 views",Nahom Records,23348,23582,234
3431,"Tamirat Desta - Meche Selechegn Alku - ታምራት ደስታ - መቼ ሠለቸኝ አልኩ - Ethiopian Music by Nahom Records Inc 1 year ago 4 minutes, 19 seconds 63,186 views",Nahom Records,63186,63441,255
3432,"Gete Aniley - Salhon Weretegna - ጌቴ አንለይ - ሳልሆን ወረተኛ - Ethiopian Music by Nahom Records Inc 1 year ago 6 minutes, 55 seconds 24,330 views",Nahom Records,24330,24442,112
3433,"Zemach(Zack & Habtish) - Marakiye - ዘማች (ዛክና ሐብትሽ) - ማራኪዬ - New Music Video 2020 by Nahom Records Inc 1 year ago 4 minutes, 10 seconds 22,355 views",Nahom Records,22355,22473,118
3434,"Sayat Demissie - Tew Maneh - ሳያት ደምሴ - ተው ማነህ - Ethiopian Music by Nahom Records Inc 1 year ago 4 minutes, 14 seconds 18,165 views",Nahom Records,18165,18414,249
3435,"Tamirat Desta - Sew Mekrosh - ታምራት ደስታ - ሠው መክሮሽ - Ethiopian Music by Nahom Records Inc 1 year ago 4 minutes, 59 seconds 15,459 views",Nahom Records,15459,15580,121
3436,"Mehari Birhanehiwot - Yefikir Abeba - መሐሪ ብርሃነህይወት - የፍቅር አበባ - New Ethiopian Music 2020 by Nahom Records Inc 1 year ago 6 minutes, 25 seconds 92,668 views",Nahom Records,92668,92793,125
3437,"Tigist Afework - Asayew Mengedun - ትግስት አፈወርቅ - Ethiopian Music by Nahom Records Inc 1 year ago 5 minutes, 32 seconds 5,652 views",Nahom Records,5652,5736,84
3438,"Fikiraddis Nekatibeb - Belew - ፍቅርአዲስ ነቃጥበብ - በለው - Ethiopian Music by Nahom Records Inc 1 year ago 4 minutes, 8 seconds 66,289 views",Nahom Records,66289,66392,103
3439,"Shewandagn hailu - Sitisik Say - ሸዋንዳኝ ኃይሉ - ስትስቅ ሳይ - Ethiopian Music by Nahom Records Inc 1 year ago 4 minutes, 39 seconds 6,484 views",Nahom Records,6484,6556,72
3440,"Zema Ahadu - Ere Enat Hager - ዜማ አሐዱ - አረ እናት ሐገር - New Ethiopian Music 2020 (Official Video) by Nahom Records Inc 1 year ago 5 minutes, 32 seconds 8,411 views",Nahom Records,8411,8421,10
3441,"Tamirat Desta - Ahun Teredahut - ታምራት ደስታ - አሁን ተረዳሁት - Ethiopian Music by Nahom Records Inc 1 year ago 4 minutes, 59 seconds 40,031 views",Nahom Records,40031,40276,245
3442,"Abeba Desalegn - Hiywot Ende Shekla - አበባ ደሳለኝ - ሕይወት እንደሸክላ - Ethiopian Music by Nahom Records Inc 1 year ago 4 minutes, 48 seconds 208,505 views",Nahom Records,208505,210046,1541
3443,"Fasil Demoz - Bilikim - ፋሲል ደሞዝ - ብልክም - Ethiopian Music by Nahom Records Inc 1 year ago 5 minutes, 14 seconds 20,793 views",Nahom Records,20793,20859,66
3444,"Nahom Mekuria - Tey Minew - ናሆም መኩርያ - ተይ ምነው - New Ethiopian Music 2020 (Official Video) by Nahom Records Inc 1 year ago 4 minutes, 3 seconds 13,911 views",Nahom Records,13911,14051,140
3445,"Lali Habesha - Marefiyaye - ላሊ ሐበሻ - ማረፊያዬ - Ethiopian Music by Nahom Records Inc 1 year ago 5 minutes, 31 seconds 1,214 views",Nahom Records,1214,1224,10
3446,"Halima Abdurahiman - Melkam shito - ሐሊማ አብዱራህማን - መልካም ሽቶ - Ethiopian Music by Nahom Records Inc 1 year ago 5 minutes, 21 seconds 2,942 views",Nahom Records,2942,2957,15
3447,"Abel Almaz - Yesew Yaleh - አቤል አልማዝ - የሠው ያለህ - New Ethiopian Music 2020 (Official Video) by Nahom Records Inc 1 year ago 4 minutes, 18 seconds 18,724 views",Nahom Records,18724,18790,66
3448,"Tibebu Workiye - Dinget - ጥበቡ ወርቅዬ - ድንገት - Ethiopian Music by Nahom Records Inc 1 year ago 6 minutes, 23 seconds 23,578 views",Nahom Records,23578,23845,267
3449,"Antew Maren - አንተው ማረን - New Ethiopian Music 2020 (Official Video) by Nahom Records Inc 1 year ago 4 minutes, 37 seconds 20,982 views",Nahom Records,20982,20994,12
3450,"Shewandagn Hailu - Alinagerim - ሸዋንዳኝ ኃይሉ - አልናገርም - Ethiopian Music by Nahom Records Inc 1 year ago 3 minutes, 49 seconds 17,012 views",Nahom Records,17012,17285,273
3451,"Ephrem Gossaye - Ajajilo - ኤፍሬም ጎሳዬ - አጃጅሎ - New Ethiopian Music 2020 (Official Video) by Nahom Records Inc 1 year ago 5 minutes, 9 seconds 3,896 views",Nahom Records,3896,3910,14
3452,"Henok Abebe – Aynafikim Wey - ሔኖክ አበበ - አይናፍቅም ወይ - Ethiopian Music by Nahom Records Inc 1 year ago 5 minutes, 36 seconds 6,851 views",Nahom Records,6851,6945,94
3453,"FikirAddis Nekatibeb - Tey Silugn - ፍቅርአዲስ ነቃጥበብ - ተይ ሲሉኝ - Ethiopian Music by Nahom Records Inc 1 year ago 5 minutes, 39 seconds 64,702 views",Nahom Records,64702,64776,74
3454,"Amsale Mitike - Engida Negn - አምሳለ ምትኬ - እንግዳ ነኝ - Ethiopian Music by Nahom Records Inc 1 year ago 5 minutes, 25 seconds 11,020 views",Nahom Records,11020,11053,33
3455,"Hibist Tiruneh - Yanetes Neger Wedya - ህብስት ጥሩነህ - ያንተስ ነገር ወዲያ - Ethiopian Music by Nahom Records Inc 1 year ago 5 minutes, 55 seconds 46,714 views",Nahom Records,46714,48625,1911
3456,"Daniel W/gebriel - Dosew - ዳንኤል ወ/ገብርኤል - ዶሴው - Ethiopian Instrumental Music by Nahom Records Inc 1 year ago 6 minutes, 37 seconds 3,293 views",Nahom Records,3293,3318,25
3457,"Theodros Mitiku - Tegegnitwal - ቴዎድሮስ ምትኩ - ተገኝቷል - Ethiopian Instrumental Music by Nahom Records Inc 1 year ago 2 minutes, 21 seconds 1,481 views",Nahom Records,1481,1488,7
3458,"Dawit Ferew Hailu - Yewedede Abede - ዳዊት ፍሬው ኃይሉ - የወደደ አበደ - Ethiopian Instrumental Music by Nahom Records Inc 1 year ago 4 minutes, 49 seconds 4,505 views",Nahom Records,4505,4513,8
3459,"Daniel Masresha - May Lemine - ዳንኤል ማስረሻ - ማይ ለሚን - New Ethiopian Music 2020 (Official Music) by Nahom Records Inc 1 year ago 5 minutes, 6 seconds 19,999 views",Nahom Records,19999,20039,40
3460,"Daniel W/Gebriel - Yenat Wiletawan - ዳንኤል ወ/ገብርኤል - የእናት ውለታዋን - Ethiopian Instrumental Music by Nahom Records Inc 1 year ago 4 minutes, 43 seconds 2,177 views",Nahom Records,2177,2189,12
3461,"Chuchu (Tsegaw Teklu ) - Maren - ቹቹ (ፀጋው ተክሉ) - ማረን - New Ethiopian Music 2020 (Official Music) by Nahom Records Inc 1 year ago 3 minutes, 41 seconds 9,554 views",Nahom Records,9554,9562,8
3462,"Theodros Mitiku - Eshururu - ቴዎድሮስ ምትኩ - እሹሩሩ - Ethiopian Instrumental Music by Nahom Records Inc 1 year ago 6 minutes, 18 seconds 6,592 views",Nahom Records,6592,6605,13
3463,"Dawit Ferew Hailu - Kiber Temesgen - ዳዊት ፍሬው ኃይሉ - ክበር ተመስገን by Nahom Records Inc 1 year ago 4 minutes, 30 seconds 881 views",Nahom Records,881,892,11
3464,"Teshome Sisay - Andand Gize - ተሾመ ሲሳይ - አንዳንድ ጊዜ - Ethiopian Instrumental Music by Nahom Records Inc 1 year ago 4 minutes, 58 seconds 1,362 views",Nahom Records,1362,1367,5
3465,"Tigist Ejigu - Marign Biyeshalew - Ethiopian Instrumental Music by Nahom Records Inc 1 year ago 5 minutes, 46 seconds 861 views",Nahom Records,861,872,11
3466,"Tena | ጤና - New Ethiopian Music 2020 (Official Video) by Nahom Records Inc 1 year ago 5 minutes, 10 seconds 42,784 views",Nahom Records,42784,42862,78
3467,"Theodros Mitiku - Balegariw - Ethiopian Instrumental Music by Nahom Records Inc 1 year ago 6 minutes, 19 seconds 2,406 views",Nahom Records,2406,2433,27
3468,"Daniel W/Gebriel - Askotu - ዳንኤል ወ/ገብርኤል - አስኮቱ - Ethiopian Instrumental Music by Nahom Records Inc 1 year ago 5 minutes, 18 seconds 1,997 views",Nahom Records,1997,2016,19
3469,"Daniel W/Gebriel - Yhich Agatami - ዳንኤል ወ/ገብርኤል - ይህች አጋጣሚ - Ethiopian Instrumental Music by Nahom Records Inc 1 year ago 5 minutes, 10 seconds 1,132 views",Nahom Records,1132,1144,12
3470,"Dawit Ferew Hailu - Meleyayet Mot New - ዳዊት ፍሬው ኃይሉ - መለያየት ሞት ነው - Ethiopian Instrumental Music by Nahom Records Inc 1 year ago 5 minutes, 33 seconds 2,409 views",Nahom Records,2409,2426,17
3471,"Teshome Sisay – Min Bilesh Neber - ተሾመ ሲሳይ - ምን ብለሽ ነበር - Ethiopian Instrumental Music by Nahom Records Inc 1 year ago 4 minutes, 50 seconds 1,104 views",Nahom Records,1104,1113,9
3472,"Tigist Ejigu - Yene Fikir - ትግስት እጅጉ - የኔ ፍቅር - Ethiopian Instrumental Music by Nahom Records Inc 1 year ago 5 minutes, 20 seconds 1,257 views",Nahom Records,1257,1270,13
3473,"Daniel W/Gebriel - Derbaba - ዳንኤል ወ/ገብርኤል - ደርባባ - Ethiopian Instrumental Music by Nahom Records Inc 1 year ago 6 minutes, 39 seconds 1,451 views",Nahom Records,1451,1466,15
3474,"Dawit Ferew Hailu - Shegitu - ዳዊት ፍሬው ኃይሉ - ሸጊቱ - Ethiopian Instrumental Music by Nahom Records Inc 1 year ago 4 minutes, 6 seconds 1,544 views",Nahom Records,1544,1549,5
3475,"Teshome Sisay - Aychilim Anjete - ተሾመ ሲሳይ - አይችልም አንጀቴ - Ethiopian Instrumental Music by Nahom Records Inc 1 year ago 5 minutes, 35 seconds 1,283 views",Nahom Records,1283,1293,10
3476,"Daniel W/Gebriel - Yeserashign Bedel - ዳንኤል ወ/ገብርኤል - የሠራሽኝ በደል - Ethiopian Instrumental Music by Nahom Records Inc 1 year ago 5 minutes, 26 seconds 1,975 views",Nahom Records,1975,2008,33
3477,"Tigist Ejigu - Nafkote - ትግስት አእጅጉ - ናፍቆቴ - Ethiopian Instrumental Music by Nahom Records Inc 1 year ago 6 minutes, 52 seconds 1,218 views",Nahom Records,1218,1231,13
3478,"Dawit Ferew Hailu - Dagmegna Bifeter - ዳዊት ፍሬው ኃይሉ - ዳግመኛ ቢፈጠር - Ethiopian Instrumental Music by Nahom Records Inc 1 year ago 5 minutes, 9 seconds 3,363 views",Nahom Records,3363,3405,42
3479,"Teshome Sisay - Almaz - ተሾመ ሲሳይ - አልማዝ - Ethiopian Instrumental Music by Nahom Records Inc 1 year ago 5 minutes, 34 seconds 933 views",Nahom Records,933,939,6
3480,"Theodros Mitiku - Yeabay Wuha - ቴድሮስ ምትኩ - የአባይ ውሃ - Ethiopian Instrumental Music by Nahom Records Inc 1 year ago 6 minutes, 59 seconds 2,827 views",Nahom Records,2827,2849,22
3481,"Tigist Ejigu - Letidar - ትግስት እጅጉ - ለትዳር - Ethiopian Instrumental Music by Nahom Records Inc 1 year ago 6 minutes, 25 seconds 1,171 views",Nahom Records,1171,1180,9
3482,"Dawit Ferew Hailu - Ybekal Lewedaj - ዳዊት ፍሬው ሐይሉ - ይበቃል ለወዳጅ – Ethiopian Instrumental Music by Nahom Records Inc 1 year ago 5 minutes, 11 seconds 2,502 views",Nahom Records,2502,2509,7
3483,"Theodros Mitiku - Ene Wisheten New - ቴዎድሮስ ምትኩ - እኔ ውሸቴን ነው - Ethiopian Instrurmental Music by Nahom Records Inc 1 year ago 7 minutes, 57 seconds 7,006 views",Nahom Records,7006,7109,103
3484,"Dawit Ferew Hailu - Tila Kelelaye - ዳዊት ፍሬው ሐይሉ - ጥላ ከለላዬ - Ethiopian Instrumental Music by Nahom Records Inc 1 year ago 5 minutes, 49 seconds 12,017 views",Nahom Records,12017,12136,119
3485,"Tigist Ejigu - Tizita - ትግስት እጅጉ - ትዝታ - Ethiopian Instrumental Music by Nahom Records Inc 1 year ago 8 minutes, 44 seconds 11,055 views",Nahom Records,11055,11183,128
3486,"Theodros Mitiku - Teshebere Hode - ቴዎድሮስ ምትኩ - ተሸበረ ሆዴ - Ethiopian Instrumental Music by Nahom Records Inc 1 year ago 6 minutes, 50 seconds 2,159 views",Nahom Records,2159,2176,17
3487,"Teshome Sisay - Mewdeden Wededkut - ተሾመ ሲሳይ - መውደዴን ወደድኩት - Ethiopian Instrumental Music by Nahom Records Inc 1 year ago 5 minutes, 17 seconds 2,307 views",Nahom Records,2307,2322,15
3488,"Theodros Mitiku – Enigenagnalen - ቴዎድሮስ ምትኩ - እንገናኛለን - Ethiopian Instrumental Music by Nahom Records Inc 1 year ago 6 minutes, 56 seconds 1,451 views",Nahom Records,1451,1492,41
3489,"Leras New - ለራስ ነው  - New Ethiopian Music 2020 (Official Video) by Nahom Records Inc 1 year ago 5 minutes, 2 seconds 132,499 views",Nahom Records,132499,132527,28
3490,"Teshome Sisay - Mech Ckekigne Kerehu - ተሾመ ሲሳይ - መች ጨክኜ ቀረሁ -  Ethiopian Instrumental Music by Nahom Records Inc 1 year ago 5 minutes, 52 seconds 1,472 views",Nahom Records,1472,1483,11
3491,"Negen Betesfa - ነገን በተስፋ - New Ethiopian Music 2020 (Official Video) by Nahom Records Inc 1 year ago 5 minutes, 4 seconds 11,131 views",Nahom Records,11131,11140,9
3492,"Tigist Ejigu - Ywedegn Aywedegn - ትግስት እጅጉ - ይወደኝ አይወደኝ - Ethiopian Instrumental Music by Nahom Records Inc 1 year ago 6 minutes, 59 seconds 1,986 views",Nahom Records,1986,2004,18
3493,"Teshome Sisay - Yelib Lay Esat - ተሾመ ሲሳይ - የልብ ላይ እሳት - Ethiopian Instrumental Music by Nahom Records Inc 1 year ago 4 minutes, 46 seconds 8,803 views",Nahom Records,8803,8942,139
3494,"Daneal W/Gebreal - Hagere Nafekshign - ዳንኤል ወ/ገብርኤል - ሐገሬ ናፈቅሽኝ - Ethiopian Music by Nahom Records Inc 1 year ago 6 minutes, 14 seconds 3,900 views",Nahom Records,3900,3911,11
3495,"Teshome Sisay - Besensel Lib Reb - ተሾመ ሲሳይ - በሠንሰል ልብ ረብ - Ethiopian Instrumental Music by Nahom Records Inc 1 year ago 5 minutes, 16 seconds 2,288 views",Nahom Records,2288,2291,3
3496,"Daniel W/Gebriel - Wey Fikir - ዳንኤል ወ/ገብርኤል - ወይ ፍቅር - Ethiopian Music by Nahom Records Inc 1 year ago 7 minutes, 47 seconds 2,178 views",Nahom Records,2178,2200,22
3497,"Daneal W/Gebreal - Yebahir Fert Nesh - ዳንኤል ወ/ገብርኤል - የባህር ፈርጥ ነሽ - Ethiopian Musi by Nahom Records Inc 1 year ago 6 minutes, 23 seconds 2,348 views",Nahom Records,2348,2369,21
3498,"Hibist Tiruneh - Akam Akam - ህብስት ጥሩነህ - አካም አካም - Ethiopian Music by Nahom Records Inc 1 year ago 6 minutes, 20 seconds 1,744 views",Nahom Records,1744,1767,23
3499,"Daneal W/Gebreal - Hilm Ayehu Mata - ዳንኤል ወ/ገብርኤል - ህልም አየሁ ማታ - Ethiopian Instrumental  Music by Nahom Records Inc 1 year ago 6 minutes, 14 seconds 3,041 views",Nahom Records,3041,3060,19
3500,"Daneal W/Gebreal - Aynema wedajish - ዳንኤል ወ/ገብርኤል - አይኔማ ወዳጅሽ - Ethiopian Music by Nahom Records Inc 1 year ago 6 minutes, 14 seconds 4,185 views",Nahom Records,4185,4195,10
3501,"Eskedar Wedaje - Yane - ያኔ - New Ethiopian Music 2020 (Official Video) by Nahom Records Inc 1 year ago 4 minutes, 44 seconds 63,642 views",Nahom Records,63642,63728,86
3502,"Madingo Afework - Mar Mar - ማዲንጎ አፈወርቅ - ማር ማር - Ethiopian Music by Nahom Records Inc 1 year ago 5 minutes, 40 seconds 256,849 views",Nahom Records,256849,258666,1817
3503,"Tigist Kiros - Zena - ትግስት ኪሮስ - ዘና - Ethiopian Music by Nahom Records Inc 1 year ago 5 minutes, 40 seconds 9,946 views",Nahom Records,9946,10029,83
3504,"Abiy Kassahun - Basayegn Hageren - አብይ ካሳሁን - ባሳየኝ አገሬን - Ethiopian Music by Nahom Records Inc 1 year ago 4 minutes, 42 seconds 1,784 views",Nahom Records,1784,1786,2
3505,"Fasil Demoz - Askalye - ፋሲል ደሞዝ - አስካልዬ - Ethiopian Music by Nahom Records Inc 1 year ago 5 minutes, 57 seconds 5,846 views",Nahom Records,5846,5882,36
3506,"Tadese mekete - Enchekorer - ታደሠ መከተ - እንጨቆረር - Ethiopian Music by Nahom Records Inc 1 year ago 5 minutes, 13 seconds 10,442 views",Nahom Records,10442,10634,192
3507,"Madingo Afework - Lalaterf - ማዲንጎ አፈወርቅ - ላላተርፍ - Ethiopian Music by Nahom Records Inc 1 year ago 4 minutes, 54 seconds 376,496 views",Nahom Records,376496,383890,7394
3508,"Gizachw Teshome - Jiru - ግዛቸው ተሾመ - ጅሩ - Ethiopian Music by Nahom Records Inc 1 year ago 6 minutes, 57 seconds 248,410 views",Nahom Records,248410,250160,1750
3509,"Meseret Belete - Merhabete - መሠረት በለጠ - መርሐቤቴ - Ethiopian Music by Nahom Records Inc 1 year ago 6 minutes, 59 seconds 45,987 views",Nahom Records,45987,48438,2451
3510,"Tamrat Desta - Deju - ታምራት ደስታ - ደጁ - Ethiopian Music by Nahom Records Inc 1 year ago 5 minutes, 50 seconds 114,797 views",Nahom Records,114797,116011,1214
3511,"Bezawit Zeleke - Menor Jemreyalehu - ቤዛዊት ዘለቀ - መኖር ጀምሬያለሁ - Ethiopian Music by Nahom Records Inc 1 year ago 6 minutes, 16 seconds 56,809 views",Nahom Records,56809,57233,424
3512,"Birtukan Dubale | Sakilign | ብርቱካን ዱባለ | ሳቅልኝ | Ethiopian Music by Nahom Records Inc 1 year ago 5 minutes, 26 seconds 21,671 views",Nahom Records,21671,21881,210
3513,"Tamirat Desta - Yeliben - ታምራት ደስታ - የልቤን - Ethiopian Music by Nahom Records Inc 1 year ago 4 minutes, 51 seconds 90,107 views",Nahom Records,90107,91325,1218
3514,"Gete Aniley - Latenet Abeka - ጌቴ አንለይ - ላጤነት አበቃ - Ethiopian Music by Nahom Records Inc 1 year ago 4 minutes, 42 seconds 5,526 views",Nahom Records,5526,5577,51
3515,"Tibebu Workye | Ebakish Asbibet | ጥበቡ ወርቅዬ | እባክሽ አስቢበት | Ethiopian Music by Nahom Records Inc 1 year ago 6 minutes 46,183 views",Nahom Records,46183,46805,622
3516,"Halima Abdurahiman – Goraw - ሐሊማ አብዱራህማን - ጎራው- Ethiopian Music by Nahom Records Inc 1 year ago 5 minutes, 32 seconds 195,647 views",Nahom Records,195647,195987,340
3517,"Mikaya Behailu - kebrara - ሚካያ በሐይሉ - ቀብራራ - Ethiopian Music by Nahom Records Inc 1 year ago 5 minutes, 49 seconds 76,016 views",Nahom Records,76016,77499,1483
3518,"Lali Habesha - Ye Ethiopia Lij  - ላሊ ሐበሻ - የኢትዮጵያ ልጅ - Ethiopian Music by Nahom Records Inc 1 year ago 5 minutes, 31 seconds 1,661 views",Nahom Records,1661,1668,7
3519,"Amsal Mitike - Yzemilishal - አምሳል ምትኬ - ይዜምልሻል - Ethiopian Music by Nahom Records Inc 1 year ago 7 minutes, 29 seconds 22,657 views",Nahom Records,22657,22885,228
3520,"Tamirat Desta - Lemin Yelegnim Alish - ታምራት ደስታ - ለምን የለኝም አልሽ - Ethiopian Music by Nahom Records Inc 1 year ago 6 minutes, 11 seconds 1,584,923 views",Nahom Records,1584923,1615613,30690
3521,"Neway Debebe - Yegna Loga - ነዋይ ደበበ - የኛ ሎጋ - Ethiopian Music by Nahom Records Inc 1 year ago 6 minutes, 11 seconds 7,493 views",Nahom Records,7493,7580,87
3522,"Shewandagn Hailu - And Liben - ሸዋንዳኝ ሐይሉ - አንድ ልቤን - Ethiopian Music by Nahom Records Inc 1 year ago 4 minutes, 54 seconds 30,681 views",Nahom Records,30681,31979,1298
3523,"Girma Tefera Kassa | Libe Libe | ግርማ ተፈራ ካሳ | ልቤ ልቤ | Ethiopian Music by Nahom Records Inc 1 year ago 5 minutes, 7 seconds 20,414 views",Nahom Records,20414,20617,203
3524,"Tibebu workye - Eyeteyayen Teleyayen - ጥበቡ ወርቅዬ - እየተያየን ተለያየን - Ethiopian Music by Nahom Records Inc 1 year ago 5 minutes, 30 seconds 28,903 views",Nahom Records,28903,29373,470
3525,"Alem Kebede - Yilegnal kir Kir - አለም ከበደ - ይለኛል ቅር ቅር - Ethiopian Music by Nahom Records Inc 1 year ago 4 minutes, 38 seconds 4,902 views",Nahom Records,4902,4988,86
3526,"Endashaw kelemework & Etenesh Wasse - Maleda - እንዳሻው ቀለመወርቅ እና እቴነሽ ዋሴ - ማለዳ - Ethiopian Music by Nahom Records Inc 1 year ago 5 minutes, 57 seconds 2,604 views",Nahom Records,2604,2612,8
3527,"Tigist Afework - Engida - ትግስት አፈወርቅ - እንግዳ - Ethiopian Music by Nahom Records Inc 1 year ago 5 minutes, 27 seconds 32,017 views",Nahom Records,32017,32319,302
3528,"Lali Habesha - Adelegn - ላሊ ሐበሻ - አደለኝ - Ethiopian Music by Nahom Records Inc 1 year ago 5 minutes, 39 seconds 1,303 views",Nahom Records,1303,1308,5
3529,"Birtukan Dubal - Wello - ብርቱካን ዱባለ - ወሎ - Ethiopian Music by Nahom Records Inc 1 year ago 7 minutes, 36 seconds 51,186 views",Nahom Records,51186,51836,650
3530,"Ephrem Tamiru - Gedam Endegeba - ኤፍሬም ታምሩ - ገዳም እንደገባ - Ethiopian Music by Nahom Records Inc 1 year ago 8 minutes, 37 seconds 262,464 views",Nahom Records,262464,264054,1590
3531,"Hibist Tiruneh - chiye Adralehu - ህብስት ጥሩነህ - ችዬ አድራለሁ - Ethiopian Music by Nahom Records Inc 1 year ago 4 minutes, 52 seconds 4,773 views",Nahom Records,4773,4823,50
3532,"Gedion Daneal - Altewishim - ጌድዮን ዳንኤል - አልተውሽም - New Ethiopian Music 2020 (Official Music Video) by Nahom Records Inc 1 year ago 6 minutes, 25 seconds 288,379 views",Nahom Records,288379,288576,197
3533,"Endashaw Kelemework & Etenesh Wasse | Bati | እንዳሻው ቀለመወርቅ እና እቴነሽ ዋሴ | ባቲ | Ethiopian Music by Nahom Records Inc 1 year ago 6 minutes, 3 seconds 6,871 views",Nahom Records,6871,7002,131
3534,"Dagim Adane - Alem Wube - አለም ውቤ - New Ethiopian Music 2020 (Official Video) by Nahom Records Inc 1 year ago 5 minutes, 39 seconds 3,619 views",Nahom Records,3619,3634,15
3535,"Amsal Mitike - Yakim Yaleh - Ethiopian Music by Nahom Records Inc 1 year ago 5 minutes, 59 seconds 23,050 views",Nahom Records,23050,23094,44
3536,"Gete Aniley - Sertesh Atafrshiw - Ethiopian Music by Nahom Records Inc 1 year ago 5 minutes, 18 seconds 4,796 views",Nahom Records,4796,4821,25
3537,"Tibebu Workye - Gebagn Ahun Gena - Ethiopian Music by Nahom Records Inc 1 year ago 5 minutes, 26 seconds 9,053 views",Nahom Records,9053,9080,27
3538,"Ziggy Zaga - loo’na - ዚጊ ዛጋ - ሎኦና - New Ethiopian Music 2020 (Official Video) by Nahom Records Inc 1 year ago 5 minutes, 27 seconds 409,231 views",Nahom Records,409231,409631,400
3539,"Bitsat Seyoum - Wil Alegn - ብፅአት ስዩም - ውል አለኝ - New Ethiopian Music 2020 (Official Video) by Nahom Records Inc 1 year ago 7 minutes, 3 seconds 646,633 views",Nahom Records,646633,647414,781
3540,"Gizachew Teshome - Yene Hasab - ግዛቸው ተሾመ - የኔ ሐሳብ - Ethiopian Music by Nahom Records Inc 1 year ago 4 minutes, 44 seconds 4,555 views",Nahom Records,4555,4596,41
3541,"Girma Tefera Kassa - Melishe - ግርማ ተፈራ ካሳ - መልሼ - Ethiopian Music by Nahom Records Inc 1 year ago 4 minutes, 12 seconds 29,253 views",Nahom Records,29253,29854,601
3542,"Tefe Lali - Endalsemash - ተፌ ላሊ - እንዳልሠማሽ - Ethiopian Music by Nahom Records Inc 2 years ago 4 minutes 2,246 views",Nahom Records,2246,2247,1
3543,"Tigist Afework - Aba Tatek - ትግስት አፈወርቅ - Ethiopian Music by Nahom Records Inc 2 years ago 5 minutes, 30 seconds 12,937 views",Nahom Records,12937,13102,165
3544,"Mikaya Behailu - Sebeb - ሚካያ በኃይሉ - ሰበብ - Ethiopian Music by Nahom Records Inc 2 years ago 7 minutes, 41 seconds 3,786 views",Nahom Records,3786,3841,55
3545,"Birtukan Dubale - Alegn Guday - ብርቱካን ዱባለ - አለኝ ጉዳይ - Ethiopian Music by Nahom Records Inc 2 years ago 6 minutes, 24 seconds 118,810 views",Nahom Records,118810,120838,2028
3546,"Henok Abebe - Yeayne quanqua - ሔኖክ አበበ - የአይኔ ቋንቋ - Ethiopian Music by Nahom Records Inc 2 years ago 4 minutes, 35 seconds 18,376 views",Nahom Records,18376,18689,313
3547,"Halima Abdurahiman - Kegebeta Betach- ሐሊማ አብዱራሂማን - ከገበታ በታች - Ethiopian Music by Nahom Records Inc 2 years ago 6 minutes, 31 seconds 5,897 views",Nahom Records,5897,6021,124
3548,"Ephrem Tamiru - Zemamie - ኤፍሬም ታምሩ - ዝማሜ - Ethiopian Music by Nahom Records Inc 2 years ago 5 minutes, 42 seconds 14,488 views",Nahom Records,14488,14785,297
3549,"Abeba Desalegn - Enbayen Abesse - አበባ ደሳለኝ - እንባዬን አበሠ - Ethiopian Music by Nahom Records Inc 2 years ago 5 minutes, 42 seconds 505,022 views",Nahom Records,505022,507269,2247
3550,"Hibist Tiruneh - Likribih - ህብስት ጥሩነህ - ልቅርብህ - Ethiopian Music by Nahom Records Inc 2 years ago 5 minutes, 16 seconds 176,794 views",Nahom Records,176794,178262,1468
3551,"Tadesse Mekete - Minale Tadya - ታደሠ መከተ - ምናለ ታድያ - Ethiopian Music by Nahom Records Inc 2 years ago 5 minutes, 7 seconds 4,771 views",Nahom Records,4771,4816,45
3552,"Gizachew Teshome - Gonder -ግዛቸው ተሾመ -ጎንደር - Ethiopian Music by Nahom Records Inc 2 years ago 5 minutes, 54 seconds 72,906 views",Nahom Records,72906,73640,734
3553,"Abeba Desalegn - Teret Teret - አበባ ደሳለኝ - ተረት ተረት - Ethiopian Music by Nahom Records Inc 2 years ago 4 minutes, 58 seconds 7,505 views",Nahom Records,7505,7622,117
3554,"Ephrem Tamiru - Akale - ኤፍሬም ታምሩ - አካሌ - Ethiopian Music by Nahom Records Inc 2 years ago 7 minutes, 18 seconds 345,560 views",Nahom Records,345560,347997,2437
3555,"Tigist Kiross - Zena Zena - ትግስት ኪሮስ - ዘና ዘና - Ethiopian Music by Nahom Records Inc 2 years ago 5 minutes, 19 seconds 1,679 views",Nahom Records,1679,1687,8
3556,"Dereje Bizuwork - Zobiew - ደረጀ ብዙወርቅ - ዞቤው - Ethiopian Music by Nahom Records Inc 2 years ago 6 minutes, 34 seconds 5,789 views",Nahom Records,5789,5861,72
3557,"Abiy Kassahun - Basayew - አብይ ካሳሁን - ባሳየው - Ethiopian Music by Nahom Records Inc 2 years ago 4 minutes, 39 seconds 965 views",Nahom Records,965,970,5
3558,"Tesfaye Taye - Eneman Neberu - ተስፋዬ ታዬ - እነማን ነበሩ - Ethiopian Music by Nahom Records Inc 2 years ago 5 minutes, 51 seconds 1,403 views",Nahom Records,1403,1410,7
3559,"Abeba Desalegn - Yefikir Hudadie - አበባ ደሳለኝ - የፍቅር ሁዳዴ - Ethiopian Music by Nahom Records Inc 2 years ago 4 minutes, 44 seconds 179,501 views",Nahom Records,179501,189636,10135
3560,"Gizachew Teshome - Bira New - ግዛቸው ተሾመ - ብራ ነው - Ethiopian Music by Nahom Records Inc 2 years ago 6 minutes, 12 seconds 118,934 views",Nahom Records,118934,119783,849
3561,"Ephrem Tamiru - Yemejemeriyaye - ኤፍሬም ታምሩ - የመጀመሪያዬ - Ethiopian Music by Nahom Records Inc 2 years ago 6 minutes, 48 seconds 65,317 views",Nahom Records,65317,67759,2442
3562,"Misanesh Gonite - Gonder - ምሳነሽ ጎንጤ - ጎንደር - Ethiopian Music by Nahom Records Inc 2 years ago 5 minutes, 55 seconds 1,596 views",Nahom Records,1596,1609,13
3563,"Tesfaye Wube - Minjar - ተስፋዬ ውቤ - ምንጃር - New Ethiopian Music by Nahom Records Inc 2 years ago 4 minutes, 41 seconds 1,547 views",Nahom Records,1547,1569,22
3564,"Halima Abdurahiman - Kemado - ሐሊማ አብዱራህማን - ከማዶ - Ethiopian Music by Nahom Records Inc 2 years ago 4 minutes, 48 seconds 9,040 views",Nahom Records,9040,9078,38
3565,"Asnakech Worku - Ende eyerusalem - አስናቀች  ወርቁ - እንደ እየሩሳሌም - New Ethiopian Music by Nahom Records Inc 2 years ago 5 minutes, 39 seconds 42,142 views",Nahom Records,42142,42743,601
3566,"Zuryash Abiyu - Arada - ዙርያሽ አብዩ - አራዳ - New Ethiopian Music by Nahom Records Inc 2 years ago 8 minutes, 25 seconds 2,014 views",Nahom Records,2014,2032,18
3567,"Bizuayehu Demisse - Mamene - ብዙአየሁ ደምሴ - ማመኔ - Ethiopian Music by Nahom Records Inc 2 years ago 5 minutes, 27 seconds 66,555 views",Nahom Records,66555,67573,1018
3568,"Fasil Demoz - Alashemin Alech - ፋሲል ደሞዝ - አላሸምን አለች - New Ethiopian Music by Nahom Records Inc 2 years ago 5 minutes, 21 seconds 8,398 views",Nahom Records,8398,8470,72
3569,"Bitseat Seyoum - Tizalegn - ብፅአት ስዩም - ትዝ አለኝ - New Ethiopian Music by Nahom Records Inc 2 years ago 6 minutes, 30 seconds 33,359 views",Nahom Records,33359,33445,86
3570,"Fikiraddis Nekatibeb - Yanekal - ፍቅርአዲስ ነቃጥበብ - ያነቃል - Ethiopian Music by Nahom Records Inc 2 years ago 6 minutes, 45 seconds 552,854 views",Nahom Records,552854,560273,7419
3571,"Abinet Agonafir – Suse - አብነት አጎናፍር - ሱሴ - Ethiopian Music by Nahom Records Inc 2 years ago 5 minutes, 43 seconds 95,106 views",Nahom Records,95106,96927,1821
3572,"Daneal W/Gebreal – Limelalesibet - ዳንኤል ወ/ገብርኤል - ልመላለስበት - Ethiopian Music by Nahom Records Inc 2 years ago 7 minutes, 19 seconds 1,612 views",Nahom Records,1612,1621,9
3573,"Henok Abebe – Yamelalisegnal - ሔኖክ አበበ - ያመላልሠኛል - Ethiopian Music by Nahom Records Inc 2 years ago 5 minutes, 19 seconds 435,943 views",Nahom Records,435943,452550,16607
3574,"Neway Debebe - Maebel New - ነዋይ ደበበ - ማዕበል ነው -  Ethiopian Music by Nahom Records Inc 2 years ago 4 minutes, 16 seconds 14,423 views",Nahom Records,14423,15295,872
3575,"Abera Worku – Zume - አበራ ወርቁ - ዙሜ - Ethiopian Music by Nahom Records Inc 2 years ago 4 minutes, 44 seconds 1,704 views",Nahom Records,1704,1713,9
3576,"Madingo Afework - Ayderegim - ማዲንጎ አፈወርቅ - አይደረግም - Ethiopian Music by Nahom Records Inc 2 years ago 5 minutes, 59 seconds 120,543 views",Nahom Records,120543,121746,1203
3577,"Hibist Tiruneh - Yene Astemari - ሕብስት ጥሩነህ - የኔ አስተማሪ - Ethiopian Music by Nahom Records Inc 2 years ago 5 minutes, 25 seconds 27,769 views",Nahom Records,27769,27947,178
3578,"Amsal Mitike - Atinekakugn - አምሳል ምትኬ - አትነካኩኝ - Ethiopian Music by Nahom Records Inc 2 years ago 7 minutes, 3 seconds 6,082 views",Nahom Records,6082,6134,52
3579,"Halima Abdurahiman - Birk Fikir - ሐሊማ አብዱራህማን - ብርቅ ፍቅር - Ethiopian Music by Nahom Records Inc 2 years ago 5 minutes, 29 seconds 5,555 views",Nahom Records,5555,5590,35
3580,"Daneal W/Gebreal - Gidyelem - ዳንኤል ወ/ገብርኤል - ግድየለም- Ethiopian Music by Nahom Records Inc 2 years ago 4 minutes, 44 seconds 949 views",Nahom Records,949,955,6
3581,"Tigist Afework - Kalgebahugn - ትግስት አፈወርቅ - ካልገባሁኝ - Ethiopian Music by Nahom Records Inc 2 years ago 5 minutes, 11 seconds 192,362 views",Nahom Records,192362,194044,1682
3582,"Alem kebede - Akelaletew - አለም ከበደ - አቀላለጠው - Ethiopian Music by Nahom Records Inc 2 years ago 5 minutes, 46 seconds 1,974 views",Nahom Records,1974,1993,19
3583,"Girma Tefera Kassa - Lik Endayehush - ግርማ ተፈራ ካሳ - ልክ እንዳየሁሽ - Ethiopian Music by Nahom Records Inc 2 years ago 4 minutes, 45 seconds 29,993 views",Nahom Records,29993,32100,2107
3584,"Tibebu workyie - Negiste Saba - ጥበቡ ወርቅዬ - ንግስተ ሳባ - Ethiopian Music by Nahom Records Inc 2 years ago 5 minutes, 32 seconds 6,660 views",Nahom Records,6660,6761,101
3585,"Birtukan Dubale - Anigenagnim - ብርቱካን ዱባለ - አንገናኝም - Ethiopian Music by Nahom Records Inc 2 years ago 7 minutes, 27 seconds 299,200 views",Nahom Records,299200,300702,1502
3586,"Daneal W/Gebreal – Kalen Atybign - ዳንኤል ወ/ገብርኤል - ቃሌን አትይብኝ - Ethiopian Music by Nahom Records Inc 2 years ago 5 minutes, 4 seconds 661 views",Nahom Records,661,670,9
3587,"Hibist Tiruneh - Befetereh - ህብስት ጥሩነህ - በፈጠረህ - Ethiopian Music by Nahom Records Inc 2 years ago 5 minutes, 8 seconds 134,453 views",Nahom Records,134453,135893,1440
3588,"Berhanu Tezara - Bela - ብርሐኑ ተዘራ - ቤላ -  Ethiopian Music by Nahom Records Inc 2 years ago 5 minutes, 2 seconds 1,832 views",Nahom Records,1832,1862,30
3589,"Tadesse Mekete - Lalibela - ታደሠ መከተ - ላልይበላ - Ethiopian Music by Nahom Records Inc 2 years ago 4 minutes, 25 seconds 3,000 views",Nahom Records,3000,3012,12
3590,"Henok Abebe - Anchin Yilal - ሔኖክ አበበ - አንቺን ይላል - Ethiopian Music by Nahom Records Inc 2 years ago 6 minutes, 5 seconds 19,734 views",Nahom Records,19734,19957,223
3591,"Alem kebede - Aznalech Midir - አለም ከበደ - አዝናለች ምድር - Ethiopian Music by Nahom Records Inc 2 years ago 4 minutes, 57 seconds 3,998 views",Nahom Records,3998,4009,11
3592,"Tigist Afework – Binorew new enji - ትግስት አፈወርቅ - ቢኖረው ነው እንጂ -  Ethiopian Music by Nahom Records Inc 2 years ago 6 minutes, 43 seconds 343,784 views",Nahom Records,343784,346404,2620
3593,"Fikiraddis Nekatibeb - Bagerachin - ፍቅርአዲስ ነቃጥበብ - ባገራችን - Ethiopian Music by Nahom Records Inc 2 years ago 7 minutes, 13 seconds 206,185 views",Nahom Records,206185,208391,2206
3594,"Amsal Mitke - Hay Megalo - አምሳል ምትኬ - ሀይ መጋሎ - Ethiopian Music by Nahom Records Inc 2 years ago 6 minutes, 32 seconds 8,645 views",Nahom Records,8645,8715,70
3595,"Ephrem Tamiru - Godanaye - ኤፍሬም ታምሩ - ጎዳናዬ - Ethiopian Music by Nahom Records Inc 2 years ago 4 minutes, 37 seconds 41,750 views",Nahom Records,41750,42912,1162
3596,"Daneal W/Gebreal - Ambasel - ዳንኤል ወ/ገብርኤል - አምባሰል - Ethiopian Music by Nahom Records Inc 2 years ago 8 minutes, 5 seconds 1,185 views",Nahom Records,1185,1192,7
3597,"Efrem Tamiru - Yfikirin Kitat - ኤፍሬም ታምሩ - የፍቅርን ቅጣት - Ethiopian Music by Nahom Records Inc 2 years ago 5 minutes, 35 seconds 162,961 views",Nahom Records,162961,165442,2481
3598,"Efrem Tamiru - Endegebsu Zala - ኤፍሬም ታምሩ - እንደገብሱ ዛላ - Ethiopian Music by Nahom Records Inc 2 years ago 6 minutes, 37 seconds 110,996 views",Nahom Records,110996,111658,662
3599,"Girma Tefera Kassa - Ene Aydelehuma - ግርማ ተፈራ ካሳ - እኔ አይደለሁማ - Ethiopian Music by Nahom Records Inc 2 years ago 4 minutes, 51 seconds 96,448 views",Nahom Records,96448,97427,979
3600,"Tefe Lali & Bini Lali - Yababolewo - ተፌ ላሊ እና  ቢኒ ላሊ - ያባቦሌዎ - Ethiopian Music by Nahom Records Inc 2 years ago 5 minutes, 17 seconds 1,895 views",Nahom Records,1895,1916,21
3601,"Shewandagn Hailu - Ayresat - ሸዋንዳኝ ኃይሉ - አይረሳት - Ethiopian Music by Nahom Records Inc 2 years ago 4 minutes, 28 seconds 8,437 views",Nahom Records,8437,8625,188
3602,"Yared Belay - Abren New wey - ያሬድ በላይ - አብረን ነው ወይ - Ethiopian Music by Nahom Records Inc 2 years ago 4 minutes, 50 seconds 3,975 views",Nahom Records,3975,3992,17
3603,"Haileyesus Girma - Wib Nesh - ሐይለየሱስ ግርማ - ውብ ነሽ - Ethiopian Music by Nahom Records Inc 2 years ago 5 minutes, 35 seconds 6,135 views",Nahom Records,6135,6255,120
3604,"Tsilat Gezmu - Endet Endet - ጽላት ገዝሙ - ይለይልኝ - Ethiopian Music by Nahom Records Inc 2 years ago 5 minutes 21,945 views",Nahom Records,21945,22085,140
3605,"Eyerusalem Getu - Degem Degem - እየሩሳሌም ጌቱ - ደገም ደገም - Official Music Video  -  Ethiopian Music 2020 by Nahom Records Inc 2 years ago 4 minutes, 47 seconds 40,147 views",Nahom Records,40147,40271,124
3606,"Anteneh werash - Keterosh - አንተነህ ወራሽ - ቀጠሮሽ - Ethiopian Music by Nahom Records Inc 2 years ago 4 minutes, 25 seconds 5,904 views",Nahom Records,5904,5942,38
3607,"Sami Beyene - Endanchi Yale - ሣሚ በየነ - እንዳንቺ ያለ - Ethiopian Music by Nahom Records Inc 2 years ago 4 minutes, 8 seconds 36,641 views",Nahom Records,36641,36801,160
3608,"Yared Belay - Ayne wha - ያሬድ በላይ - አይነ ውሃ - Ethiopian Music by Nahom Records Inc 2 years ago 4 minutes, 35 seconds 7,111 views",Nahom Records,7111,7169,58
3609,"Haileyesus Girma - Kelel Adrigo - ሐይለየሱስ ግርማ - ቀለል አድርጎ - - Ethiopian Music by Nahom Records Inc 2 years ago 4 minutes, 31 seconds 13,065 views",Nahom Records,13065,13273,208
3610,"Tsilat Gezmu - Endet Endet - ጽላት ገዝሙ - እንዴት እንዴት - Ethiopian Music by Nahom Records Inc 2 years ago 3 minutes, 38 seconds 5,625 views",Nahom Records,5625,5650,25
3611,"Genet Masresha & Gizachew Teshome – Teymansh – ገነት ማስረሻ እና ግዛቸው ተሾመ - ተይማነሽ - Ethiopian Music by Nahom Records Inc 2 years ago 6 minutes, 15 seconds 54,776 views",Nahom Records,54776,55137,361
3612,"Anteneh Worash - Tewado Yleyayal - አንተነህ ወራሽ - ተዋዶ ይለያያል - Ethiopian Music by Nahom Records Inc 2 years ago 5 minutes, 32 seconds 13,229 views",Nahom Records,13229,13325,96
3613,"Andualem Ayalew - Temari Gobez New - አንዱአለም አያሌው - ተማሪ ጎበዝ ነው - Ethiopian Music by Nahom Records Inc 2 years ago 6 minutes, 59 seconds 2,139 views",Nahom Records,2139,2142,3
3614,"Henok Abebe – Geremegn - ሐኖክ አበበ - ገረመኝ - Ethiopian Music by Nahom Records Inc 2 years ago 5 minutes, 17 seconds 153,269 views",Nahom Records,153269,157719,4450
3615,"Sami Beyene - Sak Sak - ሣሚ በየነ - ሳቅ ሳቅ - Ethiopian Music by Nahom Records Inc 2 years ago 5 minutes, 12 seconds 51,875 views",Nahom Records,51875,52118,243
3616,"Teklu Demissie & Daneal W/Gebreal - Ytayal gudu - ተክሉ  እና ዳንኤል  - ይታያል ጉዱ - Ethiopian Music by Nahom Records Inc 2 years ago 7 minutes, 22 seconds 1,002 views",Nahom Records,1002,1011,9
3617,"Rebbeca Solomon – Romeo - ርብቃ ሠለሞን - ሮሚዮ - Ethiopian Music by Nahom Records Inc 2 years ago 5 minutes, 15 seconds 1,631 views",Nahom Records,1631,1639,8
3618,"Teshome Mitiku & Frehywot Lemma - Bati - ተሾመ ምትኩ እና ፍሬህይወት ለማ - ባቲ - Ethiopian Music by Nahom Records Inc 2 years ago 7 minutes, 47 seconds 13,185 views",Nahom Records,13185,13291,106
3619,"Muluken Tsehay – Alehulish - ሙሉቀን ጸሐይ - አለሁልሽ - Ethiopian Music by Nahom Records Inc 2 years ago 4 minutes, 18 seconds 1,951 views",Nahom Records,1951,1970,19
3620,"Hibist Tiruneh - Koy Bicha - ሕብስት ጥሩነህ - ቆይ ብቻ - Ethiopian Music by Nahom Records Inc 2 years ago 5 minutes, 35 seconds 25,901 views",Nahom Records,25901,26181,280
3621,"Birtukan Dubal – Awdamet - ብርቱካን ዱባለ - አውዳመት - Ethiopian Music by Nahom Records Inc 2 years ago 6 minutes, 55 seconds 26,816 views",Nahom Records,26816,26946,130
3622,"Halima Abdurahiman – Quatign - ሐሊማ አብዱራህማን - ቋጥኝ -  Ethiopian Music by Nahom Records Inc 2 years ago 4 minutes, 51 seconds 3,469 views",Nahom Records,3469,3493,24
3623,"Ephrem Tamiru - Neylign - ኤፍሬም ታምሩ - ነይልኝ - Ethiopian Music by Nahom Records Inc 2 years ago 5 minutes, 3 seconds 268,235 views",Nahom Records,268235,269064,829
3624,"Tibebu workye - Ligaba - ጥበቡ ወርቅዬ - ሊጋባ - Ethiopian Music by Nahom Records Inc 2 years ago 5 minutes, 1 second 47,224 views",Nahom Records,47224,47565,341
3625,"Nati Haile - Wedjatalehu - ናቲ ኃይሌ - ወድጃታለሁ - Ethiopian Music by Nahom Records Inc 2 years ago 4 minutes, 41 seconds 144,829 views",Nahom Records,144829,147537,2708
3626,"Fikiraddis Nekatibeb – Enat - ፍቅርአዲስ ነቃጥበብ - እናት - Ethiopian Music by Nahom Records Inc 2 years ago 5 minutes, 8 seconds 8,624 views",Nahom Records,8624,8761,137
3627,"Chalachew Ashenafi - Awdamet - ቻላቸው አሸናፊ - አውደዓመት - Ethiopian Music by Nahom Records Inc 2 years ago 5 minutes, 5 seconds 10,141 views",Nahom Records,10141,10180,39
3628,"Mahlet G/georgis - Beyney Terife -  ማህሌት ገ ጊዮርጊስ - በይነይ ተሪፈ - Ethiopian Music by Nahom Records Inc 2 years ago 6 minutes, 30 seconds 15,357 views",Nahom Records,15357,15551,194
3629,"Fasil Demoz – Minjar - ፋሲል ደሞዝ - ምንጃር - Ethiopian Music by Nahom Records Inc 2 years ago 5 minutes, 59 seconds 53,422 views",Nahom Records,53422,53472,50
3630,"Bizuayehu Demisse - Enbuwa Zebider - ብዙአየሁ ደምሴ - እንቧ ዘቢደር - Ethiopian Music by Nahom Records Inc 2 years ago 6 minutes, 28 seconds 134,358 views",Nahom Records,134358,136995,2637
3631,"Gete Aniley – Wey Bire - ጌቴ አንለይ - ወይ ብሬ - Ethiopian Music by Nahom Records Inc 2 years ago 5 minutes, 54 seconds 34,709 views",Nahom Records,34709,35298,589
3632,"Amsal Mitike – Zemen Endeseat - አምሳል ምትኬ - ዘመን እንደሠዓት - Ethiopian Music by Nahom Records Inc 2 years ago 6 minutes, 42 seconds 345,124 views",Nahom Records,345124,346211,1087
3633,"Fasil Demoz - Enkokilish - ፋሲል ደሞዝ - እንቆቅልሽ - Ethiopian music by Nahom Records Inc 2 years ago 6 minutes, 24 seconds 8,179 views",Nahom Records,8179,8293,114
3634,"Halima Abdurahiman - Tizita - ሐሊማ አብዱራሂማን - ትዝታ - Ethiopian Music by Nahom Records Inc 2 years ago 3 minutes, 55 seconds 16,643 views",Nahom Records,16643,16705,62
3635,"Ephrem Tamiru -  Melkam Wileta - ኤፍሬም ታምሩ - መልካም ውለታ - Ethiopia Music by Nahom Records Inc 2 years ago 6 minutes, 14 seconds 232,167 views",Nahom Records,232167,232559,392
3636,"Tibebu Workye - Zim - ጥበቡ ወርቅዬ - ዝም - Ethiopian Music by Nahom Records Inc 2 years ago 4 minutes, 51 seconds 65,587 views",Nahom Records,65587,66297,710
3637,"Nati Haile - Tizita - ናቲ ኃይሌ - ትዝታ - Ethiopian Music by Nahom Records Inc 2 years ago 7 minutes, 13 seconds 26,664 views",Nahom Records,26664,26917,253
3638,"Kasahun Taye - Sora - ካሳሁን ታዬ - ሶራ - Ethiopian Music by Nahom Records Inc 2 years ago 5 minutes, 54 seconds 17,704 views",Nahom Records,17704,17904,200
3639,"Bekelech Tsegaye – Abichu - በቀለች ጸጋዬ -አቢቹ (ኦሮምኛ) – Ethiopian Music by Nahom Records Inc 2 years ago 4 minutes, 45 seconds 4,389 views",Nahom Records,4389,4465,76
3640,"Gizachew Teshome - Awde Amet - ግዛቸው ተሾመ - አውደ ዓመት - Ethiopian Music by Nahom Records Inc 2 years ago 6 minutes, 1 second 15,018 views",Nahom Records,15018,15068,50
3641,"Elias Tebabal - Mamaye - ኤልያስ ተባባል - ማማዬ - Ethiopian Music by Nahom Records Inc 2 years ago 6 minutes, 50 seconds 39,127 views",Nahom Records,39127,39835,708
3642,"Tigist Ejigu - Endet Neh (Piano) ትዕግስት እጅጉ - እንዴት ነህ (ፒያኖ) - Ethiopan Music by Nahom Records Inc 2 years ago 5 minutes, 2 seconds 3,280 views",Nahom Records,3280,3299,19
3643,"Berhanu Tezera – Yewah - ብርሐኑ ተዘራ - የዋህ - Ethiopian Music by Nahom Records Inc 2 years ago 6 minutes, 17 seconds 5,803 views",Nahom Records,5803,5837,34
3644,"Lealem Muluneh – Endiaw yehoden - ለዓለም ሙሉነህ - እንዲያው የሆዴን - Ethiopian Music by Nahom Records Inc 2 years ago 4 minutes, 20 seconds 1,094 views",Nahom Records,1094,1100,6
3645,"Muluken Dawit - Afu Belwat - ሙሉቀን ዳዊት - አፉ በሏት - Ethiopian Music by Nahom Records Inc 2 years ago 5 minutes, 33 seconds 1,770 views",Nahom Records,1770,1776,6
3646,"Sofia Atsbeha - Waniney - ሶፍያ አፅብሃ - ዋኒነይ - Ethiopian Music by Nahom Records Inc 2 years ago 4 minutes, 34 seconds 4,170 views",Nahom Records,4170,4238,68
3647,"Amsale Mitike - Abereregn - አምሳለ ምትኬ - አበረረኝ - Ethiopian Music by Nahom Records Inc 2 years ago 6 minutes, 37 seconds 82,644 views",Nahom Records,82644,83121,477
3648,"Rebbeca Solomon – Kante Gar - ርብቃ ሠለሞን - ካንተ ጋር - Ethiopian Music by Nahom Records Inc 2 years ago 4 minutes, 25 seconds 6,620 views",Nahom Records,6620,6642,22
3649,"Chalachew Ashenafi – Selam Ney - ቻላቸው አሸናፊ - ሠላም ነይ - Ethiopian music by Nahom Records Inc 2 years ago 5 minutes, 3 seconds 37,445 views",Nahom Records,37445,37638,193
3650,"Gete Aniley – Anguwache - ጌቴ አንለይ - አንጓቼ - Ethiopian Music by Nahom Records Inc 2 years ago 5 minutes, 49 seconds 6,341 views",Nahom Records,6341,6399,58
3651,"Bizuayehu Demisse - Misikir Eyaye - ብዙአየሁ ደምሴ - ምስክር እያየ - Ethiopian Music by Nahom Records Inc 2 years ago 9 minutes, 21 seconds 62,926 views",Nahom Records,62926,67367,4441
3652,"Halima Abdurahiman - Endalmeta - ሃሊማ አብዱራህማን - እንዳልመጣ - Ethiopian Music by Nahom Records Inc 2 years ago 6 minutes, 1 second 216,681 views",Nahom Records,216681,217398,717
3653,"Meseret Belete – Gud Afela - መሠረት በለጠ - ጉድ አፈላ - Ethiopian Music by Nahom Records Inc 2 years ago 5 minutes, 7 seconds 194,228 views",Nahom Records,194228,194472,244
3654,"Abinet Agonafir – Atehigbign - አብነት አጎናፍር - አትሒጅብኝ - Ethiopian Music by Nahom Records Inc 2 years ago 4 minutes, 7 seconds 140,518 views",Nahom Records,140518,144740,4222
3655,"Aster kebede - Akal Gela - አስቴር ከበደ - አካል ገላ - Ethiopian Music by Nahom Records Inc 2 years ago 6 minutes, 33 seconds 67,981 views",Nahom Records,67981,69039,1058
3656,"Henok Abebe – Enema Kasabe - ሔኖክ አበበ - እኔማ ካሳቤ Ethiopian Music by Nahom Records Inc 2 years ago 5 minutes, 20 seconds 38,273 views",Nahom Records,38273,38578,305
3657,"Shewandagn Hailu – Simes - ሸዋንዳኝ ሃይሉ - ስሜስ -  Ethiopian Music by Nahom Records Inc 2 years ago 5 minutes, 1 second 6,176 views",Nahom Records,6176,6333,157
3658,"Neway Debebe - Yeayne Abeba Nesh - ነዋይ ደበበ - የአይኔ አበባ ነሽ - Ethiopian Music by Nahom Records Inc 2 years ago 4 minutes, 9 seconds 44,293 views",Nahom Records,44293,45253,960
3659,"Abiy Kasahun - Basayegn - አብይ ካሳሁን - ባሳየኝ - Ethiopian Music by Nahom Records Inc 2 years ago 4 minutes, 32 seconds 1,074 views",Nahom Records,1074,1082,8
3660,"Madingo Afework - Mahlet - ማዲንጎ አፈወርቅ - ማህሌት - Ethiopian Music by Nahom Records Inc 2 years ago 4 minutes, 31 seconds 23,378 views",Nahom Records,23378,23886,508
3661,"Nati Haile – Temesgen New - ናቲ ሐይሌ - ተመስገን ነው - Ethiopian Music by Nahom Records Inc 2 years ago 5 minutes, 5 seconds 2,101 views",Nahom Records,2101,2114,13
3662,"Tigist Afework – Genboyen Aziye -ትግስት አፈወርቅ - ገንቦዬን አዝዬ - Ethiopian Music by Nahom Records Inc 2 years ago 5 minutes, 29 seconds 88,555 views",Nahom Records,88555,88962,407
3663,"Fikiraddis Nekatibeb - Yamu Yamu - ፍቅርአዲስ ነቃጥበብ - ያሙ ያሙ - Ethiopian Music by Nahom Records Inc 2 years ago 5 minutes, 17 seconds 60,719 views",Nahom Records,60719,61084,365
3664,"Alem Kebede - Yebolale - አለም ከበደ - የቦላሌ - Ethiopian Music by Nahom Records Inc 2 years ago 5 minutes, 21 seconds 2,925 views",Nahom Records,2925,2935,10
3665,"Tsegaye Eshetu - Yaye Ale - ፀጋዬ እሸቱ - ያየ አለ - Ethiopian Music by Nahom Records Inc 2 years ago 4 minutes, 55 seconds 185,951 views",Nahom Records,185951,188556,2605
3666,"Abeba Desalegn - Min Tesemah - አበባ ደሳለኝ - ምን ተሠማህ - Ethiopian Music by Nahom Records Inc 2 years ago 4 minutes, 35 seconds 60,065 views",Nahom Records,60065,60226,161
3667,"Hibist Tiruneh - Oromigna - ህብስት ጥሩነህ - ኦሮምኛ - Ethiopian Music by Nahom Records Inc 2 years ago 4 minutes, 35 seconds 13,021 views",Nahom Records,13021,13224,203
3668,"Tibebu Workiye – Ligletsilish - ጥበቡ ወርቅዬ - ልግለጽልሽ - Ethiopian Music by Nahom Records Inc 2 years ago 5 minutes, 54 seconds 1,861,823 views",Nahom Records,1861823,1880014,18191
3669,"Tsehaye Yohannes - Shewit - ፀሐዬ ዮሐንስ - ሸዊት - Ethiopian Music by Nahom Records Inc 2 years ago 5 minutes, 18 seconds 45,004 views",Nahom Records,45004,45508,504
3670,"Daneal w/ Gebreal - Hilm Aydegemim - ዳንኤል ወ/ገብርኤል - ህልም አይደገምም - Ethiopian Music by Nahom Records Inc 2 years ago 5 minutes, 52 seconds 870 views",Nahom Records,870,873,3
3671,"Girma Tefera - Min Honeshal - ግርማ ተፈራ - ምን ሆነሻል - Ethiopian Music by Nahom Records Inc 2 years ago 5 minutes, 9 seconds 29,302 views",Nahom Records,29302,29955,653
3672,"Daneal W/Gebreal – Instrumental (Hulle Menash Mulu) - ዳንኤል ወ/ገብርኤል - (ሁለመናሽ ሙሉ) - Ethiopian Music by Nahom Records Inc 2 years ago 6 minutes, 10 seconds 867 views",Nahom Records,867,869,2
3673,"Fikiraddis Nekatibeb – Bemedinaw - ፍቅርአዲስ ነቃጥበብ - በመዲናው - Ethiopian Music by Nahom Records Inc 2 years ago 5 minutes, 27 seconds 190,411 views",Nahom Records,190411,193254,2843
3674,"Efream Tamiru - Yelelegnin Keyet Lamta - ኤፍሬም ታምሩ - የሌለኝን ከየት ላምጣ - Ethiopian Music by Nahom Records Inc 2 years ago 5 minutes, 43 seconds 136,967 views",Nahom Records,136967,140331,3364
3675,"Daneal W/Gebreal – Instrumental Vol 7 - Ethiopian Music by Nahom Records Inc 2 years ago 5 minutes, 46 seconds 616 views",Nahom Records,616,618,2
3676,"Maritu Legesse - Zerafewa - ዘራፌዋ - Ethiopian Music by Nahom Records Inc 2 years ago 6 minutes, 48 seconds 70,452 views",Nahom Records,70452,71360,908
3677,"Daneal W/Gebreal – Instrumental Vol 7– Ethiopian Music by Nahom Records Inc 2 years ago 5 minutes, 29 seconds 1,329 views",Nahom Records,1329,1342,13
3678,"Tsegaye Eshetu -  Alasgedidishim - አላስገድድሽም - Ethiopian Music by Nahom Records Inc 2 years ago 7 minutes, 38 seconds 120,436 views",Nahom Records,120436,121336,900
3679,"Aster Kebede – Endih New Gubil - እንዲህ ነው ጉብል - Ethiopian Music by Nahom Records Inc 2 years ago 4 minutes, 32 seconds 8,892 views",Nahom Records,8892,9127,235
3680,"Girma Tefera – Ende Enat - እንደ እናት - Ethiopian Music by Nahom Records Inc 2 years ago 5 minutes, 53 seconds 247,413 views",Nahom Records,247413,250172,2759
3681,"Abreham G/Medhin – Hamelmalo - ሐመልማሎ - Ethiopian Music by Nahom Records Inc 2 years ago 6 minutes, 12 seconds 5,894 views",Nahom Records,5894,6077,183
3682,"Madingo Afework – Sew Yelegn - ሠው የለኝ - Ethiopian Music by Nahom Records Inc 2 years ago 5 minutes, 27 seconds 187,154 views",Nahom Records,187154,191760,4606
3683,"Neway Debebe – Adal Gimelitun - አዳል ግመሊቱን - Ethiopian Music by Nahom Records Inc 2 years ago 4 minutes, 35 seconds 9,049 views",Nahom Records,9049,9301,252
3684,"Abeba Desalegn - Bat Asaklugn - ባጥ አሳቅሉኝ - Ethiopian Music by Nahom Records Inc 2 years ago 5 minutes, 30 seconds 32,018 views",Nahom Records,32018,32169,151
3685,"Shewandagn Hailu - Gena Gena -  ገና ገና - Ethiopian Music by Nahom Records Inc 2 years ago 4 minutes, 36 seconds 6,835 views",Nahom Records,6835,6930,95
3686,"Fikiraddis Nekatibeb – Sebebu - ሠበቡ - Ethiopian Music by Nahom Records Inc 2 years ago 6 minutes, 20 seconds 125,114 views",Nahom Records,125114,125787,673
3687,"Bizuayehu Demissie – Atikebdegnim - አትከብደኝም - Ethiopian Music by Nahom Records Inc 2 years ago 6 minutes, 21 seconds 114,582 views",Nahom Records,114582,115911,1329
3688,"Girma Tefera Kassa - Man neber - ማን ነበር - Ethiopian Music by Nahom Records Inc 2 years ago 5 minutes, 4 seconds 10,264 views",Nahom Records,10264,10451,187
3689,"Abreham G/Medhin – Aykemaun - ኣይከምኡን- Ethiopian Music by Nahom Records Inc 2 years ago 5 minutes, 17 seconds 30,419 views",Nahom Records,30419,30833,414
3690,"Michael Lemma -  Libe Sira Feto - ልቤ ስራ ፈቶ - Ethiopian Music by Nahom Records Inc 2 years ago 4 minutes, 13 seconds 5,660 views",Nahom Records,5660,5791,131
3691,"Hibist Tiruneh - Enileyay Beka - እንለያይ በቃ - Ethiopian Music by Nahom Records Inc 2 years ago 5 minutes, 4 seconds 198,482 views",Nahom Records,198482,199411,929
3692,"Nati Haile – Balawekush - ባላወኩሽ - Ethiopian Music by Nahom Records Inc 2 years ago 6 minutes, 32 seconds 14,401 views",Nahom Records,14401,14589,188
3693,"Mikaya Behaylu – Zore Metahu - ሚካያ በሃይሉ - ዞሬ መጣሁ - Ethiopian Music by Nahom Records Inc 2 years ago 6 minutes, 13 seconds 7,607 views",Nahom Records,7607,7655,48
3694,"Bizuayehu Demisse - Ethiopia Kibre - ብዙአየሁ ደምሴ - ኢትዮጵያ ክብሬ - Ethiopian Music by Nahom Records Inc 2 years ago 6 minutes, 16 seconds 17,202 views",Nahom Records,17202,17655,453
3695,"Tsegaye Sime - Nejo Arajo - ፀጋዬ ስሜ - ነጆ አራጆ - New Ethiopian Music 2019 (Official Video) by Nahom Records Inc 2 years ago 6 minutes, 1 second 46,193 views",Nahom Records,46193,46487,294
3696,"Maritu Legesse -  Sekota - ማሪቱ ለገሠ - ሠቆጣ - Ethiopian Music by Nahom Records Inc 2 years ago 5 minutes, 46 seconds 103,234 views",Nahom Records,103234,104076,842
3697,"Tibebu Workye – Endet - ጥበቡ ወርቅዬ - እንዴት - Ethiopian Music by Nahom Records Inc 2 years ago 5 minutes, 38 seconds 200,265 views",Nahom Records,200265,201872,1607
3698,"Aster Kebede - Fikir Des Des - አስቴር ከበደ - ፍቅር ደስ ደስ - Ethiopian Music by Nahom Records Inc 2 years ago 4 minutes, 57 seconds 144,077 views",Nahom Records,144077,148193,4116
3699,"Tsehaye Yohannes & Mahmoud Ahimed – Kunjina - ቁንጅና - Ethiopian Music by Nahom Records Inc 2 years ago 5 minutes, 26 seconds 35,108 views",Nahom Records,35108,35386,278
3700,"Tigist fantahun – Min Keregn - ትግስት ፋንታሁን - ምን ቀረኝ - Ethiopian Music by Nahom Records Inc 2 years ago 6 minutes, 36 seconds 644,633 views",Nahom Records,644633,649918,5285
3701,"Efrem Tamiru - Walshisa Bayne - ኤፍሬም ታምሩ - ዋልሽሳ ባይኔ - Ethiopian Music by Nahom Records Inc 2 years ago 5 minutes, 25 seconds 122,097 views",Nahom Records,122097,125531,3434
3702,"Hibist Tiruneh – Ynegal - ይነጋል - Ethiopia Music by Nahom Records Inc 2 years ago 4 minutes, 41 seconds 124,795 views",Nahom Records,124795,124937,142
3703,"Tsegaye Eshetu – Sew Yala Sew - ሠው ያለ ሠው - Ethiopian Music by Nahom Records Inc 2 years ago 6 minutes, 39 seconds 6,427 views",Nahom Records,6427,6741,314
3704,"Abeba Desalegn - Liyu Lij - ልዩ ልጅ - Ethiopian Music by Nahom Records Inc 2 years ago 3 minutes, 36 seconds 91,758 views",Nahom Records,91758,93786,2028
3705,"Girma Tefera Kasa – Liketelish - ልከተልሽ - Ethiopian Music by Nahom Records Inc 2 years ago 5 minutes, 52 seconds 26,327 views",Nahom Records,26327,26564,237
3706,"FikirAddis Nekatibeb – Yenigat Wef - የንጋት ወፍ - Ethiopian Music by Nahom Records Inc 2 years ago 6 minutes, 6 seconds 11,038 views",Nahom Records,11038,11133,95
3707,"Tesfaye Wube | Zeblider | ዘብልደር | Ethiopian Music by Nahom Records Inc 2 years ago 4 minutes, 29 seconds 2,367 views",Nahom Records,2367,2375,8
3708,"Madingo Afework | Keteleyayen | ከተለያየን | Ethiopian Music by Nahom Records Inc 2 years ago 5 minutes, 9 seconds 8,868 views",Nahom Records,8868,8958,90
3709,"Muhamed Hasen – Meragn - መራኝ - Ethiopian Tunes by Nahom Records Inc 2 years ago 5 minutes, 58 seconds 2,117 views",Nahom Records,2117,2121,4
3710,"Tesfaye wube - Bati - ባቲ - Ethiopian Music, New Ethiopian Music 2019 by Nahom Records Inc 2 years ago 4 minutes, 23 seconds 10,497 views",Nahom Records,10497,10565,68
3711,"Bekele Arega – Wahoye - በቀለ አረጋ - ዋሆዬ - Ethiopian Music 2019 by Nahom Records Inc 2 years ago 5 minutes, 15 seconds 12,366 views",Nahom Records,12366,12405,39
3712,"Asefu Debalke - kibret Alem - አሠፉ ደባልቄ - ክብረት አለም -  New Ethiopian Music by Nahom Records Inc 2 years ago 6 minutes, 18 seconds 51,841 views",Nahom Records,51841,52659,818
3713,"Ashenafi Geremew - Lke Lke - ልኬ ልኬ - New Ethiopian Music 2019 (Official Video) by Nahom Records Inc 2 years ago 6 minutes, 34 seconds 1,083,634 views",Nahom Records,1083634,1085133,1499
3714,"Tesfaye Wube - Shemonmuwana - ተስፋዬ ውቤ - ሸሞንሟና -New Ethiopian Music by Nahom Records Inc 2 years ago 6 minutes, 19 seconds 3,263 views",Nahom Records,3263,3275,12
3715,"Bekele Arega – Awey Sew - በቀለ አረጋ - አወይ ሠው - New Ethiopian Music by Nahom Records Inc 2 years ago 6 minutes, 37 seconds 18,960 views",Nahom Records,18960,19022,62
3716,"Asefu Debalke – Yehoden - አሰፉ ደባልቄ - የሆዴን -New Ethiopian Music 2019 by Nahom Records Inc 2 years ago 6 minutes, 28 seconds 267,701 views",Nahom Records,267701,269485,1784
3717,"Tadese Mekonin and Alem Wube – Ambasel - ታደሠ መኮንን እና አለም ውቤ- አምባሰል - Ethiopian Music by Nahom Records Inc 2 years ago 6 minutes, 56 seconds 4,139 views",Nahom Records,4139,4175,36
3718,"Gizachew Teshome - Ababelekush - ግዛቸው ተሾመ - አባበልኩሽ - Ethiopian Music by Nahom Records Inc 2 years ago 6 minutes, 5 seconds 8,682 views",Nahom Records,8682,8710,28
3719,"Emebet Negasi & Gizachew Teshome – Tizita - እመቤት ነጋሲ እና ግዛቸው  ተሾመ - ትዝታ - New Ethiopian Music by Nahom Records Inc 2 years ago 6 minutes, 45 seconds 231,779 views",Nahom Records,231779,232120,341
3720,"Asefu Debalke – eskemeche - አሠፉ ደባልቄ  - እስከመቼ - New Ethiopian Music 2019 by Nahom Records Inc 2 years ago 5 minutes, 4 seconds 75,399 views",Nahom Records,75399,75749,350
3721,"Mehari Degafaw - Lanchina Legonder - መሃሪ ደገፋው - ላንቺና ለጎንደር - Ethiopian Music by Nahom Records Inc 2 years ago 6 minutes, 17 seconds 5,723 views",Nahom Records,5723,5741,18
3722,"Maritu Legesse – Maleda Maleda - ማሪቱ ለገሰ - ማለዳ ማለዳ - Ethiopian Music by Nahom Records Inc 2 years ago 5 minutes, 28 seconds 27,394 views",Nahom Records,27394,27579,185
3723,"Ahmed Teshome - Teteyeki Nazret - አህመድ ተሾመ - ተጠየቂ ናዝሬት - Ethiopian Music by Nahom Records Inc 2 years ago 5 minutes, 50 seconds 5,983 views",Nahom Records,5983,6024,41
3724,"Aster kebede - Enew Erase Negn -  አስቴር ከበደ - እኔ እራሴው ነኝ - Ethiopian Music by Nahom Records Inc 2 years ago 6 minutes, 2 seconds 3,378 views",Nahom Records,3378,3391,13
3725,"Madingo Afework – Tizita - ማዲንጎ አፈወርቅ -ትዝታ - Ethiopian Music by Nahom Records Inc 2 years ago 7 minutes, 2 seconds 217,143 views",Nahom Records,217143,218577,1434
3726,"Tsehaye Yohannes – Lemastawes - ፀሐዬ ዮሐንስ - ለማስታወስ - Ethiopian Music by Nahom Records Inc 2 years ago 4 minutes, 51 seconds 6,155 views",Nahom Records,6155,6190,35
3727,"Tibebu Workiye – Yezelaleme Nesh - ጥበቡ ወርቅዬ - የዘላለሜ ነሽ - Ethiopian Music by Nahom Records Inc 2 years ago 5 minutes, 29 seconds 48,139 views",Nahom Records,48139,48732,593
3728,"Mikaya Behailu – Nafekegn - ሚካያ በሃይሉ- ናፈቀኝ - Ethiopian Music by Nahom Records Inc 2 years ago 5 minutes, 12 seconds 8,055 views",Nahom Records,8055,8134,79
3729,"Tshaye Yohannes – Yeneta - ጸሐዬ ዮሐንስ - ላንቺማ - - Ethiopian Music by Nahom Records Inc 2 years ago 4 minutes, 57 seconds 47,889 views",Nahom Records,47889,48946,1057
3730,"Tibebu Workiye – Alamaririm - ጥበቡ ወርቅዬ - አላማርርም -  Ethiopian Music by Nahom Records Inc 2 years ago 5 minutes, 44 seconds 117,731 views",Nahom Records,117731,119490,1759
3731,"Gizachew Teshome – Ere Enante hoye - ግዛቸው ተሾመ - አረ እናንተ ሆዬ - Ethiopian Music by Nahom Records Inc 2 years ago 4 minutes, 26 seconds 8,192 views",Nahom Records,8192,8212,20
3732,"Fikiraddis Nekatibeb – Basha Welde - ፍቅርአዲስ ነቃጥበብ - ባሻ ወልዴ - Ethiopian Music by Nahom Records Inc 2 years ago 6 minutes, 42 seconds 38,619 views",Nahom Records,38619,38707,88
3733,"Neway Debebe - Yetkimt Abeba - ነዋይ ደበበ - የጥቅምት አበባ - Ethiopian Music by Nahom Records Inc 2 years ago 3 minutes, 48 seconds 3,675 views",Nahom Records,3675,3725,50
3734,"Abeba Desalegn – Mayet Kentu - አበባ ደሳለኝ - ማየቴ ከንቱ - Ethiopian Music by Nahom Records Inc 2 years ago 5 minutes, 34 seconds 59,887 views",Nahom Records,59887,60170,283
3735,"Abreham G.Medihin – Kaleo - አብርሐም ገ/መድህን -ካኣልዮ - Ethiopian Music by Nahom Records Inc 2 years ago 5 minutes, 58 seconds 1,748 views",Nahom Records,1748,1759,11
3736,"Neway Debebe - Yefikir Gedam - ነዋይ ደበበ - የፍቅር ገዳም - Ethiopian Music by Nahom Records Inc 2 years ago 4 minutes, 5 seconds 45,386 views",Nahom Records,45386,47386,2000
3737,"Maritu Legesse – Tizita - ማሪቱ ለገሰ - ትዝታ - Ethiopoian Music by Nahom Records Inc 2 years ago 6 minutes, 50 seconds 67,125 views",Nahom Records,67125,67734,609
3738,"Shewandagn Hailu - Silene - ሸዋንዳኝ ኃይሉ - ስለኔ - Ethiopian Music by Nahom Records Inc 2 years ago 5 minutes, 10 seconds 2,017 views",Nahom Records,2017,2052,35
3739,"Hibist Tiruneh - Yesuf Abeba - ህብስት ጥሩነህ - የሱፍ አበባ - Ethiopian Music by Nahom Records Inc 2 years ago 5 minutes, 48 seconds 11,866 views",Nahom Records,11866,11942,76
3740,"Aster Kebede - Atasrejugn - አስቴር ከበደ - ሰራሁለት - Ethiopian Music by Nahom Records Inc 2 years ago 4 minutes, 29 seconds 2,637 views",Nahom Records,2637,2651,14
3741,"Abeba Desalegn – Lemin Nafekegn - አበባ ደሳለኝ - ለምን ናፈቅከኝ - Ethiopian Music by Nahom Records Inc 2 years ago 4 minutes, 11 seconds 10,627 views",Nahom Records,10627,10914,287
3742,"Emebet Negasi - Abet Abet - እመቤት ነጋሲ - አቤት አቤት - Ethiopian Music by Nahom Records Inc 2 years ago 4 minutes, 11 seconds 10,032 views",Nahom Records,10032,10081,49
3743,"Fikiraddis Nekatibeb - ፍቅርአዲስ ነቃጥበብ - አዲስ አበባ - Ethiopian Music by Nahom Records Inc 2 years ago 5 minutes, 21 seconds 152,305 views",Nahom Records,152305,153337,1032
3744,"Abi Lakew – Egna Lay - አቢ ላቀው - እኛ ላይ - Ethiopian Music by Nahom Records Inc 2 years ago 4 minutes, 33 seconds 2,333 views",Nahom Records,2333,2349,16
3745,"Girma Tefera Kassa - Bedelish Tafetegn - ግርማ ተፈራ ካሳ - በደልሽ ጣፈጠኝ - Ethiopian Music by Nahom Records Inc 2 years ago 4 minutes, 57 seconds 14,405 views",Nahom Records,14405,14573,168
3746,"Fikiraddis Nekatibeb - zuma - ፍቅርአዲስ ነቃጥበብ - ዙማ - Ethiopian Music by Nahom Records Inc 2 years ago 5 minutes, 34 seconds 22,631 views",Nahom Records,22631,23328,697
3747,"Mikaya Behailu – Lante Sil - ሚካያ በኃይሉ - ላንተ ስል - Ethiopian Music by Nahom Records Inc 2 years ago 4 minutes, 8 seconds 67,521 views",Nahom Records,67521,69920,2399
3748,"Abraham G.Medihin  - Haki Knegreki - አብርሐም ገ/መድህን - ሃቂ ክነግረኪ - Ethiopian Music by Nahom Records Inc 2 years ago 4 minutes, 17 seconds 4,473 views",Nahom Records,4473,4505,32
3749,"Maritu Legesse - Bati - ማሪቱ ለገሠ - ባቲ - Ethiopian Music by Nahom Records Inc 2 years ago 5 minutes, 12 seconds 178,745 views",Nahom Records,178745,180732,1987
3750,"Hibist Tiruneh - Memtate Aykerim - ህብስት ጥሩነህ - መምጣቴ አይቀርም - Ethiopian Music by Nahom Records Inc 2 years ago 4 minutes, 29 seconds 51,811 views",Nahom Records,51811,52163,352
3751,"Asefu Debalke – Litegnabet - አሠፉ ደባልቄ - ልተኛበት - New Ethiopian Music 2019 by Nahom Records Inc 2 years ago 6 minutes, 37 seconds 76,477 views",Nahom Records,76477,77095,618
3752,"Michael Lemma – Kelib Eniwaded  -  ሚካኤል ለማ - ከልብ እንዋደድ - Ethiopian Music by Nahom Records Inc 2 years ago 4 minutes, 42 seconds 1,923 views",Nahom Records,1923,1946,23
3753,"Fikiraddis Nekatibeb - Ybelegn - ፍቅርአዲስ ነቃጥበብ - ይበለኝ - Ethiopian Music by Nahom Records Inc 2 years ago 4 minutes, 33 seconds 20,752 views",Nahom Records,20752,20827,75
3754,"Abi Lakew  - Aleme - አቢ ላቀው - አለሜ - Ethiopian Music by Nahom Records Inc 2 years ago 5 minutes, 34 seconds 1,974 views",Nahom Records,1974,1979,5
3755,"Michael Lemma – Yena Hasab -  ሚካኤል ለማ - የኔ ሐሳብ - Ethiopian Music by Nahom Records Inc 2 years ago 5 minutes 11,549 views",Nahom Records,11549,11656,107
3756,"Mikaya Behailu – Atasgedidegn -  ሚካያ በኃይሉ - አታስገድደኝ - Ethiopian Music by Nahom Records Inc 2 years ago 4 minutes, 44 seconds 7,163 views",Nahom Records,7163,7268,105
3757,"Ephrem Tamiru – Aguwaguwazegn - አፍሬም ታምሩ - አጓጓዘኝ ጎዳናው -  Ethiopian Music by Nahom Records Inc 2 years ago 7 minutes, 51 seconds 25,248 views",Nahom Records,25248,25392,144
3758,"Shewandagn Hailu - Sibirbir - ሸዋንዳኝ ኃይሉ - ስብርብር - Ethiopian Music by Nahom Records Inc 2 years ago 5 minutes, 20 seconds 8,845 views",Nahom Records,8845,9064,219
3759,"Tamirat desta – Tizita Nat Eswa - ታምራት ደስታ - ትዝታ ናት እሷ  - Ethiopian Music by Nahom Records Inc 2 years ago 9 minutes, 35 seconds 17,499 views",Nahom Records,17499,17741,242
3760,"Bizuayehu Demisse – Fikirish Betizita - ብዙአየሁ ደምሴ - ፍቅርሽ በትዝታ - Ethiopian Music by Nahom Records Inc 2 years ago 6 minutes, 51 seconds 40,369 views",Nahom Records,40369,40447,78
3761,"Hibest Tiruneh - Werash yata Fikir - ህብስት ጥሩነህ - ወራሽ ያጣ ፍቅር - EThiopian Music by Nahom Records Inc 2 years ago 6 minutes, 47 seconds 23,790 views",Nahom Records,23790,24130,340
3762,"Madingo Afework - ማዲንጎ አፈወርቅ - ባቲ - Ethiopian Music by Nahom Records Inc 2 years ago 6 minutes, 39 seconds 116,152 views",Nahom Records,116152,117402,1250
3763,"Asefu Debalke – Lalye - አሠፉ ደባልቄ - ላልዬ - Ethiopian Music by Nahom Records Inc 2 years ago 5 minutes, 20 seconds 41,501 views",Nahom Records,41501,41739,238
3764,"Getachew Kassa – Tizita – ጌታቸው ካሳ - ትዝታ - Ethiopian Music by Nahom Records Inc 2 years ago 7 minutes, 6 seconds 92,414 views",Nahom Records,92414,93092,678
3765,"Shewandagn Hailu -Semta Yihon -  ሸዋንዳኝ ሀይሉ - ሰምታ ይሆን - Ethiopian Music by Nahom Records Inc 2 years ago 4 minutes, 15 seconds 4,905 views",Nahom Records,4905,4961,56
3766,"Tamrat Desta – Anileyaym - ታምራት ደስታ - አንለያይም - Ethiopian Music by Nahom Records Inc 2 years ago 4 minutes, 36 seconds 9,419 views",Nahom Records,9419,9508,89
3767,"Shewandagn Hailu – Leka Adare - ሸዋንዳኝ ኃይሉ - ለካ አዳሬ - Ethiopian Music by Nahom Records Inc 2 years ago 4 minutes, 44 seconds 3,912 views",Nahom Records,3912,3978,66
3768,"Asefu Debalke – Hodem Bego Alwale - አሠፉ ደባልቄ - ሆዴም በጎ አልዋለ- Ethiopian Music by Nahom Records Inc 2 years ago 6 minutes, 7 seconds 143,725 views",Nahom Records,143725,144682,957
3769,"Mikaya behailu –Lemalimih - ሚካያ በኃይሉ - ለማልምህ - Ethiopian music by Nahom Records Inc 2 years ago 5 minutes, 30 seconds 3,848 views",Nahom Records,3848,3877,29
3770,"Michael Belayneh –Kine New Tizita - ሚካኤል በላይነህ - ቅኔ ነው ትዝታ -Ethiopian Music by Nahom Records Inc 2 years ago 6 minutes, 33 seconds 14,068 views",Nahom Records,14068,14313,245
3771,"Mikaya Behailu - Honelign - ሚካያ በሃይሉ  (ሆነልኝ) - Ethiopian Music by Nahom Records Inc 2 years ago 3 minutes, 35 seconds 22,489 views",Nahom Records,22489,23167,678
3772,"Ahmed Teshome - Sheger - New Ethiopian Music 2019 by Nahom Records Inc 2 years ago 5 minutes, 22 seconds 659,986 views",Nahom Records,659986,663020,3034
3773,"Bezawerk Asfaw -Tizita- በዛወርቅ አስፋው (ትዝታ)- Ethiopian Music by Nahom Records Inc 2 years ago 11 minutes, 42 seconds 3,169,215 views",Nahom Records,3169215,3191242,22027
3774,"Tsegaye Eshetu -Tizita- ፀጋዬ እሸቱ (ትዝታ)- Ethiopian Music by Nahom Records Inc 2 years ago 6 minutes, 14 seconds 80,964 views",Nahom Records,80964,81538,574
3775,"Mahmoud Ahmed -Tizita- ማህሙድ አህመድ (ትዝታ)- Ethiopian Music by Nahom Records Inc 2 years ago 8 minutes, 59 seconds 62,367 views",Nahom Records,62367,62963,596
3776,"Tigist Fantahun -Tizita- ትግስት ፋንታሁን (ትዝታ)- Ethiopian Music by Nahom Records Inc 2 years ago 7 minutes, 47 seconds 15,329 views",Nahom Records,15329,15443,114
3777,"Hibist Tiruneh- Leyelet- ህብስት ጥሩነህ (ለየለት)- Ethiopian Music by Nahom Records Inc 2 years ago 4 minutes, 58 seconds 13,557 views",Nahom Records,13557,13624,67
3778,"Bizuayehu Demissie -Tizita- ብዙአየሁ ደምሴ (ትዝታ)- Ethiopian Music by Nahom Records Inc 2 years ago 5 minutes, 31 seconds 9,394 views",Nahom Records,9394,9493,99
3779,"Bizuayehu Demise – Tesileshal Ende - ብዙአየሁ ደምሴ (ተስለሻል እንዴ)- Ethiopian Music by Nahom Records Inc 2 years ago 7 minutes, 40 seconds 54,927 views",Nahom Records,54927,55574,647
3780,"Nahom favorite Vol 38 Best Various collection (ZEMA AMAN) by Nahom Records Inc 2 years ago 45 minutes 4,067 views",Nahom Records,4067,4112,45
3781,"Hibist Tiruneh- Weg New- ህብስት ጥሩነህ- ወግ ነው - Ethiopian Music by Nahom Records Inc 2 years ago 6 minutes, 17 seconds 118,402 views",Nahom Records,118402,119731,1329
3782,"Asefu Debalke-Manzeraw  አሠፉ ደባልቄ (ማንዘራው)-Ethiopian Music 2019 by Nahom Records Inc 2 years ago 5 minutes, 13 seconds 70,993 views",Nahom Records,70993,71264,271
3783,"Asefu debalke (Gudaye) አሠፉ ደባልቄ (ጉዳዬ)-Ethiopian Music 2019 by Nahom Records Inc 2 years ago 7 minutes, 24 seconds 79,388 views",Nahom Records,79388,79771,383
3784,"Asefu Debalke (Agizegn) አሠፉ ደባልቄ (አግዘኝ)-Ethiopian Music 2019 by Nahom Records Inc 2 years ago 8 minutes, 26 seconds 222,311 views",Nahom Records,222311,223154,843
3785,"Asefu Debalke (Gora Bel) አሠፉ ደባልቄ (ጎራ በል)-Ethiopian Music by Nahom Records Inc 2 years ago 4 minutes, 55 seconds 109,947 views",Nahom Records,109947,110451,504
3786,"Ethiopian Music: Asefu Debalke-Mesh Kenu-አሰፉ ደባልቄ (መሸ ቀኑ)(Official Video) by Nahom Records Inc 2 years ago 8 minutes 508,925 views",Nahom Records,508925,511268,2343
3787,"Ethiopian Music: Hibist Tiruneh (Tetaltenal Wey) ህብስት ጥሩነህ (ተጣልተናል ወይ) by Nahom Records Inc 2 years ago 4 minutes, 53 seconds 100,039 views",Nahom Records,100039,101811,1772
3788,"Nigerign By Bizuayehu Demisse by Nahom Records Inc 2 years ago 5 minutes, 8 seconds 4,226 views",Nahom Records,4226,4253,27
3789,Best Non Stop Ethiopian instrumental music By The legendary's Mulatu Astatke & Teodros Makonnen by Nahom Records Inc 2 years ago 1 hour 20 views,Nahom Records,20,22,2
3790,"Huwala endaykochish By Legendary Ephrem Tamiru by Nahom Records Inc 2 years ago 6 minutes, 37 seconds 1,680 views",Nahom Records,1680,1691,11
3791,"Sew Meseretu By Legendary Ephrem Tamiru by Nahom Records Inc 2 years ago 8 minutes, 50 seconds 12,953 views",Nahom Records,12953,13083,130
3792,"Assefu Debalkie (Lihed New/ Awdamet) | አሰፉ ደባልቄ (ልሄድ ነው/አውድ አመት) New Ethiopian Music 2019 by Nahom Records Inc 2 years ago 2 minutes, 23 seconds 55,917 views",Nahom Records,55917,56006,89
3793,"Ethiopian Music: Assefu Debalkie (Eregnaw) | አሰፉ ደባልቄ (እረኛው) New Ethiopian Music 2019 by Nahom Records Inc 2 years ago 4 minutes, 1 second 88,466 views",Nahom Records,88466,88763,297
3794,"ተወዳጇ አሰፉ ደባልቄ በሙያ አጋሮቿ አንደበት | Assefu Debalkie in the Eyes of Her Colleagues by Nahom Records Inc 2 years ago 4 minutes, 12 seconds 18,905 views",Nahom Records,18905,18998,93
3795,"Ethiopian Music: Assefu Debalkie (Man Alegn Kelkay) አሰፉ ደባልቄ (ማን አለኝ ከልካይ) New Ethiopian Music 2019 by Nahom Records Inc 2 years ago 6 minutes, 44 seconds 137,833 views",Nahom Records,137833,138401,568
3796,"Ethiopian Music：Assefu Debalkie (Agzegn) አሰፉ ደባልቄ（አግዘኝ）New Ethiopian Music 2019 by Nahom Records Inc 2 years ago 6 minutes, 12 seconds 101,996 views",Nahom Records,101996,102371,375
3797,"Non Stop Ethiopian Instrumental Music By Daniel W/gebriel ( የዳንኤል ወ/ገብርኤል ምርጥ ስራዎች 4 45 54 by Nahom Records Inc 2 years ago 4 hours, 45 minutes 405,540 views",Nahom Records,405540,409747,4207
3798,"FIKIR YISHALAL  Bitsat Seyoum by Nahom Records Inc 2 years ago 7 minutes, 7 seconds 189,500 views",Nahom Records,189500,189702,202
3799,"fikir yishala By Legendery Bitsat Seyoum by Nahom Records Inc 2 years ago 6 minutes, 26 seconds 1,233 views",Nahom Records,1233,1243,10
3800,"Best Traditional music Called ""Arada""  By Zuriyash Abye by Nahom Records Inc 3 years ago 8 minutes, 3 seconds 2,212 views",Nahom Records,2212,2227,15
3801,"5 HOURS Non Stop Best Ethiopian Tizita Collection From Nahom Records Inc by Nahom Records Inc 3 years ago 4 hours, 31 minutes 35,091 views",Nahom Records,35091,35517,426
3802,"Min Hona new By Gedion Daneal by Nahom Records Inc 3 years ago 6 minutes, 51 seconds 71,451 views",Nahom Records,71451,71933,482
3803,"Yalew Qen By Yosef Mersha by Nahom Records Inc 3 years ago 6 minutes, 29 seconds 8,269 views",Nahom Records,8269,8277,8
3804,"Smizz Mayle Bichayen Silefa (ብቻዬን ስለፋ) 2018 by Nahom Records Inc 3 years ago 4 minutes, 24 seconds 1,069 views",Nahom Records,1069,1072,3
3805,"Smizz Mayle hugni weste (ስሚዝ ማይሌ ሁኚ ዉስጤ) 2018 by Nahom Records Inc 3 years ago 3 minutes, 44 seconds 1,165 views",Nahom Records,1165,1165,0
3806,"Smizz Mayle Ahun by Nahom Records Inc 3 years ago 4 minutes, 39 seconds 787 views",Nahom Records,787,787,0
3807,"Ethiopian Music, Ethiopian Songs   YouTube by Nahom Records Inc 3 years ago 1 minute, 33 seconds 1,262 views",Nahom Records,1262,1262,0
3808,Smiz Mayle best Album by Nahom Records Inc 3 years ago 45 seconds 588 views,Nahom Records,588,588,0
3809,"The all new Amharic album by Smizz Mayle by Nahom Records Inc 3 years ago 1 minute, 3 seconds 982 views",Nahom Records,982,988,6
3810,"Manew Esu By Smizz Mayle by Nahom Records Inc 3 years ago 4 minutes, 1 second 2,339 views",Nahom Records,2339,2342,3
3811,"Shelemechigne By Smizz Mayle by Nahom Records Inc 3 years ago 4 minutes, 1 second 1,472 views",Nahom Records,1472,1480,8
3812,"Konjiye By Smizz Mayle by Nahom Records Inc 3 years ago 3 minutes, 42 seconds 1,213 views",Nahom Records,1213,1216,3
3813,"Higgu Annd New By Dan Admassu by Nahom Records Inc 3 years ago 6 minutes, 32 seconds 1,103 views",Nahom Records,1103,1106,3
3814,"Tichlaleh By Kidest Wolde by Nahom Records Inc 3 years ago 4 minutes, 20 seconds 1,539 views",Nahom Records,1539,1541,2
3815,"AYNE WUHA By Yared Belay by Nahom Records Inc 3 years ago 4 minutes, 51 seconds 15,126 views",Nahom Records,15126,15419,293
3816,"Zebenay By Dan Admasu by Nahom Records Inc 3 years ago 5 minutes, 34 seconds 1,928 views",Nahom Records,1928,1943,15
3817,"Ethiopia By Mesele Asmamawu Non stop Ethiopian Traditional Instumental Music by Nahom Records Inc 3 years ago 1 hour, 1 minute 14,493 views",Nahom Records,14493,14529,36
3818,"Kignt Mesele (ቅኝት መሰለ) By Mesele Asmamawu Vol 2
 Non stop ethiopian Traditional Instrumental Music by Nahom Records Inc 3 years ago 1 hour, 6 minutes 5,838 views",Nahom Records,5838,5934,96
3819,"Adona ( አዶና) By Daniel W/gebriel Non stop Ethiopian Instrumental Music by Nahom Records Inc 3 years ago 1 hour, 19 minutes 24,070 views",Nahom Records,24070,24334,264
3820,"Eneman Neberu (Danny) By Daniel woldegebriel Non stop Ethiopian Instrumental Music by Nahom Records Inc 3 years ago 1 hour, 18 minutes 5,561 views",Nahom Records,5561,5697,136
3821,"Min Bedelkuat By Michael Lemma by Nahom Records Inc 3 years ago 3 minutes, 35 seconds 8,729 views",Nahom Records,8729,8829,100
3822,"Tizita By Michael Lemma by Nahom Records Inc 3 years ago 5 minutes, 29 seconds 14,136 views",Nahom Records,14136,14310,174
3823,"Keandu Biet Andu Biet By Michael Lemma by Nahom Records Inc 3 years ago 2 minutes, 46 seconds 7,702 views",Nahom Records,7702,7799,97
3824,"Astawsalehu By Michael Lemma by Nahom Records Inc 3 years ago 4 minutes, 27 seconds 11,361 views",Nahom Records,11361,11493,132
3825,"Kelib Enwaded By Michael Lemma by Nahom Records Inc 3 years ago 4 minutes, 7 seconds 28,504 views",Nahom Records,28504,29255,751
3826,"Endanchi alayehum By Michael lemma by Nahom Records Inc 3 years ago 4 minutes, 4 seconds 9,842 views",Nahom Records,9842,9945,103
3827,"Non stop Instrumental music Vol 7 By Daniel W/Gebriel by Nahom Records Inc 3 years ago 1 hour, 7 minutes 178,022 views",Nahom Records,178022,178927,905
3828,"Adrashash Tefabgne By Michael Lemma by Nahom Records Inc 3 years ago 3 minutes, 13 seconds 15,782 views",Nahom Records,15782,16022,240
3829,"Fikrie Dresh By Michael Lemma by Nahom Records Inc 3 years ago 4 minutes, 37 seconds 15,985 views",Nahom Records,15985,16258,273
3830,"Anchi qonjo By Michael lemma by Nahom Records Inc 3 years ago 3 minutes, 11 seconds 3,734 views",Nahom Records,3734,3788,54
3831,"Kassahun Taye    Sora sora by Nahom Records Inc 3 years ago 7 minutes, 27 seconds 8,695 views",Nahom Records,8695,8879,184
3832,"Shewandagne Hailu    Semes Yemanew by Nahom Records Inc 3 years ago 4 minutes, 57 seconds 4,812 views",Nahom Records,4812,4836,24
3833,"Kassahun Taye    Hagerie Semien by Nahom Records Inc 3 years ago 5 minutes, 35 seconds 457 views",Nahom Records,457,459,2
3834,"Gete Anley   Yeqey Tiqur Teyim   Ashenefech by Nahom Records Inc 3 years ago 5 minutes, 37 seconds 475 views",Nahom Records,475,477,2
3835,"Amsalle Mitkie    Babajaliew by Nahom Records Inc 3 years ago 5 minutes, 40 seconds 2,805 views",Nahom Records,2805,2806,1
3836,"Fikreaddis Nekatibeb   Misekir ምስክር New Best Ethiopian Music Video 2015 by Nahom Records Inc 3 years ago 9 minutes, 56 seconds 4,088 views",Nahom Records,4088,4132,44
3837,"Mekeyershin Salawk By Micheal lemma by Nahom Records Inc 3 years ago 2 minutes, 49 seconds 9,781 views",Nahom Records,9781,9914,133
3838,"Yenie Hasab By Michael lemma by Nahom Records Inc 3 years ago 4 minutes, 51 seconds 31,072 views",Nahom Records,31072,31485,413
3839,"Libie Sira Feto By Micheal Lemma by Nahom Records Inc 3 years ago 4 minutes, 9 seconds 18,597 views",Nahom Records,18597,19176,579
3840,"Des Blagnalech by michael lemma by Nahom Records Inc 3 years ago 3 minutes, 24 seconds 3,661 views",Nahom Records,3661,3745,84
3841,"Nahom favorite Vol 30 Non stop Weeding Instrumental By Daniel w/Gebriel Teklu Demisse by Nahom Records Inc 3 years ago 56 minutes 73,483 views",Nahom Records,73483,73994,511
3842,"(Hasabe) Non Stop Ethiopian Instumental By Thewodros mitiku by Nahom Records Inc 3 years ago 56 minutes 1,986 views",Nahom Records,1986,2026,40
3843,"Fikir Ayarejim Non Stop Ethiopian Instrumental  By Theodros mitiku by Nahom Records Inc 3 years ago 1 hour, 12 minutes 37,411 views",Nahom Records,37411,37661,250
3844,"Ethiopiawitwua Non stop Instrumental By Dawit frew  Vol 3 by Nahom Records Inc 3 years ago 53 minutes 101,336 views",Nahom Records,101336,102555,1219
3845,"Balager By Semahegn Belew by Nahom Records Inc 3 years ago 7 minutes, 35 seconds 2,057 views",Nahom Records,2057,2076,19
3846,"kidame Gebeya By Betelhem Dagnachew by Nahom Records Inc 3 years ago 5 minutes, 6 seconds 19,053 views",Nahom Records,19053,19649,596
3847,"Muna ney By Tsegaye Eshetu by Nahom Records Inc 3 years ago 4 minutes, 10 seconds 5,510 views",Nahom Records,5510,5535,25
3848,"Fikreaddis Nekatibeb - Misikir by Nahom Records Inc 6 years ago 2 minutes, 43 seconds 26,648 views",Nahom Records,26648,26662,14
3849,"Ephrem Tamiru - ""Endegena"" Reunion CD by Nahom Records Inc 6 years ago 1 minute, 15 seconds 106,728 views",Nahom Records,106728,106752,24
3850,"Ethiopian Wedding Music- Yahobelna- Mesfin  Zeberga -  (Official Music Video) by Nahom Records Inc 7 years ago 6 minutes, 4 seconds 17,523 views",Nahom Records,17523,17537,14
3851,"Ethiopian Wedding Music- shinte- Mesfin  Zeberga -  (Official Music Video) by Nahom Records Inc 7 years ago 6 minutes, 53 seconds 21,355 views",Nahom Records,21355,21361,6
3852,"Ethiopian Wedding Music- Mushiraye- Mesfin Zeberga - (Official Music Video) by Nahom Records Inc 7 years ago 10 minutes 22,041 views",Nahom Records,22041,22052,11
3853,"Ethiopian Wedding Music- Gena Ewodishalehu- Mesfin  Zeberga -  (Official Music Video) by Nahom Records Inc 7 years ago 6 minutes, 59 seconds 14,753 views",Nahom Records,14753,14763,10
3854,"Ethiopian Wedding Music- Asha Gedawo- Mesfin  Zeberga -  (Official Music Video) by Nahom Records Inc 7 years ago 13 minutes, 50 seconds 58,758 views",Nahom Records,58758,58873,115
3855,"Ethiopian Wedding Music- Amraul Shegenu - Mesfin  Zeberga -  (Official Music Video) by Nahom Records Inc 7 years ago 13 minutes, 2 seconds 37,331 views",Nahom Records,37331,37343,12
3856,"Ethiopian Wedding Music -Amama- Mesfin zeberga by Nahom Records Inc 7 years ago 4 minutes, 32 seconds 18,716 views",Nahom Records,18716,18724,8
3857,"Ethiopian Wedding Music- Eshete Wayena -Mesfin Zeberga (Official Music Video) by Nahom Records Inc 7 years ago 16 minutes 69,491 views",Nahom Records,69491,69532,41
3858,"Ethiopian Music- Tigrigna song --Abraham Gebremedhin - 2014 (Official Music Video) by Nahom Records Inc 7 years ago 6 minutes, 6 seconds 9,391,457 views",Nahom Records,9391457,9396842,5385
3859,"Ethiopian Music - Buzayehu Demissie- New 2014 - Nanaye (Official Music Video) by Nahom Records Inc 7 years ago 5 minutes, 50 seconds 393,465 views",Nahom Records,393465,393734,269
3860,"New Ethiopian Song Video 2014 --Michael Lemma by Nahom Records Inc 7 years ago 3 minutes, 37 seconds 98,179 views",Nahom Records,98179,98222,43
3861,"Ethiopian New Music 2014. Bezuayehu Demissie by Nahom Records Inc 8 years ago 2 minutes, 37 seconds 44,448 views",Nahom Records,44448,44475,27
3862,"Ethiopian Music - BIZUAYEHU DEMISSIE -  NEW CD Coming Soon (SALAYESH) by Nahom Records Inc 8 years ago 2 minutes, 5 seconds 23,803 views",Nahom Records,23803,23815,12
3863,"Ethiopian Music - Naty Hiale - Legitwa (Official Music Video) by Nahom Records Inc 8 years ago 5 minutes, 21 seconds 12,366 views",Nahom Records,12366,12407,41
3864,"Ethiopian Music - Bisrat Garedew - Asayegn (Official Music Video) by Nahom Records Inc 8 years ago 4 minutes, 45 seconds 205,364 views",Nahom Records,205364,207250,1886
3865,"Ethiopian Music - Abby Lakew - Manale (Official Music Video) by Nahom Records Inc 8 years ago 5 minutes, 46 seconds 49,550 views",Nahom Records,49550,49677,127
3866,"Ethiopian Music - Abby Lakew - Gen Lemndnew (Official Music Video) by Nahom Records Inc 8 years ago 6 minutes, 11 seconds 209,211 views",Nahom Records,209211,210634,1423
3867,"Ethiopian Music - Abby Lakew - Egnaly (Official Music Video) by Nahom Records Inc 8 years ago 5 minutes, 3 seconds 267,071 views",Nahom Records,267071,268139,1068
3868,"Ethiopian Music- Abby Lakew - Desta (Official Music Video) by Nahom Records Inc 8 years ago 5 minutes, 22 seconds 671,138 views",Nahom Records,671138,678598,7460
3869,"Ethiopian Music - Elizabeth Meshesha - Anbesa (Official Music Video) by Nahom Records Inc 8 years ago 4 minutes, 33 seconds 4,735 views",Nahom Records,4735,4740,5
3870,"Ethiopian Music-Tigabu Chernet - Agewonga (Official Music Video) by Nahom Records Inc 8 years ago 4 minutes, 11 seconds 2,993 views",Nahom Records,2993,2994,1
3871,"Ethiopian Music - Tigabu Chernet - Balager (Official Music Video) by Nahom Records Inc 8 years ago 5 minutes, 28 seconds 11,405 views",Nahom Records,11405,11427,22
3872,"Ethiopia Music - Bisrat Garedew (Official Music Video) by Nahom Records Inc 8 years ago 6 minutes, 35 seconds 516,231 views",Nahom Records,516231,518958,2727
3873,"Ethiopia Music - Abby Lakew - Iyenen Atmelket (Official Music Video) by Nahom Records Inc 8 years ago 5 minutes, 3 seconds 123,664 views",Nahom Records,123664,123692,28
3874,"Ethiopian  Music -  Abby Lakew Ft  Lioness Vikki - Manale (Official Music Video) by Nahom Records Inc 8 years ago 4 minutes, 53 seconds 19,309 views",Nahom Records,19309,19325,16
3875,"Ethiopian Music - Abbie - Hello Ethiopia - (Official Music Video) by Nahom Records Inc 8 years ago 5 minutes, 58 seconds 13,659 views",Nahom Records,13659,13666,7
3876,"Ethiopian Music - Tigabu Chernet - ZewZew - (Official Music Video) by Nahom Records Inc 8 years ago 4 minutes, 13 seconds 21,563 views",Nahom Records,21563,21588,25
3877,"Ethiopian Music - Zuryash - Arada (Official Music Video) by Nahom Records Inc 8 years ago 7 minutes, 55 seconds 54,257 views",Nahom Records,54257,55220,963
3878,"Ethiopian Music - Teferi -  Limbo - Sidama (Official Music Video) by Nahom Records Inc 8 years ago 4 minutes, 3 seconds 11,343 views",Nahom Records,11343,11364,21
3879,"Ethiopia Music - Demisey Teka - Hasehooro  (Official Music Video) by Nahom Records Inc 8 years ago 5 minutes, 18 seconds 3,266 views",Nahom Records,3266,3323,57
3880,"Ethiopia Music - Damitaw Ayele  - Yewolow Lij (Official Music Video) by Nahom Records Inc 8 years ago 5 minutes, 10 seconds 7,839 views",Nahom Records,7839,7888,49
3881,"Ethiopia Music - Damitaw Ayele - Areberebe (Official Music Video) by Nahom Records Inc 8 years ago 5 minutes, 22 seconds 17,731 views",Nahom Records,17731,17765,34
3882,"Ethiopia Music - Andualem Lema - Moresh (Official Music Video) by Nahom Records Inc 8 years ago 5 minutes, 46 seconds 61,047 views",Nahom Records,61047,61097,50
3883,"Ethiopia Music - Andualem Lema - Lijinetey (Official Music Video) by Nahom Records Inc 8 years ago 5 minutes, 5 seconds 14,913 views",Nahom Records,14913,14955,42
3884,"Ethiopia Music - Andualem Lema -  kenawite (Official Music Video) by Nahom Records Inc 8 years ago 4 minutes, 49 seconds 10,714 views",Nahom Records,10714,10721,7
3885,"Ethiopia Music - Tigabu Chernet - Zemam (Official Music Video) by Nahom Records Inc 8 years ago 5 minutes, 30 seconds 3,642 views",Nahom Records,3642,3663,21
3886,"Ethiopia Music - Tegabu Chernet - Tey Silish (Official Music Video) by Nahom Records Inc 8 years ago 4 minutes, 31 seconds 1,338 views",Nahom Records,1338,1343,5
3887,"Ethiopia Music - Tegabu Chernet - Tew Game (Official Music Video) by Nahom Records Inc 8 years ago 4 minutes, 43 seconds 1,576 views",Nahom Records,1576,1580,4
3888,"Ethiopia Music - Indalkachew - Metenu (Official Music Video) by Nahom Records Inc 8 years ago 7 minutes, 14 seconds 5,930 views",Nahom Records,5930,6018,88
3889,"Ethiopia Music - Amsale Mitike - Zemen Endesaat (Official Music Video) by Nahom Records Inc 8 years ago 6 minutes, 35 seconds 330,204 views",Nahom Records,330204,338248,8044
3890,"Ethiopia Music - Amsale Mitike - Zegeyebi (Official Music Video) by Nahom Records Inc 8 years ago 5 minutes, 25 seconds 13,485 views",Nahom Records,13485,13878,393
3891,"Ethiopia Music - Elsabeth Meshesha - Yeselam Zemen (Official Music Video) by Nahom Records Inc 8 years ago 5 minutes, 18 seconds 2,045 views",Nahom Records,2045,2051,6
3892,"Ethiopia Music - Amsale Mitike - Yeshebelu (Official Music Video) by Nahom Records Inc 8 years ago 5 minutes, 41 seconds 651,737 views",Nahom Records,651737,659997,8260
3893,"Ethiopia Music - Amsale Mitike - Halo Megal (Official Music Video) by Nahom Records Inc 8 years ago 6 minutes, 27 seconds 1,155,293 views",Nahom Records,1155293,1180450,25157
3894,"Ethiopia Music - Amsale Mitike - Gedye Neh (Official Music Video) by Nahom Records Inc 8 years ago 5 minutes, 41 seconds 30,030 views",Nahom Records,30030,30332,302
3895,"Ethiopia Music - Amsale Mitike - Beheg Amlak( Official Music Video) by Nahom Records Inc 8 years ago 5 minutes, 40 seconds 51,072 views",Nahom Records,51072,51361,289
3896,"Ethiopia Music - Amsale Mitike - Atnekakagn (Official Music Video) by Nahom Records Inc 8 years ago 6 minutes, 54 seconds 129,301 views",Nahom Records,129301,132092,2791
3897,"Ethiopia Music - Workezebo - Tizita (Official Music Video) by Nahom Records Inc 8 years ago 6 minutes, 30 seconds 23,181 views",Nahom Records,23181,23357,176
3898,"Ethiopia Music - Mekedes Mesfin - Leweye - (Official Music Video) by Nahom Records Inc 8 years ago 4 minutes, 39 seconds 64,254 views",Nahom Records,64254,64482,228
3899,"Ethiopia Music - Gebre & Workezebo - Eretey -(Official Music Video) by Nahom Records Inc 8 years ago 5 minutes, 11 seconds 19,998 views",Nahom Records,19998,20108,110
3900,"Ethiopia Music - Gebere Moges - Aleche Kena - (Official Music Video) by Nahom Records Inc 8 years ago 6 minutes, 5 seconds 16,830 views",Nahom Records,16830,16960,130
3901,"Ethiopia Music - Frehiwot Girma - Borena(Official Music Video) by Nahom Records Inc 8 years ago 6 minutes, 46 seconds 168,407 views",Nahom Records,168407,168690,283
3902,"Ethiopia Music - Ayachew Aboye - Yebre(Official Music Video) by Nahom Records Inc 8 years ago 4 minutes, 30 seconds 8,969 views",Nahom Records,8969,9011,42
3903,"Ethiopia Music - Alehegn Demesey - Alem - (Official Music Video) by Nahom Records Inc 8 years ago 5 minutes, 14 seconds 15,376 views",Nahom Records,15376,15426,50
3904,"Ethiopia Music - Alehegn Demesey & Mekedes - Tiragn - (Official Music Video) by Nahom Records Inc 8 years ago 5 minutes, 18 seconds 131,684 views",Nahom Records,131684,132141,457
3905,"Ethiopia Music - Alehegn Demesey - Yeminjar Lije - (Official Music Video) by Nahom Records Inc 8 years ago 4 minutes, 49 seconds 11,491 views",Nahom Records,11491,11512,21
3906,"Ethiopian Music - Kasahun Taye - Yeagew Lege(Official Music Video) by Nahom Records Inc 8 years ago 6 minutes, 8 seconds 133,062 views",Nahom Records,133062,134121,1059
3907,"Ethiopian Music - Kasahun Taye - Sora(Official Music Video) by Nahom Records Inc 8 years ago 6 minutes, 25 seconds 13,375 views",Nahom Records,13375,13413,38
3908,"Ethiopian Music - Kasahun Taye - Shemelu(Official Music Video) by Nahom Records Inc 8 years ago 6 minutes, 16 seconds 23,805 views",Nahom Records,23805,23926,121
3909,"Ethiopian Music - Kasahun Taye - Megala(Official Music Video) by Nahom Records Inc 8 years ago 5 minutes, 44 seconds 14,036 views",Nahom Records,14036,14110,74
3910,"Ethiopian Music - Emebet Mekonen - Shadey(Official Music Video) by Nahom Records Inc 8 years ago 6 minutes, 47 seconds 51,802 views",Nahom Records,51802,51950,148
3911,"Ethiopian Music - Kasahun Taye - Hagere Semen(Official Music Video) by Nahom Records Inc 8 years ago 5 minutes, 42 seconds 14,412 views",Nahom Records,14412,14446,34
3912,"Ethiopian Music - Kasahun Taye -  Endet Nesh(Official Music Video) by Nahom Records Inc 8 years ago 5 minutes, 29 seconds 121,494 views",Nahom Records,121494,122590,1096
3913,"Ethiopian Music - Kasahun Taye - Enanye(Official Music Video) by Nahom Records Inc 8 years ago 5 minutes, 12 seconds 17,697 views",Nahom Records,17697,17802,105
3914,"Ethiopian Music - Tefera Tibefu - Gonder(Official Music Video) by Nahom Records Inc 8 years ago 5 minutes, 2 seconds 29,785 views",Nahom Records,29785,29811,26
3915,"Ethiopian Music - Selamenesh Zemene - Korahu(Official Music Video) by Nahom Records Inc 8 years ago 6 minutes, 8 seconds 34,505 views",Nahom Records,34505,34627,122
3916,"Ethiopian Music - Gizachew Amare - Hagengna(Official Music Video) by Nahom Records Inc 8 years ago 4 minutes, 59 seconds 6,862 views",Nahom Records,6862,6870,8
3917,"Ethiopian Music - Genet Masresha - Wushet(Official Music Video) by Nahom Records Inc 8 years ago 5 minutes, 27 seconds 44,380 views",Nahom Records,44380,44425,45
3918,"Ethiopian Music - Fanta Bele - Meriko Bitegn(Official Music Video) by Nahom Records Inc 8 years ago 6 minutes, 55 seconds 438,498 views",Nahom Records,438498,439297,799
3919,"Ethiopian Music - Lemlem Shumete - Yeabay Sew(Official Music Video) by Nahom Records Inc 8 years ago 6 minutes, 40 seconds 51,581 views",Nahom Records,51581,52171,590
3920,"Ethiopian Music - Wila Ali Abel Rega - Chacolate(Official Music Video) by Nahom Records Inc 8 years ago 3 minutes, 58 seconds 21,307 views",Nahom Records,21307,21398,91
3921,"Ethiopian Music - Mesrak Taye - Tinafikagnaleh(Official Music Video) by Nahom Records Inc 8 years ago 5 minutes, 12 seconds 192,848 views",Nahom Records,192848,195538,2690
3922,"Ethiopian Music - Mezmur Yohannes - Aregedch Mider(Official Music Video) by Nahom Records Inc 8 years ago 7 minutes, 14 seconds 76,366 views",Nahom Records,76366,76620,254
3923,"Ethiopian Music - Mezimur Yohannes - Liginet(Official Music Video) by Nahom Records Inc 8 years ago 7 minutes 19,006 views",Nahom Records,19006,19067,61
3924,"Ethiopian Music - Efrem Adal - Min Ladrigat(Official Music Video) by Nahom Records Inc 8 years ago 5 minutes, 3 seconds 949,589 views",Nahom Records,949589,959269,9680
3925,"Ethiopian Music - Ahimed Toshome - Awra Amba(Official Music Video) by Nahom Records Inc 8 years ago 5 minutes, 8 seconds 4,653 views",Nahom Records,4653,4659,6
3926,"Ethiopian Music- Ahimed Teshome - Teteyeki Nazeret(Official Music Video) by Nahom Records Inc 8 years ago 5 minutes, 52 seconds 586,791 views",Nahom Records,586791,605321,18530
3927,"Ethiopian Music - Abeba Desalegn - werewn Semichalu(Official Music Video) by Nahom Records Inc 8 years ago 4 minutes, 13 seconds 631,275 views",Nahom Records,631275,631800,525
3928,"Ethiopian Music - Hibest Tiruneh - Kemeshe Metah(Official Music Video) by Nahom Records Inc 8 years ago 4 minutes, 22 seconds 57,518 views",Nahom Records,57518,57527,9
3929,"Ethiopian Music - Hebisit Tiruneh - Kemeshe(Official Music Video) by Nahom Records Inc 8 years ago 5 minutes, 38 seconds 7,501 views",Nahom Records,7501,7504,3
3930,"Ethiopian Music - Geremew - Shegnugn(Official Music Video) by Nahom Records Inc 8 years ago 4 minutes, 33 seconds 3,013 views",Nahom Records,3013,3015,2
3931,"Ethiopian Music - Geremew Asefa - Nesuhi Nesh(Official Music Video) by Nahom Records Inc 8 years ago 6 minutes, 1 second 12,664 views",Nahom Records,12664,12685,21
3932,"Ethiopian Music - Berhanu Tezera - Kef Kef(Official Music Video) by Nahom Records Inc 8 years ago 6 minutes, 21 seconds 14,161 views",Nahom Records,14161,14209,48
3933,"Ethiopian Music - Abi Lakew - Ola(Official Music Video by Nahom Records Inc 8 years ago 4 minutes, 34 seconds 13,499 views",Nahom Records,13499,13562,63
3934,"Ethiopian Music - Geremew Asefa - Keiyen(Official Music Video) by Nahom Records Inc 8 years ago 5 minutes, 53 seconds 9,717 views",Nahom Records,9717,9728,11
3935,"Ethiopian Music - Brehanu Tezera- Selam(Official Music Video) by Nahom Records Inc 8 years ago 7 minutes 2,526 views",Nahom Records,2526,2532,6
3936,"Ethiopian Music - Bizu Ayehu - Yene Konjo(Official Music Video) by Nahom Records Inc 8 years ago 5 minutes, 48 seconds 4,221 views",Nahom Records,4221,4233,12
3937,"Ethiopian Music - Berehanu Tezera - Dere Dere(Official Music Video) by Nahom Records Inc 8 years ago 5 minutes, 47 seconds 2,462 views",Nahom Records,2462,2468,6
3938,"Ethiopian Music - Abi Lakew - Awobel(Official Music Video) by Nahom Records Inc 8 years ago 5 minutes, 36 seconds 8,481 views",Nahom Records,8481,8491,10
3939,"Ethiopian Music- Efrem Tameru- Balageru(Official Music Video) by Nahom Records Inc 8 years ago 8 minutes 13,356 views",Nahom Records,13356,13479,123
3940,"Ethiopian Music- Maaza Yimer- Segawebhe(Official Music Video) by Nahom Records Inc 8 years ago 3 minutes, 56 seconds 1,331 views",Nahom Records,1331,1336,5
3941,"Ethiopian Music- Kebede Lema- Ande(Official Music Video) by Nahom Records Inc 8 years ago 3 minutes, 21 seconds 1,739 views",Nahom Records,1739,1743,4
3942,"Ethiopian Music -Getu Omahire -Salamin(Official Music Video) by Nahom Records Inc 8 years ago 6 minutes, 1 second 34,021 views",Nahom Records,34021,34103,82
3943,"Ethiopian Music -Getu Omahire -Ande new trase(Official Music Video) by Nahom Records Inc 8 years ago 6 minutes, 23 seconds 54,026 views",Nahom Records,54026,54259,233
3944,"Ethiopian Music -Getu Omahere- Inde Matusala(Official Music Video) by Nahom Records Inc 8 years ago 4 minutes, 57 seconds 25,925 views",Nahom Records,25925,26137,212
3945,"Ethiopian Music -Fekire Egz  Zewdu- Fekir(Official Music Video) by Nahom Records Inc 8 years ago 5 minutes, 37 seconds 4,329 views",Nahom Records,4329,4336,7
3946,"Ethiopian Music -Ahmed Tosheme- Yekedeme(Official Music Video) by Nahom Records Inc 8 years ago 5 minutes, 22 seconds 12,487 views",Nahom Records,12487,12555,68
3947,"Ethiopian Music -Ahmed Tosheme- Sigereda(Official Music Video) by Nahom Records Inc 8 years ago 5 minutes, 9 seconds 31,196 views",Nahom Records,31196,31329,133
3948,"Ethiopian Music -Ahmed Tosheme- Inserashine(Official Music Video) by Nahom Records Inc 8 years ago 5 minutes, 10 seconds 106,724 views",Nahom Records,106724,106977,253
3949,"Ethiopian Music- Ahmed Tosheme- Denbe(Official Music Video) by Nahom Records Inc 8 years ago 5 minutes, 21 seconds 884,708 views",Nahom Records,884708,894497,9789
3950,"Ethiopian Music - Ahmed Tosheme - Anchi Fikir(Official Music Video) by Nahom Records Inc 8 years ago 5 minutes, 33 seconds 6,121 views",Nahom Records,6121,6128,7
3951,"Ethiopian Music-Ashenafi Abay-Aythazuley(Official Music Video) by Nahom Records Inc 8 years ago 7 minutes, 37 seconds 24,642 views",Nahom Records,24642,24655,13
3952,"Ethiopian Music-Alemayehu Getachew-Afe Aweshign(Official Music Video) by Nahom Records Inc 8 years ago 4 minutes, 31 seconds 2,602 views",Nahom Records,2602,2620,18
3953,"Ethiopia Music-Meri Abebe-Ahun New(Official Music Video) by Nahom Records Inc 8 years ago 4 minutes, 59 seconds 3,033 views",Nahom Records,3033,3048,15
3954,"Ethiopian Music-Nati-I'm Habesha(Official Music Video) by Nahom Records Inc 8 years ago 4 minutes, 4 seconds 967 views",Nahom Records,967,968,1
3955,"Ethiopian Music-Dj Same-Dero-Maringe Cha(Official Music Video) by Nahom Records Inc 8 years ago 4 minutes, 16 seconds 6,663 views",Nahom Records,6663,6697,34
3956,"Ethiopian Music-ABC Aku-Addis Ladies(Official Music Video) by Nahom Records Inc 8 years ago 4 minutes, 54 seconds 3,079 views",Nahom Records,3079,3098,19
3957,"Ethiopian Music-Alex Feat Teddy Yo-Lemenbecha(Official Music Video) by Nahom Records Inc 8 years ago 3 minutes, 17 seconds 4,762 views",Nahom Records,4762,4794,32
3958,"Ethiopian Music-Haileyesus Yilma-Yefikir Engda(Official Music Video) by Nahom Records Inc 8 years ago 5 minutes, 5 seconds 9,947 views",Nahom Records,9947,9990,43
3959,"Ethiopian Music-Siyamregn & Mahder-Love & Balance(Official Music Video) by Nahom Records Inc 8 years ago 4 minutes, 24 seconds 2,148 views",Nahom Records,2148,2155,7
3960,"Ethiopian Music-Yohannes Bekele-Chembelela(Official Music Video) by Nahom Records Inc 8 years ago 5 minutes, 25 seconds 6,176 views",Nahom Records,6176,6229,53
3961,"Ethiopian Music-Yohannes Tokichaw-Bonus Video(Official Music Video) by Nahom Records Inc 8 years ago 3 minutes, 38 seconds 3,174 views",Nahom Records,3174,3205,31
3962,"Ethiopian Music-Tedy-Yo(Official Music Video) by Nahom Records Inc 8 years ago 3 minutes, 13 seconds 3,823 views",Nahom Records,3823,3850,27
3963,"Ethiopian Music-Tadele Roba-Agabuyo(Officail Music Video) by Nahom Records Inc 8 years ago 6 minutes, 12 seconds 3,094 views",Nahom Records,3094,3117,23
3964,"Ethiopian Music-Ras Yohannes-Neyney(Official Music Video) by Nahom Records Inc 8 years ago 4 minutes, 29 seconds 3,020 views",Nahom Records,3020,3040,20
3965,"Ethiopian Music-Mikias ft Meron-Wow(Official Music Video) by Nahom Records Inc 8 years ago 3 minutes, 46 seconds 1,610 views",Nahom Records,1610,1614,4
3966,"Ethiopian Music-Mahider-Mechenek(Official Music Video) by Nahom Records Inc 8 years ago 4 minutes, 25 seconds 1,197 views",Nahom Records,1197,1204,7
3967,"Ethiopian Music-Layne-Andnen(Official Music Video) by Nahom Records Inc 8 years ago 3 minutes, 52 seconds 1,193 views",Nahom Records,1193,1201,8
3968,"Ethiopian Music-Hilena-Yefikir Tiyakey(Official Music Video) by Nahom Records Inc 8 years ago 4 minutes, 56 seconds 1,077 views",Nahom Records,1077,1079,2
3969,"Ethiopian Music-Fitsum-Kiss me(Offial Music Video) by Nahom Records Inc 8 years ago 5 minutes, 20 seconds 6,841 views",Nahom Records,6841,6865,24
3970,"Ethiopian Music-Dagmawit Tsegaye-Sebseb(Official Music Video) by Nahom Records Inc 8 years ago 5 minutes, 17 seconds 37,479 views",Nahom Records,37479,37578,99
3971,"Ethiopian Music-Berhanu Tezera-bonus video(Official Music Video) by Nahom Records Inc 8 years ago 5 minutes, 39 seconds 836 views",Nahom Records,836,837,1
3972,"Ethiopian Music-Berhanu Tezera-Addis(Official Music Video) by Nahom Records Inc 8 years ago 5 minutes, 8 seconds 3,690 views",Nahom Records,3690,3857,167
3973,"Ethiopian Music-Abel Mulugeta-Ney Samigna(Official Music Video) by Nahom Records Inc 8 years ago 4 minutes, 32 seconds 13,880 views",Nahom Records,13880,14084,204
3974,"Ethiopain Music-Sayat Demise-Tewmaneh(Official Music Video) by Nahom Records Inc 8 years ago 4 minutes, 7 seconds 8,031 views",Nahom Records,8031,8107,76
3975,"Ethiopian Music-Tamerat Desta-Ethiopai(Official Music Video) by Nahom Records Inc 8 years ago 4 minutes, 36 seconds 4,387 views",Nahom Records,4387,4394,7
3976,"Ethiopian Music-Tamerat Desta-Deju(Official Music Video) by Nahom Records Inc 8 years ago 5 minutes, 31 seconds 58,075 views",Nahom Records,58075,58105,30
3977,"Ethiopian Music-Rebbeca Solomon-Romeo(Official Music Video) by Nahom Records Inc 8 years ago 5 minutes, 10 seconds 2,900 views",Nahom Records,2900,2911,11
3978,"Ethiopian Music-Mesfin Zeberga(Official Music Video) by Nahom Records Inc 8 years ago 4 minutes, 49 seconds 2,401 views",Nahom Records,2401,2406,5
3979,"Ethiopian Music-Mesfin Zeberga - Hiwot Nat(Official Music Video) by Nahom Records Inc 8 years ago 5 minutes, 23 seconds 4,428 views",Nahom Records,4428,4441,13
3980,"Ethiopian Music-Mesfin Zeberga -Balageru (Official Music Video) by Nahom Records Inc 8 years ago 7 minutes, 36 seconds 207,532 views",Nahom Records,207532,208465,933
3981,"Ethiopian Music-Mesfin Bekele(Official Music Video) by Nahom Records Inc 8 years ago 6 minutes, 35 seconds 10,147 views",Nahom Records,10147,10172,25
3982,"Ethiopian Music-Mesfin Bekele - Felekech Gonder(Official Music Video) by Nahom Records Inc 8 years ago 5 minutes, 43 seconds 89,010 views",Nahom Records,89010,89324,314
3983,"Ethiopian Music-Mesfin Bekel -Dem Melash(official Music Video) by Nahom Records Inc 8 years ago 6 minutes, 5 seconds 21,398 views",Nahom Records,21398,21509,111
3984,"Ethiopian Music-Eyayu Bele-Ber Mardaw(official Music Video) by Nahom Records Inc 8 years ago 4 minutes, 51 seconds 6,733 views",Nahom Records,6733,6745,12
3985,"Ethiopian Music-Bezawit Zeleke-Menor(official Music Video) by Nahom Records Inc 8 years ago 6 minutes, 11 seconds 6,565 views",Nahom Records,6565,6572,7
3986,"Ethiopian Music Azalech Abate - Leyelegn(official Music Video) by Nahom Records Inc 8 years ago 5 minutes, 28 seconds 17,646 views",Nahom Records,17646,17660,14
3987,"Ethiopian Music-Eskedar Hamesalu-Demo Behilmie(Official Music Video) by Nahom Records Inc 8 years ago 6 minutes, 11 seconds 2,150 views",Nahom Records,2150,2164,14
3988,"Ethiopian Music-Kumelachew Wolde-Efuyi(Official Music Video) by Nahom Records Inc 8 years ago 5 minutes, 43 seconds 1,009 views",Nahom Records,1009,1014,5
3989,"Ethiopian Music-Berhanu Tezera-Manew(Official Music Video) by Nahom Records Inc 8 years ago 4 minutes, 23 seconds 4,189 views",Nahom Records,4189,4200,11
3990,"Ethiopian Music --Asni Abate and Dimonie-Melkamu(Official Music Video) by Nahom Records Inc 8 years ago 4 minutes, 29 seconds 2,884 views",Nahom Records,2884,2896,12
3991,"Ethiopian Music-Eskadar Hamesalu-Gondor(Official Music Video) by Nahom Records Inc 8 years ago 8 minutes, 6 seconds 12,229 views",Nahom Records,12229,12265,36
3992,"Ethiopian Music-Tsedenya G  Markos-Himemie(Official Music Video) by Nahom Records Inc 8 years ago 4 minutes, 50 seconds 6,181 views",Nahom Records,6181,6214,33
3993,"Ethiopian Song-Berhanu Tezera-Bolio(Official Music Video) by Nahom Records Inc 8 years ago 4 minutes, 7 seconds 3,648 views",Nahom Records,3648,3652,4
3994,"Ethiopian Song Eskedar Hamsalu-Tegabegn(Official Music Video) by Nahom Records Inc 8 years ago 6 minutes, 46 seconds 4,917 views",Nahom Records,4917,4950,33
3995,"Ethiopia Music-Michael Belayneh-Tizita(Official Music Video) by Nahom Records Inc 8 years ago 6 minutes, 33 seconds 8,526 views",Nahom Records,8526,8573,47
3996,"Ethiopian Music-Sentayehu Tilahune Hibongo(Official Music Video) by Nahom Records Inc 8 years ago 5 minutes, 56 seconds 35,455 views",Nahom Records,35455,36407,952
3997,"Ethiopian Music-Hibongo Sentayehu Tilahune (Official Music Video) by Nahom Records Inc 8 years ago 5 minutes, 56 seconds 211,688 views",Nahom Records,211688,213656,1968
3998,"BEKA Nati Haile (Official Music Video) Ethiopian Music by Nahom Records Inc 8 years ago 5 minutes, 16 seconds 93,153 views",Nahom Records,93153,94589,1436
3999,"Ethiopian Music, Ethiopian Songs by Nahom Records Inc 8 years ago 1 minute, 33 seconds 9,101 views",Nahom Records,9101,9102,1
4000,#NOMORE RALLY by NarelArt 1 month ago 26 minutes 233 views,NarelArt,233,234,1
4001,Squid Game : Sketch ✍🏽 Tribute by NarelArt 4 months ago 54 seconds 25 views,NarelArt,25,26,1
4002,"NATIONWIDE ROOFING & HOME IMPROVEMENT AD by NarelArt 6 months ago 14 minutes, 58 seconds 104 views",NarelArt,104,107,3
4003,"KELL FENDII FT MACK MANNS - MY LIFE by NarelArt 10 months ago 3 minutes, 2 seconds 959 views",NarelArt,959,960,1
4004,""" RANDOM ACCESS MEMORY ""  ll  Short Film by Narel by NarelArt 2 years ago 4 minutes, 35 seconds 604 views",NarelArt,604,606,2
4005,"SOLO - BOBBY BIZ & SB RICH NOONIE by NarelArt 3 years ago 3 minutes, 57 seconds 516 views",NarelArt,516,516,0
4006,"BK Scandalous - The Loft (6 O Interlude) by NarelArt 6 years ago 7 minutes, 6 seconds 1,119 views",NarelArt,1119,1120,1
4007,"Etsegenet Hailemariam - Tizita  •  New Ethiopian Music • 2018 by NarelArt 7 years ago 4 minutes, 57 seconds 21,710 views",NarelArt,21710,21738,28
4008,"BOBBY BIZ - SOUL by NarelArt 7 years ago 2 minutes, 55 seconds 824 views",NarelArt,824,825,1
4009,"Young Vant - Feed The Fam by NarelArt 8 years ago 3 minutes, 43 seconds 2,247 views",NarelArt,2247,2248,1
4010,"Young Vant - Young Nigga by NarelArt 8 years ago 4 minutes, 21 seconds 2,192 views",NarelArt,2192,2193,1
4011,"LOUIE DINERO - MONEY AND BITCHES by NarelArt 8 years ago 2 minutes, 17 seconds 3,536 views",NarelArt,3536,3536,0
4012,"Sanctuary - Louie DInero Ft FIlly Fu by NarelArt 8 years ago 6 minutes, 2 seconds 8,691 views",NarelArt,8691,8691,0
4013,"SSG - CANT GET CAUGHT UP by NarelArt 8 years ago 5 minutes, 30 seconds 8,214 views",NarelArt,8214,8214,0
4014,"LOUIE DINERO - MONEY GANG FBMG by NarelArt 8 years ago 4 minutes, 20 seconds 6,631 views",NarelArt,6631,6642,11
4015,"SSG - CANT GET CAUGHT UP TRAILER by NarelArt 8 years ago 1 minute, 55 seconds 11,645 views",NarelArt,11645,11645,0
4016,"BOBBY BIZ -  SINCE DAY ONE by NarelArt 9 years ago 5 minutes, 11 seconds 2,268 views",NarelArt,2268,2268,0
4017,"BK SCANDALOUS - SMOKE GOOD .SSG. by NarelArt 9 years ago 4 minutes, 16 seconds 8,411 views",NarelArt,8411,8411,0
4018,"B-DUPREE - HIGHER by NarelArt 9 years ago 7 minutes, 2 seconds 1,102 views",NarelArt,1102,1102,0
4019,"KID WONDER - BACK IN IT by NarelArt 10 years ago 3 minutes, 10 seconds 1,013 views",NarelArt,1013,1013,0
4020,"Columbus St. George Ethiopian Soccer Team NEW YEARS PARTY!! *ESFNA  2011 CHAMPIONSHIPS* by NarelArt 10 years ago 2 minutes, 40 seconds 3,512 views",NarelArt,3512,3513,1
4021,"LONELY STAR - THE WEEKND * EXPRESSIONISM SKETCH - NAREL ARTS by NarelArt 10 years ago 6 minutes, 32 seconds 3,618 views",NarelArt,3618,3618,0
4022,"Etsegenet - Sew negn ena *NEW SINGLE* HOT!! by NarelArt 10 years ago 7 minutes, 7 seconds 24,986 views",NarelArt,24986,25004,18
4023,"COLUMBUS HIP HOP CYPHER by NarelArt 10 years ago 4 minutes, 11 seconds 32,781 views",NarelArt,32781,32783,2
4024,"Brent Dupree - HERE I GO by NarelArt 11 years ago 3 minutes, 27 seconds 1,146 views",NarelArt,1146,1146,0
4025,"Speed Drawing Lil wayne. by NarelArt 12 years ago 5 minutes, 28 seconds 7,226 views",NarelArt,7226,7226,0
4026,"Nati TV - Abey Nerki {ኣበይ ኔርኪ} - New Eritrean Movie Series 2022 - S2/Part 8 by NatiMedia 1 month ago 27 minutes 165,897 views",NatiMedia,165897,169637,3740
4027,"Nati TV - MesTa Hluf {መስጣ ሕሉፍ} - New Eritrean Movie Series 2022 - Part 8 by NatiMedia 1 month ago 28 minutes 79,642 views",NatiMedia,79642,80418,776
4028,"Nati TV - MesTa Hluf {መስጣ ሕሉፍ} - New Eritrean Movie Series 2022 - Part 7 by NatiMedia 1 month ago 30 minutes 69,044 views",NatiMedia,69044,69575,531
4029,"Nati TV - MesTa Hluf {መስጣ ሕሉፍ} - New Eritrean Movie Series 2022 - Part 6 by NatiMedia 2 months ago 30 minutes 71,311 views",NatiMedia,71311,71848,537
4030,"Nati TV - MesTa Hluf {መስጣ ሕሉፍ} - New Eritrean Movie Series 2021 - Part 5 by NatiMedia 2 months ago 30 minutes 68,121 views",NatiMedia,68121,68608,487
4031,"Nati TV - New Eritrean Nati Akra Drama Contest {ውድድር ድራማ} Show 2021 - Part 5 by NatiMedia 2 months ago 33 minutes 6,610 views",NatiMedia,6610,6688,78
4032,"Nati TV - MesTa Hluf {መስጣ ሕሉፍ} - New Eritrean Movie Series 2021 - Part 4 by NatiMedia 2 months ago 30 minutes 60,878 views",NatiMedia,60878,61189,311
4033,"Nati TV - Abey Nerki {ኣበይ ኔርኪ} - New Eritrean Movie Series 2021 - S2/Part 7 by NatiMedia 2 months ago 29 minutes 159,560 views",NatiMedia,159560,160300,740
4034,"Nati TV - New Eritrean Nati Akra Drama Contest {ውድድር ድራማ} Show 2021 - Part 4 by NatiMedia 2 months ago 32 minutes 9,830 views",NatiMedia,9830,9885,55
4035,"Nati TV - MesTa Hluf {መስጣ ሕሉፍ} - New Eritrean Movie Series 2021 - Part 3 by NatiMedia 2 months ago 30 minutes 65,331 views",NatiMedia,65331,65702,371
4036,"Nati TV - New Eritrean Nati Akra Drama Contest {ውድድር ድራማ} Show 2021 - Part 3 by NatiMedia 2 months ago 32 minutes 9,322 views",NatiMedia,9322,9381,59
4037,"Nati TV - Abey Nerki {ኣበይ ኔርኪ} - New Eritrean Movie Series 2021 - S2/Part 6 by NatiMedia 2 months ago 31 minutes 146,602 views",NatiMedia,146602,147039,437
4038,"Nati TV - MesTa Hluf {መስጣ ሕሉፍ} - New Eritrean Movie Series 2021 - Part 2 by NatiMedia 2 months ago 30 minutes 63,093 views",NatiMedia,63093,63453,360
4039,"Nati TV - New Eritrean Nati Akra Drama Contest {ውድድር ድራማ} Show 2021 - Part 2 by NatiMedia 2 months ago 33 minutes 12,152 views",NatiMedia,12152,12201,49
4040,"Nati TV - MesTa Hluf {መስጣ ሕሉፍ} - New Eritrean Movie Series 2021 - Part 1 by NatiMedia 2 months ago 30 minutes 92,843 views",NatiMedia,92843,93353,510
4041,"Nati TV - Abey Nerki {ኣበይ ኔርኪ} - New Eritrean Movie Series 2021 - S2/Part 5 by NatiMedia 2 months ago 31 minutes 148,422 views",NatiMedia,148422,148829,407
4042,"Nati TV - MesTa Hluf {መስጣ ሕሉፍ} - New Eritrean Movie Series 2021 - Premier Saturday by NatiMedia 3 months ago 2 minutes, 22 seconds 14,947 views",NatiMedia,14947,14977,30
4043,"Nati TV - New Eritrean Nati Akra Drama Contest {ውድድር ድራማ} Show 2021 - Part 1 by NatiMedia 3 months ago 40 minutes 41,910 views",NatiMedia,41910,41998,88
4044,"Nati TV - Abey Nerki {ኣበይ ኔርኪ} - New Eritrean Movie Series 2021 - S2/Part 4 by NatiMedia 3 months ago 30 minutes 162,448 views",NatiMedia,162448,162777,329
4045,"Nati TV - Abey Nerki {ኣበይ ኔርኪ} - New Eritrean Movie Series 2021 - S2/Part 3 by NatiMedia 3 months ago 32 minutes 153,864 views",NatiMedia,153864,154205,341
4046,"Nati TV - Abey Nerki {ኣበይ ኔርኪ} - New Eritrean Movie Series 2021 - S2/Part 2 by NatiMedia 4 months ago 30 minutes 157,601 views",NatiMedia,157601,157973,372
4047,"Nati TV - Abey Nerki {ኣበይ ኔርኪ} - New Eritrean Movie Series 2021 - S2/Part 1 by NatiMedia 4 months ago 27 minutes 189,347 views",NatiMedia,189347,189835,488
4048,"Nati TV - Massawa Trip Celebrity Show with Abey Nerki team (ኣባላት ኣበይ ኔርኪ) - Part 3 by NatiMedia 5 months ago 24 minutes 33,497 views",NatiMedia,33497,33567,70
4049,"Nati TV - Massawa Trip Celebrity Show with Abey Nerki team (ኣባላት ኣበይ ኔርኪ) - Part 2 by NatiMedia 5 months ago 18 minutes 37,666 views",NatiMedia,37666,37703,37
4050,"Nati TV - Massawa Trip Celebrity Show with Abey Nerki team (ኣባላት ኣበይ ኔርኪ) - Part 1 by NatiMedia 5 months ago 17 minutes 80,159 views",NatiMedia,80159,80219,60
4051,"Nati TV - Abey Nerki {ኣበይ ኔርኪ} - New Eritrean Movie Series 2021 - Season 2 [Coming Soon] by NatiMedia 6 months ago 2 minutes, 44 seconds 99,369 views",NatiMedia,99369,99406,37
4052,"Nati TV - Interview with top Psychologist Habteweld Misgina {መም ሃብተወልድ ምስግና} Part 2/2 by NatiMedia 6 months ago 43 minutes 6,391 views",NatiMedia,6391,6408,17
4053,"Nati TV - Frdi Emnto {ፍርዲ እምንቶ} - New Eritrean Short Comedy Movie 2021 by NatiMedia 6 months ago 40 minutes 76,101 views",NatiMedia,76101,76209,108
4054,"Nati TV - Interview with top Psychologist Habteweld Misgina {መም ሃብተወልድ ምስግና} Part 1/2 by NatiMedia 6 months ago 44 minutes 14,456 views",NatiMedia,14456,14497,41
4055,"Nati TV - Abey Nerki {ኣበይ ኔርኪ} - New Eritrean Movie Series 2021 - Part 36 by NatiMedia 6 months ago 24 minutes 197,907 views",NatiMedia,197907,198262,355
4056,"Nati TV - Abey Nerki {ኣበይ ኔርኪ} - New Eritrean Movie Series 2021 - Part 35 by NatiMedia 7 months ago 22 minutes 193,218 views",NatiMedia,193218,193455,237
4057,"Nati TV - Abey Nerki {ኣበይ ኔርኪ} - New Eritrean Movie Series 2021 - Part 34 by NatiMedia 7 months ago 24 minutes 194,939 views",NatiMedia,194939,195182,243
4058,"Nati TV - Abey Nerki {ኣበይ ኔርኪ} - New Eritrean Movie Series 2021 - Part 33 by NatiMedia 7 months ago 24 minutes 212,709 views",NatiMedia,212709,212919,210
4059,"Nati TV - Abey Nerki {ኣበይ ኔርኪ} - New Eritrean Movie Series 2021 - Part 32 by NatiMedia 7 months ago 27 minutes 209,748 views",NatiMedia,209748,209984,236
4060,"Nati TV - Lul Tedros l Yikeses telo {ይከሰስ ተሎ} - New Eritrean Tigrigna Music 2021 [Official Video] by NatiMedia 8 months ago 5 minutes, 13 seconds 784,038 views",NatiMedia,784038,786858,2820
4061,"Nati TV - Abey Nerki {ኣበይ ኔርኪ} - New Eritrean Movie Series 2021 - Part 31 by NatiMedia 8 months ago 22 minutes 193,891 views",NatiMedia,193891,194114,223
4062,"Nati TV - Top 10 Best Eritrean Actresses 2020 - 21 by NatiMedia 8 months ago 8 minutes, 48 seconds 37,932 views",NatiMedia,37932,37981,49
4063,"Nati TV - Abey Nerki {ኣበይ ኔርኪ} - New Eritrean Movie Series 2021 - Part 30 by NatiMedia 8 months ago 21 minutes 206,254 views",NatiMedia,206254,206484,230
4064,"Nati TV - Abey Nerki {ኣበይ ኔርኪ} - New Eritrean Movie Series 2021 - Part 29 by NatiMedia 8 months ago 24 minutes 211,100 views",NatiMedia,211100,211335,235
4065,"Nati TV - Abey Nerki {ኣበይ ኔርኪ} - New Eritrean Movie Series 2021 - Part 28 by NatiMedia 8 months ago 23 minutes 199,435 views",NatiMedia,199435,199678,243
4066,"Nati TV - Abey Nerki {ኣበይ ኔርኪ} - New Eritrean Movie Series 2021 - Part 27 by NatiMedia 9 months ago 19 minutes 182,271 views",NatiMedia,182271,182534,263
4067,"Nati TV - Shumay G/hiwet Joli l aQedmyo {ኣቐድምዮ} - New Eritrean Tigrigna Music 2021 [Official Video] by NatiMedia 9 months ago 5 minutes, 47 seconds 534,459 views",NatiMedia,534459,535728,1269
4068,"Nati TV - Abey Nerki {ኣበይ ኔርኪ} - New Eritrean Movie Series 2021 - Part 26 by NatiMedia 9 months ago 24 minutes 204,929 views",NatiMedia,204929,205193,264
4069,"Nati TV - Abey Nerki {ኣበይ ኔርኪ} - New Eritrean Movie Series 2021 - Part 25 by NatiMedia 9 months ago 24 minutes 192,694 views",NatiMedia,192694,192947,253
4070,"Nati TV - Abey Nerki {ኣበይ ኔርኪ} - New Eritrean Movie Series 2021 - Part 24 by NatiMedia 9 months ago 26 minutes 210,038 views",NatiMedia,210038,210315,277
4071,"Awet Teklemariam Hashe l menalo kemay {መንኣሎ ከማይ} - New Eritrean Tigrigna Music 2021 [Official Video] by NatiMedia 10 months ago 4 minutes, 51 seconds 181,166 views",NatiMedia,181166,181365,199
4072,"Nati TV - Abey Nerki {ኣበይ ኔርኪ} - New Eritrean Movie Series 2021 - Part 23 by NatiMedia 10 months ago 25 minutes 196,454 views",NatiMedia,196454,196769,315
4073,"Nati TV - Abey Nerki {ኣበይ ኔርኪ} - New Eritrean Movie Series 2021 - Part 22 by NatiMedia 10 months ago 32 minutes 204,125 views",NatiMedia,204125,204425,300
4074,"Nati TV - Nati Friday Show with Top Artist Kibra Mesfin {ክብራ መስፍን} Part 2/2 by NatiMedia 10 months ago 37 minutes 48,855 views",NatiMedia,48855,48907,52
4075,"Nati TV - Betty Afewerki l Baeley {ባዕለይ} - New Eritrean Tigrigna Music 2021 [Official Video] by NatiMedia 10 months ago 6 minutes 959,966 views",NatiMedia,959966,965029,5063
4076,"Nati TV - Abey Nerki {ኣበይ ኔርኪ} - New Eritrean Movie Series 2021 - Part 21 by NatiMedia 10 months ago 24 minutes 195,654 views",NatiMedia,195654,195961,307
4077,"Nati TV - Interview Show with Top Artist Kibra Mesfin {ክብራ መስፍን} Part 1/2 by NatiMedia 10 months ago 42 minutes 168,392 views",NatiMedia,168392,168499,107
4078,"Nati TV - Abey Nerki {ኣበይ ኔርኪ} - New Eritrean Movie Series 2021 - Part 20 by NatiMedia 10 months ago 29 minutes 207,312 views",NatiMedia,207312,207634,322
4079,"Nati TV - Abey Nerki {ኣበይ ኔርኪ} - New Eritrean Movie Series 2021 - Part 19 by NatiMedia 11 months ago 26 minutes 194,192 views",NatiMedia,194192,194499,307
4080,"Nati TV - Abey Nerki {ኣበይ ኔርኪ} - New Eritrean Movie Series 2021 - Part 18 by NatiMedia 11 months ago 22 minutes 194,988 views",NatiMedia,194988,195267,279
4081,"Nati TV - Wedi Chelay {ወዲ ጨላይ} - New Eritrean Short Comedy Movie 2021 by NatiMedia 11 months ago 26 minutes 152,589 views",NatiMedia,152589,152750,161
4082,"Nati TV - Abey Nerki {ኣበይ ኔርኪ} - New Eritrean Movie Series 2021 - Part 17 by NatiMedia 11 months ago 21 minutes 194,090 views",NatiMedia,194090,194360,270
4083,"Nati TV - Abey Nerki {ኣበይ ኔርኪ} - New Eritrean Movie Series 2021 - Part 16 by NatiMedia 11 months ago 22 minutes 183,867 views",NatiMedia,183867,184097,230
4084,"Nati TV - Seri WaTot {ሰሪ ዋጦት} - New Eritrean Short Comedy Movie 2021 by NatiMedia 11 months ago 35 minutes 167,602 views",NatiMedia,167602,167737,135
4085,"Nati TV - Abey Nerki {ኣበይ ኔርኪ} - New Eritrean Movie Series 2021 - Part 15 by NatiMedia 11 months ago 27 minutes 204,634 views",NatiMedia,204634,204949,315
4086,"Nati TV - Abey Nerki {ኣበይ ኔርኪ} - New Eritrean Movie Series 2021 - Part 14 by NatiMedia 1 year ago 23 minutes 194,723 views",NatiMedia,194723,194919,196
4087,"Nati TV - Abey Nerki {ኣበይ ኔርኪ} - New Eritrean Movie Series 2021 - Part 13 by NatiMedia 1 year ago 24 minutes 193,579 views",NatiMedia,193579,193812,233
4088,"Nati TV - Abey Nerki {ኣበይ ኔርኪ} - New Eritrean Movie Series 2021 - Part 12 by NatiMedia 1 year ago 21 minutes 187,258 views",NatiMedia,187258,187475,217
4089,"Nati TV - Abey Nerki {ኣበይ ኔርኪ} - New Eritrean Movie Series 2020 - Part 11 by NatiMedia 1 year ago 24 minutes 239,615 views",NatiMedia,239615,239860,245
4090,"Nati TV - New Eritrean Celebrity Show 2021 [SE01] - Final by NatiMedia 1 year ago 27 minutes 50,925 views",NatiMedia,50925,50929,4
4091,"Nati TV - Nati Friday Show with Top Artist Alem Rezene {ኣለም ረዘነ} Part 3/3 by NatiMedia 1 year ago 28 minutes 10,969 views",NatiMedia,10969,10989,20
4092,"Nati TV - Abey Nerki {ኣበይ ኔርኪ} - New Eritrean Movie Series 2021 - Part 10 by NatiMedia 1 year ago 22 minutes 206,322 views",NatiMedia,206322,206504,182
4093,"Nati TV - Nati Friday Show with Top Artist Belaynesh Goitom {በላይነሽ ጎይትኦም} Part 2/2 by NatiMedia 1 year ago 41 minutes 33,633 views",NatiMedia,33633,33670,37
4094,"Nati TV - Abey Nerki {ኣበይ ኔርኪ} - New Eritrean Movie Series 2020 - Part 9 by NatiMedia 1 year ago 22 minutes 200,006 views",NatiMedia,200006,200564,558
4095,"Nati TV - Nati Friday Show with Top Artist Belaynesh Goitom {በላይነሽ ጎይትኦም} Part 1/2 by NatiMedia 1 year ago 40 minutes 97,070 views",NatiMedia,97070,97126,56
4096,"Nati TV - Abey Nerki {ኣበይ ኔርኪ} - New Eritrean Movie Series 2021 - Part 8 by NatiMedia 1 year ago 23 minutes 181,003 views",NatiMedia,181003,181108,105
4097,"Nati TV - Sport Journal - Liverpool Achievements - Part 3/3 by NatiMedia 1 year ago 8 minutes, 4 seconds 9,878 views",NatiMedia,9878,9886,8
4098,"Nati TV - Nati Friday Show with Top Artist Alem Rezene {ኣለም ረዘነ} Part 2/3 by NatiMedia 1 year ago 30 minutes 21,126 views",NatiMedia,21126,21146,20
4099,"Nati TV - Abey Nerki {ኣበይ ኔርኪ} - New Eritrean Movie Series 2020 - Part 7 by NatiMedia 1 year ago 24 minutes 184,749 views",NatiMedia,184749,184871,122
4100,"Nati TV - Lipton {ሊፕቶን} - New Eritrean Comedy Movie 2020 by NatiMedia 1 year ago 22 minutes 25,191 views",NatiMedia,25191,25208,17
4101,"Nati TV - Nati Friday Show with Top Artist Alem Rezene {ኣለም ረዘነ} Part 1/3 by NatiMedia 1 year ago 31 minutes 56,304 views",NatiMedia,56304,56337,33
4102,"Nati TV - Abey Nerki {ኣበይ ኔርኪ} - New Eritrean Movie Series 2020 - Part 6 by NatiMedia 1 year ago 24 minutes 185,005 views",NatiMedia,185005,185110,105
4103,"Nati TV - Abey Nerki {ኣበይ ኔርኪ} - New Eritrean Movie Series 2020 - Part 5 by NatiMedia 1 year ago 24 minutes 189,772 views",NatiMedia,189772,189878,106
4104,"Nati TV - New Eritrean Celebrity Show 2020 [SE01-EP05] - Part 2 of 2 by NatiMedia 1 year ago 31 minutes 38,285 views",NatiMedia,38285,38295,10
4105,"Nati TV - Abey Nerki {ኣበይ ኔርኪ} - New Eritrean Movie Series 2020 - Part 4 by NatiMedia 1 year ago 27 minutes 207,805 views",NatiMedia,207805,207935,130
4106,"Nati TV - Eritrean Celebrity Show 2020 [S01 EP05] Part 1/2 by NatiMedia 1 year ago 28 minutes 60,129 views",NatiMedia,60129,60142,13
4107,"Nati TV - Daniel Debesay (Tatula) l Shkorina {ሽኮሪና} - New Eritrean Music 2020 [Official Video] by NatiMedia 1 year ago 4 minutes, 46 seconds 19,906 views",NatiMedia,19906,19924,18
4108,"Nati TV - Abey Nerki {ኣበይ ኔርኪ} - New Eritrean Movie Series 2020 - Part 3 by NatiMedia 1 year ago 23 minutes 209,906 views",NatiMedia,209906,210026,120
4109,"Nati TV - New Eritrean Celebrity Show 2020 [SE01-EP04] - Part 2/2 by NatiMedia 1 year ago 35 minutes 37,186 views",NatiMedia,37186,37197,11
4110,"Nati TV - Abey Nerki {ኣበይ ኔርኪ} - New Eritrean Movie Series 2020 - Part 2 by NatiMedia 1 year ago 25 minutes 216,974 views",NatiMedia,216974,217107,133
4111,"Nati TV - New Eritrean Celebrity Show 2020 [SE01-EP04] - Part 1/2 by NatiMedia 1 year ago 26 minutes 48,578 views",NatiMedia,48578,48582,4
4112,"Nati TV - Abey Nerki {ኣበይ ኔርኪ} - New Eritrean Movie Series 2020 - Part 1 by NatiMedia 1 year ago 27 minutes 300,074 views",NatiMedia,300074,300268,194
4113,"Nati TV - New Eritrean Celebrity Show 2020 [SE01-EP03] - Part 2/2 by NatiMedia 1 year ago 37 minutes 43,104 views",NatiMedia,43104,43112,8
4114,"Nati TV - New Eritrean Celebrity Show 2020 [SE01-EP03] - Part 1/2 by NatiMedia 1 year ago 31 minutes 62,279 views",NatiMedia,62279,62286,7
4115,"Nati TV - New Eritrean Celebrity Show 2020 [SE01-EP02] - Part 2/2 by NatiMedia 1 year ago 38 minutes 61,935 views",NatiMedia,61935,61964,29
4116,"Nati TV - Mahlet Gebregiorgis l Abeyimo {ኣበይሞ} - New Ethiopian Tigrigna Music 2020 [Official Video] by NatiMedia 1 year ago 4 minutes, 23 seconds 4,399,647 views",NatiMedia,4399647,4430956,31309
4117,"Nati TV - New Eritrean Celebrity Show 2020 [SE01-EP02] - Part 1 of 2 by NatiMedia 1 year ago 33 minutes 82,671 views",NatiMedia,82671,82685,14
4118,"Nati TV - New Eritrean Celebrity Show 2020 [SE01-EP01] - Part 2 of 2 by NatiMedia 1 year ago 38 minutes 131,647 views",NatiMedia,131647,131669,22
4119,"Nati TV - Million Eshetu l Haderaka {ሓደራኻ} - New Tigrigna Music 2020 [Official Video] by NatiMedia 1 year ago 4 minutes, 59 seconds 487,241 views",NatiMedia,487241,488310,1069
4120,"Nati TV - New Eritrean Celebrity Show 2020 [SE01-EP01] - Part 1 of 2 by NatiMedia 1 year ago 30 minutes 148,277 views",NatiMedia,148277,148309,32
4121,"Nati TV - Eritrean Celebrity Show 2020 by Sabela Tesfay [Coming Soon] by NatiMedia 1 year ago 2 minutes, 36 seconds 21,576 views",NatiMedia,21576,21597,21
4122,"Nati TV - Special Interview with Top singer Timnit Welday {ትምኒት ወልዳይ} by NatiMedia 1 year ago 16 minutes 289,222 views",NatiMedia,289222,289426,204
4123,"Nati TV - Timnit Welday | qaH {ቃሕ} - Ethiopian Tigrigna Music 2020 [Official Video] by NatiMedia 1 year ago 5 minutes, 1 second 12,127,531 views",NatiMedia,12127531,12190087,62556
4124,"Nati TV - Saba Andemariam | Shenen {ሽነን} - New Eritrean Music 2020 [Official Video] by NatiMedia 1 year ago 5 minutes, 5 seconds 7,628,236 views",NatiMedia,7628236,7670076,41840
4125,"Nati TV - Feven Tsegai | Wusedeni {ውሰደኒ} - New Eritrean Music 2020 [Official Video] by NatiMedia 1 year ago 4 minutes, 40 seconds 4,086,259 views",NatiMedia,4086259,4099252,12993
4126,"Nati TV - zinguO qelbi {ዝንጉዕ ቀልቢ} - New Eritrean Movie Series 2020 - Part 4/4 by NatiMedia 1 year ago 25 minutes 78,282 views",NatiMedia,78282,78315,33
4127,"Nati TV - zinguO qelbi {ዝንጉዕ ቀልቢ} - New Eritrean Movie Series 2020 - Part 3/4 by NatiMedia 1 year ago 28 minutes 88,983 views",NatiMedia,88983,89021,38
4128,"Nati TV - G Mesay Kebede | Egzio Mehren {አግዚዮ ማህረን} - New Ethiopian Music 2020 [Music Video] by NatiMedia 1 year ago 5 minutes, 9 seconds 163,570 views",NatiMedia,163570,163870,300
4129,"Nati TV - Nati Friday Show with Top Actress Helen Riyale {ሄለን ሪያለ} Part 3/3 by NatiMedia 1 year ago 25 minutes 22,684 views",NatiMedia,22684,22703,19
4130,"Nati TV - zinguO qelbi {ዝንጉዕ ቀልቢ} - New Eritrean Movie Series 2020 - Part 2/4 by NatiMedia 1 year ago 26 minutes 96,510 views",NatiMedia,96510,96541,31
4131,"Nati TV - zinguO qelbi {ዝንጉዕ ቀልቢ} - New Eritrean Movie Series 2020 - Part 1/4 by NatiMedia 1 year ago 25 minutes 138,861 views",NatiMedia,138861,138881,20
4132,"Nati TV - Nati Friday Show with Top Actress Helen Riyale {ሄለን ሪያለ} Part 2/3 by NatiMedia 1 year ago 44 minutes 46,378 views",NatiMedia,46378,46410,32
4133,"Nati TV - Sport Journal - Liverpool  Achievments - Part 2/3 by NatiMedia 1 year ago 14 minutes, 15 seconds 3,048 views",NatiMedia,3048,3051,3
4134,"Nati TV - New Eritrean Series Movie 2020 - znbuO qelbi {ዝንቡዕ ቀልቢ} - Coming Soon !!! by NatiMedia 1 year ago 1 minute, 58 seconds 19,608 views",NatiMedia,19608,19612,4
4135,"Nati TV - Msley {ምስለይ} - A film about Student Life (Full Movie) by NatiMedia 1 year ago 1 hour, 54 minutes 61,436 views",NatiMedia,61436,61526,90
4136,"Nati TV - Nati Friday Show with Top Actress Helen Riyale {ሄለን ሪያለ} Part 1/3 by NatiMedia 1 year ago 28 minutes 92,987 views",NatiMedia,92987,93035,48
4137,"Nati TV - Eritrean Fashion Show 2020 by Designer Aman at Westend by NatiMedia 1 year ago 42 minutes 30,691 views",NatiMedia,30691,30750,59
4138,"Nati TV - Nati Friday Show with Top Actress Genet Alem {ገነት ኣለም} Part 2/2 by NatiMedia 1 year ago 28 minutes 23,258 views",NatiMedia,23258,23277,19
4139,"Nati TV - Nati Friday Show with Top Actress Genet Alem {ገነት ኣለም} Part 1/2 by NatiMedia 1 year ago 29 minutes 87,485 views",NatiMedia,87485,87511,26
4140,"Nati TV - Sport Journal - Liverpool Achievements - Part 1/3 by NatiMedia 1 year ago 10 minutes, 53 seconds 3,252 views",NatiMedia,3252,3257,5
4141,"Nati TV - Sizeይ {ሳይዘይ} - New Eritrean Movie Series 2020 - Part 3 by NatiMedia 2 years ago 20 minutes 37,821 views",NatiMedia,37821,37841,20
4142,"Nati TV - Sport Journal - Sir Alex Ferguson Biography - Part 6/6 by NatiMedia 2 years ago 17 minutes 7,728 views",NatiMedia,7728,7735,7
4143,"Nati TV - Sizeይ {ሳይዘይ} - New Eritrean Movie Series 2020 - Part 2 by NatiMedia 2 years ago 25 minutes 64,816 views",NatiMedia,64816,64838,22
4144,"Nati TV - Sizeይ {ሳይዘይ} - New Eritrean Comedy Movie Series 2020 - Part 1 by NatiMedia 2 years ago 28 minutes 139,544 views",NatiMedia,139544,139617,73
4145,"Nati TV - Nati Friday Show with Legend Actress Tsega Hagos {ጸጋ ሓጎስ} Part 3/3 by NatiMedia 2 years ago 31 minutes 18,736 views",NatiMedia,18736,18747,11
4146,"Nati TV - Nati Friday Show with Top Singer Merhawi Tewolde {መርሃዊ ተወልደ} Part 2/2 by NatiMedia 2 years ago 33 minutes 22,742 views",NatiMedia,22742,22763,21
4147,"Nati TV - Lilly {ሊሊ} - New Eritrean Movie Series 2020 - Part 1 & 2 by NatiMedia 2 years ago 37 minutes 82,827 views",NatiMedia,82827,82907,80
4148,"Nati TV - Nati Friday Show with Legend Actress Tsega Hagos {ጸጋ ሓጎስ} Part 2/3 by NatiMedia 2 years ago 27 minutes 26,087 views",NatiMedia,26087,26098,11
4149,"Nati TV - Nati Friday Show with Top Singer Merhawi Tewolde {መርሃዊ ተወልደ} Part 1/2 by NatiMedia 2 years ago 39 minutes 69,141 views",NatiMedia,69141,69177,36
4150,"Nati TV - Nati Friday Show with Legend Actress Tsega Hagos {ጸጋ ሓጎስ} Part 1/3 by NatiMedia 2 years ago 32 minutes 100,390 views",NatiMedia,100390,100416,26
4151,"Nati TV - Lilly{ሊሊ} - New Eritrean Series Comedy 2019 - Part 1 by NatiMedia 2 years ago 21 minutes 69,314 views",NatiMedia,69314,69326,12
4152,"Nati TV - Sport Journal - Eritrean Best Goal Keeper Year 2018 - Million Aforqi - Part 2/2 by NatiMedia 2 years ago 23 minutes 3,690 views",NatiMedia,3690,3693,3
4153,"Nati TV - Sport Journal - Sir Alex Ferguson Biography - Part 5/6 by NatiMedia 2 years ago 13 minutes, 17 seconds 5,107 views",NatiMedia,5107,5113,6
4154,"Nati TV - Sport Journal - Eritrean Best Goal Keeper Year 2018 - Million Aforqi - Part 1/2 by NatiMedia 2 years ago 16 minutes 4,334 views",NatiMedia,4334,4339,5
4155,"Nati TV - Sport Journal - Sir Alex Ferguson Biography - Part 4/6 by NatiMedia 2 years ago 12 minutes, 34 seconds 6,225 views",NatiMedia,6225,6229,4
4156,"Nati TV - Sport Journal - Sir Alex Ferguson Biography - Part 3/6 by NatiMedia 2 years ago 12 minutes, 32 seconds 5,637 views",NatiMedia,5637,5643,6
4157,"Nati TV - Sport Journal - Sir Alex Ferguson Biography - Part 2/6 by NatiMedia 2 years ago 16 minutes 8,942 views",NatiMedia,8942,8951,9
4158,"Nati TV - Sport Journal - Sir Alex Ferguson Biography - Part 1/6 by NatiMedia 2 years ago 11 minutes, 32 seconds 7,693 views",NatiMedia,7693,7699,6
4159,"Nati TV - bxeytey {ብጸይተይ} - New Eritrean Movie Series 2019 - Part 4/4 by NatiMedia 2 years ago 20 minutes 61,060 views",NatiMedia,61060,61080,20
4160,"Nati TV - Nati Talk Show with Top Actress Senait Hagos {ሰናይት ሓጎስ} Part 3/3 by NatiMedia 2 years ago 29 minutes 41,426 views",NatiMedia,41426,41468,42
4161,"Nati TV - bxeytey {ብጸይተይ} - New Eritrean Movie Series 2019 - Part 3/4 by NatiMedia 2 years ago 24 minutes 76,056 views",NatiMedia,76056,76082,26
4162,"Nati TV - Nati Friday Show with Top Actress Senait Hagos {ሰናይት ሓጎስ} Part 2/3 by NatiMedia 2 years ago 29 minutes 87,142 views",NatiMedia,87142,87208,66
4163,"Nati TV - bxeytey {ብጸይተይ} - New Eritrean Movie Series 2019 - Part 2/4 by NatiMedia 2 years ago 25 minutes 104,778 views",NatiMedia,104778,104793,15
4164,"Nati TV - Nati Friday Show with Top Actress Senait Hagos {ሰናይት ሓጎስ} Part 1/3 by NatiMedia 2 years ago 30 minutes 144,395 views",NatiMedia,144395,144493,98
4165,"Nati TV - bxeytey {ብጸይተይ} - New Eritrean Movie Series 2019 - Part 1/4 by NatiMedia 2 years ago 22 minutes 127,602 views",NatiMedia,127602,127616,14
4166,"Nati TV - Abel Kiflom | Rhus Gama {ርሑስ ጋማ}  - New Eritrean Music 2019 [Music Video] by NatiMedia 2 years ago 5 minutes, 38 seconds 68,962 views",NatiMedia,68962,69186,224
4167,"Nati TV - bxeytey {ብጸይተይ} - New Eritrean Movie Series 2019 - Coming Soon !!! by NatiMedia 2 years ago 6 minutes 67,449 views",NatiMedia,67449,67467,18
4168,"Nati TV - Nati Friday Show with Legend Artist Oqbakedir Negash {ዒባ} Part 3/3 by NatiMedia 2 years ago 31 minutes 16,644 views",NatiMedia,16644,16661,17
4169,"Nati TV - Nati Friday Show with Legend Artist Oqbakedir Negash {ዒባ} Part 2/3 by NatiMedia 2 years ago 32 minutes 22,460 views",NatiMedia,22460,22478,18
4170,"Nati TV - Nati Friday Show with Legend Artist Oqbakedir Negash {ዒባ} Part 1/3 by NatiMedia 2 years ago 33 minutes 34,404 views",NatiMedia,34404,34424,20
4171,"Nati TV - Nati Friday Show with Promising Actress Winta Habtemichael {ቅርጣሽ} Part 1/1 by NatiMedia 2 years ago 30 minutes 63,197 views",NatiMedia,63197,63217,20
4172,"Nati TV - Msley {ምስለይ} - New Eritrean Movie Series 2019 - Part 6/6 by NatiMedia 2 years ago 20 minutes 44,337 views",NatiMedia,44337,44351,14
4173,"Nati TV - Msley {ምስለይ} - New Eritrean Movie Series 2019 - Part 5/6 by NatiMedia 2 years ago 21 minutes 47,447 views",NatiMedia,47447,47476,29
4174,"Nati TV - Merhawi {መርሃዊ} - New Eritrean Movie Series 2019 - [Coming Soon] by NatiMedia 2 years ago 3 minutes, 2 seconds 69,183 views",NatiMedia,69183,69431,248
4175,"Nati TV - Msley {ምስለይ} - New Eritrean Movie Series 2019 - Part 4/6 by NatiMedia 2 years ago 20 minutes 56,564 views",NatiMedia,56564,56583,19
4176,"Nati TV - Msley {ምስለይ} - New Eritrean Movie Series 2019 - Part 3/6 by NatiMedia 2 years ago 30 minutes 37,175 views",NatiMedia,37175,37193,18
4177,"Nati TV - Msley {ምስለይ} - New Eritrean Movie Series 2019 - Part 2/6 by NatiMedia 2 years ago 16 minutes 66,254 views",NatiMedia,66254,66273,19
4178,"Nati TV - Interview with Mosaic {ሞዛይክ} 2 Actors - Part 2/2 by NatiMedia 2 years ago 24 minutes 12,043 views",NatiMedia,12043,12043,0
4179,"Nati TV - Msley {ምስለይ} - New Eritrean Movie Series 2019 - Part 1/6 by NatiMedia 2 years ago 23 minutes 103,663 views",NatiMedia,103663,103681,18
4180,"Nati TV - New Eritrean Drama Series 2019 - Msley|ምስለይ [Coming Soon] by NatiMedia 2 years ago 3 minutes, 6 seconds 25,397 views",NatiMedia,25397,25397,0
4181,"Nati TV - Interview with Mosaic {ሞዛይክ} 2 Actors - Part 1/2 by NatiMedia 2 years ago 24 minutes 40,994 views",NatiMedia,40994,40996,2
4182,"Nati TV - Artist Saba Andemaiam Welcome Ceremony [Stockholm 2019] by NatiMedia 2 years ago 10 minutes, 58 seconds 202,202 views",NatiMedia,202202,202310,108
4183,"Nati TV - Nati Friday Show with Top Singer Feven Tsegay {ፌቨን ጸጋይ} Part 2/2 by NatiMedia 2 years ago 26 minutes 63,363 views",NatiMedia,63363,63381,18
4184,"Nati TV - Mosaic {ሞዛይክ} - New Eritrean Movie Series 2019 - S2 EP13 by NatiMedia 2 years ago 24 minutes 96,080 views",NatiMedia,96080,96094,14
4185,"Nati TV - Nati Friday Show with Top Singer Feven Tsegay {ፌቨን ጸጋይ} Part 1/2 by NatiMedia 2 years ago 30 minutes 253,444 views",NatiMedia,253444,253507,63
4186,"Nati TV - Mosaic {ሞዛይክ} - New Eritrean Movie Series 2019 - S2 EP12 by NatiMedia 2 years ago 26 minutes 102,957 views",NatiMedia,102957,102974,17
4187,"Saba Andemariam - Music Concert Tour 2019 by NatiMedia 2 years ago 53 seconds 36,458 views",NatiMedia,36458,36462,4
4188,"Nati TV - Mosaic {ሞዛይክ} - New Eritrean Movie Series 2019 - S2 EP11 by NatiMedia 2 years ago 26 minutes 104,496 views",NatiMedia,104496,104518,22
4189,"Nati TV - Mosaic {ሞዛይክ} - New Eritrean Movie Series 2019 - S2 EP10 by NatiMedia 2 years ago 24 minutes 105,932 views",NatiMedia,105932,105952,20
4190,"Nati TV - Mosaic {ሞዛይክ} - New Eritrean Movie Series 2019 - S2 EP09 by NatiMedia 2 years ago 25 minutes 114,912 views",NatiMedia,114912,114939,27
4191,"Nati TV - Nati Friday Show with Artist Yohannes Amlesom {ዮሃንስ ኣምለሶም} Part 3/3 by NatiMedia 2 years ago 22 minutes 43,052 views",NatiMedia,43052,43093,41
4192,"Nati TV - Mosaic {ሞዛይክ} - New Eritrean Movie Series 2019 - S2 EP08 by NatiMedia 2 years ago 27 minutes 118,282 views",NatiMedia,118282,118298,16
4193,"Nati TV - Nati Friday Show with Artist Yohannes Amlesom {ዮሃንስ ኣምለሶም} Part 2/3 by NatiMedia 2 years ago 21 minutes 86,091 views",NatiMedia,86091,86124,33
4194,"Nati TV - Nati Friday Show with Artist Yohannes Amlesom {ዮሃንስ ኣምለሶም} Part 1/3 by NatiMedia 2 years ago 32 minutes 154,056 views",NatiMedia,154056,154100,44
4195,"Nati TV - Mosaic {ሞዛይክ} - New Eritrean Movie Series 2019 - S2 EP07 by NatiMedia 2 years ago 25 minutes 110,063 views",NatiMedia,110063,110085,22
4196,"Nati TV - Mosaic {ሞዛይክ} - New Eritrean Movie Series 2019 - S2 EP06 by NatiMedia 2 years ago 30 minutes 116,648 views",NatiMedia,116648,116673,25
4197,"Nati TV - Mosaic {ሞዛይክ} - New Eritrean Movie Series 2019 - S2 EP05 by NatiMedia 2 years ago 26 minutes 109,991 views",NatiMedia,109991,110024,33
4198,"Nati TV - Nati Friday Show With Actor Said Anwar {ስዒድ ኣንዋር} Part 1/1 by NatiMedia 2 years ago 31 minutes 118,332 views",NatiMedia,118332,118369,37
4199,"Nati TV - Mosaic {ሞዛይክ} - New Eritrean Movie Series 2019 - S2 EP04 by NatiMedia 2 years ago 29 minutes 120,971 views",NatiMedia,120971,121003,32
4200,"Nati TV - Mosaic {ሞዛይክ} - New Eritrean Movie Series 2019 - S2 EP03 by NatiMedia 2 years ago 27 minutes 119,074 views",NatiMedia,119074,119104,30
4201,"Nati TV - Mosaic {ሞዛይክ} - New Eritrean Movie Series 2019 - S2 EP02 by NatiMedia 2 years ago 27 minutes 126,882 views",NatiMedia,126882,126921,39
4202,"Nati TV - Mosaic {ሞዛይክ} - New Eritrean Movie Series 2019 - S2 EP01 by NatiMedia 2 years ago 26 minutes 151,784 views",NatiMedia,151784,151835,51
4203,"Nati TV - Nati Friday Show With Singer Nahom Tekeste (Mehazay) Part 2/2 by NatiMedia 2 years ago 30 minutes 38,285 views",NatiMedia,38285,38306,21
4204,"Nati TV - Zeyhmamka {ዘይሕማምካ} - New Eritrean Series Comedy 2019 - EP 6 by NatiMedia 2 years ago 25 minutes 74,833 views",NatiMedia,74833,74840,7
4205,"Nati TV - Nahom Tekeste | Lomi Ke {ሎሚ ኸ}  - New Eritrean Music 2019 [Music Video] by NatiMedia 2 years ago 4 minutes, 10 seconds 488,445 views",NatiMedia,488445,488682,237
4206,"Nati TV - Zeyhmamka {ዘይሕማምካ} - New Eritrean Series Comedy 2019 - EP 5 by NatiMedia 2 years ago 23 minutes 88,976 views",NatiMedia,88976,88982,6
4207,"Nati TV - Awet Teklemariam | sOirkni {ስዒርክኒ}  - New Eritrean Music 2019 [Music Video] by NatiMedia 2 years ago 4 minutes, 48 seconds 274,790 views",NatiMedia,274790,274819,29
4208,"Nati TV - Nati Friday Show With Singer Nahom Tekeste (Mehazay) Part 1/2 by NatiMedia 2 years ago 29 minutes 68,423 views",NatiMedia,68423,68438,15
4209,"Nati TV - Zeyhmamka {ዘይሕማምካ} - New Eritrean Series Comedy 2019 - EP 4 by NatiMedia 2 years ago 24 minutes 83,108 views",NatiMedia,83108,83114,6
4210,"Nati TV – Nahom Tekeste (Mehazay) | Lomi Ke {ሎሚ ኸ} - New Eritrean Music 2019 [Coming Soon] by NatiMedia 2 years ago 30 seconds 37,407 views",NatiMedia,37407,37412,5
4211,"Nati TV - Zeyhmamka {ዘይሕማምካ} - New Eritrean Series Comedy 2019 - EP 3 by NatiMedia 2 years ago 26 minutes 109,307 views",NatiMedia,109307,109317,10
4212,"Nati TV - Zeyhmamka {ዘይሕማምካ} - New Eritrean Series Comedy 2019 - EP 1 by NatiMedia 3 years ago 25 minutes 149,013 views",NatiMedia,149013,149026,13
4213,"Nati TV - Zeyhmamka {ዘይሕማምካ} - New Eritrean Series Comedy 2019 - EP 2 by NatiMedia 3 years ago 25 minutes 130,861 views",NatiMedia,130861,130866,5
4214,"Nati TV - Nati Friday Show With Artist Sidon Redi Part 3/3 by NatiMedia 3 years ago 24 minutes 53,855 views",NatiMedia,53855,53893,38
4215,"Nati TV - Haftey Tefqro Wedi {ሓፍተይ ተፍቅሮ ወዲ} - New Eritrean Series Movie 2019 - EP 5 by NatiMedia 3 years ago 25 minutes 171,820 views",NatiMedia,171820,171830,10
4216,"Nati TV - Haftey Tefqro Wedi {ሓፍተይ ተፍቅሮ ወዲ} - New Eritrean Series Movie 2019 - EP 4 by NatiMedia 3 years ago 24 minutes 161,791 views",NatiMedia,161791,161802,11
4217,"Nati TV - Haftey Tefqro Wedi {ሓፍተይ ተፍቅሮ ወዲ} - New Eritrean Series Movie 2019 - EP 3 by NatiMedia 3 years ago 20 minutes 202,068 views",NatiMedia,202068,202087,19
4218,"Nati TV - Nati Friday Show With Artist Sidon Redi Part 2/3 by NatiMedia 3 years ago 36 minutes 61,853 views",NatiMedia,61853,61886,33
4219,"Nati TV - Haftey Tefqro Wedi {ሓፍተይ ተፍቅሮ ወዲ} - New Eritrean Series Movie 2019 - EP 2 by NatiMedia 3 years ago 20 minutes 205,500 views",NatiMedia,205500,205513,13
4220,"Nati TV - Haftey Tefqiro Wedi {ሓፍተይ ተፍቅሮ ወዲ} - New Eritrean Series Movie 2019 - EP 1 by NatiMedia 3 years ago 16 minutes 260,661 views",NatiMedia,260661,260702,41
4221,"Nati TV - Nati Friday Show With Artist Sidon Redi Part 1/3 by NatiMedia 3 years ago 31 minutes 294,407 views",NatiMedia,294407,294520,113
4222,"Nati TV - Exclusive Interview with Artist Awet Teklemariam (Shingrwa 2018 Winner) Part 2/2 by NatiMedia 3 years ago 33 minutes 63,544 views",NatiMedia,63544,63557,13
4223,"Nati TV - Exclusive Interview with Artist Awet Teklemariam (Shingrwa 2018 Winner) Part 1/2 by NatiMedia 3 years ago 36 minutes 193,418 views",NatiMedia,193418,193448,30
4224,"Nati TV - Nati Friday Show With Artist Tesfay Mengesha Part 3/3 by NatiMedia 3 years ago 32 minutes 58,232 views",NatiMedia,58232,58282,50
4225,"Nati TV - Marta {ማርታ} - New Eritrean Series Movie 2018 - Episode 7/7 by NatiMedia 3 years ago 16 minutes 188,823 views",NatiMedia,188823,188963,140
4226,"Nati TV - Rahel Teklezgi | kmetsekaye {ክመጸካ'የ}  - New Eritrean Music 2018 [Music Video] by NatiMedia 3 years ago 6 minutes, 25 seconds 137,370 views",NatiMedia,137370,137426,56
4227,"Nati TV - Marta {ማርታ} - New Eritrean Series Movie 2018 - Episode 6/7 by NatiMedia 3 years ago 16 minutes 223,549 views",NatiMedia,223549,223729,180
4228,"Nati TV - Marta {ማርታ} - New Eritrean Series Movie 2018 - Episode 5/7 by NatiMedia 3 years ago 17 minutes 257,883 views",NatiMedia,257883,258047,164
4229,"Nati TV - Nati Friday Show With Artist Tesfay Mengesha Part 2/3 by NatiMedia 3 years ago 30 minutes 79,188 views",NatiMedia,79188,79249,61
4230,"Nati TV - Marta {ማርታ} - New Eritrean Series Movie 2018 - Episode 4/7 by NatiMedia 3 years ago 18 minutes 284,879 views",NatiMedia,284879,285044,165
4231,"Nati TV - Marta {ማርታ} - New Eritrean Series Movie 2018 - S01 Episode 3/7 by NatiMedia 3 years ago 17 minutes 295,970 views",NatiMedia,295970,296178,208
4232,"Nati TV - Fiori Berhane | Alash ile {ኣላሽ ኢለ} - New Eritrean Music 2018 [Music Video] by NatiMedia 3 years ago 5 minutes, 13 seconds 304,651 views",NatiMedia,304651,304772,121
4233,"Nati TV - Nati Friday Show With Artist Tesfay Mengesha Part 1/3 by NatiMedia 3 years ago 30 minutes 259,659 views",NatiMedia,259659,259839,180
4234,"Nati TV - Nati Friday Show With Artist Fiori Berhane Part 3/3 by NatiMedia 3 years ago 18 minutes 60,797 views",NatiMedia,60797,60807,10
4235,"Nati TV - Abraham Alem (Abi) | Yikela {ይእከላ} - New Eritrean Music 2018 [Live Concert Video ] by NatiMedia 3 years ago 5 minutes, 34 seconds 447,632 views",NatiMedia,447632,448684,1052
4236,"Nati TV - Marta {ማርታ} - New Eritrean Series Movie 2018 - S01 Episode 2/7 by NatiMedia 3 years ago 18 minutes 351,397 views",NatiMedia,351397,351668,271
4237,"Nati TV - Nati Friday Show With Artist Fiori Berhane Part 2/3 by NatiMedia 3 years ago 20 minutes 55,267 views",NatiMedia,55267,55292,25
4238,"Nati TV - Nati Friday Show With Artist Fiori Berhane Part 1/3 by NatiMedia 3 years ago 27 minutes 154,537 views",NatiMedia,154537,154570,33
4239,"Nati TV - Marta {ማርታ} - New Eritrean Series Movie 2018 - S01 Episode 1/7 by NatiMedia 3 years ago 20 minutes 529,083 views",NatiMedia,529083,529462,379
4240,"Nati TV - Berhe Gile (Meshesh) | Oayney {ዓይነይ} - New Eritrean Music 2018 [Music Video] by NatiMedia 3 years ago 5 minutes, 38 seconds 201,960 views",NatiMedia,201960,202041,81
4241,"Nati TV - Saba Andemariam | Harirey {ሃሪረይ} - New Eritrean Music 2018 [Official Music Video] by NatiMedia 3 years ago 5 minutes, 3 seconds 724,335 views",NatiMedia,724335,726064,1729
4242,"Nati TV - Sport Documentary with 5 First National Team Legends from Asmera Bira Part 4/4 by NatiMedia 3 years ago 15 minutes 5,619 views",NatiMedia,5619,5620,1
4243,"Nati TV - Trhas Tekleab (Gual Keren) | Tsebdelay {ጸብደላይ} - New Eritrean Music 2018 [Music Video] by NatiMedia 3 years ago 4 minutes, 55 seconds 1,235,791 views",NatiMedia,1235791,1236822,1031
4244,"Nati TV - Sport Documentary with 5 First National Team Legends from Asmera Bira Part 3/4 by NatiMedia 3 years ago 12 minutes, 37 seconds 4,580 views",NatiMedia,4580,4584,4
4245,"Nati TV - Sport Documentary with 5 First National Team Legends from Asmera Bira Part 2/4 by NatiMedia 3 years ago 8 minutes, 17 seconds 3,754 views",NatiMedia,3754,3760,6
4246,"Nati TV - Nati Friday Show With Artist Weini Tewelde (Selome) Part 2/2 by NatiMedia 3 years ago 27 minutes 28,034 views",NatiMedia,28034,28048,14
4247,"Nati TV - Sport Documentary with 5 First National Team Legends from Asmera Bira Part 1/4 by NatiMedia 3 years ago 12 minutes, 17 seconds 10,767 views",NatiMedia,10767,10769,2
4248,"Nati TV - Nati Friday Show With Artist Weini Tewelde (Selome) Part 1/2 by NatiMedia 3 years ago 24 minutes 114,246 views",NatiMedia,114246,114270,24
4249,"Nati TV - Nati Friday Show with Designer Alemxehay Lebasi Part 2/2 by NatiMedia 3 years ago 24 minutes 10,222 views",NatiMedia,10222,10226,4
4250,"Nati TV - Nati Friday Show with Designer Alemxehay Lebasi Part 1/2 by NatiMedia 3 years ago 22 minutes 43,659 views",NatiMedia,43659,43670,11
4251,"Nati TV - Nati Surprise Show With Artist Berhe Gile (Meshesh) Part 3/3 by NatiMedia 3 years ago 27 minutes 80,144 views",NatiMedia,80144,80271,127
4252,"Nati TV - Nati Friday Show With Artist Girmay Gebrelul (Wedi Muzolo) Part 3/3 by NatiMedia 3 years ago 29 minutes 53,059 views",NatiMedia,53059,53072,13
4253,"Nati TV - Nati Surprise Show With Artist Berhe Gile (Meshesh) Part 2/3 by NatiMedia 3 years ago 31 minutes 173,788 views",NatiMedia,173788,173944,156
4254,"Nati TV - Nati Friday Show With Artist Saba Andermariam Part 2/2 by NatiMedia 3 years ago 22 minutes 99,118 views",NatiMedia,99118,99158,40
4255,"Nati TV - Nati Surprise Show With Artist Berhe Gile (Meshesh) Part 1/3 by NatiMedia 3 years ago 27 minutes 201,624 views",NatiMedia,201624,201753,129
4256,"Nati TV - Nati Friday Show With Artist Saba Andermariam Part 1/2 by NatiMedia 3 years ago 21 minutes 311,106 views",NatiMedia,311106,311235,129
4257,"Nati TV - Nati Friday Show With Artist Girmay Gebrelul (Wedi Muzolo) Part 2/3 by NatiMedia 3 years ago 26 minutes 59,552 views",NatiMedia,59552,59568,16
4258,"Nati TV - Nati Friday Show With Artist Girmay Gebrelul (Wedi Muzolo) Part 1/3 by NatiMedia 3 years ago 22 minutes 165,663 views",NatiMedia,165663,165675,12
4259,"Nati TV - Nati Friday Show With Artist Trhas (Gual Keren) Part 2/2 by NatiMedia 3 years ago 17 minutes 98,296 views",NatiMedia,98296,98326,30
4260,"Nati TV - Nati Friday Show With Artist Trhas (Gual Keren) Part 1/2 by NatiMedia 4 years ago 16 minutes 195,307 views",NatiMedia,195307,195344,37
4261,"Nati TV - Nati Friday Show With Artist Temie Hipop Part 3/3 by NatiMedia 4 years ago 18 minutes 23,474 views",NatiMedia,23474,23482,8
4262,"Nati TV - Nati Friday Show With Artist Temie Hip Hop Part 2/3 by NatiMedia 4 years ago 14 minutes, 57 seconds 22,041 views",NatiMedia,22041,22047,6
4263,"Nati TV - Dirar Gebreyesus | Hulubey - New Eritrean Music 2018 [Official Music Video] by NatiMedia 4 years ago 5 minutes, 27 seconds 321,681 views",NatiMedia,321681,322050,369
4264,"Nati TV - Nati Friday Show With Artist Temie Hip Hop Part 1/3 by NatiMedia 4 years ago 15 minutes 69,401 views",NatiMedia,69401,69417,16
4265,"Nati TV - New Eritrean Interview 2018 With Artist Drar Gebreyesus Part 2 by NatiMedia 4 years ago 14 minutes, 42 seconds 24,620 views",NatiMedia,24620,24627,7
4266,"Nati TV - Abraham Alem (Abi) | Yikela - New Eritrean Music 2018 [Official Music Video] by NatiMedia 4 years ago 5 minutes, 44 seconds 2,749,688 views",NatiMedia,2749688,2755819,6131
4267,"Nati TV - New Eritrean Interview 2018 - Artist Drar Gebreyesus Part 1 by NatiMedia 4 years ago 16 minutes 37,174 views",NatiMedia,37174,37184,10
4268,"Nati TV - New Eritrean Interview with Artist Luul Tekle (Aini) Part 2 by NatiMedia 4 years ago 11 minutes 16,348 views",NatiMedia,16348,16355,7
4269,"Nati TV - New Eritrean Interview with Artist Luul Tekle (Aini) Part 1 by NatiMedia 4 years ago 12 minutes, 58 seconds 49,354 views",NatiMedia,49354,49377,23
4270,"Nati TV - Abraham Alem (Abi) | Yikela [Offical Audio] by NatiMedia 4 years ago 5 minutes, 8 seconds 166,163 views",NatiMedia,166163,166235,72
4271,"Nati TV - The amazing Eritrean disable Football Trainer - Documentary by NatiMedia 4 years ago 1 minute, 34 seconds 2,453 views",NatiMedia,2453,2455,2
4272,"Nati TV - The Eritrean Champion of the Year Footballer - Documentary by NatiMedia 4 years ago 1 minute, 2 seconds 2,007 views",NatiMedia,2007,2008,1
4273,"Nati TV - The First Eritrean National Team with 5 Legends from Melloti - Documentary by NatiMedia 4 years ago 1 minute, 9 seconds 1,482 views",NatiMedia,1482,1482,0
4274,"Nati TV - Marta Series Movie Trailer by NatiMedia 4 years ago 58 seconds 89,900 views",NatiMedia,89900,89902,2
4275,"Nati TV - Nati Media Advert by NatiMedia 4 years ago 6 minutes, 47 seconds 64,738 views",NatiMedia,64738,64740,2
4276,"Ephrem Amare & Eden Gebreselassie - Banderay (ባንዴራይ) - New Tigrigna Music Video 2021 by NBN Records 7 months ago 4 minutes, 37 seconds 582,428 views",NBN Records,582428,590368,7940
4277,"Abebe Araya ft Ephrem Amare - Ambesa (ኣምበሳ) - New Tigrigna Music Video 2021 by NBN Records 7 months ago 4 minutes, 7 seconds 205,515 views",NBN Records,205515,206127,612
4278,"Abraham G/yowhans-ትግራይ(Tigray) New Tigrigna music video by NBN Records 9 months ago 3 minutes, 47 seconds 6,131 views",NBN Records,6131,6227,96
4279,"Abraham G/yowhans-ትግራይ(Tigray) New Tigrigna music video coming soon by NBN Records 10 months ago 1 minute, 6 seconds 13,447 views",NBN Records,13447,13454,7
4280,"Temesgen Nega(pato) -ሃገር እያ ትግራይ(Hager Eya Tigray)- New Tigrigna music video 2021(official video) by NBN Records 10 months ago 4 minutes, 6 seconds 14,166 views",NBN Records,14166,14219,53
4281,"mesgen Nega(pato) -ሃገር እያ ትግራይ(Hager Eya Tigray)- New Tigrigna music video coming soon by NBN Records 10 months ago 1 minute, 3 seconds 1,454 views",NBN Records,1454,1461,7
4282,"መቅደሀ ነቃጥበብ - ምርጥ የ አማርኛ ዘፈኖች ቅንብር | Ethiopian music mashup by News ET Social 2 days ago 5 minutes, 3 seconds 622 views",News ET Social,622,928,306
4283,"ድንገተኛ የልብና የትንፋሽ መቆም ሲያጋጥም የመጀመሪያ ህክምና እርዳታ አሰጣጥ | Healthy Life by News ET Social 3 days ago 14 minutes, 25 seconds 810 views",News ET Social,810,928,118
4284,"የቪያግራ መድሃኒት የጎንዮሽ ጉዳት | Healthy Life by News ET Social 6 days ago 6 minutes, 42 seconds 4,014 views",News ET Social,4014,4176,162
4285,"ተጠንቀቂ!..ከአንዳንድ ወንዶች ባህርይ | Youth by News ET Social 8 days ago 9 minutes, 30 seconds 650 views",News ET Social,650,699,49
4286,"ኮሌስትሮል ከውፍረት ጋር ይገናኛል? | Healthy Life by News ET Social 10 days ago 10 minutes, 55 seconds 767 views",News ET Social,767,1028,261
4287,"ኮስሞቲክስ ከመጠቀማችሁ በፊት አስተውሉ! | Healthy Life by News ET Social 13 days ago 12 minutes, 59 seconds 895 views",News ET Social,895,890,-5
4288,"ወንዶች የሚዋሹባቸው 3 ምክንያቶች | Youth by News ET Social 2 weeks ago 8 minutes, 22 seconds 1,429 views",News ET Social,1429,1468,39
4289,"ጤናማ ያልሆነ የብልት ፈሳሽ በምን ይታወቃል? | Healthy Life by News ET Social 2 weeks ago 13 minutes, 53 seconds 4,350 views",News ET Social,4350,4431,81
4290,"በብጉር ለምን እንጠቃለን? | Healthy Life by News ET Social 2 weeks ago 9 minutes, 51 seconds 1,406 views",News ET Social,1406,1468,62
4291,"ወንዶች በወሲብ ወቅት የሚፈፅሟቸው 3 ስህተቶች | Youth by News ET Social 3 weeks ago 8 minutes, 16 seconds 7,283 views",News ET Social,7283,7399,116
4292,"በሽንት ቧንቧ ኢፌክሽን እየተሰቃየሁ ነው፤ መፍትሔ ምንድነው? የእናንተ ጥያቄዎችና መልሶች እነሆ | Healthy Life by News ET Social 3 weeks ago 12 minutes, 23 seconds 1,940 views",News ET Social,1940,1959,19
4293,"የስንፈተ ወሲብ መነሻዎች | Healthy Life by News ET Social 3 weeks ago 7 minutes, 48 seconds 13,948 views",News ET Social,13948,14234,286
4294,"ጤናማ የፍቅር ሕይወት ለመመስረት | Youth by News ET Social 1 month ago 10 minutes, 11 seconds 992 views",News ET Social,992,1010,18
4295,"የወሊድ መቆጣጠሪያ ለመካንነት ያጋልጣልን? | Healthy Life by News ET Social 1 month ago 11 minutes, 59 seconds 1,768 views",News ET Social,1768,1796,28
4296,"የፌስቱላ ሕመም ከወሊድ ጋር ይያያዛል? by News ET Social 1 month ago 10 minutes, 45 seconds 724 views",News ET Social,724,786,62
4297,"ፍቅር ግንኙነትን ለማሳደግ የሚረዱ 6 ነጥቦች | Youth by News ET Social 1 month ago 14 minutes, 55 seconds 1,250 views",News ET Social,1250,1316,66
4298,"የዲስክ መንሸራተት | Healthy Life by News ET Social 1 month ago 8 minutes, 13 seconds 851 views",News ET Social,851,871,20
4299,"የማህፀን በር ካንሰር ምልክቶች by News ET Social 1 month ago 9 minutes, 27 seconds 2,108 views",News ET Social,2108,2356,248
4300,"ብስለት ማጣት በፍቅር ግንኙነት ውስጥ | Youth by News ET Social 1 month ago 8 minutes, 37 seconds 1,580 views",News ET Social,1580,1585,5
4301,"የሰሞኑ ጉንፋን መሰል ህመም እንዴት እንከላከል? | Healthy Life by News ET Social 1 month ago 9 minutes, 55 seconds 1,290 views",News ET Social,1290,1292,2
4302,"በወር አበባ ወቅት ስለሚከሰት ከፍተኛ ሕመም | Healthy Life by News ET Social 1 month ago 10 minutes, 25 seconds 1,770 views",News ET Social,1770,1782,12
4303,"የፍቅር ጓደኛሽን ~ በፍቅር መጣል ትችያለሽ  | Youth by News ET Social 1 month ago 11 minutes, 29 seconds 1,074 views",News ET Social,1074,1083,9
4304,ከእርግዝና ጋር የተያያዘ የደም ግፊት | Healthy Life by News ET Social 1 month ago 15 minutes 477 views,News ET Social,477,478,1
4305,"ጥሩ ባል እንዴት ማወቅ ትችያለሽ? | Youth by News ET Social 1 month ago 9 minutes, 27 seconds 1,821 views",News ET Social,1821,1840,19
4306,"Mekdeha Nekatibeb - ምን ላርግህ | Min Largh | Oldies Ethiopian Music by News ET Social 1 month ago 4 minutes, 21 seconds 922 views",News ET Social,922,945,23
4307,"በቃጠሎ አደጋ የተጎዳን እንዴት እንርዳ?  | Healthy Life by News ET Social 1 month ago 12 minutes, 24 seconds 355 views",News ET Social,355,357,2
4308,"Mekdeha Nekatibeb - ጠያቂ በዝቶ | Teyaki bezto | Oldies Ethiopian Music by News ET Social 2 months ago 12 minutes, 32 seconds 1,493 views",News ET Social,1493,1522,29
4309,"ለልብ ድካም ህመም ተጋልጠው ይኾን? | Healthy Life by News ET Social 2 months ago 8 minutes, 28 seconds 1,199 views",News ET Social,1199,1205,6
4310,"የአጥንት ስብራት የመጀመሪያ ሕክምና ዕርዳታ | Healthy Life by News ET Social 2 months ago 10 minutes, 18 seconds 584 views",News ET Social,584,609,25
4311,"የፍቅር ግንኙነት አደጋዎች | Youth by News ET Social 2 months ago 12 minutes, 16 seconds 1,418 views",News ET Social,1418,1423,5
4312,"እርግዝና እና  የደም ማነስ | Healthy Life by News ET Social 2 months ago 9 minutes, 17 seconds 794 views",News ET Social,794,796,2
4313,"እርግዝና ለኮቪድ የበለጠ ያጋልጣልን? | Healthy Life by News ET Social 2 months ago 8 minutes, 56 seconds 664 views",News ET Social,664,668,4
4314,"Ethiopia - ከወሲብ ጥቃት ራስሽን ለመጠበቅ ትችያለሽ ግን እንዴት? | Youth by News ET Social 2 months ago 10 minutes, 57 seconds 1,198 views",News ET Social,1198,1198,0
4315,"የሽንት ቱቦ ኢንፌክሽን ሴቶች ላይ ለምን ይበረታል? | Healthy Life by News ET Social 2 months ago 10 minutes, 29 seconds 1,385 views",News ET Social,1385,1389,4
4316,"የብልት ፈንገስ ኢንፌክሽን የሚያጠቃው ሴቶችን ብቻ ነውን? | Healthy Life by News ET Social 2 months ago 9 minutes, 34 seconds 6,542 views",News ET Social,6542,6629,87
4317,"ለወሲብ ብቻ  የሚፈልግሽ ወንድ ባህርያት | Healthy Life by News ET Social 2 months ago 11 minutes, 48 seconds 6,157 views",News ET Social,6157,6175,18
4318,"ከወሊድ በኋላ የሚከሰት የደም መፍሰስ አስጊ ነውን? | Healthy Life by News ET Social 2 months ago 11 minutes, 54 seconds 893 views",News ET Social,893,910,17
4319,"በእርግዝና ወቅት የኤችአይቪ/ኤድስ ተፅዕኖ | Healthy Life by News ET Social 2 months ago 11 minutes, 1 second 928 views",News ET Social,928,930,2
4320,"የርቀት ፍቅረኛሽ ይወድሻል? | Youth by News ET Social 3 months ago 12 minutes, 46 seconds 1,715 views",News ET Social,1715,1725,10
4321,"እርግዝና እና የስኳር ህመም | Healthy Life by News ET Social 3 months ago 13 minutes, 1 second 999 views",News ET Social,999,1029,30
4322,"በእርግዝና ጊዜ የሚከሰት የደም ግፊት ምልክቶች ምንድናቸው? | Healthy Life by News ET Social 3 months ago 9 minutes, 28 seconds 1,215 views",News ET Social,1215,1226,11
4323,"ዉይ ወንዶች?! | Youth by News ET Social 3 months ago 13 minutes, 16 seconds 1,575 views",News ET Social,1575,1585,10
4324,"የማህጸን ዕጢ ያለባት ማርገዝ ትችላለች | የግብረሥጋ ግንኙነት ሳደርግ ያመኛል | ካገባሁ ዓመት ሞላኝ ግን ማርገዝ አልቻልኩም | Healthy Life by News ET Social 3 months ago 14 minutes, 57 seconds 4,799 views",News ET Social,4799,4806,7
4325,"የጨቅላ ሕጻናት እንክብካቤ | Healthy Life by News ET Social 3 months ago 12 minutes, 4 seconds 1,140 views",News ET Social,1140,1320,180
4326,"ቆሞ ለመኼድ ወሳኝ የኾኑ 7 ነጥቦች | Young by News ET Social 3 months ago 14 minutes, 58 seconds 1,096 views",News ET Social,1096,1097,1
4327,"ይጠንቀቁ! ​ከእርግዝና ጋር የተያያዘ የደም መፍሰስ ለሞት ሊዳርግ ይችላል | Healthy Life by News ET Social 3 months ago 14 minutes, 29 seconds 917 views",News ET Social,917,919,2
4328,"ተስማሚ የእርግዝና መከላከያ እንዴት መምረጥ ትችያለሽ? | Healthy Life by News ET Social 3 months ago 15 minutes 2,058 views",News ET Social,2058,2064,6
4329,"የገንዘብ ጥገኛ አትሁኚ  | Youth by News ET Social 3 months ago 17 minutes 1,293 views",News ET Social,1293,1293,0
4330,"የሪህ በሽታ እንዴት ይከሰታል? | Healthy Life by News ET Social 3 months ago 13 minutes, 29 seconds 4,127 views",News ET Social,4127,4376,249
4331,"ከማህፀን ውጪ እርግዝና እንዴት ይከሰታል? | Healthy Life by News ET Social 3 months ago 9 minutes, 39 seconds 3,418 views",News ET Social,3418,3478,60
4332,"ስለትዳር ወጣቶች ምን ይላሉ? | Youth by News ET Social 3 months ago 10 minutes, 38 seconds 1,197 views",News ET Social,1197,1201,4
4333,"ሕፃናት ባዕድ ነገሮችን ሲውጡ የሚያሳዩአቸው ምልክቶች | Healthy Life by News ET Social 4 months ago 10 minutes, 5 seconds 996 views",News ET Social,996,996,0
4334,"ወንዶችንም ጭምር የሚያጠቃው የጡት ካንሰር | Healthy Life by News ET Social 4 months ago 12 minutes, 54 seconds 1,063 views",News ET Social,1063,1080,17
4335,"ባል መኾን ችለሀል? | Youth by News ET Social 4 months ago 16 minutes 1,854 views",News ET Social,1854,1854,0
4336,"ስለኦቲዝም ጠቃሚ ነጥቦች | Healthy Life by News ET Social 4 months ago 10 minutes, 23 seconds 993 views",News ET Social,993,995,2
4337,"ወሊድ በምጥ ወይስ በቀዶጥገና ? | Healthy Life by News ET Social 4 months ago 11 minutes, 40 seconds 2,696 views",News ET Social,2696,2705,9
4338,"ማህበራዊ ቦታዎች ማሳየት የሌለብን ባህርያት | Youth by News ET Social 4 months ago 14 minutes, 17 seconds 1,238 views",News ET Social,1238,1240,2
4339,"ዝምተኛው ገዳይ - የደም ካንሰር | Healthy Life by News ET Social 4 months ago 13 minutes, 14 seconds 2,347 views",News ET Social,2347,2467,120
4340,"በትዳር ውስጥ የሚስት ኃላፊነት | Youth by News ET Social 4 months ago 16 minutes 2,444 views",News ET Social,2444,2455,11
4341,"መካንነት ይታከማልን?  | Healthy Life by News ET Social 4 months ago 10 minutes, 18 seconds 5,915 views",News ET Social,5915,5963,48
4342,"የአስም ሕመም መነሻና ሕክምናው | Healthy Life by News ET Social 5 months ago 12 minutes, 25 seconds 2,940 views",News ET Social,2940,2944,4
4343,"በሴቶች የወር አበባ ወቅት ከባሎች ምን ይጠበቃል? | Youth by News ET Social 5 months ago 9 minutes, 8 seconds 3,235 views",News ET Social,3235,3247,12
4344,"የሚጥል በሽታ ምንድነው? | Healthy Life by News ET Social 5 months ago 18 minutes 1,441 views",News ET Social,1441,1498,57
4345,"Yirsaw baye - Hagers Neberegn |  ""ሀገርስ ነበረኝ"" - New Ethiopian Music 2021 (Official Video) by News ET Social 5 months ago 6 minutes, 1 second 1,889 views",News ET Social,1889,1896,7
4346,"ከወሲብ ጋር የተያያዙ ሕመሞችና ሕክምናቸው | Healthy Life by News ET Social 5 months ago 14 minutes, 21 seconds 3,864 views",News ET Social,3864,3864,0
4347,"ወንድ ልጅ ሊያገባ ሲፈልግ የሚያሳያቸው 6 ምልክቶች | Youth by News ET Social 5 months ago 8 minutes, 26 seconds 4,416 views",News ET Social,4416,4422,6
4348,"የተመረዘ ሰው ምን ዓይነት ምልክቶችን ያሳያል? | Healthy Life by News ET Social 5 months ago 13 minutes, 14 seconds 1,809 views",News ET Social,1809,1809,0
4349,"መጀመሪያ ራሳችንን እንውደድ፤ ግን እንዴት?  | Youth by News ET Social 6 months ago 11 minutes, 15 seconds 1,750 views",News ET Social,1750,1753,3
4350,"የጨጓራ ሕመም መነሻውና መፍትሔው | Healthy Life by News ET Social 6 months ago 8 minutes, 45 seconds 3,362 views",News ET Social,3362,3366,4
4351,"የእንቅልፍ ችግር ለገጠማችኹ እንካችኹ ምክር! | Youth by News ET Social 6 months ago 11 minutes, 6 seconds 2,389 views",News ET Social,2389,2393,4
4352,"የወንድ መካንነት ምልክቶቹ ምንድናቸው? ሕክምናውስ? | Healthy Life by News ET Social 6 months ago 18 minutes 5,381 views",News ET Social,5381,5639,258
4353,"የርቀት ፍቅርን  ፈተና ለማለፍ | Youth by News ET Social 6 months ago 10 minutes, 25 seconds 1,744 views",News ET Social,1744,1746,2
4354,"መካንነት መቼና እንዴት ይከሰታል?  | Healthy Life by News ET Social 6 months ago 15 minutes 2,065 views",News ET Social,2065,2101,36
4355,"እነዚህን ምልክቶች ካየህ የፍቅር አጋርህ እየራቀችህ  መሆኑን እወቅ | Youth by News ET Social 6 months ago 9 minutes, 1 second 3,886 views",News ET Social,3886,3896,10
4356,"እርጉዝ ነሽ? እያመመሽ ይኾን? | Healthy Life by News ET Social 6 months ago 21 minutes 2,784 views",News ET Social,2784,2785,1
4357,"የአስመሳይ ጓደኞች 5 ባህርያት | Youth by News ET Social 6 months ago 7 minutes, 34 seconds 4,380 views",News ET Social,4380,4413,33
4358,"መንታ ልጆችን እንዴት መውለድ ይቻላል?እና ሌሎች የእናንተ ጥያቄዎች መልሶች by News ET Social 7 months ago 14 minutes, 8 seconds 4,567 views",News ET Social,4567,4661,94
4359,"ሰዎች በፍቅር ሕይወታቸው ለምን ይሳሳታሉ? | Youth by News ET Social 7 months ago 13 minutes, 21 seconds 1,599 views",News ET Social,1599,1603,4
4360,"በሴቶች ላይ የሚከሰት የወሲብ ድክመት መነሻው | ምልክቱ | ሕክምናው | Healthy Life by News ET Social 7 months ago 12 minutes, 11 seconds 6,273 views",News ET Social,6273,6277,4
4361,"ለወጣቶች፡- ፍቅረኛ እንዴት እንምረጥ? | Youth by News ET Social 7 months ago 9 minutes, 58 seconds 1,630 views",News ET Social,1630,1633,3
4362,"የስኳር ሕመም የጎንዮሽ ጉዳቶች | Healthy Life by News ET Social 7 months ago 14 minutes, 8 seconds 2,052 views",News ET Social,2052,2052,0
4363,"ለሴቶች ብቻ!...እንዲናፍቅሽ ማድረግ ትችያለሽ | Youth by News ET Social 7 months ago 17 minutes 2,559 views",News ET Social,2559,2560,1
4364,"የስኳር በሽታ ሕመም ዓይነቶችና መንስኤዎች | Health Life by News ET Social 7 months ago 16 minutes 1,758 views",News ET Social,1758,1759,1
4365,"ፍቅርን የሚያጠፉ ክፉ ባህርያት | Youth by News ET Social 7 months ago 10 minutes, 52 seconds 2,482 views",News ET Social,2482,2482,0
4366,"የጀርባ ሕመምን እንዴት ማስታገስ ይቻላል by News ET Social 7 months ago 10 minutes, 10 seconds 1,997 views",News ET Social,1997,1998,1
4367,"ከስንፍና እስር ቤት ለመውጣት ምን እናድርግ?  | Youth by News ET Social 8 months ago 9 minutes, 56 seconds 2,598 views",News ET Social,2598,2604,6
4368,"ለኮሮና ታማሚ ተስማሚ ምግብ የቱ ነው? | Healthy Life by News ET Social 8 months ago 7 minutes, 14 seconds 1,811 views",News ET Social,1811,1814,3
4369,"የፍቅር ግንኙነትን ለመጠበቅ የሚረዱ 5 ነጥቦች | Youth by News ET Social 8 months ago 13 minutes, 34 seconds 1,621 views",News ET Social,1621,1626,5
4370,"በብዛት ሴቶችን የሚያጠቃው የማይግሬን ሕመም | Healthy Life by News ET Social 8 months ago 16 minutes 2,775 views",News ET Social,2775,2782,7
4371,"ክፍል ሁለት መፈንቅለ ኮሜዲ - እጅግ አዝናኝ ኮሜዲ በመልካሙ ከበደ by News ET Social 8 months ago 37 minutes 2,252 views",News ET Social,2252,2256,4
4372,"የሳምባ ምች (ኒሞኒያ) እንዴት ይከሰታል? | Healthy Life by News ET Social 8 months ago 9 minutes, 40 seconds 3,489 views",News ET Social,3489,3566,77
4373,"ደስተኛ ለመኾን ምን እናድርግ? by News ET Social 8 months ago 17 minutes 1,726 views",News ET Social,1726,1729,3
4374,"መፈንቅለ ኮሜዲ | እጅግ አዝናኝ ኮሜዲ በመልካሙ ከበደ by News ET Social 8 months ago 36 minutes 2,864 views",News ET Social,2864,2871,7
4375,"ከስትሮክ ድንገተኛ አደጋ ለመፈወስ | Healthy Life by News ET Social 8 months ago 14 minutes, 10 seconds 1,697 views",News ET Social,1697,1697,0
4376,"ከአሉታዊ አመለካከት እንዴት እንላቀቅ? by News ET Social 8 months ago 20 minutes 1,446 views",News ET Social,1446,1449,3
4377,"""የምንችለውን ነገር ኹሉ አድርገን የምርጫውን ጊዜ እንለፈው"" ሙሐዘ ጥበባት ዲያቆን ዳንኤል ክብረት by News ET Social 8 months ago 20 minutes 1,451 views",News ET Social,1451,1452,1
4378,"አይናችን መጎዳቱን ሳናውቀው ለአይነ ሥውርነት የሚዳርገን - ግላኮማ | Healthy Life by News ET Social 9 months ago 13 minutes, 28 seconds 1,149 views",News ET Social,1149,1152,3
4379,"የወሲብ ያለተነገሩ ጠቀሜታዎች | Youth by News ET Social 9 months ago 7 minutes, 50 seconds 5,364 views",News ET Social,5364,5388,24
4380,"የልብ ድካም (Heart Failure) ምንድን ነው ? by News ET Social 9 months ago 12 minutes, 8 seconds 1,675 views",News ET Social,1675,1677,2
4381,"አእምሮን ለማጠንከር የሚረዱን 5 መንገዶች | Youth by News ET Social 9 months ago 10 minutes, 29 seconds 2,162 views",News ET Social,2162,2164,2
4382,"ስለኮቪድ 19 ክትባት መታወቅ ያለባቸው ነጥቦች | Healthy Life by News ET Social 9 months ago 8 minutes, 51 seconds 2,053 views",News ET Social,2053,2053,0
4383,"ወንዶች ትዳርን የሚሸሹበት 5 ነጥቦች | Youth by News ET Social 9 months ago 13 minutes, 45 seconds 3,441 views",News ET Social,3441,3443,2
4384,"ቪያግራ መቼና እንዴት ይወሰዳል? by News ET Social 9 months ago 15 minutes 32,967 views",News ET Social,32967,35021,2054
4385,"ፍቅረኛህን ከልብ ለማስደሰት ልትከተላቸው የሚገቡ መንገዶች | Youth by News ET Social 9 months ago 9 minutes, 40 seconds 2,550 views",News ET Social,2550,2575,25
4386,"የስኳር ሕሙማን መጾም የሚያስከትልባቸው የጤና ቀውስ | Healthy Life by News ET Social 10 months ago 12 minutes, 4 seconds 1,904 views",News ET Social,1904,1904,0
4387,"ከወሲብ በኋላ የሚወሰደው የእርግዝና መከላከያ ለሁሉም ሴቶች ይሰራልን?  | Healthy Life by News ET Social 10 months ago 13 minutes, 53 seconds 3,189 views",News ET Social,3189,3229,40
4388,"በፍቅር ግንኙነት ውስጥ መሰልቸትን መቅረፍ ትችያለሽ | Youth by News ET Social 10 months ago 19 minutes 2,300 views",News ET Social,2300,2315,15
4389,"የኩላሊት ሥራ መታወክ የሚያስከትለው የጤና ቀውስ | Healthy Life by News ET Social 10 months ago 20 minutes 1,404 views",News ET Social,1404,1406,2
4390,"ጥሩ ተግባቢ ለመሆን የሚረዱ 6 መንገዶች | Youth by News ET Social 10 months ago 13 minutes, 51 seconds 5,977 views",News ET Social,5977,6161,184
4391,"Healthy Life | የእንቅልፍ መዛባት፣ የወር አበባ መብዛት ፣ የእርግዝና መዘግየት ችግሮች… ለቀረቡ ጥያቄዎች የዶ/ር ሙስጠፋ መልሶች by News ET Social 10 months ago 11 minutes, 16 seconds 8,593 views",News ET Social,8593,9078,485
4392,"ድብርት ውስጥ መሆንዎን የሚያውቁበት ቀላል መንገዶች | Youth by News ET Social 10 months ago 10 minutes, 5 seconds 2,637 views",News ET Social,2637,2655,18
4393,"በቤት ውስጥ ሕክምና የሚወሰኑ የኮሮና ሕመምተኞች ምን ማድረግ አለባቸው? by News ET Social 10 months ago 9 minutes, 14 seconds 2,596 views",News ET Social,2596,2598,2
4394,"ከማህጸን ውጪ እርግዝና እንዴት ይከሰታል? by News ET Social 11 months ago 9 minutes, 52 seconds 2,141 views",News ET Social,2141,2197,56
4395,"ለክብረንጽህና ያለን አመለካካት ጤናማ ነውን? by News ET Social 11 months ago 13 minutes, 9 seconds 2,656 views",News ET Social,2656,2657,1
4396,"የጉበት በሽታ የሚያስከትለው ጣጣ...! by News ET Social 11 months ago 16 minutes 2,651 views",News ET Social,2651,2662,11
4397,"ፍቅረኛሽ/ህ እየማገጠ ስለመሆኑ የምታወቂበት ምልክቶች | Youth by News ET Social 11 months ago 9 minutes, 33 seconds 2,831 views",News ET Social,2831,2833,2
4398,"ወሲብ ድክመት ይታከማልን? by News ET Social 11 months ago 28 minutes 4,558 views",News ET Social,4558,4560,2
4399,"የፍቅር ግንኙነት መቋረጥ እንዳይጎዳን ምን እናድርግ? | Youth by News ET Social 11 months ago 11 minutes, 32 seconds 2,234 views",News ET Social,2234,2241,7
4400,"ጤናማ ሕይወት | በእርግዝና ወቅት የግብረሥጋ ግንኙነት ማድረግ የሚከለከለው መቼ ነው? by News ET Social 11 months ago 9 minutes, 8 seconds 6,419 views",News ET Social,6419,6508,89
4401,"ወንድ ልጅ ሲያፈቅርሽ የሚያሳያቸው ምልክቶች | Youth by News ET Social 11 months ago 12 minutes, 32 seconds 3,432 views",News ET Social,3432,3454,22
4402,"ለማህጸን በር ካንሰር መጋለጥ/አለመጋለጥዎን እነሆ ያጢኑ by News ET Social 11 months ago 11 minutes, 10 seconds 2,031 views",News ET Social,2031,2043,12
4403,"የፍቅር ጓደኛ መያዝ ለምን ይሳነናል? | Youth by News ET Social 1 year ago 6 minutes, 51 seconds 3,874 views",News ET Social,3874,3879,5
4404,"ጤናማ ሕይወት | ለጡት ካንሰር ተጋልጠው ይሆን? by News ET Social 1 year ago 12 minutes, 6 seconds 1,339 views",News ET Social,1339,1339,0
4405,"ሴቶች ከወንዶች የሚፈልጓቸው 8 መልካም ባህርያት | Youth by News ET Social 1 year ago 9 minutes, 45 seconds 3,025 views",News ET Social,3025,3038,13
4406,"ጤናማ ሕይወት | የደም ማነስ እና የደም ግፊት አንድነትና ልዩነት ምንድነው? by News ET Social 1 year ago 21 minutes 4,976 views",News ET Social,4976,5141,165
4407,"ወጣቶች ሊከተሏቸው የሚገቡ 7 ወርቃማ ህጎች | Youth by News ET Social 1 year ago 7 minutes, 57 seconds 2,264 views",News ET Social,2264,2264,0
4408,"ጤናማ ሕይወት | በምጥ ወይም በኦፕሬሽን መውለድ by News ET Social 1 year ago 15 minutes 3,155 views",News ET Social,3155,3167,12
4409,"ምርጥ ሴት ለመሆን የሚረዱን 6 ነጥቦች | Youth by News ET Social 1 year ago 7 minutes, 54 seconds 2,312 views",News ET Social,2312,2316,4
4410,"ጤናማ ሕይወት | በእርግዝና ወቅት የሚያጋጥም ውርጃ መንስኤዎች by News ET Social 1 year ago 19 minutes 10,057 views",News ET Social,10057,10499,442
4411,"ጤናማ ሕይወት | ከወር አበባ ጋር ተያያዥ የሆኑ ህመሞችና መንስኤዎች by News ET Social 1 year ago 10 minutes, 17 seconds 2,044 views",News ET Social,2044,2045,1
4412,"ወንዶች ስለክብር ምን ያስባሉ? | Youth by News ET Social 1 year ago 11 minutes, 18 seconds 2,043 views",News ET Social,2043,2046,3
4413,"ጤናማ ሕይወት | ከወር አበባ ጋር የሚመጡ ችግሮችና መፍትሄዎች by News ET Social 1 year ago 14 minutes, 47 seconds 2,292 views",News ET Social,2292,2298,6
4414,"ጠንካራ የፍቅር ግንኙነት እንዲኖረን የሚረዱን 6 ነጥቦች | Youth by News ET Social 1 year ago 12 minutes, 27 seconds 2,438 views",News ET Social,2438,2441,3
4415,"ጤናማ ሕይወት | እንቅልፍና ከእንቅልፍ ጋር ተያያዥ ጉዳዮች by News ET Social 1 year ago 12 minutes, 19 seconds 2,233 views",News ET Social,2233,2276,43
4416,"ፍቅር ሲይዘን የሚታይብን 5 ነገሮች | Youth by News ET Social 1 year ago 9 minutes, 24 seconds 1,816 views",News ET Social,1816,1825,9
4417,"Amir Wada | Abuche Epy Nmajesh  ""አቡጭ ኤፐዪ ንማጀሸ"" | New Ethiopian Guragigna Music 2021 by News ET Social 1 year ago 6 minutes, 5 seconds 66,959 views",News ET Social,66959,68521,1562
4418,"ጤናማ ሕይወት | በጎን ሕመም ተቸግረዋል? የሐኪምዎ ምክር እነሆ! by News ET Social 1 year ago 15 minutes 3,359 views",News ET Social,3359,3467,108
4419,"Oromoo Music: Nagasaa Ayaanuu - Gargarfacaanee Turee | New Oromiffa Music 2019 by News ET Social 2 years ago 6 minutes, 59 seconds 26,931 views",News ET Social,26931,26948,17
4420,"ETHIOPIA: ""የቅድመ አያቶቻችን ስጦታ"" ገጣሚ ዘካሪያስ ወንድምነህ by News ET Social 2 years ago 8 minutes, 14 seconds 9,475 views",News ET Social,9475,9477,2
4421,"Ethiopia: ሰውነቷ አዲስ ፊልም 2019 | Sewentwa - New Ethiopian Full Movie by News ET Social 2 years ago 1 hour, 29 minutes 221,104 views",News ET Social,221104,221226,122
4422,"Ethiopia: AD PAC - Prime minister  [New Ethiopian Rap Music Video] by News ET Social 3 years ago 3 minutes, 10 seconds 8,317 views",News ET Social,8317,8336,19
4423,"Ethiopia: Yabu Jc  -  1990 [Official Music Video 2019] by News ET Social 3 years ago 2 minutes, 9 seconds 7,309 views",News ET Social,7309,7330,21
4424,"Oromo Music: Abdulmaalik Hasan - Tokkummaa [New Oromoo Music Video] by News ET Social 3 years ago 4 minutes, 29 seconds 85,273 views",News ET Social,85273,85430,157
4425,"Oromoo Music: Abdulmaalik Hasan - Xalayaakoo [New Oromiffa Music Video] by News ET Social 3 years ago 4 minutes, 31 seconds 946,004 views",News ET Social,946004,949025,3021
4426,"Oromo Music: Bilisummaa Gammachuu | Riqicha Tokummaa - New Oromo Music Video by News ET Social 3 years ago 4 minutes, 43 seconds 10,018 views",News ET Social,10018,10013,-5
4427,"Oromoo Music: Kadiir Gammadaa - Hin Booyin Harmee | New Oromiffa Music Video| by News ET Social 3 years ago 6 minutes 7,071 views",News ET Social,7071,7077,6
4428,"Oromoo Music: Kadiir Gammadaa -  Haa Tikfannu | New Oromo Music Video| by News ET Social 3 years ago 5 minutes, 48 seconds 6,016 views",News ET Social,6016,6023,7
4429,"Ethiopia: Ayenew Negash አየነው ነጋሽ - ህመሜ Himeme | New Ethiopian Music Video| by News ET Social 3 years ago 5 minutes, 9 seconds 5,638 views",News ET Social,5638,5641,3
4430,"Ethiopia: Ayenew Negash አየነው ነጋሽ /አዩድሬ - አሮማያ Haromaya | New Music Video 2019| by News ET Social 3 years ago 5 minutes, 36 seconds 8,230 views",News ET Social,8230,8233,3
4431,"Ethiopia: Ayenew Negash አየነው ነጋሽ | አዩድሬ - ማነው | Manew አዲስ አማርኛ የሙዚቃ ክሊፕ by News ET Social 3 years ago 4 minutes, 16 seconds 3,894 views",News ET Social,3894,3899,5
4432,"Ethiopia: አፍሪካ ውመን አግሪ ቢዝነስ ኔትዎርክ ስራውን በይፋ ጀመረ by News ET Social 3 years ago 6 minutes 2,039 views",News ET Social,2039,2039,0
4433,"Ethiopia: Teddy ዉስዋሴ -  Weswase | ""ዉስዋሴ"" - New Ethiopian Music Video 2019 by News ET Social 3 years ago 5 minutes, 16 seconds 26,607 views",News ET Social,26607,26644,37
4434,"Ethiopia: በመሀል ፒያሳ የጎዳና ላይ የወንዶች የፋሽን ትርዒት ተካሄደ by News ET Social 3 years ago 3 minutes, 37 seconds 4,389 views",News ET Social,4389,4397,8
4435,"Oromoo Music: Bilisummaa Gammachuu  - Seenaa Guudaa [New Oromiffa Music Video] by News ET Social 3 years ago 7 minutes, 11 seconds 4,743 views",News ET Social,4743,4750,7
4436,"Ethiopia: እሷ ....... እኔ | አጭር ግጥም by News ET Social 3 years ago 7 minutes, 15 seconds 10,687 views",News ET Social,10687,10689,2
4437,"Ethiopia: Rita Adere - ""Ande Nen"" - New Ethiopian Music 2019 by News ET Social 3 years ago 4 minutes, 40 seconds 8,261 views",News ET Social,8261,8262,1
4438,"Ethiopia: ገናን ከልጆች ጋር በጄቲቪ ይጠብቁን  | ልዩ የበዓል ፕሮግራም by News ET Social 3 years ago 1 minute, 7 seconds 5,007 views",News ET Social,5007,5009,2
4439,"Ethiopia: Ye Enat Eda | የዕናት እዳ - New Ethiopian Movie | Coming soon by News ET Social 3 years ago 1 minute, 12 seconds 6,979 views",News ET Social,6979,6979,0
4440,"Ethiopia: Werashoch | ወራሾቹ - New Ethiopian Movie | Coming Soon by News ET Social 3 years ago 1 minute, 1 second 7,910 views",News ET Social,7910,7910,0
4441,"Guragigna Music: Tariku Bekele - Tesaru [New Ethiopian Music Video] by News ET Social 3 years ago 6 minutes, 22 seconds 300,154 views",News ET Social,300154,303144,2990
4442,"Oromo Music: Gaashaw Mulgetaa - Gaddaa fi Gammachuu [New Oromiffa Music] by News ET Social 3 years ago 4 minutes, 29 seconds 6,354 views",News ET Social,6354,6360,6
4443,"Ethiopia: Made In Ethiopia - የሀገሬን ምርት by News ET Social 3 years ago 6 minutes, 37 seconds 4,226 views",News ET Social,4226,4228,2
4444,"Ethiopia: በኢትዮጵያ የሚገኙ ባለስልጣናት እና ባለሀብቶች መቄዶንያ የአረጋውያን እና የአዕምሮ ህሙማን መርጃን ጎበኙ by News ET Social 3 years ago 12 minutes, 54 seconds 1,959 views",News ET Social,1959,1959,0
4445,"Ethiopia: የኢትዮጵያ ልማት ባንክ ለመቄዶኒያ የ5 ሚሊዮን ብር ድጋፍ አደረገ by News ET Social 3 years ago 14 minutes, 45 seconds 1,184 views",News ET Social,1184,1184,0
4446,"Ethiopia: Melkamu Abete | Wez Wez - መልካሙ አብጤ | ወዝ ወዝ by News ET Social 3 years ago 5 minutes, 45 seconds 4,522 views",News ET Social,4522,4529,7
4447,"Oromoo Music: Ashebbir Taasisaa [New Oromo Music 2018] by News ET Social 3 years ago 6 minutes, 24 seconds 11,887 views",News ET Social,11887,11893,6
4448,"Oromiffa Music: Girma Kasa | Koolooluu [New Oromo Music] by News ET Social 3 years ago 4 minutes, 20 seconds 4,809 views",News ET Social,4809,4812,3
4449,"Ethiopia: እኔም የተፈጥሮ ሀብቴ አምባሳደር ነኝ by News ET Social 3 years ago 20 minutes 1,114 views",News ET Social,1114,1114,0
4450,"Ethiopia:  ""ኤርትራ ጉዳይ""   ኦድዮ ሲዲ ተመረቀ by News ET Social 3 years ago 10 minutes, 30 seconds 4,080 views",News ET Social,4080,4080,0
4451,"Ethiopia: “ምን ለብሳ ነበር?” by News ET Social 3 years ago 18 minutes 2,594 views",News ET Social,2594,2594,0
4452,"Ethiopia: አዲስ ማህበራዊ የስራ ፈጣሪ ማህበር በኢትዮጵያ ተከፈተ by News ET Social 3 years ago 8 minutes, 42 seconds 2,534 views",News ET Social,2534,2534,0
4453,"Ethiopia: የኢትዮጵያ አየር መንገድ ዋና ሥራ አስፈፃሚ አቶ ተወልደ እና የማኔጅመንት አባላቱ የሰጡት ጋዜጣዊ መግለጫ by News ET Social 3 years ago 24 minutes 10,309 views",News ET Social,10309,10309,0
4454,"Ethiopia: ትራንሽን የኤክስፖርት ስኬቱን አከበረ by News ET Social 3 years ago 17 minutes 2,167 views",News ET Social,2167,2168,1
4455,"Ethiopia: ዳዊት መንገሻ - እፎይ እርፍ [New Ethiopian Music Video] by News ET Social 3 years ago 5 minutes, 12 seconds 24,439 views",News ET Social,24439,24444,5
4456,"Ethiopia: አራተኛው የአፍሪካ የቁም እንስሳት አውደ ርዕይና ጉባዔ እና ስምንተኛው የኢትዮ ፖልትሪ ኤክስፖ ተካሄደ by News ET Social 3 years ago 2 minutes, 52 seconds 3,029 views",News ET Social,3029,3029,0
4457,"Ethiopia: ልባም ፊልም - በቅርብ ቀን |  በአቀራረቡ በቀረፃው ልዩ የሆነ አዲስ ፊልም by News ET Social 3 years ago 1 minute, 8 seconds 37,525 views",News ET Social,37525,37536,11
4458,"Ethiopia: የኢትዮጵያ አየር መንገድ የአውሮፕላን የሞተር ጥገና አገልግሎት መስጠት ጀመረ by News ET Social 3 years ago 5 minutes, 7 seconds 2,372 views",News ET Social,2372,2374,2
4459,"Ethiopia: ሁለተኛው የአካል ጉዳተኞች የፋሽን ሾዉ ትርኢት by News ET Social 3 years ago 31 minutes 2,561 views",News ET Social,2561,2561,0
4460,"Ethiopia: አራተኛው የሶርሲንግና ፋሽን ሳምንት አውደርዕይና ጉባዔ ከመስከረም 21-24/2011 ይካሄዳል by News ET Social 3 years ago 7 minutes, 22 seconds 1,383 views",News ET Social,1383,1383,0
4461,"Ethiopia: ከእንግዲህ የሙዝ ልጣጭ የትም ወድቆ ላይታይ እኛንም ላይጥለን ይሆን?? by News ET Social 3 years ago 2 minutes, 29 seconds 11,140 views",News ET Social,11140,11144,4
4462,"DIRETUBE: መስቀል በአል አከባበር – አዲስ አበባ – መስቀል አደባባይ 2011 - Part 2/ Diretube by News ET Social 3 years ago 9 minutes, 55 seconds 7,070 views",News ET Social,7070,7070,0
4463,"DIRETUBE: መስቀል በአል አከባበር – አዲስ አበባ – መስቀል አደባባይ 2011 - Part 1 / Diretube by News ET Social 3 years ago 10 minutes, 29 seconds 31,561 views",News ET Social,31561,31572,11
4464,"Ethiopia: ልዩ የመስቀል ፕሮግራም - መስቀልና ባህላዊ አከባበር“ ሀሙስ መስከረም 17 ይጠብቁን by News ET Social 3 years ago 1 minute, 1 second 14,844 views",News ET Social,14844,14845,1
4465,"Ethiopia: አዲስ አመት ከቀድሞ የኢትዮጵያ ባህር ሀይል ጋር - ክፍል 5 by News ET Social 3 years ago 27 minutes 4,761 views",News ET Social,4761,4766,5
4466,"Ethiopia: ከመቐሌ የተወነጨፈው የህወሓት የቃላት ሚሳዔል! by News ET Social 3 years ago 4 minutes, 15 seconds 26,774 views",News ET Social,26774,26774,0
4467,"Ethiopia: ‹ልጄ ከሞተ ጀምሮ በሀዘንና ትካዜ ውስጥ ነኝ፤ የነፃ-ህክምና ድጋፍ ይደረግላቸው የሚል ብጣሽ ወረቀት ይፃፍልኝ::›› by News ET Social 3 years ago 8 minutes, 20 seconds 3,648 views",News ET Social,3648,3648,0
4468,"Oromo Music: by News ET Social 3 years ago 3 minutes, 55 seconds 14,746 views",News ET Social,14746,14755,9
4469,"Oromoo Music - Abbishu Alamuu - Goroogor [New Ethiopian Music 2018 ] by News ET Social 3 years ago 4 minutes, 18 seconds 7,216 views",News ET Social,7216,7216,0
4470,"Ethiopia: ኖህ ሪል እስቴት አዲስ ያስገነባቸውን አፓርታማዎች መሰከረም 6 ያስመርቃል by News ET Social 3 years ago 8 minutes, 6 seconds 1,766 views",News ET Social,1766,1768,2
4471,"ETHIOPIA: የሼህ ሙሐመድ እስር ያደኽያቸው ሹማምንቶች!  ጫሊ በላይነህ by News ET Social 3 years ago 7 minutes, 2 seconds 3,113 views",News ET Social,3113,3113,0
4472,"ETHIOPIA: ከንቲባ ነኝ | ሄኖክ ስዩም by News ET Social 3 years ago 3 minutes, 42 seconds 6,725 views",News ET Social,6725,6725,0
4473,"ETHIOPIA: ለትዳሩና ለራሱ ያልታመነ አርቲስት የበዓል ዕለት ሲመክር… by News ET Social 3 years ago 7 minutes, 32 seconds 2,553 views",News ET Social,2553,2554,1
4474,"ETHIOPIA: አፓርታይድ በኢትዮጵያ! by News ET Social 3 years ago 3 minutes, 58 seconds 3,673 views",News ET Social,3673,3673,0
4475,"ETHIOPIA: ‹ግቡ የአጥቂው፣ ድሉ የቡድኑ ነው› በዳንኤል ክብረት by News ET Social 3 years ago 5 minutes, 40 seconds 2,109 views",News ET Social,2109,2109,0
4476,"Ethiopia: አዲስ አመት ከቀድሞ የኢትዮጵያ ባህር ሀይል ጋር - ክፍል 4 by News ET Social 3 years ago 24 minutes 3,859 views",News ET Social,3859,3860,1
4477,"Ethiopia: አዲስ አመት ከቀድሞ የኢትዮጵያ ባህር ሀይል ጋር - ክፍል 3 by News ET Social 3 years ago 12 minutes, 16 seconds 8,510 views",News ET Social,8510,8510,0
4478,"Ethiopia: አዲስ አመት ከቀድሞ የኢትዮጵያ ባህር ሀይል ጋር - ክፍል 2 by News ET Social 3 years ago 21 minutes 9,027 views",News ET Social,9027,9028,1
4479,"Ethiopia: አዲስ አመት ከቀድሞ የኢትዮጵያ ባህር ሀይል ጋር - ክፍል 1 by News ET Social 3 years ago 24 minutes 10,281 views",News ET Social,10281,10291,10
4480,"Ethiopia: AMAZING AND FUNNY  NEW YEAR COUPLES COMPETITION GAME - 3 by News ET Social 3 years ago 14 minutes, 11 seconds 59,800 views",News ET Social,59800,59804,4
4481,"Ethiopia: AMAZING AND FUNNY  NEW YEAR COUPLES COMPETITION GAME - 4 by News ET Social 3 years ago 10 minutes, 56 seconds 16,875 views",News ET Social,16875,16875,0
4482,"Ethiopia: AMAZING AND FUNNY  NEW YEAR COUPLES COMPETITION GAME - 1 by News ET Social 3 years ago 8 minutes, 44 seconds 8,313 views",News ET Social,8313,8316,3
4483,"Ethiopia: AMAZING AND FUNNY  NEW YEAR COUPLES COMPETITION GAME - 2 by News ET Social 3 years ago 7 minutes, 26 seconds 11,628 views",News ET Social,11628,11630,2
4484,"Ethiopia: አዲስ አመት ከቀድሞ የኢትዮጵያ ባህር ሀይል ጋር - ይጠብቁን by News ET Social 3 years ago 1 minute, 57 seconds 2,515 views",News ET Social,2515,2517,2
4485,"Ethiopia: አውደአመት - ያምርብናል | Awedeamet - Yamrebnal [Short New Ethiopian  Movie ] New Year 2011 by News ET Social 3 years ago 19 minutes 40,034 views",News ET Social,40034,40034,0
4486,"Enkutatash A Film by Henok Yewalashet - Ethiopian First Stop Motion Animation  New Year 2011 by News ET Social 3 years ago 8 minutes, 4 seconds 3,628 views",News ET Social,3628,3628,0
4487,"Ethiopia: ጆይስ ኤቨንት እና ፕሮሞሽን በቴዲ አፍሮ ላይ ቅሬታ አቀረበ by News ET Social 3 years ago 27 minutes 7,392 views",News ET Social,7392,7394,2
4488,"Ethiopia: አርቲስት እና አክቲቪስት ታማኝ በየነ ቦሌ አለም አቀፍ አየር ማረፊያ መግለጫ ሰጠ by News ET Social 3 years ago 13 minutes, 17 seconds 8,969 views",News ET Social,8969,8969,0
4489,"Ethiopia: አርቲስት እና አክቲቪስት ታማኝ በየነ ከ22 አመት የስደት ኑሮ ቡሀላ ዛሬ ጠዋት ወደ ሀገሩ ገባ by News ET Social 3 years ago 3 minutes, 9 seconds 39,578 views",News ET Social,39578,39581,3
4490,"Shimalis Indaashaw - BADEE GARAATOO  [Oromo Music Video] by News ET Social 3 years ago 5 minutes, 32 seconds 3,881 views",News ET Social,3881,3885,4
4491,"Ethiopia: Sun of The Night by Biniam Tefera - Diretube by News ET Social 3 years ago 9 minutes, 24 seconds 1,592 views",News ET Social,1592,1592,0
4492,"Ethiopia: አደገኛው ወንጀል by News ET Social 3 years ago 5 minutes, 30 seconds 1,326 views",News ET Social,1326,1326,0
4493,"Ethiopia: የወ/ሪት አዲስ አበባ የቆንጅና ውድድር መስከረም 3 ይካሄዳል - Diretube by News ET Social 3 years ago 2 minutes, 52 seconds 1,766 views",News ET Social,1766,1766,0
4494,"Habtamu Samuel ""ዶ/ር አብይ ውስጤ ነህ"" New Ethiopian Music Video by News ET Social 3 years ago 3 minutes, 23 seconds 7,344 views",News ET Social,7344,7354,10
4495,"Ethiopia: የታፔላ አመዳደብ ፍትሃዊ አለመሆንና የአሰራር ብልሹነት - አበይተ ዜና by News ET Social 3 years ago 4 minutes, 34 seconds 1,085 views",News ET Social,1085,1085,0
4496,"Ethiopia: ከአንበሳ ግቢ አምልጣ የወጣች ጦጣ በሰዎች ላይ ጉዳት አደረሰች - አበይተ ዜና by News ET Social 3 years ago 3 minutes, 25 seconds 3,568 views",News ET Social,3568,3570,2
4497,"Ethiopia: አርቲስት ዓለምፀሀይ ወዳጆ አዲስ አበባ ገባች - አበይተ ዜና by News ET Social 3 years ago 3 minutes, 27 seconds 2,287 views",News ET Social,2287,2288,1
4498,"Ethiopia: Taddasaa Ashetuu - Qilinxooraa gadiyaasne [New Oromiffa Music ] by News ET Social 3 years ago 5 minutes, 36 seconds 23,151 views",News ET Social,23151,23199,48
4499,"Elias Degfa - Booda Indeebinu - New Oromoo Music Video 2018 by News ET Social 3 years ago 5 minutes, 22 seconds 1,938 views",News ET Social,1938,1938,0
4500,"Elias Degfa - Qellemkoo - Oromo Music 2018 New by News ET Social 3 years ago 5 minutes, 9 seconds 2,605 views",News ET Social,2605,2605,0
4501,"Ethiopia: Jemiil Abduu (Naad) - Dubbiin Haa Bilchaatu [New Oromiffa Music] by News ET Social 3 years ago 4 minutes, 58 seconds 16,005 views",News ET Social,16005,16011,6
4502,"Ethiopia: አለም አቀፍ የወይዘሮ ቱሪዙም ንግስት የቆንጅና ውደድር ነሀሴ 24 ይካሄዳል  Diretube by News ET Social 3 years ago 8 minutes, 58 seconds 3,871 views",News ET Social,3871,3871,0
4503,"Ethiopia: Jiituu Mohammad - Nadhii Gamada Nuu Barbaada [New Oromo Music] by News ET Social 3 years ago 5 minutes, 27 seconds 5,782 views",News ET Social,5782,5786,4
4504,"Ethiopia: Dinkisaa Debela - Addaan hin Baanuu [New Oromoo Music 2018] by News ET Social 3 years ago 6 minutes, 28 seconds 1,967 views",News ET Social,1967,1970,3
4505,"ግድቡም ዝም፣ገዳዩም ዝም፣ መርማሪውም ዝም-የስመኘው ነገር by News ET Social 3 years ago 3 minutes, 1 second 3,455 views",News ET Social,3455,3455,0
4506,"ከሚነሶታ እስከ አዲስ አበባ - ዲያቆን ዳንኤል ክብረት by News ET Social 3 years ago 9 minutes, 36 seconds 5,466 views",News ET Social,5466,5467,1
4507,"Ethiopia:  ኪሚ  -  ተደምሬአለው [ New Ethiopian Music ] by News ET Social 3 years ago 3 minutes, 27 seconds 3,509 views",News ET Social,3509,3511,2
4508,"Ethiopia: ቢኒያም ተፈራ (ቢኒቾ) - ሆያ ሆዬ -  ለጠቅላይ ሚኒስትር ዶክተር ዐብይ አህመድ - Diretube by News ET Social 3 years ago 4 minutes, 45 seconds 144,458 views",News ET Social,144458,144510,52
4509,"Yeroosan Fiqaduu 'siinjaalanne' New oromo music video by News ET Social 3 years ago 6 minutes, 2 seconds 7,831 views",News ET Social,7831,7839,8
4510,"Yetelut Sinesa (የጣሉት ሲነሳ) New Amharic Full Movie from DireTube Movies by News ET Social 3 years ago 53 minutes 310,845 views",News ET Social,310845,311318,473
4511,"Robel Rassu 'Ethiopiawi' New Amharic Music video by News ET Social 3 years ago 4 minutes, 34 seconds 35,970 views",News ET Social,35970,35971,1
4512,"Wondwossen Assefa (Wendye Dire) 'ስንደመር በፍቅር' New Amharic Music Video 2018 by News ET Social 3 years ago 7 minutes 10,151 views",News ET Social,10151,10151,0
4513,"Naggasaa Ayyanuu 'Goota biyyaf yaadu' New oromo music video by News ET Social 3 years ago 6 minutes, 56 seconds 105,593 views",News ET Social,105593,105602,9
4514,"Manyazewal Girma 'Ligba Wedehagere'  New Amharic music video 2018 by News ET Social 3 years ago 6 minutes, 14 seconds 5,712 views",News ET Social,5712,5714,2
4515,"'Singenagn' Short Ethiopian Movie by News ET Social 3 years ago 4 minutes, 55 seconds 3,939 views",News ET Social,3939,3940,1
4516,"Melaku Ayenew 'Marzeneb'  New Amharic Music Video 2018 by News ET Social 3 years ago 5 minutes, 47 seconds 40,376 views",News ET Social,40376,40382,6
4517,"Sena Urgesa ' Ilma Aba Gada'  New Oromo music video 2018 by News ET Social 3 years ago 4 minutes, 3 seconds 36,342 views",News ET Social,36342,36353,11
4518,"ETHIOPIA - የአራተኛ አመት የህክምና ተማሪ ሞዴል  ምስክር ካሳሁን - DireTube.com by News ET Social 3 years ago 6 minutes, 41 seconds 3,566 views",News ET Social,3566,3569,3
4519,"እንድሪያስ የፊልም አካዳሚ በይፋ ተመረቀ by News ET Social 3 years ago 2 minutes, 58 seconds 2,810 views",News ET Social,2810,2811,1
4520,"Alex Gutemaw ' Zim' New Amharic Music video 2018 by News ET Social 3 years ago 3 minutes, 35 seconds 30,741 views",News ET Social,30741,30741,0
4521,"ላልተከፈላቸው እንዲከፈላቸው ከፋይ ዘመን መጣ by News ET Social 3 years ago 23 minutes 4,004 views",News ET Social,4004,4004,0
4522,"ETHIOPIA - ‹‹የጠቅላያችን አድናቂዎችና ተቺዎች››  DireTube.com by News ET Social 3 years ago 4 minutes, 12 seconds 2,200 views",News ET Social,2200,2200,0
4523,"ETHIOPIA - አጼ ዮሐንስ ሀዉልት ሊቆምላቸዉ ነዉ - DireTube.com by News ET Social 3 years ago 8 minutes, 40 seconds 1,903 views",News ET Social,1903,1903,0
4524,"Bashiir Didaa 'Aanoolee' New Oromo music video by News ET Social 3 years ago 6 minutes, 41 seconds 13,472 views",News ET Social,13472,13527,55
4525,"Yemsirach Mekuriya (Nunu) ' Dresilgn' New ethiopian Music video by News ET Social 3 years ago 5 minutes, 7 seconds 3,530 views",News ET Social,3530,3532,2
4526,"ETHIOPIA - የሰላም መዝሙር ለኢትዮጵያና ኤርትራ ህዝቦች:: by News ET Social 3 years ago 8 minutes 68,998 views",News ET Social,68998,68998,0
4527,"Merry Mesale X Teferah 'Cheb Cheb' New ethiopian Music video by News ET Social 3 years ago 3 minutes, 52 seconds 6,589 views",News ET Social,6589,6591,2
4528,"ETHIOPIA - የመክተፏ የስዕል ዐዉድ -ርዕይ - DireTube.com by News ET Social 3 years ago 6 minutes, 59 seconds 330 views",News ET Social,330,330,0
4529,"Alex Genanew 'Yemar Sew Welela' New Amharic Music by News ET Social 3 years ago 5 minutes, 54 seconds 1,492 views",News ET Social,1492,1492,0
4530,"Gannat Kormee 'Wawuma Kee' New Oromoo music video by News ET Social 3 years ago 5 minutes, 45 seconds 28,461 views",News ET Social,28461,28480,19
4531,"Fetene Ababu 'Erst ena Gult' New Amharic music Video by News ET Social 3 years ago 5 minutes, 28 seconds 12,754 views",News ET Social,12754,12755,1
4532,"Gaaddisaa Abarraa 'Jalaqaabaa Loolumaa' New Oromoo Music Video by News ET Social 3 years ago 5 minutes, 51 seconds 11,464 views",News ET Social,11464,11472,8
4533,"Gaaddisaa Abarraa 'Bareeduu Oromiyaa' New Oromoo Music video by News ET Social 3 years ago 6 minutes, 7 seconds 42,743 views",News ET Social,42743,42749,6
4534,"ETHIOPIA - ሀበሻ ሙዚቃ ፌስቲቫል ግንቦት 11 በጊዮን ሆቴል ይካሄዳል - DireTube .com by News ET Social 3 years ago 5 minutes, 39 seconds 1,081 views",News ET Social,1081,1081,0
4535,"ETHIOPIA - የበጎ ሰዉ ሽልማት የእጩ ጥቆማ ተጀመረ - DireTube.com by News ET Social 3 years ago 8 minutes, 51 seconds 1,230 views",News ET Social,1230,1230,0
4536,"'Nofkot' Short Movie - ናፍቆት አጭር ድራማ by News ET Social 3 years ago 5 minutes, 36 seconds 3,160 views",News ET Social,3160,3163,3
4537,"ጉማ 5ኛው የኢትዮጵያ ፊልሞች ሽልማት by News ET Social 3 years ago 1 minute, 43 seconds 3,443 views",News ET Social,3443,3443,0
4538,"ETHIOPIA - ቤተዛታ ጠቅላላ ሆስፒታል አዲስ ባለ 8 ፎቅ ህንጻ ሆስፒታል አስገነባ - DireTube.com by News ET Social 3 years ago 3 minutes, 6 seconds 1,128 views",News ET Social,1128,1130,2
4539,"Mulualem Fantu 'Anten' New Ethiopian Music Video 2018 by News ET Social 3 years ago 4 minutes, 38 seconds 8,213 views",News ET Social,8213,8219,6
4540,"Faayo Mootii 'Magaalahoo' New Oromoo Music Video 2018 by News ET Social 3 years ago 6 minutes, 36 seconds 202,315 views",News ET Social,202315,202807,492
4541,"Dammituu Gabbitaa 'Barana Hin Baatu'  New Oromoo music Video 2018 by News ET Social 3 years ago 8 minutes, 19 seconds 8,470 views",News ET Social,8470,8477,7
4542,"Araarsaa Gazmuu 'Gowwee' New Oromoo Music Video 2018 Official Video by News ET Social 3 years ago 4 minutes, 54 seconds 9,444 views",News ET Social,9444,9518,74
4543,"Dammituu Gabbitaa 'Ateetee Qoorara Ruufaa' New Oromoo Music Video 2018 by News ET Social 3 years ago 6 minutes, 46 seconds 71,143 views",News ET Social,71143,71457,314
4544,"Araarsaa Gazmuu 'Yoon Gabaa Galu' New Oromifa Music 2018 by News ET Social 3 years ago 6 minutes, 2 seconds 4,815 views",News ET Social,4815,4831,16
4545,"ETHIOPIA - የሁለተኛዉ የቻይና የንግድ ሳምንት ሊካሄድ ነው - DireTube.com by News ET Social 3 years ago 1 minute, 37 seconds 901 views",News ET Social,901,901,0
4546,"ETHIOPIA - የጃሉድ አወል ሁለተኛዉ አልበም ሊመረቅ ነዉ - DireTube.com by News ET Social 3 years ago 1 minute, 3 seconds 4,808 views",News ET Social,4808,4810,2
4547,"ETHIOPIA - ሰለብሪቲ ኤቨንትስ- DireTube.com by News ET Social 3 years ago 8 minutes, 23 seconds 4,114 views",News ET Social,4114,4114,0
4548,"በሱፍቃድ ዲባባ (የጥበብ ጦረኛ) - ""የጅል ሞት"" አሪፍ ግጥም by News ET Social 3 years ago 2 minutes, 18 seconds 5,720 views",News ET Social,5720,5722,2
4549,"ETHIOPIA - የጃኖ ባንድ የፊታችን ቅዳሜ ሚያዚያ 20 በሚሊኒየም አዳራሽ ዉስጥ የሙዚቃ ኮንሰርት አዘጋጅተዋል by News ET Social 3 years ago 1 minute, 42 seconds 2,091 views",News ET Social,2091,2091,0
4550,"ETHIOPIA - 2ኛው የኢትዮጵያ የግብርና ምግብና መጠጥ ማቀነባበር እንዲሁም የፕላስቲክ ህትመትና ፓኬጂንግ ንግድ ትርኢት ሊካሄድ ነው by News ET Social 3 years ago 2 minutes, 46 seconds 2,244 views",News ET Social,2244,2244,0
4551,"ሰላም ኢትዮጵያ ከባህልና ቱሪዝም ሚኒስተር ጋር በመተባበር በባህል ዘርፍ በቀጣይ ሶስት አመታት ሊሰራ ያቀዳቸውን ፕሮጀክት ተፈራረሙ by News ET Social 3 years ago 4 minutes, 58 seconds 2,718 views",News ET Social,2718,2718,0
4552,"ETHIOPIA - ሮናልዲዮ በሒልተን ጋዜጣዊ መግለጫ ሰጠ - DireTube.com by News ET Social 3 years ago 9 minutes, 53 seconds 27,314 views",News ET Social,27314,27315,1
4553,"አምስተኛው የጉማ አዋርድ ሽልማት by News ET Social 3 years ago 8 minutes, 13 seconds 1,608 views",News ET Social,1608,1609,1
4554,"የሀገራችን ወቅታዊ ጉዳይ እና መሆን ያለበት ነገር - የህይወት ስንቅ by News ET Social 3 years ago 2 minutes, 39 seconds 3,355 views",News ET Social,3355,3355,0
4555,"በኢትዮጵያ የመጀመሪያው የፒዛ ሃት ሬስቶራንት ተከፈተ by News ET Social 3 years ago 3 minutes, 8 seconds 5,320 views",News ET Social,5320,5320,0
4556,"Zikre Jah  'Amnalew'  New music Video 2018 by News ET Social 3 years ago 3 minutes, 49 seconds 5,002 views",News ET Social,5002,5003,1
4557,"ፋሲካን ከእኛ ጋር - በጄቲቪ by News ET Social 3 years ago 1 minute 5,488 views",News ET Social,5488,5488,0
4558,"ኖህ እሪልስቴት ባለ 16 ፎቅ  አፓርትመንት ህንጻ አስመረቀ by News ET Social 3 years ago 1 minute, 30 seconds 9,169 views",News ET Social,9169,9170,1
4559,"#MUST_WACH የኢትዮጵያውያን ሰቆቃ የድረሱልን ጥሪ by News ET Social 3 years ago 26 minutes 4,426 views",News ET Social,4426,4426,0
4560,"ደራሲ ሰናይት ፈቃዴ ማራ የተሰኘውን መጽሀፏን አስመረቀች by News ET Social 3 years ago 7 minutes, 19 seconds 1,376 views",News ET Social,1376,1377,1
4561,"የሁሉንም ሰው ልብ የነካ ደግነት ጋሽ ፍቄ የሰራው ስራ by News ET Social 3 years ago 8 minutes, 20 seconds 6,231 views",News ET Social,6231,6237,6
4562,"ETHIOPIA - በቅጭብጭቡ "" የፍቅር እስከ መቃብር"" ትረካ በአርቲስት ተፈሪ አለሙ እና በጋዜጠኛ ንጉሴ አክሊሉ by News ET Social 3 years ago 7 minutes, 9 seconds 2,960 views",News ET Social,2960,2962,2
4563,"የህይወት ስንቅ ""የሰው ልጅ ምስጢራዊነት"" - በአስቴር በዳኔ by News ET Social 3 years ago 7 minutes, 52 seconds 4,086 views",News ET Social,4086,4087,1
4564,"Belaynesh ' Shebela ' New Ethiopian music Video 2108 by News ET Social 3 years ago 5 minutes, 36 seconds 14,928 views",News ET Social,14928,14933,5
4565,"Aschalew Fetene (Ardi)  'Aqua' new Ethiopian Music Video by News ET Social 3 years ago 4 minutes, 24 seconds 34,782 views",News ET Social,34782,35373,591
4566,"Binimos Mulugeta  ቢኒሞስ ሙሉጌታ ' Nunuye' New ethiopian Music video 2018 by News ET Social 3 years ago 5 minutes, 7 seconds 20,058 views",News ET Social,20058,20095,37
4567,"ቅንጡ ሰርግ አውደርዕይ በሸራተን አዲስ ሆቴል by News ET Social 3 years ago 6 minutes, 26 seconds 4,448 views",News ET Social,4448,4448,0
4568,"ETHIOPIA: የጀርመን ባህል ማዕከል  በአዲስ መልኩ የሰራው የመጀመሪያው ዲጂታል ላይብረሪ by News ET Social 3 years ago 10 minutes, 21 seconds 1,356 views",News ET Social,1356,1356,0
4569,"አትሌት ጡሩነሽ ዲባባ በኢትዮጵያ አየር መንገድ የሴቶች አምባሳደር ተብላ ተሸመች by News ET Social 3 years ago 5 minutes, 37 seconds 9,963 views",News ET Social,9963,9969,6
4570,"ETHIOPIA: 2010 የአለም አቀፍ የሴቶች ቀን አከባበር በሲዊድን ኢምባሲ መኖሪያ by News ET Social 3 years ago 1 minute, 4 seconds 2,317 views",News ET Social,2317,2319,2
4571,"ታላቅ የንግሥ በዓል በምድረ ከብድ አቡነ ገብረ መንፈስ ቅዱስ አንድነት ገዳም by News ET Social 3 years ago 29 minutes 13,723 views",News ET Social,13723,13794,71
4572,"ETHIOPIA - ማልታ ጊነስ ለማልታቬተር ዉድድር ኢትዮጵያን የሚወክሉ ተሳታፊዎች ይፋ አደረግ by News ET Social 3 years ago 1 minute, 52 seconds 3,296 views",News ET Social,3296,3296,0
4573,"Misganaw Andarge 'yagerlij' new music by News ET Social 3 years ago 7 minutes, 15 seconds 31,956 views",News ET Social,31956,31987,31
4574,"Misganaw Andarge 'Weynalem' Music video by News ET Social 3 years ago 6 minutes, 41 seconds 17,383 views",News ET Social,17383,17406,23
4575,"Misganaw Andarge 'Ababal new eyalku' New music video by News ET Social 3 years ago 5 minutes, 32 seconds 28,224 views",News ET Social,28224,28249,25
4576,"Ephrem Habtemichael Demisse -'Yenafkot Esregna' New music video by News ET Social 4 years ago 4 minutes, 23 seconds 11,523 views",News ET Social,11523,11529,6
4577,"ETHIOPIA -  ኢትዮጲያ አየር መንገድ በአፍሪካ የመጀመሪያ 'Air Bus Family' ጥቅም ላይ ሊዉል ነዉ by News ET Social 4 years ago 1 minute, 1 second 3,323 views",News ET Social,3323,3327,4
4578,"ETHIOPIA -  ሁለተኛዉ የአፍሪካ ሰርከስ ፌስቲቫል ሊጀምር ነዉ by News ET Social 4 years ago 3 minutes, 28 seconds 2,306 views",News ET Social,2306,2307,1
4579,"Aschalew Fetene (Ardi)New music video 2018- Adwa by News ET Social 4 years ago 4 minutes, 36 seconds 17,167 views",News ET Social,17167,17517,350
4580,"Abiy Zema - New music Video 2018 - Dedicated to Dr. Abiy Ahmed Ali by News ET Social 4 years ago 4 minutes, 20 seconds 1,152,448 views",News ET Social,1152448,1153097,649
4581,"ETHIOPIA - የኢትዮጵያንና የኤርትራን ግንኙነት ወደ ሰላም ለመመለስ ተጠየቀ by News ET Social 4 years ago 6 minutes, 2 seconds 5,826 views",News ET Social,5826,5826,0
4582,"የተጣሉ የፕላስቲክ የውኋ ማሸጊያዎችን በመጠቀም ዘመናዊ መኖሪያ ቤት ተሰራ by News ET Social 4 years ago 2 minutes, 55 seconds 6,665 views",News ET Social,6665,6666,1
4583,"""ደርሶ መልስ"" አዲስ ተከታታይ የቴሌቪዠን ድራማ by News ET Social 4 years ago 1 minute, 17 seconds 6,174 views",News ET Social,6174,6176,2
4584,"በአስቴር በዳኔ ( Aster Bedane) ከኢትዮጵያ ሰማይ ስር by News ET Social 4 years ago 3 minutes, 24 seconds 7,972 views",News ET Social,7972,7975,3
4585,"ETHIOPIA ለፌስቲቫል የተጓዙ ጋዜጠኞች ጉድ ተሰሩ። ጉድ የተሰሩት እንዴት ነዉ ? by News ET Social 4 years ago 4 minutes, 23 seconds 748 views",News ET Social,748,748,0
4586,"ETHIOPIA የቴዲ አፍሮ ቀጣይ ኮንሰርቶች የሚደረጉበት ቦታ ታወቁ by News ET Social 4 years ago 2 minutes, 10 seconds 1,944 views",News ET Social,1944,1944,0
4587,"ETHIOPIA በታዋቂዋ አርቲስት ክስ ምክንያት የ10 አመት እስር ተፈረደ ።  በታዋቂዋ አትሌት ክስ ምክንያት 10 አመት የተፈረደበት ማን ነዉ? by News ET Social 4 years ago 2 minutes, 28 seconds 3,506 views",News ET Social,3506,3506,0
4588,"ትርታ - ወንጀል ነክ ልብ አንጠልጣይ ድራማ by News ET Social 4 years ago 6 minutes, 39 seconds 30,614 views",News ET Social,30614,30615,1
4589,"Barkelegn Mulugeta(teddy) - lensaye New Ethiopian Music Video 2018 by News ET Social 4 years ago 6 minutes, 6 seconds 6,782 views",News ET Social,6782,6784,2
4590,"የ78ኛው አውማ ፈረሥ ጉግሥ ፌስቲቫል በእንጅባራ አዊ ዞን ከፕር 26-27 ይካሄዳል። by News ET Social 4 years ago 5 minutes, 34 seconds 24,454 views",News ET Social,24454,24481,27
4591,"GRAZMI - Yemetawa Nigist (የማታዋ ንግስት) - NEW Ethiopian Music Video 2018 by News ET Social 4 years ago 4 minutes, 45 seconds 8,662 views",News ET Social,8662,8665,3
4592,"ቀነኒሳ በቀለ በለንደን ማራቶን እንደሚሳተፍ አስታወቀ by News ET Social 4 years ago 54 seconds 1,646 views",News ET Social,1646,1646,0
4593,"YeMirekaw Mishet - የምረቃ ምሽት - 2017 ETHIOPIAN MOVIES ❤ by News ET Social Streamed 4 years ago 1 hour, 38 minutes 6,331 views",News ET Social,6331,6342,11
4594,"ተወዳጇ አርቲስት የልጅ እናት ልትሆን ነዉ፡፡ by News ET Social 4 years ago 2 minutes, 33 seconds 2,899 views",News ET Social,2899,2899,0
4595,"ተወዳጇ አርቲስት ድንገተኛ አደጋ ደረሰባት፡፡ by News ET Social 4 years ago 2 minutes, 55 seconds 2,497 views",News ET Social,2497,2497,0
4596,"Yemaytareku Kelemat (የማይታረቁ ቀለማት) Ethiopian Movie by News ET Social Streamed 4 years ago 2 hours, 16 minutes 11,653 views",News ET Social,11653,11657,4
4597,"ETHIOPIA: ድምፃዊ ቴዲ አፍሮ ለባህርዳር ስታዲዩም ኮንሰርት ዝግጅት by News ET Social 4 years ago 1 minute, 20 seconds 10,586 views",News ET Social,10586,10589,3
4598,"'በእናንተ ለሁሉ' Benante Lehulu Feleke Kassa New Ethiopian Music Video by News ET Social 4 years ago 9 minutes, 59 seconds 1,670 views",News ET Social,1670,1671,1
4599,"ብራዚላዊው ኮከብ ሮናልዲንሆ ከእግር ኳስ ጨዋታ ራሱን አገለለ by News ET Social 4 years ago 1 minute, 33 seconds 2,881 views",News ET Social,2881,2883,2
4600,"አደባባይ የወጣው የሰበታው ነዋሪየ4 ሚሊየን ብር ሎተሪ እድለኛ ሆኗል by News ET Social 4 years ago 1 minute, 15 seconds 733 views",News ET Social,733,733,0
4601,"በድሬዳዋ ኢንዱስትሪ ፓርክ  የመሠረት ድንጋይ ተቀመጠ by News ET Social 4 years ago 1 minute, 15 seconds 1,731 views",News ET Social,1731,1731,0
4602,"ስለ ቴዲ አፍሮ ኮንሰርት አንዳንድ ነገሮች by News ET Social 4 years ago 6 minutes, 52 seconds 29,408 views",News ET Social,29408,29411,3
4603,"ኦሮሚያና አማራ የሚፈቱ እስረኞችን እየለዩ ነው by News ET Social 4 years ago 1 minute, 53 seconds 903 views",News ET Social,903,903,0
4604,"አል ሲሲ ግብፅ በአባይ ላይ ያላትን ጥቅም ለማስጠበቅ ቃል ገቡ by News ET Social 4 years ago 2 minutes, 2 seconds 23,992 views",News ET Social,23992,23992,0
4605,"Yemeskerem Adey -  Misganaw  Bogale New Ethiopian Music Video by News ET Social 4 years ago 5 minutes, 52 seconds 9,789 views",News ET Social,9789,9796,7
4606,"The damage caused by earthquake in California by News ET Social 4 years ago 1 minute, 37 seconds 2,718 views",News ET Social,2718,2718,0
4607,"Teddy Afro is going to prepare  a concert in Bahirdar by News ET Social 4 years ago 1 minute, 12 seconds 5,068 views",News ET Social,5068,5068,0
4608,"Zikre Jah - Amnalew New Ethiopian Music 2018 (Audio) by News ET Social 4 years ago 3 minutes, 44 seconds 5,297 views",News ET Social,5297,5297,0
4609,"ወርቃማ ምሽቶች፤ ከወርቃማው ጋራ! ሀበሻ ቢራ! by News ET Social 4 years ago 1 minute, 3 seconds 5,624 views",News ET Social,5624,5633,9
4610,"Government response on remittance boycott by News ET Social 4 years ago 8 minutes, 9 seconds 2,678 views",News ET Social,2678,2678,0
4611,"ወደ እያንዳንዳችን እየገሰገሰ ያለ ክስተት!-የትራፊክ አደጋ by News ET Social 4 years ago 4 minutes, 56 seconds 1,049 views",News ET Social,1049,1049,0
4612,"Ethiopian Airlines Celebrated Christmas with children by News ET Social 4 years ago 1 minute, 47 seconds 2,074 views",News ET Social,2074,2074,0
4613,"Elias Firdawek - Endagersh እንዳገርሽ - New Ethiopian Music Video 2018 by News ET Social 4 years ago 4 minutes, 56 seconds 6,293 views",News ET Social,6293,6293,0
4614,"Mekedonia rewarded winners of 8050 SMS participants by News ET Social 4 years ago 3 minutes, 1 second 4,394 views",News ET Social,4394,4396,2
4615,"The untold stories of the late Aklilu Habtewold by News ET Social 4 years ago 1 hour, 7 minutes 26,828 views",News ET Social,26828,26986,158
4616,"Sisay Mekuanent ""Gena Ale Gena""  New Ethiopian Music Video 2017 by News ET Social 4 years ago 6 minutes, 4 seconds 3,997 views",News ET Social,3997,3997,0
4617,"Abebawa Lije ""አበባዋ ልጄ"" New Ethiopian Music Video (Official Video) 2017 by News ET Social 4 years ago 9 minutes, 4 seconds 22,133 views",News ET Social,22133,22147,14
4618,"Ethiopia: ""ሳንታ እና ዛፉ"" ገጣሚ ታገል ሰይፉ | Christmas Santa Claus and the Tree by News ET Social 4 years ago 7 minutes, 25 seconds 16,031 views",News ET Social,16031,16075,44
4619,"Tadi Lucky T ft. Eth Mambo ""Aye Malle | አይ ማሌ"" New Ethiopian Music Video 2017 by News ET Social 4 years ago 4 minutes, 51 seconds 4,134 views",News ET Social,4134,4175,41
4620,"A Chinese investor crates a job opportunity for Ethiopian youth's by News ET Social 4 years ago 3 minutes, 19 seconds 3,247 views",News ET Social,3247,3247,0
4621,"የኤርትራ እና የኢትዮጵያ ሕዝቦች የሰላም ተነሳሽነት by News ET Social 4 years ago 12 minutes, 9 seconds 6,660 views",News ET Social,6660,6661,1
4622,"New year's Eve Event At Monarch Hotel Addis Ababa 2018 by News ET Social 4 years ago 7 minutes, 13 seconds 3,532 views",News ET Social,3532,3533,1
4623,"የኢትዮጵያና የስዊድን አሪፍ አባት በሚል የተዘጋጀዉ የፎቶ ኤግዝቢሽን ተመረቀ by News ET Social 4 years ago 3 minutes, 8 seconds 2,761 views",News ET Social,2761,2761,0
4624,"በአይነቱ ልዩ የሆነ የቀዶ ህክምና አገልግሎት መስጫ ማዕከል ተመርቆ አግልግሎት መስጠት ጀመረ። by News ET Social 4 years ago 12 minutes, 48 seconds 1,910 views",News ET Social,1910,1910,0
4625,"Bini T Man - ""Be Amaregna"" [New Ethiopian Music Video 2017] by News ET Social 4 years ago 4 minutes, 18 seconds 14,972 views",News ET Social,14972,14978,6
4626,"ETHIOPIA: የአቶ መለስ እንጥፍጣፊ ሌጋሲዎች … by News ET Social 4 years ago 6 minutes, 13 seconds 3,732 views",News ET Social,3732,3732,0
4627,"ድሬቲዩብ ታሪክ: ጸሀፌ ትዕዛዝ አክሊሉ ሀብተ ወልድ ከ43 አመት በኃላ ሲታወሱ by News ET Social 4 years ago 8 minutes, 41 seconds 5,971 views",News ET Social,5971,5977,6
4628,"የንግድ ባዛር እና ኤግዚቢሽን በሞጆ ከተማ by News ET Social 4 years ago 3 minutes, 27 seconds 1,840 views",News ET Social,1840,1840,0
4629,"በሎተሪ ገንዘብ ህይወታቸው ወደ ገሀነምነት የተቀየረባቸው እድለኞቹ እድለቢሶች by News ET Social 4 years ago 9 minutes, 13 seconds 7,247 views",News ET Social,7247,7247,0
4630,"Yalew Aneley (Tiger)  ""ዓለምለወይ| Alem Laway"" Ethiopian Music Video by News ET Social 4 years ago 5 minutes, 44 seconds 6,337 views",News ET Social,6337,6343,6
4631,"Ethiopia: ""የቀን ጨለማ"" አጭር ድራማ Short Film 2017 by News ET Social 4 years ago 3 minutes, 38 seconds 15,331 views",News ET Social,15331,15365,34
4632,"Stand Up Comedian Talent Competition Round 1 Episode 3 by News ET Social 4 years ago 41 minutes 10,565 views",News ET Social,10565,10568,3
4633,"17th Annual Great Ethiopian Run by News ET Social 4 years ago 6 minutes, 29 seconds 7,051 views",News ET Social,7051,7055,4
4634,"Ethiopian Movie: ""ነግ በኔ"" New Ethiopian Short Film 2017 by News ET Social 4 years ago 3 minutes, 12 seconds 6,715 views",News ET Social,6715,6718,3
4635,"Ethiopian Movie: ""የደግነት ፍሬ"" New Ethiopian Short Film 2017 by News ET Social 4 years ago 5 minutes, 1 second 58,026 views",News ET Social,58026,58102,76
4636,"Ethiopian Movie: ""ወደ ብርሃን ጉዞ"" New Ethiopian Short Film 2017 by News ET Social 4 years ago 3 minutes, 32 seconds 18,738 views",News ET Social,18738,18762,24
4637,"New TV Station ‘Afri Health’ is about to Start by News ET Social 4 years ago 24 minutes 8,727 views",News ET Social,8727,8730,3
4638,"Opening ceremony of Sika Abyssinia Chemicals Manufacturing PLC by News ET Social 4 years ago 10 minutes, 13 seconds 6,535 views",News ET Social,6535,6540,5
4639,"Ethiopian Movie: ""My Fingers"" Short Ethiopian Film by News ET Social 4 years ago 4 minutes, 52 seconds 12,270 views",News ET Social,12270,12294,24
4640,"ETHIO FM: የኢትዮ ጣዕም ፕሮግራም - ለእጮኛዋ የጋብቻ ጥያቄ ያቀረበችው ሴት አዝናኝ ቆይታ by News ET Social 4 years ago 1 hour, 28 minutes 61,313 views",News ET Social,61313,61389,76
4641,"Basa Kadir (Bifftu)- Booja aa Jaalalaa (Oromo Music Video) by News ET Social 4 years ago 5 minutes, 14 seconds 27,912 views",News ET Social,27912,27929,17
4642,"Bassa Kadir (Biftuu) - Natti Himi Naaf Hingallee  [Oromo Music Video] by News ET Social 4 years ago 5 minutes, 35 seconds 34,088 views",News ET Social,34088,34136,48
4643,"Dan Admasu - Gagano | ጋጋኖ [NEW! Ethiopian Music Video 2017] by News ET Social 4 years ago 5 minutes, 14 seconds 146,726 views",News ET Social,146726,147246,520
4644,"Teqem ""ጥቅም"" - New Ethiopian Film 2017 From DireTube Cinema by News ET Social 4 years ago 1 hour, 19 minutes 97,391 views",News ET Social,97391,97479,88
4645,"Nahome & Alazare ""ቀልቤን የወሰደች"" [New Ethiopian Music Video 2017] by News ET Social 4 years ago 3 minutes, 33 seconds 4,449 views",News ET Social,4449,4452,3
4646,"Eros ""ኢሮስ"" - New Ethiopian Film 2017 From DireTube Cinema by News ET Social 4 years ago 1 hour 142,787 views",News ET Social,142787,142874,87
4647,"Henok Getu aka Heni G | Balebeta - ባለቤቴ NEW Ethiopian Music Video 2017 by News ET Social 4 years ago 4 minutes, 41 seconds 14,889 views",News ET Social,14889,14898,9
4648,"Tafarii Taddasaa – Goota Jamaamee New Oromoo 2017 Official Video by News ET Social 4 years ago 6 minutes, 7 seconds 33,251 views",News ET Social,33251,33318,67
4649,"Fitawrari – Menhen New ( Ere Weyee) New Ethiopian Music 2017 Official Video by News ET Social 4 years ago 5 minutes, 28 seconds 8,455 views",News ET Social,8455,8473,18
4650,"Faayoo Mootii – Geerare Didaan New Oromoo Music New Oromoo Music 2017 Official Video by News ET Social 4 years ago 8 minutes, 18 seconds 304,010 views",News ET Social,304010,304968,958
4651,"Geetuu Damissuu (Xiqqaa) – Amboo Gara Galgalla New Oromoo Music 2017 Official Video by News ET Social 4 years ago 5 minutes, 59 seconds 89,671 views",News ET Social,89671,90085,414
4652,"Ali Wendimu -  Sisite (ስስቴ) New Ethiopian Music 2017 Official Video by News ET Social 4 years ago 4 minutes, 28 seconds 4,889 views",News ET Social,4889,4894,5
4653,"Takee Tasfaa-  Maal Wayya? New Ethiopian Music 2017 Official Video by News ET Social 4 years ago 5 minutes, 4 seconds 731,111 views",News ET Social,731111,733182,2071
4654,"Bini Banks - Ye Habesha Lij (የሐበሻ ልጅ)  New Ethiopian Hip Hop Music 2017 Official Video by News ET Social 4 years ago 3 minutes, 23 seconds 9,826 views",News ET Social,9826,9834,8
4655,"Seenaa Mulugeetaa  - Kudhaama Seenaa New  Oromoo Music 2017 Official Video by News ET Social 4 years ago 6 minutes, 34 seconds 1,401,943 views",News ET Social,1401943,1408447,6504
4656,"Ethiopian Music - Nahome Haile - Wube (ውቤ) Official New Music Video 2017 by News ET Social 4 years ago 5 minutes, 21 seconds 15,100 views",News ET Social,15100,15108,8
4657,"Ethiopia: New Ethiopian VFX CGI Short Movie Tobiya with Break Down by News ET Social 4 years ago 20 minutes 2,475 views",News ET Social,2475,2476,1
4658,"Tesfaye Asefa  - Neyelegn Ney (ነይልኝ ነይ ) New Ethiopian Music 2017 Official Video by News ET Social 4 years ago 5 minutes, 5 seconds 9,981 views",News ET Social,9981,9989,8
4659,"Ethiopia: በ8400 ማንኛውም ፊደል በመላክ ሴቶችን ይርዱ ይሸለሙ by News ET Social 4 years ago 1 minute, 1 second 2,685 views",News ET Social,2685,2685,0
4660,"Lammaa Nugusuu – Maashoo Koo NEW Ethiopian Music Video 2017 Official Video by News ET Social 4 years ago 4 minutes, 37 seconds 3,291 views",News ET Social,3291,3292,1
4661,"Abarraa Warquu – Baafadhu Gumaa  NEW Ethiopian Music Video 2017 Official Video by News ET Social 4 years ago 6 minutes, 6 seconds 61,248 views",News ET Social,61248,61358,110
4662,"Qormaata Jaalalaa  NEW! Ethiopian Movie 2017 in Afaan Oromoo by News ET Social 4 years ago 1 hour, 18 minutes 155,504 views",News ET Social,155504,155701,197
4663,"Betty G - Passion | Tilk Simet (ጥልቅ ስሜት) - Official Music Video 2017 by News ET Social 4 years ago 3 minutes, 28 seconds 126,160 views",News ET Social,126160,126237,77
4664,"Abby Lakew New Album 2017 Ad by News ET Social 4 years ago 1 minute, 1 second 10,200 views",News ET Social,10200,10200,0
4665,"Kenny Allen Journey to Forever - ስለ ""ኬኒ አለን"" አዲስ የሙዚቃ አልበም by News ET Social 4 years ago 5 minutes, 43 seconds 4,099 views",News ET Social,4099,4100,1
4666,"Ethiopia:  ""የመጨረሻዎቹ""Short Ethiopian Movie by News ET Social 4 years ago 20 minutes 7,169 views",News ET Social,7169,7181,12
4667,"Muluken Dereje  (muler) - Atwashi (አትዋሺ) - New Ethiopian Music 2017 Official Video by News ET Social 4 years ago 3 minutes, 47 seconds 12,454 views",News ET Social,12454,12458,4
4668,"ኬኩን ዞር በል ብላ በድፎ ዳቦ ሰርጓን ያከበረችበት ቪዲዮ - Ethiopian Cultural Wedding Part 2 by News ET Social 4 years ago 13 minutes, 26 seconds 514,171 views",News ET Social,514171,514216,45
4669,"የመቅደስ ፀጋዬና የሰለሞን ሚዜዎች ያሳዩት ባህላዊ ፉከራ ጭፈራ - Actress Mekdes Tsegaye Wedding Part 1 by News ET Social 4 years ago 7 minutes, 59 seconds 344,869 views",News ET Social,344869,344898,29
4670,"የመቅደስ ፀጋዬ እና ሰለሞን መንጀታ የሰርግ ቪዲዮ - Mekdes Tsegaye Wedding Live! by News ET Social 4 years ago 6 minutes, 27 seconds 330,995 views",News ET Social,330995,331018,23
4671,"Fayoo Motii  - Tissoolee New Ethiopian Music 2017 Official Video by News ET Social 4 years ago 6 minutes, 23 seconds 51,557 views",News ET Social,51557,51665,108
4672,"Ahme Mered (Asher)  - Ney Ney Wedene (ነይ ነይ ወደኔ ) - New Ethiopian Music 2017 Official Video by News ET Social 4 years ago 3 minutes, 43 seconds 4,728 views",News ET Social,4728,4731,3
4673,"ETHIOPIA - Betty G - PASSION (ጥልቅ ስሜት) NEW! Album - Enjoy by News ET Social 4 years ago 2 minutes, 56 seconds 10,038 views",News ET Social,10038,10038,0
4674,"Biniyam Zelalem  - Anchi kalesh Gone  (አንቺ ካለሸ ጎኔ ) - New Ethiopian Music 2017 Official Video by News ET Social 4 years ago 4 minutes, 20 seconds 15,611 views",News ET Social,15611,15613,2
4675,"Ethiopian Motivational Video ""ህልምህ እስኪሳካ"" By Alexander Mulualem 2017 by News ET Social 4 years ago 5 minutes, 8 seconds 15,768 views",News ET Social,15768,15781,13
4676,"Teddy Afro - ""የተስፋ ቃል"" Video by Alexander Mulualem 2017 by News ET Social 4 years ago 4 minutes, 45 seconds 22,148 views",News ET Social,22148,22151,3
4677,"ETHIOPIA - Kaleab Mulugeta - Enja Semonun (እንጃ ሰሞኑን) Ethiopian Music Video 2017 Official by News ET Social 4 years ago 4 minutes, 4 seconds 655,808 views",News ET Social,655808,658140,2332
4678,"Ethiopian Movie - ""ፍሬዋማ ተጓዥ"" አዲስ ሙሉ ፊልም  - NEW Movie 2017 by News ET Social 4 years ago 54 minutes 9,556 views",News ET Social,9556,9569,13
4679,"Alemayehu Mersha - Merkato (መርካቶ ) - New Ethiopian Music 2017 Official Video by News ET Social 4 years ago 5 minutes, 36 seconds 3,912 views",News ET Social,3912,3914,2
4680,"Andargachew Genetu  – Awegizani (አውግዛኒ) New Ethiopian Music 2017 Official Video by News ET Social 4 years ago 4 minutes, 42 seconds 12,012 views",News ET Social,12012,12014,2
4681,"Abilam - ዓቢላማ (NEW! Ethiopian Movie 2017) by News ET Social 4 years ago 1 hour, 27 minutes 247,003 views",News ET Social,247003,247119,116
4682,"Ethiopia: ""ሙዝ"" Short Film by News ET Social 4 years ago 12 minutes, 5 seconds 9,318 views",News ET Social,9318,9322,4
4683,"Tsegazeab G/Selasie ""Asena""  [NEW! Ethiopian Music Video 2017] Official Video by News ET Social 4 years ago 5 minutes, 35 seconds 29,384 views",News ET Social,29384,29412,28
4684,"Ras Za Meh – Behagere (በሐገሬ) New Ethiopian Music 2017 Official Video by News ET Social 4 years ago 4 minutes, 36 seconds 6,561 views",News ET Social,6561,6568,7
4685,"Zantana – Hoyaye (ሆያዬ) New Ethiopian Music 2017 Official Video by News ET Social 4 years ago 6 minutes, 6 seconds 8,978 views",News ET Social,8978,8991,13
4686,"Girum Regassa ( Ra- G) – Bel Rot Rot  (በል ሮጥ ሮጥ) New Ethiopian Music 2017 Official Video by News ET Social 4 years ago 4 minutes, 18 seconds 6,117 views",News ET Social,6117,6117,0
4687,"Werkye Mamuye - Yizogn Geba Weloo (ይዞኝ ገባ ወሎ) New Ethiopian Music 2017 Official Video by News ET Social 4 years ago 5 minutes, 34 seconds 857,915 views",News ET Social,857915,858039,124
4688,"ETHIOPIA: Betty G, Sami Dan, Jano Band and Asgegnew Ashko - New Year Hit Single by News ET Social 4 years ago 3 minutes, 52 seconds 15,249 views",News ET Social,15249,15251,2
4689,"Netsanet Berhane - Ene Alemedim (እኔ አለምድም)  New Ethiopian Music 2017 Official Video by News ET Social 4 years ago 4 minutes, 45 seconds 70,267 views",News ET Social,70267,70320,53
4690,"Alemayhu Mersha - Bahilachen (ባሕላችን )- New Ethiopian Music Video 2017 by News ET Social 4 years ago 5 minutes, 21 seconds 8,700 views",News ET Social,8700,8700,0
4691,"Yared Shumet  - Kemekem Gofere  ( ከመከም ጎፈሬ) - New Ethiopian Music Video by News ET Social 4 years ago 5 minutes, 2 seconds 52,050 views",News ET Social,52050,52069,19
4692,"Ethiopia: Halefom Barento Live Performance by News ET Social 4 years ago 10 minutes, 38 seconds 5,215 views",News ET Social,5215,5219,4
4693,"Ethiopia: ""Nekawe"" Ethiopian Short Comedy Drama by News ET Social 4 years ago 10 minutes, 47 seconds 1,651,934 views",News ET Social,1651934,1673115,21181
4694,"Lammii Borjii - Bellamni Yoomii  [NEW! Ethiopian Music Video 2017] Official Video by News ET Social 4 years ago 4 minutes, 50 seconds 8,740 views",News ET Social,8740,8744,4
4695,"Sami Dan & Lij Michael (Faf) - Ayzosh (አይዞሽ) - New Ethiopian Music Video by News ET Social 4 years ago 5 minutes, 12 seconds 1,935,770 views",News ET Social,1935770,1950530,14760
4696,"Matoo Fufaa  - Ayyaana Wagga 2faa [NEW! Ethiopian Music Video 2017] Official Video by News ET Social 4 years ago 5 minutes, 49 seconds 20,000 views",News ET Social,20000,20031,31
4697,"Alex Sheger  - Fikre Ale  [NEW! Ethiopian Music Video 2017] Official Video by News ET Social 4 years ago 5 minutes, 17 seconds 11,263 views",News ET Social,11263,11267,4
4698,"ETHIOPIA: ""የአባቶች ወግ ""New Short Ethiopian Drama by News ET Social 4 years ago 14 minutes, 57 seconds 322,224 views",News ET Social,322224,325032,2808
4699,"Ethiopian Short Film ""Feker Bastergome"" ፍቅር በአስተርጓሚ New Movie by News ET Social 4 years ago 24 minutes 45,376 views",News ET Social,45376,45385,9
4700,"Tsegalule Hailemariam Live Performance 2017 by News ET Social 4 years ago 9 minutes, 18 seconds 1,265 views",News ET Social,1265,1266,1
4701,"Aduunyaa Badhadhaa - Sossobi Garaa [NEW! Ethiopian Music Video 2017] Official Video by News ET Social 4 years ago 5 minutes, 29 seconds 3,735 views",News ET Social,3735,3739,4
4702,"Daniel Zewdu - Enzirt Nat [NEW! Ethiopian Music Video 2017] Official Video by News ET Social 4 years ago 4 minutes, 5 seconds 20,761 views",News ET Social,20761,20783,22
4703,"ETHIOPIA: ""Gudayachin"" Short New Ethiopian Movie 2017 by News ET Social 4 years ago 10 minutes, 58 seconds 343,577 views",News ET Social,343577,344607,1030
4704,"Selamat Kelolom and Askal Huluf [Ethiopian Traditional Music] by News ET Social 4 years ago 10 minutes, 27 seconds 1,638 views",News ET Social,1638,1639,1
4705,"Ashannaafii Nugusuu - Atuu Damma [NEW! Ethiopian Music Video 2017] Official Video by News ET Social 4 years ago 5 minutes, 15 seconds 17,596 views",News ET Social,17596,17598,2
4706,"Ethio Zodiac Music\Movie Award  2017 by News ET Social 4 years ago 1 minute, 22 seconds 5,998 views",News ET Social,5998,6001,3
4707,"Ayer Bayer ""አየር በአየር "" New Series Ethiopian Movie Coming Soon by News ET Social 4 years ago 2 minutes, 16 seconds 11,013 views",News ET Social,11013,11015,2
4708,"Teddy Gwangul - ""እንገናኛለን"" [NEW! Ethiopian Music Video 2017] Official Video by News ET Social 4 years ago 5 minutes, 18 seconds 8,056 views",News ET Social,8056,8067,11
4709,"Abebe Araya ""ኣይርስዐኪን ዓደይ"" Live Performance [Ethiopian Music Video 2017] by News ET Social 4 years ago 13 minutes, 33 seconds 12,450 views",News ET Social,12450,12452,2
4710,"Muluye Derso - Argiw Neka [NEW! Ethiopian Music Video 2017] Official Video by News ET Social 4 years ago 6 minutes, 1 second 19,228 views",News ET Social,19228,19278,50
4711,"Juke Box and Dawit Biru - Kuri [NEW! Ethiopian Music Video 2017] Official Video by News ET Social 4 years ago 4 minutes, 8 seconds 9,576 views",News ET Social,9576,9577,1
4712,"Semien Worku - Kan Siidhukku buu Gaaranii [NEW! Ethiopian Music Video 2017] Official Video by News ET Social 4 years ago 4 minutes, 12 seconds 3,719 views",News ET Social,3719,3719,0
4713,"Kinbiola [ New Tigrigna Film 2017] Part B by News ET Social 4 years ago 39 minutes 158,219 views",News ET Social,158219,158327,108
4714,"Kinbiola  [ New Tigrigna Film 2017] Part A by News ET Social 4 years ago 45 minutes 161,050 views",News ET Social,161050,161204,154
4715,"አባባ ተስፋዬ ከዚህ አለም በሞት ተለዩ  | Ababa Tesfaye Sahilu Dead at the Age of 94 by News ET Social 4 years ago 7 minutes, 5 seconds 7,417 views",News ET Social,7417,7417,0
4716,"Endashaw Shenekute - Weye Adefaferu [NEW! Ethiopian Music Video 2017] Official Video by News ET Social 4 years ago 6 minutes, 53 seconds 31,761 views",News ET Social,31761,31764,3
4717,"Dire Dawa - Documentary Soundtrack [NEW! Ethiopian Music Video 2017] Official Video by News ET Social 4 years ago 6 minutes, 5 seconds 14,513 views",News ET Social,14513,14527,14
4718,"Faayoo Mootii Leetoo [NEW! Music Video 2017] - Official Video by News ET Social 4 years ago 4 minutes, 43 seconds 25,688 views",News ET Social,25688,25725,37
4719,"Malee Zaan Jaar - Yyaaddoo  [NEW! Ethiopian Music Video 2017] Official Video by News ET Social 4 years ago 4 minutes, 9 seconds 7,970 views",News ET Social,7970,7971,1
4720,"Sertse Tadesse - New Bahlawi Tigrigna Wedding Music Video 2017 (Official Video) by News ET Social 4 years ago 6 minutes, 24 seconds 580,328 views",News ET Social,580328,580630,302
4721,"ABUSH ZELEKE - Koottu (NEW! Official Video 2017) Afaan Oromoo Music Video by News ET Social 4 years ago 5 minutes, 20 seconds 579,341 views",News ET Social,579341,583136,3795
4722,"Wave Slassan - Shirea Endaslase [NEW! Ethiopian Music Video 2017] Official Video by News ET Social 4 years ago 4 minutes, 26 seconds 35,146 views",News ET Social,35146,35176,30
4723,"Melaku Demelew - Astawseshalew [NEW! Ethiopian Music Video 2017] Official Video by News ET Social 4 years ago 6 minutes, 19 seconds 3,914 views",News ET Social,3914,3918,4
4724,"Abel Asefa - [NEW! Ethiopian Music Video 2017] Official Video by News ET Social 4 years ago 4 minutes, 49 seconds 12,085 views",News ET Social,12085,12107,22
4725,"Shumet Andarge - Teketelat [NEW! Ethiopian Music Video 2017] Official Video by News ET Social 4 years ago 5 minutes, 26 seconds 17,394 views",News ET Social,17394,17398,4
4726,"Kasahun Wendemu - Enteyay [NEW! Ethiopian Music Video 2017] Official Video by News ET Social 4 years ago 6 minutes, 39 seconds 2,992 views",News ET Social,2992,2993,1
4727,"Ashenafi Aweke - Emnete Nesh [NEW! Ethiopian Music Video 2017] Official Video by News ET Social 4 years ago 4 minutes, 50 seconds 4,519 views",News ET Social,4519,4520,1
4728,"Ibrahim Roba - Doorii (ዶሪ) - New Afaan Oromoo Karrayyu Music Video 2017 by News ET Social 4 years ago 5 minutes, 57 seconds 4,527 views",News ET Social,4527,4538,11
4729,"Yenes Adam - የእኔስ አዳም (NEW! Ethiopian Movie 2017) by News ET Social 4 years ago 1 hour, 31 minutes 1,453,631 views",News ET Social,1453631,1463592,9961
4730,"Dawit Tsige - Arada [Ethiopian Music Video ] Official Video by News ET Social 4 years ago 6 minutes, 3 seconds 92,217 views",News ET Social,92217,92770,553
4731,"G-Mix Ft Tomms Music - Bekera [NEW! Ethiopian Music Video 2017] Official Video by News ET Social 4 years ago 3 minutes, 4 seconds 3,745 views",News ET Social,3745,3757,12
4732,"Tsewar Libi   ፀዋር ልቢ Trailer Ethiopian Tigrigna Movie by News ET Social 4 years ago 31 seconds 22,376 views",News ET Social,22376,22388,12
4733,"Yeltesebere (ያልተሰበረ) Full Amharic Movie from DireTube Cinema by News ET Social 4 years ago 1 hour, 34 minutes 142,032 views",News ET Social,142032,142159,127
4734,"Dereje Bezuwerek - Etaye [NEW! Ethiopian Music Video 2017] Official Video by News ET Social 4 years ago 6 minutes, 44 seconds 213,405 views",News ET Social,213405,214017,612
4735,"Daniel Kebede - Mariya [NEW! Ethiopian Music Video 2017] Official Video by News ET Social 4 years ago 5 minutes, 17 seconds 18,124 views",News ET Social,18124,18146,22
4736,"The 5 Ethiopian Multi-Millionaires You Should Know! - Forbes 👏 by News ET Social 4 years ago 1 minute, 31 seconds 20,693 views",News ET Social,20693,20698,5
4737,"Tihut Ahimed - Damma Daamuu [NEW! Ethiopian Music Video 2017] Official Video by News ET Social 4 years ago 5 minutes, 59 seconds 27,064 views",News ET Social,27064,27077,13
4738,"Million Tekle - Seketaki [NEW! Ethiopian Music Video 2017] Official Video by News ET Social 4 years ago 3 minutes, 58 seconds 13,557 views",News ET Social,13557,13561,4
4739,"Ethiopia - Amare Mere'ed - Teleyalesh [NEW! Ethiopian Music Video 2017 by News ET Social 4 years ago 4 minutes, 19 seconds 21,334 views",News ET Social,21334,21359,25
4740,"Asayhgn Alemayehu - Mesaki ምሳኪ  [NEW! Ethiopian Music Video 2017] Official Video by News ET Social 4 years ago 6 minutes, 45 seconds 6,674 views",News ET Social,6674,6677,3
4741,"Ebeza Aligaze -Yekrata [NEW! Ethiopian Music Video 2017] Official Video by News ET Social 4 years ago 6 minutes, 1 second 4,946 views",News ET Social,4946,4947,1
4742,"W/Gebriel Awethagne - Mene Eki Mene [NEW! Ethiopian Music Video 2017] Official Video by News ET Social 4 years ago 6 minutes, 26 seconds 10,592 views",News ET Social,10592,10592,0
4743,"Asayhgn Alemayehu - kesad herge hergo [NEW! Ethiopian Music Video 2017] Official Video by News ET Social 4 years ago 7 minutes, 18 seconds 6,871 views",News ET Social,6871,6872,1
4744,"Ephrem Amare - Azamet [NEW! Ethiopian Music Video 2017] Official Video by News ET Social 4 years ago 6 minutes, 14 seconds 1,787,262 views",News ET Social,1787262,1791240,3978
4745,"Reshan Kassa - Cefreseye ቸፈረሰየ [NEW! Ethiopian Music Video 2017] Official Video by News ET Social 4 years ago 6 minutes, 32 seconds 15,478 views",News ET Social,15478,15507,29
4746,"Senait Berhane - Habhaby [NEW! Ethiopian Music Video 2017] Official Video by News ET Social 4 years ago 5 minutes, 42 seconds 13,611 views",News ET Social,13611,13626,15
4747,"Ethiopia - Alemu Aysa - Gisole (ጊሶሌ) | [NEW! Ethiopian Music Video 2017] by News ET Social 4 years ago 5 minutes, 17 seconds 4,028 views",News ET Social,4028,4035,7
4748,"Ethiopian Actress Hanan Tariq is Three Month Pregnant by News ET Social 4 years ago 1 minute, 23 seconds 78,809 views",News ET Social,78809,78819,10
4749,"Yemaytareku Kelemat የማይታረቁ ቀለማት Ethiopian Movie by News ET Social 4 years ago 1 hour, 34 minutes 26,165 views",News ET Social,26165,26171,6
4750,"Maya - ማያ - New Ethiopian Movie - አዲስ ፊልም by News ET Social 4 years ago 1 minute, 39 seconds 274,606 views",News ET Social,274606,274610,4
4751,"Abarraa Warquu - Warra Jiillee [NEW! Ethiopian Music Video 2017] Kamisee Tradition by News ET Social 4 years ago 5 minutes, 40 seconds 345,226 views",News ET Social,345226,346444,1218
4752,"Amanuel Abu - Ye Ewnet Mesker - [NEW! Ethiopian Music Video 2017] by News ET Social 4 years ago 4 minutes, 4 seconds 5,816 views",News ET Social,5816,5820,4
4753,"Yalew Aneley - Bey Wediya Wedi (በይ ወዲያ ወዲህ) [NEW! African Style Ethiopian Music 2017] by News ET Social 4 years ago 4 minutes, 3 seconds 19,143 views",News ET Social,19143,19164,21
4754,"Yohannes Yirdaw - Zaleye (ዛልዬ) [NEW Ethiopian Music Video 2017] by News ET Social 4 years ago 4 minutes, 50 seconds 39,062 views",News ET Social,39062,39082,20
4755,"Teddy Afro Mar Eske Tuwaf - WOW! Animation! 😀 ❤ 🇪🇹 👌 👍 by News ET Social 4 years ago 1 minute, 59 seconds 189,157 views",News ET Social,189157,189190,33
4756,"EBC Journalist Biruk Endale Resigned over Teddy Afro Interview by News ET Social 4 years ago 1 minute, 22 seconds 5,622 views",News ET Social,5622,5628,6
4757,"Elisabeth Ayenew - Yademeko (ያደሜኮ) [New! Ethiopian Music Video 2017] by News ET Social 4 years ago 5 minutes, 3 seconds 10,117 views",News ET Social,10117,10119,2
4758,"Emebet Yeshibelay - Amrobetal (አምሮበታል) [NEW! Ethiopian Wedding Song 2017] by News ET Social 4 years ago 5 minutes, 28 seconds 25,377 views",News ET Social,25377,25407,30
4759,"Abush Zeleke - Ee, Malawwee [NEW! Ethiopian Music Video 2017] Official Video by News ET Social 4 years ago 4 minutes, 41 seconds 981,097 views",News ET Social,981097,986215,5118
4760,"Breaking News: Teddy Afro and Amleset Muchie Surprise Gift! by News ET Social 4 years ago 2 minutes, 33 seconds 16,073 views",News ET Social,16073,16073,0
4761,"Alem Takele - Welelaye (ወለላዬ) [NEW! Ethiopian Music Video 2017] by News ET Social 4 years ago 5 minutes, 1 second 127,905 views",News ET Social,127905,127914,9
4762,"ETHIOPIA - Binito Gezahegn - Lal Yeblale (ላል ይበላል) [NEW! Ethiopian Music Video 2017] by News ET Social 4 years ago 5 minutes, 35 seconds 14,752 views",News ET Social,14752,14752,0
4763,"ETHIOPIA - የቴዲ አፍሮ ቃለ መጠይቅ በኢቢሲ ነገ እሁድ መዝናኛ ፕሮግራም ላይ አይቀርብም by News ET Social 4 years ago 3 minutes, 21 seconds 7,563 views",News ET Social,7563,7564,1
4764,"ETHIOPIA - Actress Hanan Tarik Says Goodbye to Welafen TV Show by News ET Social 4 years ago 1 minute, 6 seconds 19,907 views",News ET Social,19907,19908,1
4765,"Teddy Afro's Ethiopia Album #1 on Billboard World Chart by News ET Social 4 years ago 1 minute, 3 seconds 65,634 views",News ET Social,65634,65653,19
4766,"ETHIOPIA: Wibeshet Awgechew - Ney Ney (ነይ..ነይ) NEW Ethiopian Music Video 2017 🇪🇹 ❤ by News ET Social 4 years ago 5 minutes, 11 seconds 72,968 views",News ET Social,72968,73083,115
4767,"ETHIOPIA - Tesfu Delta - Delash Wey (ደላሽ ወይ) New Ethiopian Music Video 2017 🇪🇹 by News ET Social 4 years ago 7 minutes, 9 seconds 853,807 views",News ET Social,853807,855250,1443
4768,"🇪🇹 ETHIOPIA - 😀 Habesha Beer 🍻 New Year Wish AMAZING Ads by News ET Social 4 years ago 1 minute, 2 seconds 6,180 views",News ET Social,6180,6189,9
4769,"Teddy Afro ""Ethiopia"" - At a Live Concert - The Crowed Going WILD! 🎧❤🔝 by News ET Social 4 years ago 3 minutes, 43 seconds 712,613 views",News ET Social,712613,712828,215
4770,"ETHIOPIA 🇪🇹 Jah Yeab -  ኸረ...ኸረ Ere Ere [New! Ethiopian Music Video 2017]  ❤ by News ET Social 4 years ago 2 minutes, 58 seconds 15,463 views",News ET Social,15463,15466,3
4771,"🇪🇹 ETHIOPIA - Artist Madingo Afework Message to Teddy Afro - Ethiopia! by News ET Social 4 years ago 58 seconds 19,179 views",News ET Social,19179,19185,6
4772,"Selamawit Girma - Mabede New (ማበዴ ነው) [NEW! Ethiopian Bahilawi Music Video 2017] by News ET Social 4 years ago 4 minutes, 1 second 118,556 views",News ET Social,118556,118656,100
4773,"Exclusive Interview with Actress Helen Bedlu - May 5, 2017 by News ET Social 4 years ago 3 minutes, 48 seconds 115,551 views",News ET Social,115551,115577,26
4774,"🇪🇹 ETHIOPIA - Thomas Ayele - Shegeye (ሸግዬ) | NEW Ethiopian Music Video 2017 by News ET Social 4 years ago 4 minutes, 24 seconds 13,230 views",News ET Social,13230,13238,8
4775,"ETHIOPIA - Surafel Chaine - Eyetemegnehu እየተመኘሁ (NEW! Ethiopian Music Video 2017) by News ET Social 4 years ago 3 minutes, 34 seconds 2,412 views",News ET Social,2412,2412,0
4776,"❤ ETHIOPIA: Meron Weded - Duma (ዱማ) [NEW! Ethiopian Music Video 2017] HOT! by News ET Social 4 years ago 4 minutes 8,856 views",News ET Social,8856,8860,4
4777,"ETHIOPIA: Tadele Gemechu - BarriHindarba [Ethiopian Music Video 2017] by News ET Social 4 years ago 5 minutes, 46 seconds 4,650,238 views",News ET Social,4650238,4678810,28572
4778,"Meskerem Ye Hodakogn Lij - Gelmitku (ጌልሚትኩ) [NEW Ethiopian Music Video 2017] by News ET Social 4 years ago 3 minutes, 48 seconds 3,056 views",News ET Social,3056,3069,13
4779,"Alemu Ayesa - Wike (ዋይኬ) [NEW! Ethiopian Music Video 2017] by News ET Social 4 years ago 4 minutes, 31 seconds 6,624 views",News ET Social,6624,6629,5
4780,"Meseret Mulugeta - ሲያዩት ያማልላል ጎፈሬው [NEW! Ethiopian Bahilawi Music Video 2017] by News ET Social 4 years ago 5 minutes, 16 seconds 88,398 views",News ET Social,88398,88429,31
4781,"Ethiopia: Yidne Rasta - Fiker [NEW! Ethiopian Reggae Music Video 2017] by News ET Social 4 years ago 5 minutes, 23 seconds 56,014 views",News ET Social,56014,56158,144
4782,"Teddy Afro Ethiopia - One Week Stats - Teddy Afro is Trending! by News ET Social 4 years ago 1 minute, 21 seconds 15,975 views",News ET Social,15975,15975,0
4783,"Ethiopia: ''ላብጦስ'' በተወዳጅ ተዋንያን የተሰራ አዲስ ምርጥ ፊልም by News ET Social 4 years ago 1 minute, 1 second 56,707 views",News ET Social,56707,56708,1
4784,"Ethiopian Movie Trailer - ""የአርበኛው ልጅ ጉዞ ወደ ማንነት "" DireTube Cinema 2017 Ye Arbegnaw Lij Part 2 by News ET Social 4 years ago 1 minute, 5 seconds 54,397 views",News ET Social,54397,54472,75
4785,"Ephrem Habte Michael & Habte Michael Demessie - Bati - ባቲ ምርጥ ባህላዊ ሙዚቃ 🇪🇹 ❤ 🎧 by News ET Social 4 years ago 5 minutes, 41 seconds 119,131 views",News ET Social,119131,119419,288
4786,"YeMirekaw Mishet - የምረቃ ምሽት - 2017 ETHIOPIAN MOVIES ❤ by News ET Social 4 years ago 1 hour, 27 minutes 28,399 views",News ET Social,28399,28409,10
4787,"Semehal Hailu - Yante Amelegna | ያንተ አመለኛ (NEW! Ethiopian Music Video 2017) 🇪🇹 ❤ 🎧 2⃣0⃣1⃣7⃣ 🔝 by News ET Social 4 years ago 3 minutes, 24 seconds 151,475 views",News ET Social,151475,151489,14
4788,"Singer Henok Addis - ""Alew Leka Motim Tinsae""  New! 2017 by News ET Social 4 years ago 5 minutes, 34 seconds 15,740 views",News ET Social,15740,15752,12
4789,"The Forbidden ""የተከለከለ ቅድመእይታ"" Hollywood Standard Ethiopian movie trailer by News ET Social 4 years ago 1 minute, 33 seconds 14,433 views",News ET Social,14433,14434,1
4790,"Meskerem Ye Hodakogn Lij - Kaymeze | ካይሜዜ [NEW! Ethiopian Music 2017] by News ET Social 4 years ago 4 minutes, 22 seconds 10,356 views",News ET Social,10356,10375,19
4791,"Yalew Tariku aka Yaya - Seb Teri | ሰብ  ጥሪ - NEW Ethiopian Music 2017 (Official Video) by News ET Social 4 years ago 5 minutes, 3 seconds 7,160 views",News ET Social,7160,7162,2
4792,"Micky Gonderegna - Pee | ፐ - New Ethiopian Music 2017 (Official Video) by News ET Social 4 years ago 3 minutes, 56 seconds 184,079 views",News ET Social,184079,184365,286
4793,"Ethiopia - Bereket Mesgina - Bealti Zegoley (NEW Ethiopian Music Video 2017) Tigrigna Official Video by News ET Social 4 years ago 6 minutes, 16 seconds 76,571 views",News ET Social,76571,76586,15
4794,"Ethiopia - Amare Mere'ed Delekaw (ድለቃው) - NEW Ethiopian Music Video 2017 Official Video by News ET Social 4 years ago 6 minutes, 31 seconds 36,573 views",News ET Social,36573,36579,6
4795,"Ethiopia - Leake Tadese - Lale Nesh (ላሌ ነሽ) - NEW! Ethiopian Music Video 2017 by News ET Social 4 years ago 5 minutes, 35 seconds 6,239 views",News ET Social,6239,6239,0
4796,"Hermon Baraki - Fikri Mefatrtey [NEW! Ethiopian Music Video 2017] - Ethiopia by News ET Social 4 years ago 4 minutes, 57 seconds 18,796 views",News ET Social,18796,18824,28
4797,"ETHIOPIA - Mozazo ሞዛዞ [NEW! Ethiopian Music Video 2017] by News ET Social 4 years ago 4 minutes, 12 seconds 9,974 views",News ET Social,9974,9977,3
4798,"BATA RECORDS Debre Zeit Bishoftu Amazing Concert! Enjoy by News ET Social 4 years ago 2 minutes, 38 seconds 1,705 views",News ET Social,1705,1706,1
4799,"Addis Gurmesa - Talaq Chilota New (ታላቅ ችሎታ ነው) [NEW Ethiopian Music 2017] Official Video by News ET Social 4 years ago 3 minutes, 56 seconds 170,538 views",News ET Social,170538,170998,460
4800,"Ethiopian Movie Trailer - ""ፈልጌ አስፈልጌ"" DireTube Cinema 2017 by News ET Social 4 years ago 46 seconds 6,769 views",News ET Social,6769,6769,0
4801,"Fikru Arage - Mekemecha (ፍቅሩ አራጌ - መቀመጫ) - NEW Ethiopian Musical Comedy by News ET Social 4 years ago 5 minutes, 54 seconds 37,486 views",News ET Social,37486,37505,19
4802,"Eyobed X Jordan & Bek Ge'ez - Tsedal (ፀዳል) NEW Ethiopian Music 2017 (Official Video) by News ET Social 4 years ago 4 minutes, 25 seconds 52,625 views",News ET Social,52625,52788,163
4803,"Tadele Gemechu - SABABUYAAKO Ft. Abbush Zelaqa - NEW! Ethiopian Music Afaan Oromoo 2017 by News ET Social 4 years ago 6 minutes, 26 seconds 348,094 views",News ET Social,348094,349553,1459
4804,"FetaZena App - A MUST Have Ethiopian APP by News ET Social 4 years ago 47 seconds 3,029 views",News ET Social,3029,3029,0
4805,"Kaleb ArayaSlasia & Fasika Alemayehu Setemechign Wilesh | ስትመቺኝ ውለሽ - NEW Ethiopian Music 2017 by News ET Social 4 years ago 4 minutes, 23 seconds 14,716 views",News ET Social,14716,14722,6
4806,"Mihret Tenker (Beyo) - Teregaga | ተረጋጋ - New Ethiopian Music 2017 (Official Video) by News ET Social 4 years ago 5 minutes, 1 second 52,905 views",News ET Social,52905,52908,3
4807,"Halima Abdurehman - Esikalew (እስቃለው) Official Music Video by News ET Social 4 years ago 5 minutes, 18 seconds 11,949 views",News ET Social,11949,11966,17
4808,"ፍቅርና ፌስቡክ Ethiopian Movie from DireTube Cinema by News ET Social 4 years ago 1 hour, 41 minutes 26,494 views",News ET Social,26494,26513,19
4809,"ETHIOPIA: Nege ነገ Ethiopian Movie from DireTube Cinema by News ET Social 4 years ago 1 hour, 48 minutes 343,823 views",News ET Social,343823,344690,867
4810,"ETHIOPIA - Artist Shewit Kebede talk about her funny childhood love letter by News ET Social 4 years ago 2 minutes, 21 seconds 96,799 views",News ET Social,96799,96844,45
4811,"Ethiopia - Sami Dan - Wedelay (ወደ ላይ) - NEW! Ethiopian Music Video 2017 by News ET Social 4 years ago 4 minutes, 8 seconds 18,511 views",News ET Social,18511,18527,16
4812,"Ethiopia - Yisak Samuel & Ras Zailo Ethio Ghana - Ethiopian Music Video 2017 by News ET Social 4 years ago 4 minutes, 37 seconds 5,683 views",News ET Social,5683,5688,5
4813,"Filiya (ፊሊያ) - NEW! Ethiopian Film 2017 by News ET Social 5 years ago 1 hour, 15 minutes 477,490 views",News ET Social,477490,477622,132
4814,"Ethiopia - Syco David Ahadu - Feta (ፈታ) NEW! Official Music Video 2017 by News ET Social 5 years ago 3 minutes, 7 seconds 15,291 views",News ET Social,15291,15298,7
4815,"Hussein Berhale - Wagte Me'a (ዋግቴህ ሜኤ) - NEW! Official Music Video 2017 by News ET Social 5 years ago 4 minutes, 35 seconds 148,017 views",News ET Social,148017,149578,1561
4816,"Abush Zeleke - Jaljilo ጃልጂሎ NEW! Ethiopian Music Video 2017 by News ET Social 5 years ago 6 minutes, 16 seconds 1,109,924 views",News ET Social,1109924,1114486,4562
4817,"Meeroon Araarsaa (Merry) - Ee Saayyahoo (NEW! Official Music Video 2017 by News ET Social 5 years ago 5 minutes, 19 seconds 16,565 views",News ET Social,16565,16596,31
4818,"Meselu Tesema - Gojamew Na - NEW! Ethiopian Traditional Music Video 2017 by News ET Social 5 years ago 5 minutes, 45 seconds 54,783 views",News ET Social,54783,54789,6
4819,"Ethiopian Movie - ሁለት ወዶ Hulet Wedo - NEW Ethiopia Film 2017 by News ET Social 5 years ago 1 hour, 24 minutes 434,934 views",News ET Social,434934,435094,160
4820,"Ethiopian Movie: Misale - ምሳሌ - New Ethiopia Film 2017 by News ET Social 5 years ago 1 hour, 35 minutes 136,622 views",News ET Social,136622,136629,7
4821,"Dawit Nega Wezamey ወዛመይ NEW! Tigrigna Traditional Music Video 2016 by News ET Social 5 years ago 7 minutes, 30 seconds 29,196 views",News ET Social,29196,29241,45
4822,"Ethiopian Movie: Bechana Gulecha (ብቻና ጉልቻ) - New Ethiopia Film 2017 by News ET Social 5 years ago 1 hour, 19 minutes 209,722 views",News ET Social,209722,209796,74
4823,"Mingi (ሚንጊ) - Amazing Film Made in Ethiopia - 2017 by News ET Social 5 years ago 20 minutes 108,996 views",News ET Social,108996,109163,167
4824,"Zelalem Tusa Wol Gorfena - New Ethiopian Music 2017 Official Video by News ET Social 5 years ago 7 minutes, 21 seconds 8,910 views",News ET Social,8910,8912,2
4825,"Yabu jc - Yenegal (ይነጋል) Ft. Ahadu - Official NEW! Music Video 2017 - Ethiopian Music by News ET Social 5 years ago 2 minutes, 31 seconds 29,782 views",News ET Social,29782,29801,19
4826,"Ethiopian Movie Trailer - ""የተከለከለ"" DireTube Cinema 2017 by News ET Social 5 years ago 1 minute, 20 seconds 179,787 views",News ET Social,179787,179788,1
4827,"Ethiopian Movie Trailer - ""Fidelawit"" DireTube Cinema 2017 by News ET Social 5 years ago 1 minute, 9 seconds 70,626 views",News ET Social,70626,70626,0
4828,"Ethiopian Movie Trailer - ""Yet Neberesh"" DireTube Cinema 2017 by News ET Social 5 years ago 1 minute, 1 second 144,104 views",News ET Social,144104,144118,14
4829,"ETHIOPIA - Funny Interview with Little Mandela by News ET Social 5 years ago 2 minutes, 5 seconds 453,483 views",News ET Social,453483,453599,116
4830,"Ethiopian Movie Trailer - ""Bale Gudaye"" DireTube Cinema 2017 by News ET Social 5 years ago 1 minute, 3 seconds 39,255 views",News ET Social,39255,39261,6
4831,"AFRICAN WHINE 'Featuring' The East African Music Alliance by News ET Social 5 years ago 4 minutes, 10 seconds 5,201 views",News ET Social,5201,5204,3
4832,"Ethiopia: Ela Get Anchi Demo - NEW! Official Music Video 2017 - African Music by News ET Social 5 years ago 5 minutes, 2 seconds 10,949 views",News ET Social,10949,10960,11
4833,"Ethiopia: Hussien Ali Berhale - Yoo Wada - NEW! Official Ethiopian Music Video 2017 by News ET Social 5 years ago 3 minutes, 59 seconds 7,628 views",News ET Social,7628,7634,6
4834,"Ethiopian Movie - Fiker Be Amaregna ፍቅር በአማርኛ - NEW! Full Movie - Ethiopia by News ET Social 5 years ago 1 hour, 37 minutes 665,151 views",News ET Social,665151,665793,642
4835,"Ethiopia - YeFikir Akukulu - Ethiopian Movie Based on Eyob Mekonnen's Song by News ET Social 5 years ago 9 minutes, 39 seconds 40,735 views",News ET Social,40735,40758,23
4836,"Ethiopian Movie - Yeleba Lij (የሌባ ልጅ) Amharic Full Film from DireTube 2016 by News ET Social 5 years ago 1 hour, 40 minutes 2,103,365 views",News ET Social,2103365,2119253,15888
4837,"NEW Ethiopian Movie - Jegnochu (ጀግኖቹ) - Ethiopian Film 2016 from DireTube by News ET Social 5 years ago 1 hour, 33 minutes 861,196 views",News ET Social,861196,863563,2367
4838,"Ethiopian Movie - Chombe (ቾምቤ) - Ethiopian Film 2016 from DireTube by News ET Social 5 years ago 1 hour, 23 minutes 2,559,038 views",News ET Social,2559038,2578301,19263
4839,"Ethiopian Movie -  Yesem Werk (የሴም ወርቅ) - NEW Amharic Film 2016 from DireTube by News ET Social 5 years ago 1 hour, 38 minutes 1,417,246 views",News ET Social,1417246,1424472,7226
4840,"Ethiopian Movie: Sabela (ሳቤላ) - New Ethiopian Film 2016 from DireTube by News ET Social 5 years ago 1 hour, 33 minutes 952,951 views",News ET Social,952951,953295,344
4841,"Ethiopian Movie: Sigebagn Litash (ሲገባኝ ልጣሽ) - New Ethiopian Movie 2016 by News ET Social 5 years ago 1 hour, 35 minutes 823,310 views",News ET Social,823310,823700,390
4842,"Nazrawi (ናዝራዊ) Ethiopian Film from DireTube Cinema 2016 by News ET Social 5 years ago 1 hour, 46 minutes 290,513 views",News ET Social,290513,290692,179
4843,"Keanget Belay (ከአንገት በላይ) Ethiopian Film from DireTube Cinema 2016 by News ET Social 5 years ago 1 hour, 25 minutes 606,870 views",News ET Social,606870,607677,807
4844,"Himeme (ህመሜ) Ethiopian Film from DireTube Cinema 2016 by News ET Social 5 years ago 1 hour, 38 minutes 52,443 views",News ET Social,52443,52450,7
4845,"Yeserge Leta (የሰርጌ ለታ!) NEW! Amharic Full Movie from DireTube 2016 by News ET Social 5 years ago 1 hour, 23 minutes 1,563,047 views",News ET Social,1563047,1563912,865
4846,"Yeserge Leta Movie Trailer - DireTube Cinema 2016 by News ET Social 5 years ago 1 minute, 15 seconds 75,418 views",News ET Social,75418,75446,28
4847,"Esketemechi Libed (እስክትመጪ ልበድ) NEW! Amharic Full Movie from DireTube 2016 by News ET Social 5 years ago 1 hour, 25 minutes 2,096,078 views",News ET Social,2096078,2097097,1019
4848,"Ha....Belu ""ሀ""...በሉ!! NEW! Funny Amharic Full Movies 2016 from DireTube by News ET Social 5 years ago 1 hour, 28 minutes 543,479 views",News ET Social,543479,544921,1442
4849,"Ethiopian Movies - Yetefaw Lij - የጠፋው ልጅ - NEW! Best Amharic Films 2016 by News ET Social 5 years ago 1 hour, 36 minutes 1,714,754 views",News ET Social,1714754,1717422,2668
4850,"Yelib Kelebet (የልብ ቀለበት) NEW! AMharic Full Movie from DireTube 2016 by News ET Social 6 years ago 1 hour, 33 minutes 1,598,753 views",News ET Social,1598753,1606072,7319
4851,"SHIFTA (Reggae Singer) - Visiting Ethiopia - Interview with DireTube by News ET Social 6 years ago 15 minutes 21,012 views",News ET Social,21012,21014,2
4852,"Lij Michael & Fantu Mandoye Rapping! Very FUNNY! by News ET Social 6 years ago 2 minutes, 35 seconds 127,674 views",News ET Social,127674,127859,185
4853,"Seglelet - ሰግለለት NEW! Tigrigna Movie by News ET Social 6 years ago 1 hour, 43 minutes 426,265 views",News ET Social,426265,426483,218
4854,"DireTube TV: Marriage at the Epiphany Year after He threw Lemon on the Bride by News ET Social 6 years ago 7 minutes, 1 second 110,823 views",News ET Social,110823,110824,1
4855,"Ameletegn (አመለጠኝ) - Amharic Movies from DireTube Cinema by News ET Social 6 years ago 1 hour, 38 minutes 525,140 views",News ET Social,525140,525239,99
4856,"DireTube Exclusive - The Story of St George Cathedral & Museum by News ET Social 6 years ago 43 minutes 12,326 views",News ET Social,12326,12328,2
4857,"Netsanet Melesse - Negeregn [NEW! Music Video 2016] by News ET Social 6 years ago 5 minutes, 21 seconds 45,000 views",News ET Social,45000,45127,127
4858,"DireTube Exclusive: This Discussion Puts Ermias Amelga of Access Real state in Jail by News ET Social 6 years ago 20 minutes 17,637 views",News ET Social,17637,17653,16
4859,"PM Hailemariam Daughter Dr. Sosina and Ato Abel Wedding at the National Palace by News ET Social 6 years ago 32 seconds 104,371 views",News ET Social,104371,104391,20
4860,"Enena Bete - New Amharic Full Movie from DireTube Cinema by News ET Social 6 years ago 1 hour, 44 minutes 363,403 views",News ET Social,363403,363520,117
4861,"Enena Bete Official Movie Trailer by News ET Social 6 years ago 2 minutes, 14 seconds 12,229 views",News ET Social,12229,12230,1
4862,"Ethiopian Comedy - Celebrating Gena Ethiopian Christmas with Comedian Lij Yared by News ET Social 6 years ago 45 minutes 202,920 views",News ET Social,202920,203002,82
4863,"Bekegnitesh - New Amharic Full Movie from DireTube Cinema by News ET Social 6 years ago 1 hour, 24 minutes 600,149 views",News ET Social,600149,600415,266
4864,"Amalayu (አማላዩ) - Amharic Movies from DireTube Cinema by News ET Social 6 years ago 1 hour, 43 minutes 1,565,373 views",News ET Social,1565373,1575479,10106
4865,"Yemist Yaleh (የሚስት ያለህ) - Top Theater in Ethiopia on DireTube Cinema by News ET Social 6 years ago 2 hours 546,967 views",News ET Social,546967,548077,1110
4866,"Yene Jegna - Ethiopian Film Full - DireTube Cinema by News ET Social 6 years ago 1 hour, 28 minutes 470,488 views",News ET Social,470488,470670,182
4867,"Hareyet ኀረየት - New! Ethiopian Movies 2015 - Full by News ET Social 6 years ago 1 hour, 47 minutes 916,800 views",News ET Social,916800,917457,657
4868,"YeSilet Lij (የስለት ልጅ) Ethiopian Movie from DireTube Cinema by News ET Social 6 years ago 1 hour, 22 minutes 3,017,189 views",News ET Social,3017189,3036770,19581
4869,"Kukusha - Ethiopian Comedy by News ET Social 6 years ago 2 minutes, 43 seconds 4,050 views",News ET Social,4050,4052,2
4870,"Kukusha - Ethiopian Comedy by News ET Social 6 years ago 57 seconds 3,784 views",News ET Social,3784,3785,1
4871,"Kukusha - Ethiopian Comedy by News ET Social 6 years ago 3 minutes, 44 seconds 2,926 views",News ET Social,2926,2927,1
4872,"Kukusha - Ethiopian Comedy by News ET Social 6 years ago 2 minutes, 42 seconds 1,435 views",News ET Social,1435,1437,2
4873,"Kukusha: Funny Ethiopian Comedy by News ET Social 6 years ago 4 minutes, 3 seconds 4,636 views",News ET Social,4636,4636,0
4874,"Kukusha: Ethiopian Comedy by News ET Social 6 years ago 3 minutes, 25 seconds 1,978 views",News ET Social,1978,1980,2
4875,"Kukusha: Agegnehu (አገኘሁ) Ethiopian Comedy by News ET Social 6 years ago 9 minutes, 41 seconds 8,964 views",News ET Social,8964,8966,2
4876,"Gize Lekulu (ጊዜ ለኩሉ) Ethiopian Movie from DireTube Cinema by News ET Social 6 years ago 1 hour, 20 minutes 76,136 views",News ET Social,76136,76162,26
4877,"Kukusha: Feleta (ፈለጣ) Ethiopian Comedy by News ET Social 6 years ago 5 minutes, 20 seconds 55,987 views",News ET Social,55987,55989,2
4878,"Kukusha: Gracha (ግራጫ) - Ethiopian Comedy by News ET Social 6 years ago 9 minutes, 37 seconds 10,456 views",News ET Social,10456,10458,2
4879,"Kukusha: James Bond - Ethiopian Comedy by News ET Social 6 years ago 9 minutes, 23 seconds 20,702 views",News ET Social,20702,20707,5
4880,"Kukusha: Kelk Yalefe Chuhet - Ethiopian Comedy by News ET Social 6 years ago 3 minutes, 53 seconds 1,818 views",News ET Social,1818,1819,1
4881,"Kukusha: Ethiopian Comedy by News ET Social 6 years ago 4 minutes, 15 seconds 3,034 views",News ET Social,3034,3034,0
4882,"Kukusha: Temesasay - Ethiopian Comedy by News ET Social 6 years ago 3 minutes, 51 seconds 2,917 views",News ET Social,2917,2919,2
4883,"Latewochu - Comedian Filfilu - Ethiopian Comedy by News ET Social 6 years ago 54 seconds 2,825 views",News ET Social,2825,2826,1
4884,"Latewochu: Funny Ethiopian Comedy by News ET Social 6 years ago 53 seconds 1,507 views",News ET Social,1507,1507,0
4885,"Latewochu: Comedian Filfilu - Ethiopian Comedy by News ET Social 6 years ago 2 minutes, 2 seconds 4,936 views",News ET Social,4936,4941,5
4886,"Latewochu - Ethiopian Comedy by News ET Social 6 years ago 26 minutes 6,033 views",News ET Social,6033,6034,1
4887,"Latewochu: Yaltadelew - Ethiopian Comedy by News ET Social 6 years ago 11 minutes, 10 seconds 6,406 views",News ET Social,6406,6407,1
4888,"Kukusha: Zena Alubalta - Ethiopian Comedy by News ET Social 6 years ago 2 minutes, 31 seconds 5,625 views",News ET Social,5625,5629,4
4889,"Latewochu - Sikilat - Ethiopian Comedy by News ET Social 6 years ago 8 minutes, 38 seconds 8,441 views",News ET Social,8441,8442,1
4890,"Endalsmish (እንዳልስምሽ) Ethiopian Movie from DireTube Cinema by News ET Social 6 years ago 1 hour, 43 minutes 161,653 views",News ET Social,161653,161674,21
4891,"Latewocu - Sancho - Ethiopian Comedy by News ET Social 6 years ago 11 minutes, 41 seconds 16,430 views",News ET Social,16430,16433,3
4892,"Kukusha - Lamrot (ላምሮት) Ethiopian Comedy by News ET Social 6 years ago 9 minutes, 16 seconds 27,171 views",News ET Social,27171,27172,1
4893,"Hermen (ሔርሜን) Ethiopian Movie from DireTube Cinema by News ET Social 6 years ago 1 hour, 41 minutes 117,629 views",News ET Social,117629,117644,15
4894,"Kebero (ከበሮ) Ethiopian Comedy Movie from DireTube Cinema by News ET Social 6 years ago 1 hour, 31 minutes 86,151 views",News ET Social,86151,86279,128
4895,"Asira Minamin (አስራ ምናምን) Ethiopian Movie from DireTube Cinema by News ET Social 6 years ago 1 hour, 32 minutes 65,556 views",News ET Social,65556,65558,2
4896,"Afajeshign (አፋጀሽኝ) Ethiopian Movie from DireTube Cinema by News ET Social 6 years ago 1 hour, 39 minutes 317,939 views",News ET Social,317939,318030,91
4897,"Awakiwochu (አዋቂዎቹ) Ethiopian Movie from DireTube Cinema by News ET Social 6 years ago 1 hour, 17 minutes 39,988 views",News ET Social,39988,39996,8
4898,"Achaye (አቻዬ) Ethiopian Movie from DireTube Cinema by News ET Social 6 years ago 1 hour, 36 minutes 235,131 views",News ET Social,235131,235239,108
4899,"Bezih Sament (በዚህ ሳምንት) Ethiopian Movie from DireTube Cinema by News ET Social 6 years ago 1 hour, 24 minutes 175,406 views",News ET Social,175406,175513,107
4900,"DireTube.com - News, Videos, Entertainment by News ET Social 6 years ago 18 seconds 391,359 views",News ET Social,391359,391500,141
4901,"DireTube TV - East Africa Tiger Brands Industries donate cleaning supplies by News ET Social 6 years ago 7 minutes, 7 seconds 11,773 views",News ET Social,11773,11773,0
4902,"DireTube TV - East African Tiger Brand Industry donates soaps worth 700,000 Birr by News ET Social 6 years ago 7 minutes, 7 seconds 3,591 views",News ET Social,3591,3591,0
4903,"Nile 'party boat' crash kills at least 21 in Egypt by News ET Social 6 years ago 1 minute, 1 second 4,678 views",News ET Social,4678,4678,0
4904,"Ethiopia to Sell Power to Sudan by News ET Social 6 years ago 38 seconds 3,388 views",News ET Social,3388,3389,1
4905,"New Earth-like Planet Found by News ET Social 6 years ago 1 minute, 6 seconds 3,862 views",News ET Social,3862,3862,0
4906,"US Congress Members to Visit Coffee Farmers Union by News ET Social 6 years ago 50 seconds 2,032 views",News ET Social,2032,2032,0
4907,"Institute for Economics and Business launched in Addis Ababa by News ET Social 6 years ago 1 minute, 16 seconds 3,106 views",News ET Social,3106,3106,0
4908,"Ethiopia-Djibouti rail way project will be completed next October by News ET Social 6 years ago 1 minute, 1 second 6,099 views",News ET Social,6099,6100,1
4909,"China to give $700 million loan to Ethiopia by News ET Social 6 years ago 1 minute, 33 seconds 3,506 views",News ET Social,3506,3506,0
4910,"Addis Ababa To Host 4th Africa-Arab Legislators Business Forum by News ET Social 6 years ago 2 minutes 1,068 views",News ET Social,1068,1068,0
4911,"Barack Obama Upbeat on Africa on Eve of Kenya, Ethiopia Trip by News ET Social 6 years ago 1 minute, 41 seconds 2,309 views",News ET Social,2309,2309,0
4912,"Addis Ababa education office penalizes Gibson Youth Academy by News ET Social 6 years ago 1 minute, 42 seconds 6,518 views",News ET Social,6518,6527,9
4913,"The Tripartite Talk Begins by News ET Social 6 years ago 40 seconds 1,194 views",News ET Social,1194,1194,0
4914,"Civil aviation works to improve performance by News ET Social 6 years ago 1 minute, 55 seconds 1,064 views",News ET Social,1064,1064,0
4915,"A group of Civic Societies Send a Letter to Obama by News ET Social 6 years ago 1 minute 3,375 views",News ET Social,3375,3375,0
4916,"Court orders Mr. Andargachew Tsige to appear in court for the second time by News ET Social 6 years ago 3 minutes, 5 seconds 4,305 views",News ET Social,4305,4305,0
4917,"American Company, Yolk, invents a new solar telephone charger by News ET Social 6 years ago 52 seconds 1,657 views",News ET Social,1657,1657,0
4918,"Ethio-telecom cancels the contract it signed with Ericsson by News ET Social 6 years ago 2 minutes, 25 seconds 1,547 views",News ET Social,1547,1550,3
4919,"IOM: 3,400 Ethiopian migrants evacuated from Yemen by News ET Social 6 years ago 1 minute, 23 seconds 2,654 views",News ET Social,2654,2654,0
4920,New Development Bank Launch Today by News ET Social 6 years ago 44 seconds 820 views,News ET Social,820,820,0
4921,"‘Clearly Obama is not a man of peace, and neither are his European enablers and the UN’ by News ET Social 6 years ago 1 minute, 11 seconds 1,076 views",News ET Social,1076,1076,0
4922,"Broadcast Authority Warned “Wust Awaqi” for Libel by News ET Social 6 years ago 2 minutes, 23 seconds 3,645 views",News ET Social,3645,3645,0
4923,"Africa’s youth sign forced football contracts in Asia by News ET Social 6 years ago 1 minute, 17 seconds 1,374 views",News ET Social,1374,1374,0
4924,"CEO of Toshiba Electronics Company resigned by News ET Social 6 years ago 1 minute, 7 seconds 866 views",News ET Social,866,866,0
4925,"Houses, for the people displaced for redevelopment, will be allotted next year. by News ET Social 6 years ago 2 minutes, 38 seconds 915 views",News ET Social,915,915,0
4926,"AMISOM, the Somali army, and Ethiopian army opened joint military campaign against Alshabab by News ET Social 6 years ago 1 minute, 34 seconds 2,953 views",News ET Social,2953,2955,2
4927,"DireTube TV - Power Africa: Sami Oye from Nigeria speaking at Access Beyond the Grid Event by News ET Social 6 years ago 10 minutes, 4 seconds 802 views",News ET Social,802,802,0
4928,"DireTube TV - U.S. Government Sponsors Financing Electricity Access Beyond the Grid Event by News ET Social 6 years ago 8 minutes, 25 seconds 1,373 views",News ET Social,1373,1374,1
4929,"DireTube TV - Power Africa: Per Bolund, Minister for Financial Markets (Sweden) by News ET Social 6 years ago 10 minutes, 43 seconds 497 views",News ET Social,497,497,0
4930,"DireTube TV - Power Africa: Alfonso E. Lenhardt, Acting Administrator of USAID July 15, 2015 by News ET Social 6 years ago 8 minutes, 37 seconds 538 views",News ET Social,538,538,0
4931,"Bizu Tebazu (ብዙ ተባዙ) - Ethiopian Movie Coming Soon! - DireTube Trailer by News ET Social 6 years ago 1 minute, 5 seconds 60,796 views",News ET Social,60796,60811,15
4932,"Social security for private employees’ to be implemented by News ET Social 6 years ago 1 minute, 29 seconds 1,416 views",News ET Social,1416,1418,2
4933,"More Chinese donations for infrastructure development on its way by News ET Social 6 years ago 1 minute, 18 seconds 1,158 views",News ET Social,1158,1158,0
4934,"World agrees on framework to generate financing for post-2015 development agenda by News ET Social 6 years ago 1 minute, 15 seconds 883 views",News ET Social,883,883,0
4935,"Malnutrition and its complications take center stage by News ET Social 6 years ago 1 minute, 42 seconds 1,205 views",News ET Social,1205,1205,0
4936,"Ethiopia: a better investment option in Africa. by News ET Social 6 years ago 2 minutes, 44 seconds 1,908 views",News ET Social,1908,1909,1
4937,"Italian PM visits Gibe III hydropower project, Ethiopia by News ET Social 6 years ago 49 seconds 5,478 views",News ET Social,5478,5480,2
4938,"Starbucks Expands to Sub-Saharan by News ET Social 6 years ago 1 minute, 30 seconds 1,160 views",News ET Social,1160,1160,0
4939,"Ethiopian journalist on fear of returning to prison by News ET Social 6 years ago 1 minute, 33 seconds 1,539 views",News ET Social,1539,1539,0
4940,"Yesem Werk (የሴም ወርቅ) Ethiopian Film Coming soon! DireTube Trailer by News ET Social 6 years ago 1 minute, 25 seconds 36,446 views",News ET Social,36446,36472,26
4941,"'Affair of missing Ethiopian-Israeli in Gaza smells of racism' by News ET Social 6 years ago 56 seconds 3,679 views",News ET Social,3679,3680,1
4942,"First students to graduate from Volvo’s vocational training school in Ethiopia by News ET Social 6 years ago 52 seconds 1,517 views",News ET Social,1517,1517,0
4943,"President Inaugurates Korean Hospital Expanded with 12 Million USD by News ET Social 6 years ago 1 minute, 16 seconds 2,856 views",News ET Social,2856,2858,2
4944,"Federal Police Claims to have Killed 30 Soldier Sent by Eritrea by News ET Social 6 years ago 1 minute, 16 seconds 4,961 views",News ET Social,4961,4962,1
4945,"Ethiopia politicizes courts to strangle dissent - Al Jazeera by News ET Social 6 years ago 1 minute, 3 seconds 3,823 views",News ET Social,3823,3823,0
4946,"Obama’s visit to Ethiopia will strengthen mutual interests – Ambassador Girma by News ET Social 6 years ago 1 minute, 43 seconds 10,928 views",News ET Social,10928,10928,0
4947,"Indonesia closes five airports as Mount Raung erupts by News ET Social 6 years ago 48 seconds 1,077 views",News ET Social,1077,1077,0
4948,"Remembering Assistant professor poet Debebe Seifu by News ET Social 6 years ago 3 minutes, 59 seconds 4,653 views",News ET Social,4653,4657,4
4949,"Ethiopia's homemade aircraft second test successful by News ET Social 6 years ago 17 seconds 42,255 views",News ET Social,42255,42278,23
4950,"DireTube TV - Ambo mineral water company sponsoring Nehemiah Autism Center by News ET Social 6 years ago 9 minutes, 27 seconds 2,045 views",News ET Social,2045,2050,5
4951,"Ethiopia to host Cecafa Senior Challenge Cup 2015 by News ET Social 6 years ago 1 minute, 6 seconds 5,738 views",News ET Social,5738,5738,0
4952,"Ethiopia aims to join international space station by 2025 by News ET Social 6 years ago 1 minute, 2 seconds 5,157 views",News ET Social,5157,5157,0
4953,"Malik Obama sells handwritten letters from his famous brother by News ET Social 6 years ago 54 seconds 3,735 views",News ET Social,3735,3735,0
4954,"Help journalist, drummer and police officer Abebe Mulugeta by News ET Social 6 years ago 50 seconds 4,471 views",News ET Social,4471,4475,4
4955,"Ethiopian Authors Association ""Reading Day"" national campaign on July 7, 2015 by News ET Social 6 years ago 2 minutes, 13 seconds 1,521 views",News ET Social,1521,1521,0
4956,"DireTube News - Ethiopia Summit by News ET Social 6 years ago 2 minutes, 45 seconds 2,077 views",News ET Social,2077,2077,0
4957,"Facebook Opening Africa Office to Target Next Billion Users by News ET Social 6 years ago 47 seconds 1,616 views",News ET Social,1616,1616,0
4958,"Israel OKs Extension of High-Tech Wall Along Jordan Border by News ET Social 6 years ago 1 minute, 2 seconds 1,893 views",News ET Social,1893,1893,0
4959,"AUC condemns terrorist attack in Tunisia by News ET Social 6 years ago 43 seconds 1,080 views",News ET Social,1080,1080,0
4960,"Ethiopian sesame export revenue drops by 24% by News ET Social 6 years ago 50 seconds 2,347 views",News ET Social,2347,2351,4
4961,"2nd phase of Addis light rail under negotiation by News ET Social 6 years ago 1 minute, 53 seconds 2,529 views",News ET Social,2529,2530,1
4962,"Haile to lead 40,000 participants at Great Ethiopian Run by News ET Social 6 years ago 2 minutes, 51 seconds 1,464 views",News ET Social,1464,1464,0
4963,"Greek debt crisis: Banks to remain shut all week by News ET Social 6 years ago 1 minute, 10 seconds 1,561 views",News ET Social,1561,1561,0
4964,"20 Hilarious Pieces Of Wisdom Seen Behind Indian Trucks by News ET Social 6 years ago 1 minute, 32 seconds 2,873 views",News ET Social,2873,2873,0
4965,"Africa’s broken food security value chain: unraveling the hidden fortune by News ET Social 6 years ago 1 minute, 27 seconds 1,065 views",News ET Social,1065,1066,1
4966,"Western students reportedly left Sudan to join ISIL in Syria by News ET Social 6 years ago 39 seconds 2,348 views",News ET Social,2348,2348,0
4967,"African Eco-hydrology center established in Addis Ababa by News ET Social 6 years ago 1 minute, 37 seconds 1,167 views",News ET Social,1167,1167,0
4968,"Material theft on Addis Ababa- Mieso railway project by News ET Social 6 years ago 2 minutes, 25 seconds 1,926 views",News ET Social,1926,1926,0
4969,"Ye Awerew Ergeboch (የአውሬው እርግቦች) Latest Ethiopian Movie from DireTube Cinema by News ET Social 6 years ago 2 hours, 10 minutes 77,137 views",News ET Social,77137,77148,11
4970,"US call to establish anti terrorism information center in the horn of Africa by News ET Social 6 years ago 57 seconds 1,634 views",News ET Social,1634,1634,0
4971,"ERCA chief receives stern criticism from MPs over audit report by News ET Social 6 years ago 2 minutes, 37 seconds 1,915 views",News ET Social,1915,1915,0
4972,"Ethiopia Signs a Deal for Construction of a High-Voltage Transmission Line to Kenya by News ET Social 6 years ago 35 seconds 1,247 views",News ET Social,1247,1248,1
4973,"DireTube TV - Roha Band and Musician Dawit Yifru in Ethiopian Music History by News ET Social 6 years ago 13 minutes, 36 seconds 22,579 views",News ET Social,22579,22599,20
4974,"Triangle Movie Choosen at African Film Acadamy by News ET Social 6 years ago 2 minutes, 12 seconds 9,903 views",News ET Social,9903,9904,1
4975,"Court passes verdict on Indians who caused $26 mln damage on the Government by News ET Social 6 years ago 1 minute, 19 seconds 1,166 views",News ET Social,1166,1166,0
4976,"Ethiopia Clothes Maker Upgrades Factory to Boost Sales by News ET Social 6 years ago 1 minute, 20 seconds 1,762 views",News ET Social,1762,1764,2
4977,"I need my dad to be here, pleads daughter by News ET Social 6 years ago 1 minute, 14 seconds 1,626 views",News ET Social,1626,1626,0
4978,"Seven passengers on inaugural flight from Ethiopia claim asylum by News ET Social 6 years ago 1 minute, 39 seconds 5,551 views",News ET Social,5551,5551,0
4979,"Eritreans demand their leader to be indicted to the ICC at an AU rally by News ET Social 6 years ago 1 minute, 5 seconds 2,014 views",News ET Social,2014,2015,1
4980,"Terrorist Attacks in France, Tunisia and Kuwait Kill Dozens by News ET Social 6 years ago 2 minutes, 4 seconds 1,625 views",News ET Social,1625,1627,2
4981,"Addis Ababa Metro will Official Start Operation Soon by News ET Social 6 years ago 2 minutes, 12 seconds 783 views",News ET Social,783,783,0
4982,"Happy Birth Day Ababa Tesfaye - Untold Storys of Ababa Tesfaye by News ET Social 6 years ago 27 minutes 17,153 views",News ET Social,17153,17163,10
4983,"Jacky Gosee - Alsemam New Single 2015 by News ET Social 6 years ago 4 minutes, 25 seconds 141,467 views",News ET Social,141467,142510,1043
4984,"Tilahun Mekonnen - Dubitiya (ዱቢቲያ) New Ethiopian Afaan Oromoo music video 2015 by News ET Social 6 years ago 5 minutes, 38 seconds 7,146 views",News ET Social,7146,7150,4
4985,"15 Blue party members who were captured by federal police released by News ET Social 6 years ago 1 minute, 26 seconds 1,079 views",News ET Social,1079,1079,0
4986,"MEDREK says four party members have died after 5th National Election by News ET Social 6 years ago 2 minutes, 47 seconds 2,059 views",News ET Social,2059,2059,0
4987,"Blue Party members sentenced to 2 months for violating during Anti-ISIL rally by News ET Social 6 years ago 1 minute, 45 seconds 1,917 views",News ET Social,1917,1917,0
4988,"A musical summer to savor in Geneva by News ET Social 6 years ago 57 seconds 1,732 views",News ET Social,1732,1733,1
4989,"SOS Infant Ethiopia cannot pay employees' wage by News ET Social 6 years ago 3 minutes, 24 seconds 1,230 views",News ET Social,1230,1230,0
4990,"Hiber sugar factory construction will be started at the end of this month by News ET Social 6 years ago 1 minute, 56 seconds 2,119 views",News ET Social,2119,2120,1
4991,"Forget fancy growth figures, try our Africa 'True Business' Index by News ET Social 6 years ago 2 minutes, 35 seconds 821 views",News ET Social,821,821,0
4992,"Blind dog and 'guide-dog' best friend looking for home after being abandoned by News ET Social 6 years ago 49 seconds 1,509 views",News ET Social,1509,1509,0
4993,"Ethiopian Airlines Launches New Direct Flights Between Los Angeles and East Africa by News ET Social 6 years ago 29 seconds 1,395 views",News ET Social,1395,1395,0
4994,NSA spying: France summons US envoy after Wikileaks revelation by News ET Social 6 years ago 49 seconds 820 views,News ET Social,820,820,0
4995,"Los Angeles Trade Delegation's Visit in Addis Ababa by News ET Social 6 years ago 1 minute, 15 seconds 588 views",News ET Social,588,588,0
4996,"Mumbai toxic alcohol 'supplier' arrested in Delhi by News ET Social 6 years ago 1 minute, 44 seconds 1,313 views",News ET Social,1313,1313,0
4997,"ICL completes Allana Potash acquisition by News ET Social 6 years ago 53 seconds 2,243 views",News ET Social,2243,2243,0
4998,"Ethiopia, Ghana Agree to Establish Joint Ministerial Commission by News ET Social 6 years ago 1 minute, 50 seconds 651 views",News ET Social,651,651,0
4999,"130 railway wagons assembled in Ethiopia by News ET Social 6 years ago 2 minutes, 4 seconds 7,791 views",News ET Social,7791,7791,0
5000,"Amnesty International Asks Ethiopia to Investigate Suspicious Murders and Human Rights Violations by News ET Social 6 years ago 2 minutes, 9 seconds 802 views",News ET Social,802,803,1
5001,"Rabies treatments to be given in health centers by News ET Social 6 years ago 55 seconds 1,093 views",News ET Social,1093,1093,0
5002,'Tanzania borrowing page from Ethiopia on Commodity Exchange Market' by News ET Social 6 years ago 39 seconds 935 views,News ET Social,935,935,0
5003,"Yegna: Ethiopia’s Sound of Change by News ET Social 6 years ago 1 minute, 42 seconds 3,165 views",News ET Social,3165,3166,1
5004,"Walias awarded for winning Lesotho and Kenya Games by News ET Social 6 years ago 1 minute, 9 seconds 3,135 views",News ET Social,3135,3135,0
5005,"Buzuayehu Kifle - Tiru Nesh (ጥሩ ነሽ) [NEW! Ethiopian Music video 2015] by News ET Social 6 years ago 4 minutes, 59 seconds 451,086 views",News ET Social,451086,451256,170
5006,"FDA approve device that helps blind 'see with tongue' by News ET Social 6 years ago 1 minute, 6 seconds 2,274 views",News ET Social,2274,2274,0
5007,"5 by News ET Social 6 years ago 57 seconds 1,498 views",News ET Social,1498,1498,0
5008,"Turkey vows to highlight agendas of developing countries in the upcoming G20 Summit by News ET Social 6 years ago 1 minute, 22 seconds 2,096 views",News ET Social,2096,2096,0
5009,"Single-window service system center to be launched in Addis Ababa by News ET Social 6 years ago 2 minutes, 5 seconds 1,405 views",News ET Social,1405,1406,1
5010,"Lemn Sissay wins University of Manchester chancellor vote by News ET Social 6 years ago 2 minutes, 7 seconds 1,669 views",News ET Social,1669,1669,0
5011,"Indian firms sprawling land empire in Ethiopia fails to ensure food security back home by News ET Social 6 years ago 2 minutes, 23 seconds 2,136 views",News ET Social,2136,2136,0
5012,"DireTube TV - Poet Demsew Mersha's ""Yaltayew Tewnet"" inauguration, Hilton Hotel, Addis Ababa by News ET Social 6 years ago 1 hour, 19 minutes 12,255 views",News ET Social,12255,12260,5
5013,"Selamawit Yohannes - Milash (ምላሽ) [NEW! Ethiopian Music Video 2015] - Senay Video by News ET Social 6 years ago 5 minutes, 29 seconds 7,682,230 views",News ET Social,7682230,7694563,12333
5014,"Love & Facebook (ፍቅርና ፌስቡክ) Ethiopian Movie from DireTube Cinema by News ET Social 6 years ago 1 hour, 41 minutes 288,884 views",News ET Social,288884,290223,1339
5015,"Kenya slum Mathare gets cheap water through ATMs by News ET Social 6 years ago 49 seconds 1,572 views",News ET Social,1572,1572,0
5016,"China Yulin dog meat festival under way despite outrage by News ET Social 6 years ago 44 seconds 2,107 views",News ET Social,2107,2111,4
5017,"Frontier Markets: Ethiopia, the next frontier? by News ET Social 6 years ago 51 seconds 1,799 views",News ET Social,1799,1799,0
5018,Age limit Under-20 Women's All-African Games 2015 Ethiopia vs Cameroon by News ET Social 6 years ago 37 seconds 963 views,News ET Social,963,963,0
5019,"Teenage maid steals 800 birr and cell phone from her employer by News ET Social 6 years ago 1 minute, 23 seconds 1,002 views",News ET Social,1002,1002,0
5020,"How Zuma and ministers plotted Omar al-Bashir's escape by News ET Social 6 years ago 2 minutes, 36 seconds 2,878 views",News ET Social,2878,2878,0
5021,"EPRDF and its affiliate parties won all announced Federal Parliament seats by News ET Social 6 years ago 4 minutes, 1 second 1,176 views",News ET Social,1176,1176,0
5022,"DireTube Comedy - Comedian Meskerem Bekele stand-up comedy by News ET Social 6 years ago 12 minutes, 45 seconds 334,760 views",News ET Social,334760,334918,158
5023,"Funny Ethiopian Comedy - Tigist, Ayalkbet and Kuribachew by News ET Social 6 years ago 9 minutes, 25 seconds 209,563 views",News ET Social,209563,210010,447
5024,"DireTube Comedy - Very Funny Ethiopian Comedy by Comedian Meskerem Bekele by News ET Social 6 years ago 3 minutes, 51 seconds 180,735 views",News ET Social,180735,181038,303
5025,"Ethiopian Comedy in DC by News ET Social 6 years ago 9 minutes, 17 seconds 398,536 views",News ET Social,398536,398723,187
5026,"Comedian Meskerem - Funny Ethiopian comedy by Meskerem, Kuribachew and Ayalkbet by News ET Social 6 years ago 9 minutes, 58 seconds 133,038 views",News ET Social,133038,133294,256
5027,"Amazing Ethiopian Dance by News ET Social 6 years ago 12 minutes, 39 seconds 231,557 views",News ET Social,231557,231627,70
5028,"DireTube Comedy - Comedian Meskerem Bekele Stand-Up comedy by News ET Social 6 years ago 7 minutes, 56 seconds 380,128 views",News ET Social,380128,380446,318
5029,"DireTube Comedy - Funny Ethiopian comedy by Meskerem and Tigist by News ET Social 6 years ago 15 minutes 554,568 views",News ET Social,554568,555125,557
5030,"Comedian Meskerem - Kuankua - Very Funny Ethiopian Comedy by Comedian Meskerem Bekele by News ET Social 6 years ago 29 minutes 337,222 views",News ET Social,337222,337871,649
5031,"Islamic State web accounts to be blocked by new police team by News ET Social 6 years ago 1 minute, 20 seconds 1,294 views",News ET Social,1294,1294,0
5032,"Chinese company to set up Kenya-Ethiopia power link by News ET Social 6 years ago 1 minute, 3 seconds 1,952 views",News ET Social,1952,1952,0
5033,"INSA intercepts cyber attacks targeting infrastructure, organizations by News ET Social 6 years ago 52 seconds 2,056 views",News ET Social,2056,2057,1
5034,"Melaku Fenta et al case raises another constitutionality issue by News ET Social 6 years ago 4 minutes, 5 seconds 2,097 views",News ET Social,2097,2097,0
5035,"Ethiopia denies land giveaways to Sudan by News ET Social 6 years ago 59 seconds 2,936 views",News ET Social,2936,2936,0
5036,"IS militants plant mines and bombs in Palmyra: monitoring group by News ET Social 6 years ago 50 seconds 1,133 views",News ET Social,1133,1133,0
5037,"Yemen Talks Stalled Over Terms of Negotiations in Geneva by News ET Social 6 years ago 1 minute, 15 seconds 496 views",News ET Social,496,496,0
5038,"Ethiopia beats Kenya 2-0 at the Bahir Dar Stadium by News ET Social 6 years ago 1 minute, 6 seconds 11,151 views",News ET Social,11151,11155,4
5039,"Kenya wages war on smugglers who fund Somali militants by News ET Social 6 years ago 50 seconds 1,156 views",News ET Social,1156,1156,0
5040,"Ethiopia to Host East African Astronomical Society Conference by News ET Social 6 years ago 1 minute, 19 seconds 997 views",News ET Social,997,997,0
5041,"Nebiyu Solomon (Neba) New Music Album 2015 Coming Soon! by News ET Social 6 years ago 1 minute, 26 seconds 4,874 views",News ET Social,4874,4876,2
5042,"Saudi Arabia sought to portray case of detained Ethiopians as an immigration issue: cable by News ET Social 6 years ago 1 minute, 14 seconds 22,337 views",News ET Social,22337,22337,0
5043,"Ayasikem (አያስቅም) - Ethiopian Movie from DireTube Cinema by News ET Social 6 years ago 1 hour, 34 minutes 71,153 views",News ET Social,71153,72045,892
5044,"EPRDF and its affiliate parties won all announced Federal Parliament seats by News ET Social 6 years ago 12 minutes, 43 seconds 2,855 views",News ET Social,2855,2856,1
5045,"DireTube News - 5th Ethiopian General election final result to be announced today by News ET Social 6 years ago 1 minute, 20 seconds 2,559 views",News ET Social,2559,2559,0
5046,"DireTube News - Ethiopian Airlines Commences Direct Flights to Dublin, Los Angeles by News ET Social 6 years ago 1 minute, 42 seconds 6,290 views",News ET Social,6290,6290,0
5047,"DireTube News - Dam protects East Africa's land from drought by News ET Social 6 years ago 2 minutes, 16 seconds 4,937 views",News ET Social,4937,4937,0
5048,"Albo (አልቦ) - Ethiopian Movie from DireTube Cinema by News ET Social 6 years ago 1 hour, 53 minutes 91,003 views",News ET Social,91003,91137,134
5049,"Yewendoch Guday 1 (የወንዶች ጉዳይ 1) - Ethiopian Romantic Comedy Film from DireTube Cinema by News ET Social 6 years ago 1 hour, 46 minutes 2,328,116 views",News ET Social,2328116,2341013,12897
5050,"Velo (ቬሎ) - Ethiopian Movie from DireTube Cinema by News ET Social 6 years ago 1 hour, 39 minutes 133,698 views",News ET Social,133698,133732,34
5051,"Zewariw - Ethiopian comedy by News ET Social 6 years ago 6 minutes, 20 seconds 182,417 views",News ET Social,182417,182419,2
5052,"Wey Sport - Ethiopian Comedy by News ET Social 6 years ago 8 minutes, 22 seconds 3,266 views",News ET Social,3266,3266,0
5053,"DireTube Comedy - Sira Leseriw - Ethiopian drama by News ET Social 6 years ago 14 minutes, 25 seconds 58,068 views",News ET Social,58068,58072,4
5054,"DireTube Comedy - Funny Ethiopian Stand-Up Comedy by News ET Social 6 years ago 1 minute, 29 seconds 11,047 views",News ET Social,11047,11051,4
5055,"DireTube Comedy - Yefikr Clinic - Ethiopian comedy by News ET Social 6 years ago 15 minutes 24,219 views",News ET Social,24219,24220,1
5056,"DireTube Comedy - Ethiopian Stand-Up comedy by comedian Dokle and others by News ET Social 6 years ago 1 minute, 19 seconds 11,119 views",News ET Social,11119,11124,5
5057,"DireTube Comedy - Yalderesebet (ያልደረሰበት) Short Ethiopian Comedy by News ET Social 6 years ago 11 minutes, 42 seconds 25,673 views",News ET Social,25673,25699,26
5058,"DireTube Comedy - Welaj Amchi (ወላጅ አምጪ) Ethiopian Comedy by News ET Social 6 years ago 17 minutes 384,723 views",News ET Social,384723,385269,546
5059,"DireTube Comedy - Mot Yishalal (ሞት ይሻላል) Ethiopian Comedy by News ET Social 6 years ago 4 minutes, 59 seconds 232,702 views",News ET Social,232702,232753,51
5060,"DireTube Comedy - Yetsega Enat (የፀጋ እናት) Funny Ethiopian comedy by News ET Social 6 years ago 11 minutes, 27 seconds 31,987 views",News ET Social,31987,31992,5
5061,"DireTube Comedy - Tapela, Merkun (መርቁን) - Ethiopian Comedy by News ET Social 6 years ago 8 minutes, 2 seconds 30,440 views",News ET Social,30440,30458,18
5062,"DireTube News - IMF Staff Completes 2015 Article IV Mission to Ethiopia by News ET Social 6 years ago 1 minute, 28 seconds 1,892 views",News ET Social,1892,1893,1
5063,"DireTube News - I’ve left my other half by News ET Social 6 years ago 57 seconds 10,073 views",News ET Social,10073,10073,0
5064,"DireTube News - White House: Obama to visit Ethiopia by News ET Social 6 years ago 33 seconds 10,348 views",News ET Social,10348,10349,1
5065,"DireTube News -  India toxic alcohol kills 35 in Mumbai by News ET Social 6 years ago 57 seconds 1,211 views",News ET Social,1211,1211,0
5066,"DireTube News - Zami 90.7 FM radio station to be Shut Down by News ET Social 6 years ago 1 minute, 16 seconds 5,906 views",News ET Social,5906,5907,1
5067,"DireTube News - Zeway- Arsi Negele section of the Mojo- Hawassa Highway Project by News ET Social 6 years ago 42 seconds 16,030 views",News ET Social,16030,16033,3
5068,"Yaltayew Tewenet - Poet Demsew Mersha by News ET Social 6 years ago 13 minutes, 45 seconds 2,189 views",News ET Social,2189,2192,3
5069,"Min Alebet (ምን አለበት) Ethiopian Comedy Movie from DireTube Cinema by News ET Social 6 years ago 1 hour, 26 minutes 412,601 views",News ET Social,412601,412701,100
5070,"Yetesasate Menged (የተሳሳተ መንገድ) Ethiopian Movie from DireTube Cinema by News ET Social 6 years ago 1 hour, 33 minutes 228,491 views",News ET Social,228491,228521,30
5071,"DireTube News -  UN says 60 million people uprooted due to war and persecution by News ET Social 6 years ago 59 seconds 2,143 views",News ET Social,2143,2143,0
5072,"DireTube News - Arson guts Israeli church where 'Jesus fed 5,000' by News ET Social 6 years ago 1 minute, 15 seconds 2,143 views",News ET Social,2143,2144,1
5073,"DireTube News - Ethiopia starts training Kaizen Principles to African Countries by News ET Social 6 years ago 2 minutes, 34 seconds 2,566 views",News ET Social,2566,2567,1
5074,"DireTube News - Space Science Agency to be established in Ethiopia by News ET Social 6 years ago 2 minutes, 2 seconds 2,818 views",News ET Social,2818,2819,1
5075,"Yefikr Ken (የፍቅር ቀን) Ethiopian Movie from DireTube Cinema by News ET Social 6 years ago 1 hour, 23 minutes 22,952 views",News ET Social,22952,22956,4
5076,"Berera (በረራ) Ethiopian Comedy by News ET Social 6 years ago 5 minutes, 38 seconds 23,822 views",News ET Social,23822,23822,0
5077,"Alasgebam (አላስገባም) Ethiopian Comedy Drama by News ET Social 6 years ago 9 minutes, 17 seconds 59,146 views",News ET Social,59146,59214,68
5078,"Tapela (ታፔላ) Funny Ethiopian Musical Comedy by News ET Social 6 years ago 4 minutes, 8 seconds 7,264 views",News ET Social,7264,7264,0
5079,"Mistregnaw Bet (ሚስጢረኛው ቤት) Ethiopian Movie from DireTube Cinema by News ET Social 6 years ago 1 hour, 32 minutes 49,360 views",News ET Social,49360,49374,14
5080,"Beserge Wazema (በሠርጌ ዋዜማ) Ethiopian Movie from DireTube Cinema by News ET Social 6 years ago 1 hour 59,228 views",News ET Social,59228,59242,14
5081,"Ye Addis Ababa Gudoch (የአዲስ አበባ ጉዶች) Ethiopian Movie from DireTube Cinema by News ET Social 6 years ago 1 hour, 2 minutes 36,189 views",News ET Social,36189,36202,13
5082,"DireTube Comedy - Alwerdm (አልወርድም) Funny Ethiopian Comedy by News ET Social 6 years ago 2 minutes, 27 seconds 37,993 views",News ET Social,37993,38007,14
5083,"DireTube News - Court starts hearing witnesses in case of Getaneh plc manager death by News ET Social 6 years ago 2 minutes, 48 seconds 1,694 views",News ET Social,1694,1694,0
5084,"DireTube News - Ethiopia emerges Africa's most favourable investment spot by News ET Social 6 years ago 1 minute, 55 seconds 1,950 views",News ET Social,1950,1950,0
5085,"DireTube News - The American secretary who became king in Otuam, Ghana by News ET Social 6 years ago 1 minute, 9 seconds 5,986 views",News ET Social,5986,5987,1
5086,"DireTube News - The king with 100 wives by News ET Social 6 years ago 59 seconds 11,783 views",News ET Social,11783,11783,0
5087,"DireTube News - Burka and Edris win Ethiopian 10,000m trials in Hengelo by News ET Social 6 years ago 1 minute, 24 seconds 15,889 views",News ET Social,15889,15890,1
5088,"Bale Gize (ባለ ጊዜ) Ethiopian Movie from DireTube Cinema by News ET Social 6 years ago 1 hour, 29 minutes 694,600 views",News ET Social,694600,694884,284
5089,"DireTube News - Coca Cola Ethiopia new campaign with 50 students in Addis Ababa by News ET Social 6 years ago 1 minute, 58 seconds 2,452 views",News ET Social,2452,2453,1
5090,"DireTube News - High voltage electric line to link Wollayita Sodo with Kenyan border by News ET Social 6 years ago 1 minute, 27 seconds 1,248 views",News ET Social,1248,1249,1
5091,"DireTube News - Ethiopia to get giant edible oil plant by News ET Social 6 years ago 1 minute, 47 seconds 10,029 views",News ET Social,10029,10197,168
5092,"DireTube News - Ethiopia world's 5th biggest refugee hosting country by News ET Social 6 years ago 2 minutes, 2 seconds 1,501 views",News ET Social,1501,1501,0
5093,"Sheftaw (ሽፍታው) Ethiopian Comedy Movie from DireTube Cinema by News ET Social 6 years ago 1 hour, 51 minutes 19,868 views",News ET Social,19868,19877,9
5094,"DireTube News - What the Philippines Can Learn from Morocco, Peru and Ethiopia by News ET Social 6 years ago 1 minute, 6 seconds 1,479 views",News ET Social,1479,1479,0
5095,"Tasfelgegnaleh (ታስፈልገኛለህ) - Ethiopian Movie from DireTube Cinema by News ET Social 6 years ago 1 hour, 43 minutes 252,570 views",News ET Social,252570,252674,104
5096,"DireTube News - Opposition, government contest cause of Samuel Awoke’s death by News ET Social 6 years ago 3 minutes, 17 seconds 32,761 views",News ET Social,32761,32761,0
5097,"DireTube News - East African Oil & Gas Market 2014-2024 by News ET Social 6 years ago 1 minute, 30 seconds 18,783 views",News ET Social,18783,18825,42
5098,"DireTube News - Andy Tsege: Fears grow over state of mind of British activist by News ET Social 6 years ago 57 seconds 2,110 views",News ET Social,2110,2110,0
5099,"DireTube News - MK Abraham Naguise warns the Ethiopian-Israeli community is losing faith by News ET Social 6 years ago 55 seconds 2,404 views",News ET Social,2404,2404,0
5100,"DireTube TV  - 3rd Hotel Show Ethiopia 2015 Hospitality & Tourism Trade Show by News ET Social 6 years ago 4 minutes, 41 seconds 4,753 views",News ET Social,4753,4759,6
5101,"Yegud ken (የጉድ ቀን) Ethiopian Movie from DireTube Cinema by News ET Social 6 years ago 1 hour, 34 minutes 132,948 views",News ET Social,132948,133005,57
5102,"Temarekulesh (ተማረኩልሽ) Ethiopian Movie from DireTube Cinema by News ET Social 6 years ago 1 hour, 28 minutes 211,924 views",News ET Social,211924,212595,671
5103,"DierTube News - Africa Union headquarters' garden in Addis Ababa named after Wangari Maathai by News ET Social 6 years ago 1 minute, 25 seconds 1,048 views",News ET Social,1048,1048,0
5104,"DireTube News - Dr. Tedros meets Ethiopians residing in South Africa by News ET Social 6 years ago 1 minute, 3 seconds 2,553 views",News ET Social,2553,2553,0
5105,"DireTube News - Wisconsin engineers contribute to GERD discussion by News ET Social 6 years ago 1 minute, 43 seconds 1,145 views",News ET Social,1145,1145,0
5106,"DireTube News - First Lady elected into steering committee of OAFLA by News ET Social 6 years ago 2 minutes, 16 seconds 1,954 views",News ET Social,1954,1954,0
5107,"DireTube News - Yaltayew Tewnet: poem by poet Demsew Mersha to be inaugurated by News ET Social 6 years ago 1 minute, 6 seconds 944 views",News ET Social,944,944,0
5108,"DireTube News - Ramadan: Islamic holy month 2015 by News ET Social 6 years ago 1 minute 2,937 views",News ET Social,2937,2937,0
5109,"Sergud (ስርጉድ) Ethiopian Movie from DireTube Cinema by News ET Social 6 years ago 1 hour, 27 minutes 49,630 views",News ET Social,49630,49639,9
5110,"DireTube News - Regreening Ethiopian Highlands, step by step by News ET Social 6 years ago 2 minutes, 11 seconds 2,733 views",News ET Social,2733,2733,0
5111,"DireTube News - Sudan's Bashir arrives in Khartoum from South Africa by News ET Social 6 years ago 1 minute, 20 seconds 2,530 views",News ET Social,2530,2530,0
5112,"DireTube Sport - Walias started their training for CHAN Championship by News ET Social 6 years ago 1 minute, 33 seconds 992 views",News ET Social,992,992,0
5113,"DireTube News - 597 Ethiopians return home from Yemen via Djibouti by News ET Social 6 years ago 1 minute, 13 seconds 1,468 views",News ET Social,1468,1468,0
5114,"DireTube News - Arab Contractors to build new Residential City in Ethiopia at 2015-end by News ET Social 6 years ago 1 minute, 16 seconds 5,255 views",News ET Social,5255,5256,1
5115,"Menda (ምንዳ) Ethiopian Movie from DireTube Cinema by News ET Social 6 years ago 1 hour, 46 minutes 14,246 views",News ET Social,14246,14259,13
5116,"DireTube News - Taschereshegnalesh Part 2 CD Release Banned by News ET Social 6 years ago 48 seconds 5,151 views",News ET Social,5151,5151,0
5117,"DireTube News - Egypt’s Ministry of Youth organizes camp for 100 Ethiopians by News ET Social 6 years ago 49 seconds 2,694 views",News ET Social,2694,2694,0
5118,"DireTube News - Mokhtar Belmokhtar: Top Islamist 'killed' in US strike by News ET Social 6 years ago 31 seconds 2,701 views",News ET Social,2701,2704,3
5119,DireTube News - Specialized museum to support Ethiopia’s coffee branding efforts by News ET Social 6 years ago 55 seconds 955 views,News ET Social,955,955,0
5120,"DireTube News - Areya Girmay Appointed Head of Ethiopian Roads Authority by News ET Social 6 years ago 57 seconds 1,167 views",News ET Social,1167,1167,0
5121,"Z Captain (ካፒቴኑ) Latest Ethiopian Movie from DireTube Cinema by News ET Social 6 years ago 1 hour, 43 minutes 111,185 views",News ET Social,111185,111232,47
5122,"Adagn Fikir (አዳኝ ፍቅር) Ethiopian Movie from DireTube Cinema by News ET Social 6 years ago 1 hour, 31 minutes 145,905 views",News ET Social,145905,145952,47
5123,"Agebagn (አግባኝ) Ethiopian Movie from DireTube Cinema by News ET Social 6 years ago 1 hour, 19 minutes 30,149 views",News ET Social,30149,30153,4
5124,"DireTube News - FEACC says Ethiopian Roads Authority Vulnerable to Corruption, Overruns by News ET Social 6 years ago 2 minutes, 45 seconds 2,313 views",News ET Social,2313,2319,6
5125,"DireTube News - 597 Ethiopians return home from Yemen via Djibouti by News ET Social 6 years ago 56 seconds 38,889 views",News ET Social,38889,38893,4
5126,"DireTube News - Police officer filmed beating Ethiopian soldier not to face criminal charges by News ET Social 6 years ago 1 minute, 4 seconds 2,661 views",News ET Social,2661,2664,3
5127,"DireTube News - Mugabe: women are special breed by News ET Social 6 years ago 2 minutes, 16 seconds 1,069 views",News ET Social,1069,1070,1
5128,"DireTube News - First penis transplant patient's girlfriend is pregnant, doctor says by News ET Social 6 years ago 1 minute, 42 seconds 2,396 views",News ET Social,2396,2396,0
5129,"DireTube TV - The former NASA space scientist Dr. Kitaw Ejigu's biography documentary by News ET Social 6 years ago 5 minutes, 14 seconds 37,669 views",News ET Social,37669,37726,57
5130,"Tascherishignalesh 2 - ታስጨርሺኛለሽ 2 - Trailer by News ET Social 6 years ago 58 seconds 39,723 views",News ET Social,39723,39728,5
5131,"Zelalem Bekele - YeAbay Mado (የአባይ ማዶ) New Ethiopian Music 2015 - DireTube by News ET Social 6 years ago 5 minutes, 46 seconds 6,595 views",News ET Social,6595,6598,3
5132,"DireTube News - Nepal needs $6.6 billion for post-quake rebuilding by News ET Social 6 years ago 1 minute, 18 seconds 1,428 views",News ET Social,1428,1428,0
5133,"DireTube News - Yemen air strike demolished the heritage by News ET Social 6 years ago 59 seconds 1,538 views",News ET Social,1538,1538,0
5134,"DireTube News - Julia Bleasdale to host running camps in Ethiopia by News ET Social 6 years ago 54 seconds 1,590 views",News ET Social,1590,1590,0
5135,"DireTube - Ethiopian Wins Bombardier’s Airline Reliability Performance Award For 5th Year in a Row by News ET Social 6 years ago 1 minute, 31 seconds 1,519 views",News ET Social,1519,1520,1
5136,"DireTube Sport - Ethiopia beats Lesotho 2-1 by News ET Social 6 years ago 1 minute, 33 seconds 16,546 views",News ET Social,16546,16546,0
5137,"DireTube News - Election in Bonga peacefully accomplished by News ET Social 6 years ago 1 minute, 21 seconds 656 views",News ET Social,656,656,0
5138,"DireTube News - 25th Ordinary Session of the Assembly of the African Union by News ET Social 6 years ago 1 minute, 57 seconds 887 views",News ET Social,887,887,0
5139,"DireTube TV - Mahamud Ahmed: 50th year anniversary of his musical careers at Sheraton Addis Hotel by News ET Social 6 years ago 47 minutes 255,060 views",News ET Social,255060,255104,44
5140,"DireTube News - New curriculem formulated in Higher education institutions by News ET Social 6 years ago 2 minutes, 9 seconds 1,152 views",News ET Social,1152,1152,0
5141,"DireTube News - Malaysia Airlines plane makes Melbourne emergency landing by News ET Social 6 years ago 43 seconds 1,414 views",News ET Social,1414,1414,0
5142,DireTube News - UN Chief to African Union member states: ‘Seize your future’ by News ET Social 6 years ago 50 seconds 745 views,News ET Social,745,745,0
5143,"DireTube News - Turkish riot police officer who tear - gassed woman ordered to plant 600 trees by News ET Social 6 years ago 1 minute, 2 seconds 1,412 views",News ET Social,1412,1412,0
5144,"9th Addis International Film Festival - DireTube TV by News ET Social 6 years ago 13 minutes, 45 seconds 1,523 views",News ET Social,1523,1525,2
5145,"Tsehay Welde - Zim Kum [New! Music Video 2015] - DireTube by News ET Social 6 years ago 5 minutes, 8 seconds 15,360 views",News ET Social,15360,15428,68
5146,"DireTube News - INSA proposed new law to start digital signature system for electronic banking by News ET Social 6 years ago 3 minutes, 19 seconds 1,640 views",News ET Social,1640,1641,1
5147,"DireTube News - Efforts to extradite more than 80 human traffickers by News ET Social 6 years ago 1 minute, 41 seconds 2,729 views",News ET Social,2729,2729,0
5148,"DireTube News - Gilgel Gibe III Hydro Plant to Produce Power in August by News ET Social 6 years ago 1 minute, 44 seconds 16,021 views",News ET Social,16021,16026,5
5149,"DireTube News - Sawiris family eyes Ethiopia’s hotel sector by News ET Social 6 years ago 49 seconds 2,451 views",News ET Social,2451,2451,0
5150,DireTube News - Israel denies bugging Iran's nuclear talks by News ET Social 6 years ago 56 seconds 911 views,News ET Social,911,911,0
5151,"DireTube News - U.S. doesn't have 'complete strategy' to fight ISIS by News ET Social 6 years ago 56 seconds 1,129 views",News ET Social,1129,1129,0
5152,"Wubshet Fikadu - Dire Kombolcha (ድሬ ኮምቦልቻ) New Ethiopian Music 2015 - DireTube by News ET Social 6 years ago 5 minutes, 4 seconds 4,701 views",News ET Social,4701,4711,10
5153,"DireTube TV - Abstract Ethiopian Amharic movie inaugurated by News ET Social 6 years ago 3 minutes, 50 seconds 21,000 views",News ET Social,21000,21003,3
5154,"DireTube News - UNESCO registers Lake Tana as world heritage site by News ET Social 6 years ago 1 minute, 16 seconds 1,356 views",News ET Social,1356,1356,0
5155,"DireTube News - Commission announced sectors facing corruption on road construction by News ET Social 6 years ago 1 minute, 33 seconds 765 views",News ET Social,765,765,0
5156,"DireTube News - Chinese Officials Use Drone to Stop Cheating on Exam by News ET Social 6 years ago 2 minutes, 45 seconds 2,473 views",News ET Social,2473,2474,1
5157,"DireTube News - Ethiopia submits carbon cutting plan for UN climate deal by News ET Social 6 years ago 1 minute, 4 seconds 810 views",News ET Social,810,810,0
5158,"DireTube News - Authority puts an an injunction against Sebastopol Cinema, Ethiopia by News ET Social 6 years ago 37 seconds 656 views",News ET Social,656,656,0
5159,"DireTube News - Egypt, Sudan and Ethiopia agree to form supreme trilateral council by News ET Social 6 years ago 1 minute, 12 seconds 2,386 views",News ET Social,2386,2386,0
5160,DireTube News - Child accused of killing husband to be freed in Nigeria by News ET Social 6 years ago 56 seconds 999 views,News ET Social,999,999,0
5161,"DireTube News - The tribe who live in Ethiopian mud huts are more familiar than you might think by News ET Social 6 years ago 48 seconds 2,321 views",News ET Social,2321,2321,0
5162,"DireTube TV - Ethiopia preparing to mark Diaspora Day August 12-16/2015 by News ET Social 6 years ago 8 minutes, 7 seconds 2,092 views",News ET Social,2092,2092,0
5163,"DireTube News - Egypt, Sudan and Ethiopia agree to form supreme trilateral council by News ET Social 6 years ago 3 minutes, 4 seconds 1,181 views",News ET Social,1181,1181,0
5164,"DireTube News - Hilton to host the first International Day of Yoga in Ethiopia by News ET Social 6 years ago 1 minute, 13 seconds 991 views",News ET Social,991,991,0
5165,"DireTube News - Ethio Telecom fulfils 90% of the sector’s objective in the GTP by News ET Social 6 years ago 1 minute, 39 seconds 1,506 views",News ET Social,1506,1507,1
5166,"DireTube News - Ethiopia readies record $11 billion budget for fiscal year from July by News ET Social 6 years ago 1 minute, 4 seconds 1,004 views",News ET Social,1004,1004,0
5167,"DireTube News - Diaspora housing registration at the final stage in Addis Ababa by News ET Social 6 years ago 2 minutes, 32 seconds 6,421 views",News ET Social,6421,6422,1
5168,"DireTube TV - Yetibeb Andnet - Art Night at Kaleb Hotel Addis Ababa May 15, 2015 by News ET Social 6 years ago 2 minutes, 57 seconds 5,307 views",News ET Social,5307,5308,1
5169,"DireTube News - UN: 20 Million Yemenis need urgent assistance by News ET Social 6 years ago 1 minute, 3 seconds 843 views",News ET Social,843,843,0
5170,"DireTube News - The Sound of Munich meets Forrest Gump by News ET Social 6 years ago 1 minute, 23 seconds 895 views",News ET Social,895,895,0
5171,"DireTube News - Ethiopia plans to construct 110,000 km road for the next 5 years by News ET Social 6 years ago 1 minute, 49 seconds 997 views",News ET Social,997,997,0
5172,"DireTube News - UN excludes Israel from child rights violators list by News ET Social 6 years ago 1 minute, 7 seconds 934 views",News ET Social,934,934,0
5173,"DireTube News - Ethiopia is set to host a 5,000 people strong Conference in Addis on July by News ET Social 6 years ago 51 seconds 847 views",News ET Social,847,847,0
5174,"DireTube News - Ethiopian Athletics Queen Derartu honored by News ET Social 6 years ago 51 seconds 3,134 views",News ET Social,3134,3134,0
5175,"Tsedenia G-Markos - Hareyet (ሀረየት) [NEW! Ethiopian Music Video 2015] - DireTube by News ET Social 6 years ago 6 minutes, 17 seconds 396,493 views",News ET Social,396493,397567,1074
5176,"DireTube News - PM H-Mariam Desalegn is in Egypt by News ET Social 6 years ago 58 seconds 1,393 views",News ET Social,1393,1393,0
5177,DireTube News - National soil conservation campaign in Ethiopia by News ET Social 6 years ago 50 seconds 761 views,News ET Social,761,761,0
5178,"DireTube News - Factory worker sentenced to 3 years and 5 months for stealing clothes by News ET Social 6 years ago 1 minute, 36 seconds 1,232 views",News ET Social,1232,1232,0
5179,"DireTube News - Claims raised on private organization employees' pension in Ethiopia by News ET Social 6 years ago 3 minutes, 28 seconds 1,109 views",News ET Social,1109,1121,12
5180,"DireTube News - Commission is conducting an investigation on five organizations by News ET Social 6 years ago 2 minutes, 36 seconds 1,263 views",News ET Social,1263,1263,0
5181,"DireTube News - Ethiopia plans to sell 400 MW electricity to Tanzania by News ET Social 6 years ago 2 minutes, 33 seconds 1,716 views",News ET Social,1716,1717,1
5182,"DireTube TV - Wondimu Negash: Seminar on awareness for Mental Health problems by News ET Social 6 years ago 56 minutes 2,134 views",News ET Social,2134,2138,4
5183,"DireTube News - Ethiopia formulated New law to force drivers pay fees for using roads by News ET Social 6 years ago 1 minute, 57 seconds 1,453 views",News ET Social,1453,1453,0
5184,"DireTube News - Barack Obama Ignores Iraqi PM at the G7 Meeting in Germany by News ET Social 6 years ago 28 seconds 4,278 views",News ET Social,4278,4279,1
5185,"DireTube News - A Chinese businessman is paying $2.35 million to eat lunch with Warren Buffett by News ET Social 6 years ago 1 minute, 12 seconds 1,943 views",News ET Social,1943,1943,0
5186,"DireTube News - U.S. Embassy organized a half-day workshop for students in Addis by News ET Social 6 years ago 35 seconds 1,416 views",News ET Social,1416,1416,0
5187,"DireTube News - Ethiopia plans to produce 2026 MW electricity by News ET Social 6 years ago 2 minutes 4,751 views",News ET Social,4751,4751,0
5188,"DireTube News - The G-7 meeting held in Germany is concluded by News ET Social 6 years ago 1 minute, 16 seconds 937 views",News ET Social,937,937,0
5189,"DireTube News - Eritrea ruled by fear, not law, UN says by News ET Social 6 years ago 46 seconds 2,103 views",News ET Social,2103,2103,0
5190,"DireTube - Maed Adwa Program held in Addis Ababa by News ET Social 6 years ago 1 minute, 14 seconds 1,062 views",News ET Social,1062,1065,3
5191,DireTube News - Policy Measures Taken By Ethiopia Help Boost FDI Inflows by News ET Social 6 years ago 46 seconds 689 views,News ET Social,689,690,1
5192,DireTube News - Bonga election to be held on Sunday by News ET Social 6 years ago 39 seconds 889 views,News ET Social,889,889,0
5193,"DireTube News - NEBE Says No Complaints Despite Parties’ Rejection of Results by News ET Social 6 years ago 2 minutes, 29 seconds 971 views",News ET Social,971,971,0
5194,"Weynshet Belew - Bela Bela (በላ በላ) [NEW! Ethiopian Music Video 2015] - DireTube by News ET Social 6 years ago 5 minutes, 4 seconds 10,233 views",News ET Social,10233,10240,7
5195,"Sol Romeyo - Mokerigna (ሞክሪኛ) - [NEW! Ethiopian Music Video 2015] - DireTube by News ET Social 6 years ago 4 minutes, 21 seconds 6,842 views",News ET Social,6842,6843,1
5196,"Abstract - NEW Ethiopian Movie Trailer አብስትራክት - DireTube Trailer by News ET Social 6 years ago 2 minutes, 36 seconds 66,302 views",News ET Social,66302,66303,1
5197,"Simintegnaw Shi (8ኛው ሺ) Latest Ethiopian Movie from DireTube Cinema by News ET Social 6 years ago 1 hour, 27 minutes 468,061 views",News ET Social,468061,471005,2944
5198,"DireTube News - Smoking both down, and shockingly up, in Africa by News ET Social 6 years ago 1 minute, 1 second 1,256 views",News ET Social,1256,1256,0
5199,"DireTube News - Dazzling jewels from an Ethiopian grave reveal 2,000-year-old link to Rome by News ET Social 6 years ago 1 minute, 8 seconds 2,332 views",News ET Social,2332,2333,1
5200,"DireTube News -  Ethiopian Aviation Academy Awarded ICAO TRAINAIR PLUS Membership by News ET Social 6 years ago 1 minute, 8 seconds 1,562 views",News ET Social,1562,1562,0
5201,"DireTube News - Ethiopia keen to bolster cooperation with China by News ET Social 6 years ago 1 minute, 17 seconds 929 views",News ET Social,929,929,0
5202,"DireTube News - Ethiopia's first Modern Real Estate to be constructed by News ET Social 6 years ago 2 minutes, 3 seconds 16,677 views",News ET Social,16677,16677,0
5203,"Ke Eletat (ከዕለታት…) New Ethiopian Film coming soon! - DireTube Trailer by News ET Social 6 years ago 1 minute, 15 seconds 78,761 views",News ET Social,78761,78785,24
5204,"DireTube News - Audit report shows no improvement in public finance administration by News ET Social 6 years ago 3 minutes, 2 seconds 587 views",News ET Social,587,587,0
5205,"DireTube News - ICT Park Costing 5 Billion Br Inaugurated by News ET Social 6 years ago 2 minutes, 21 seconds 2,602 views",News ET Social,2602,2602,0
5206,"DireTube News - Ambo and Origin bottled water brands secured quality certificate by News ET Social 6 years ago 2 minutes, 20 seconds 2,024 views",News ET Social,2024,2024,0
5207,"Ras Yohannes - Jedhime (ጄዲሜ) [NEW! Ethiopian Music Video 2015] - DireTube by News ET Social 6 years ago 5 minutes, 5 seconds 22,140 views",News ET Social,22140,22153,13
5208,"DireTube Comedy - Boxegnaw (ቦክሰኛው) Funny Ethiopian Comedy Drama by News ET Social 6 years ago 14 minutes, 51 seconds 497,305 views",News ET Social,497305,498628,1323
5209,"Yehilm Rucha (የህልም ሩጫ) Ethiopian Movie from DireTube Cinema by News ET Social 6 years ago 1 hour, 20 minutes 21,311 views",News ET Social,21311,21327,16
5210,"Lageba New (ላገባ ነው) Ethiopian Movie from DireTube Cinema by News ET Social 6 years ago 1 hour, 46 minutes 361,444 views",News ET Social,361444,364623,3179
5211,"Ya Lij (ያ ልጅ) Ethiopian Amharic Movie from DireTube Cinema by News ET Social 6 years ago 1 hour, 57 minutes 37,926 views",News ET Social,37926,38321,395
5212,"DireTube Comedy - የውጪ ጉዳይ - Ethiopian Comedy by News ET Social 6 years ago 4 minutes, 47 seconds 10,329 views",News ET Social,10329,10329,0
5213,"DireTube News - WEF names Ethiopian Airlines one of four Africa growth finalists by News ET Social 6 years ago 1 minute, 16 seconds 2,910 views",News ET Social,2910,2910,0
5214,"DireTube News - Bomb at Nigerian market kills dozens by News ET Social 6 years ago 45 seconds 1,369 views",News ET Social,1369,1369,0
5215,"DireTube News - Death toll in twin fire, flood disaster hits 200 by News ET Social 6 years ago 1 minute, 1 second 1,472 views",News ET Social,1472,1472,0
5216,"DireTube News - Ethiopia's first ICT village built at cost of 600 million Birr to be Inaugurated by News ET Social 6 years ago 51 seconds 3,593 views",News ET Social,3593,3595,2
5217,"DireTube News - The life of Musical Maestro Dawit Yifru by News ET Social 6 years ago 1 minute, 48 seconds 2,121 views",News ET Social,2121,2123,2
5218,"DireTube News - 5 people who support inmates escape after prison break killed by security forces by News ET Social 6 years ago 56 seconds 3,296 views",News ET Social,3296,3296,0
5219,"DireTube News - Ethiopian Young Man Built a Plane by News ET Social 6 years ago 48 seconds 24,636 views",News ET Social,24636,24638,2
5220,"Celebrating the Life of Musical Maestro Dawit Yifru - Documentary Film by News ET Social 6 years ago 37 minutes 11,956 views",News ET Social,11956,11962,6
5221,"Mike Solo - HABESHA (New Ethiopian Music 2015) by News ET Social 6 years ago 4 minutes, 31 seconds 40,435 views",News ET Social,40435,40481,46
5222,"Haacaaluu Hundeessaa - Maalan Jira...? - DireTube Music Video 2015 by News ET Social 6 years ago 5 minutes, 31 seconds 2,722,288 views",News ET Social,2722288,2750964,28676
5223,"Our Son - ልጃችን - The True Story of Kitaw Ejigu - DireTube Trailer by News ET Social 6 years ago 1 minute, 26 seconds 33,091 views",News ET Social,33091,33138,47
5224,"DireTube News - 15 men arrested for selling fake Diamonds and Mercury by News ET Social 6 years ago 1 minute, 38 seconds 3,955 views",News ET Social,3955,3955,0
5225,"DireTube News - UN honours Ethiopian peacekeepers by News ET Social 6 years ago 1 minute, 23 seconds 3,023 views",News ET Social,3023,3023,0
5226,"DireTube News - Diamond League 2015 - Rome - Men's 800m Mohammed Aman Wins by News ET Social 6 years ago 1 minute, 7 seconds 7,083 views",News ET Social,7083,7086,3
5227,"DireTube News - Blurring Ethiopian blues by News ET Social 6 years ago 39 seconds 3,628 views",News ET Social,3628,3628,0
5228,"DireTube News - G7 Summit programme by News ET Social 6 years ago 1 minute, 16 seconds 1,243 views",News ET Social,1243,1243,0
5229,"DireTube News - Africa Hotel Investment Forum to be held in Addis Ababa by News ET Social 6 years ago 1 minute, 17 seconds 913 views",News ET Social,913,913,0
5230,"DireTube News - Over 10,000 militants killed in nine months - US by News ET Social 6 years ago 39 seconds 2,302 views",News ET Social,2302,2302,0
5231,"DireTube News - Gas explosion kills 78 persons in Ghana by News ET Social 6 years ago 38 seconds 1,681 views",News ET Social,1681,1682,1
5232,"DireTube News - Hungary plans to open Embassy in Ethiopia by News ET Social 6 years ago 40 seconds 2,175 views",News ET Social,2175,2175,0
5233,"DireTube News - Man gets 15 years in prison for violation by News ET Social 6 years ago 1 minute, 40 seconds 1,308 views",News ET Social,1308,1308,0
5234,"DireTube News - FEACC report says it has rescued over 645 million birr by News ET Social 6 years ago 1 minute, 26 seconds 723 views",News ET Social,723,723,0
5235,"DireTube News - NEBE says no party complained during the election day by News ET Social 6 years ago 2 minutes, 26 seconds 945 views",News ET Social,945,945,0
5236,"DireTube Comedy - Vat (ስለቫት) Comedian Dokle, Ethiopian Comedy by News ET Social 6 years ago 4 minutes, 5 seconds 225,579 views",News ET Social,225579,226474,895
5237,"DireTube Comedy - Sancho (ሳንቾ) Ethiopian Comedy by News ET Social 6 years ago 11 minutes, 40 seconds 67,698 views",News ET Social,67698,67719,21
5238,"DireTube Comedy - Yaltadlew (ያልታደለው) Comedian Dokle and Others by News ET Social 6 years ago 11 minutes, 19 seconds 325,039 views",News ET Social,325039,325286,247
5239,"DireTube Comedy - Sikilat (ስቅላት) Short Funny Ethiopian Comedy by News ET Social 6 years ago 8 minutes, 30 seconds 78,850 views",News ET Social,78850,78865,15
5240,"DireTube Sport - Stadium is not set yet for the coming game between Ethiopia and Lesotho by News ET Social 6 years ago 1 minute, 51 seconds 2,480 views",News ET Social,2480,2480,0
5241,"DireTube News - Dangote cement factory inaugurated June 4, 2015 by News ET Social 6 years ago 1 minute, 48 seconds 3,090 views",News ET Social,3090,3090,0
5242,"DireTube News - Ethiopia To Host First Africa-Japan Investment Forum Outside Japan by News ET Social 6 years ago 39 seconds 1,187 views",News ET Social,1187,1187,0
5243,"DireTube News - Pro-rebels South Sudanese academician dies in Ethiopia by News ET Social 6 years ago 48 seconds 1,603 views",News ET Social,1603,1605,2
5244,"DireTube News - Doc­u­men­tary film titled “Dukale’s Dream” is set to hit cinema screens by News ET Social 6 years ago 37 seconds 1,114 views",News ET Social,1114,1114,0
5245,"DireTube News - John Kerry's leg surgery a success by News ET Social 6 years ago 59 seconds 1,021 views",News ET Social,1021,1021,0
5246,"DireTube News - Six Commercial Bank of Ethiopia workers killed by security guard in Tigray region by News ET Social 6 years ago 3 minutes, 24 seconds 14,670 views",News ET Social,14670,14670,0
5247,"DireTube News - MIDROC to invest 18 billion birr on 13 areas of Addis Abeba by News ET Social 6 years ago 3 minutes, 4 seconds 2,758 views",News ET Social,2758,2762,4
5248,"DireTube News -  223.3 billion birr Ethiopian budget for the next 2008 fiscal year by News ET Social 6 years ago 2 minutes 2,662 views",News ET Social,2662,2662,0
5249,"DireTube - Federal Auditor indicates the existence illegal moneys in different federal organizations by News ET Social 6 years ago 4 minutes, 15 seconds 1,418 views",News ET Social,1418,1418,0
5250,"DireTube News - Jennifer Lopez’ sexy ‘unacceptable’ Morocco gig offends Islamist officials by News ET Social 6 years ago 54 seconds 4,056 views",News ET Social,4056,4057,1
5251,"Cambolojo (ካምቦሎጆ) Ethiopian Movie from DireTube Cinema by News ET Social 6 years ago 1 hour, 29 minutes 155,360 views",News ET Social,155360,155390,30
5252,"DireTube Comedy - Ras Milas (ራስ ምላስ) Ethiopian Funny by News ET Social 6 years ago 3 minutes, 35 seconds 5,059 views",News ET Social,5059,5065,6
5253,"DireTube Comedy - Comedian Filfilu, Ethiopian Comedy by News ET Social 6 years ago 42 seconds 32,526 views",News ET Social,32526,32532,6
5254,"DireTube Comedy - Funny Ethiopian Comedy by comedian Assefa by News ET Social 6 years ago 1 minute, 38 seconds 7,923 views",News ET Social,7923,7932,9
5255,"Wirs (ውርስ) Ethiopian Movie from DireTube Cinema by News ET Social 6 years ago 1 hour, 14 minutes 56,628 views",News ET Social,56628,56633,5
5256,"Bisrat FM 101.1 - Gender Equality and Religion - Ethiopian Religious representatives speak by News ET Social 6 years ago 1 hour, 20 minutes 4,750 views",News ET Social,4750,4752,2
5257,"Buzuayehu Kifle - Yene Alem (የኔ አለም) - [NEW! Ethiopian Music Video 2015] - DireTube by News ET Social 6 years ago 5 minutes, 2 seconds 793,398 views",News ET Social,793398,793757,359
5258,"DireTube News - Netanyahu introduces committee for Ethiopian assimilation to Israel by News ET Social 6 years ago 1 minute, 58 seconds 4,146 views",News ET Social,4146,4148,2
5259,"DireTube Sport - Five Ethiopian players excluded from Walia team by News ET Social 6 years ago 1 minute, 42 seconds 7,265 views",News ET Social,7265,7265,0
5260,"DireTube News - World No Tobacco Day 2015 in Ethiopia by News ET Social 6 years ago 1 minute 1,515 views",News ET Social,1515,1515,0
5261,"DireTube News - Ethiopia to help East Africa to record coffee harvest by News ET Social 6 years ago 43 seconds 1,669 views",News ET Social,1669,1669,0
5262,"DireTube News - Private schools fees’ too much, intervention needed by News ET Social 6 years ago 41 seconds 1,331 views",News ET Social,1331,1331,0
5263,"DireTube News - Tuskys of Kenya Plans Share Sale, Ethiopia Stores in Five Years by News ET Social 6 years ago 36 seconds 1,886 views",News ET Social,1886,1886,0
5264,"DireTube News - Africa and global power: on the rise, but at the margins by News ET Social 6 years ago 1 minute, 27 seconds 1,067 views",News ET Social,1067,1067,0
5265,"DireTube News - Global ranking on corruption and justice aims to promote good governance by News ET Social 6 years ago 2 minutes, 24 seconds 758 views",News ET Social,758,758,0
5266,"DireTube News - Court Sentences on protesters during the Anti-ISIL rally violence by News ET Social 6 years ago 2 minutes, 52 seconds 5,387 views",News ET Social,5387,5387,0
5267,"DireTube News - New wave of refugees fleeing ongoing violence in South Sudan by News ET Social 6 years ago 52 seconds 1,166 views",News ET Social,1166,1166,0
5268,"DireTube News - Ethiopia To Formulate Policy To Minimize Energy Wastage by News ET Social 6 years ago 1 minute, 11 seconds 1,050 views",News ET Social,1050,1050,0
5269,"DireTube News - No more than 1000 voters on the 5th Ethiopian Election by News ET Social 6 years ago 3 minutes, 57 seconds 593 views",News ET Social,593,593,0
5270,"DireTube News - Chinese ship capsizes on Yangtze with 458 people by News ET Social 6 years ago 1 minute 2,174 views",News ET Social,2174,2174,0
5271,"Latewochu (ላጤዎቹ) Short Ethiopian Funny Drama - DireTube Comedy by News ET Social 6 years ago 26 minutes 445,563 views",News ET Social,445563,445597,34
5272,"DireTube TV - Mulatu Astatke Performing Ethio-Jazz Night at the African Village, Ghion Hotel by News ET Social 6 years ago 42 minutes 11,175 views",News ET Social,11175,11185,10
5273,"Biniam Addis -Yeliben (የልቤን) [NEW! Ethiopian Music Video 2015] - DireTube by News ET Social 6 years ago 4 minutes, 34 seconds 4,025 views",News ET Social,4025,4026,1
5274,"DireTube News - Climate change is HELPING Africa says new study by News ET Social 6 years ago 1 minute, 34 seconds 3,817 views",News ET Social,3817,3817,0
5275,"DireTube News - Center trains Ethiopian-Israelis for high-tech careers by News ET Social 6 years ago 1 minute, 3 seconds 2,060 views",News ET Social,2060,2060,0
5276,"DireTube News - People died after Bus accident from Dire Dawa to Addis Ababa by News ET Social 6 years ago 43 seconds 19,293 views",News ET Social,19293,19294,1
5277,"Yohannes (Jona) - Fidele (ፊደሌ) [NEW! Ethiopian Music Video 2015] - DireTube by News ET Social 6 years ago 3 minutes, 47 seconds 8,915 views",News ET Social,8915,8918,3
5278,"DireTube News - East African leaders call for Burundi to delay elections by News ET Social 6 years ago 1 minute, 5 seconds 1,448 views",News ET Social,1448,1448,0
5279,"DireTube News - Ethiopia to export the large amount of coffee production by News ET Social 6 years ago 1 minute, 24 seconds 965 views",News ET Social,965,965,0
5280,"DireTube News - A Documentary Film on the Biography of Ethiopian Scientist Kitaw Ejigu by News ET Social 6 years ago 1 minute, 47 seconds 23,911 views",News ET Social,23911,23922,11
5281,"DireTube News - A wedding 70 years late by News ET Social 6 years ago 1 minute, 51 seconds 1,197 views",News ET Social,1197,1197,0
5282,"DireTube News - The lost Budget of New Generation Party by News ET Social 6 years ago 2 minutes, 37 seconds 970 views",News ET Social,970,970,0
5283,"Fikir Endabede (ፍቅር እንዳበደ) New Ethiopian Movie coming soon - DireTube Trailer by News ET Social 6 years ago 1 minute, 29 seconds 329,961 views",News ET Social,329961,330007,46
5284,DireTube News - Somalia’s population more than 12 million by News ET Social 6 years ago 52 seconds 852 views,News ET Social,852,852,0
5285,"DireTube News - 10 African super foods you need to be eating and drinking right now by News ET Social 6 years ago 2 minutes, 45 seconds 1,800 views",News ET Social,1800,1800,0
5286,"DireTube News - Police kill 2 people a day in US, report reveals by News ET Social 6 years ago 49 seconds 1,628 views",News ET Social,1628,1628,0
5287,"DireTube News - Latest census: Somalia’s population more than 12 million by News ET Social 6 years ago 43 seconds 1,304 views",News ET Social,1304,1304,0
5288,DireTube News - John Kerry to stay overnight at Geneva hospital after bike accident by News ET Social 6 years ago 42 seconds 817 views,News ET Social,817,817,0
5289,"Ethiopia in History - A Must Listen! Story of the Son of Emperor Tewodros, Alemayehu Tewodros by News ET Social 6 years ago 15 minutes 80,462 views",News ET Social,80462,80500,38
5290,"Atamelchignem (አታመልጪኝም) Ethiopian Movie from DireTube Cinema by News ET Social 6 years ago 1 hour, 40 minutes 38,360 views",News ET Social,38360,38367,7
5291,"Man Yawtaw? (ማን ያውጣው?) Amharic Movie from DireTube Cinema by News ET Social 6 years ago 1 hour, 59 minutes 81,459 views",News ET Social,81459,81681,222
5292,"DireTube News - Ethiopian politician calls for probing 'poll fraud' by News ET Social 6 years ago 43 seconds 4,623 views",News ET Social,4623,4623,0
5293,"DireTube News -  Rate of world hunger dropping amid wider eradication efforts - UN report by News ET Social 6 years ago 1 minute, 23 seconds 1,247 views",News ET Social,1247,1247,0
5294,"DireTube News - Nigeria violence: Militants kill 29 in Maiduguri by News ET Social 6 years ago 45 seconds 1,499 views",News ET Social,1499,1499,0
5295,"DireTube News - Court hearing prosecutors witnesses in Melaku Fenta case by News ET Social 6 years ago 4 minutes, 12 seconds 3,235 views",News ET Social,3235,3235,0
5296,"DireTube News - Ethiopian Human Rights Commission said election process was successful by News ET Social 6 years ago 2 minutes 1,538 views",News ET Social,1538,1539,1
5297,"DireTube News - Railway projects for the next transformation plan by News ET Social 6 years ago 1 minute, 27 seconds 2,689 views",News ET Social,2689,2689,0
5298,"DireTube News - Ethiopian Airlines to launch flights to Los Angeles by News ET Social 6 years ago 1 minute, 17 seconds 4,057 views",News ET Social,4057,4057,0
5299,"Filfilu - Funny Ethiopian Comedy - DireTube by News ET Social 6 years ago 35 seconds 9,951 views",News ET Social,9951,9964,13
5300,"DireTube Comedy - Gandi (ጋንዲ) Funny Ethiopian Drama by News ET Social 6 years ago 8 minutes, 8 seconds 14,007 views",News ET Social,14007,14010,3
5301,"DireTube Comedy - Ethiopian Musical comedy by News ET Social 6 years ago 4 minutes, 39 seconds 44,756 views",News ET Social,44756,44818,62
5302,"DireTube Comedy - Interview - Comedian Dokle and others by News ET Social 6 years ago 5 minutes, 56 seconds 264,004 views",News ET Social,264004,266266,2262
5303,"Filfilu - Funny Ethiopian Comedy - DireTube by News ET Social 6 years ago 30 seconds 4,820 views",News ET Social,4820,4824,4
5304,"DireTube Comedy - Ethiopian Comedy: Filfilu by News ET Social 6 years ago 1 minute, 54 seconds 1,035 views",News ET Social,1035,1039,4
5305,"DireTube Comedy - Latewochu (ላጤዎቹ) Short Funny Ethiopian Drama by News ET Social 6 years ago 12 minutes, 54 seconds 11,978 views",News ET Social,11978,11992,14
5306,"DireTube Comedy - Funny Ethiopian Comedy by News ET Social 6 years ago 6 minutes, 21 seconds 391,285 views",News ET Social,391285,392188,903
5307,"DireTube Comedy - Tashichalew (ታሽቻለው) - Filfilu and Others by News ET Social 6 years ago 8 minutes, 32 seconds 170,919 views",News ET Social,170919,171424,505
5308,"DireTube Comedy - Ethiopian Funny Drama by News ET Social 6 years ago 14 minutes, 49 seconds 4,882 views",News ET Social,4882,5229,347
5309,"DireTube Comedy - Ayalew Mognu (አያሌው ሞኙ) - Short Ethiopian Drama by News ET Social 6 years ago 29 minutes 4,924 views",News ET Social,4924,4933,9
5310,DireTube Comedy - by Comedian Filfilu by News ET Social 6 years ago 56 seconds 888 views,News ET Social,888,888,0
5311,"DireTube Comedy - Business - Funny Short Ethiopian Comedy Drama by Alebachew and Asres by News ET Social 6 years ago 14 minutes, 14 seconds 87,371 views",News ET Social,87371,87438,67
5312,"DireTube Comedy - Funny Comedy by Comedian Asres Bekele and others by News ET Social 6 years ago 10 minutes, 2 seconds 23,243 views",News ET Social,23243,23336,93
5313,"Daniel Kuncho - Hulachinim Alen - Ethiopian Comedy - DireTube by News ET Social 6 years ago 2 minutes, 43 seconds 15,538 views",News ET Social,15538,15586,48
5314,"DireTube Comedy - Comedian Filfilu and Sentayehu - Ethiopian Comedy by News ET Social 6 years ago 2 minutes, 1 second 94,571 views",News ET Social,94571,94623,52
5315,"DireTube News - Ethiopia’s economy Neither a sprint nor a marathon by News ET Social 6 years ago 2 minutes, 12 seconds 1,288 views",News ET Social,1288,1288,0
5316,"DireTube News - The Death Toll From India’s Hellish Heat Wave Is Now More Than 1,800 by News ET Social 6 years ago 1 minute, 31 seconds 3,037 views",News ET Social,3037,3037,0
5317,"DireTube News - Blue party rejects election results by News ET Social 6 years ago 48 seconds 2,640 views",News ET Social,2640,2640,0
5318,"DireTube Sport - Ethiopia Walia Ibex will play friendly match against Zambia by News ET Social 6 years ago 57 seconds 2,985 views",News ET Social,2985,2985,0
5319,"DireTube News - S. Sudan's warring parties Peace talk in Nairobi, Kenya by News ET Social 6 years ago 1 minute, 43 seconds 816 views",News ET Social,816,816,0
5320,"DireTube Comedy - Funny Ethiopian Comedy by comedian Sentayehu Kifle by News ET Social 6 years ago 52 seconds 10,466 views",News ET Social,10466,10473,7
5321,"DireTube News - Sepp Blatter re-elected as Fifa president for fifth term by News ET Social 6 years ago 1 minute, 4 seconds 723 views",News ET Social,723,723,0
5322,"DireTube News - South Africans joining ISIS by News ET Social 6 years ago 45 seconds 7,307 views",News ET Social,7307,7309,2
5323,"DireTube News - Ethiopian security officers injure two Kenyans by News ET Social 6 years ago 57 seconds 1,452 views",News ET Social,1452,1452,0
5324,"Bisrat FM Radio - What is Philosophy? - Part 2 by News ET Social 6 years ago 1 hour, 4 minutes 24,103 views",News ET Social,24103,24152,49
5325,"Bisrat FM Radio - What is Philosophy? Dr. Dagnachew Assefa by News ET Social 6 years ago 1 hour, 10 minutes 39,409 views",News ET Social,39409,39516,107
5326,"DireTube News - Electoral Board briefs diplomatic community about preliminary results by News ET Social 6 years ago 1 minute, 19 seconds 809 views",News ET Social,809,809,0
5327,"DireTube News - US hails Ethiopian elections, warns of restrictions on media by News ET Social 6 years ago 54 seconds 10,171 views",News ET Social,10171,10172,1
5328,"We are Ethiopia - እኛ ነን ኢትዮጵያ by News ET Social 6 years ago 5 minutes, 12 seconds 32,570 views",News ET Social,32570,32573,3
5329,"Firehiwot and Armah - Sene 30 (ሰኔ 30) [NEW! Ethiopian Music Video 2015] - DireTube by News ET Social 6 years ago 5 minutes, 40 seconds 25,376 views",News ET Social,25376,25379,3
5330,"DireTube News - Internet used by 3.2 billion people in 2015 by News ET Social 6 years ago 1 minute, 11 seconds 2,386 views",News ET Social,2386,2386,0
5331,"DireTube News -  Referendum on Britain's membership of the EU by News ET Social 6 years ago 44 seconds 1,901 views",News ET Social,1901,1901,0
5332,"DireTube News - Family of murdered Ethiopian maid accept blood money by News ET Social 6 years ago 43 seconds 44,869 views",News ET Social,44869,44869,0
5333,"DireTube TV - Taitu Cultural Center Literary Art Program at Axum Hotel, May 27, 2015 by News ET Social 6 years ago 26 minutes 4,282 views",News ET Social,4282,4283,1
5334,"DireTube News - 48 modern car parks to be contracted in Addis Ababa, Ethiopia by News ET Social 6 years ago 2 minutes, 19 seconds 6,807 views",News ET Social,6807,6810,3
5335,"DireTube News - PM Hailemariam Desalegn Thanks the People of Ethiopia by News ET Social 6 years ago 2 minutes, 9 seconds 3,949 views",News ET Social,3949,3949,0
5336,"DireTube News - NEBE Announces Provisional Election Results by News ET Social 6 years ago 1 minute, 20 seconds 2,496 views",News ET Social,2496,2496,0
5337,"DireTube TV - Blue Party in Ethiopia Press Conference after the 2015 Election - Full by News ET Social 6 years ago 48 minutes 32,852 views",News ET Social,32852,32854,2
5338,"DireTube News -  Horizon Addis Tire presents new Bus to St. George Sport Association by News ET Social 6 years ago 2 minutes, 25 seconds 1,152 views",News ET Social,1152,1154,2
5339,"DireTube Comedy - Abreham Asmelash - Funny Ethiopian Comedy by News ET Social 6 years ago 6 minutes, 30 seconds 108,419 views",News ET Social,108419,109178,759
5340,"Dereje & Habte - Ethiopian Comedy - Hello! - DireTube by News ET Social 6 years ago 2 minutes, 11 seconds 92,856 views",News ET Social,92856,93324,468
5341,"DireTube Comedy - Hello - Comedian Dereje and Habte: Ethiopian Comedy by News ET Social 6 years ago 3 minutes, 50 seconds 271,291 views",News ET Social,271291,272527,1236
5342,"Blue Party in Ethiopia Press Conference after the 2015 Election by News ET Social 6 years ago 5 minutes, 43 seconds 11,349 views",News ET Social,11349,11349,0
5343,"Ethiopian Comedy - Fantu Mandoye - Ehud Yekub Tella (እሁድ የእቁብ ጠላ) - DireTube by News ET Social 6 years ago 3 minutes, 13 seconds 60,550 views",News ET Social,60550,61253,703
5344,"DireTube News - Kenyan lawyer offers livestock for Barack Obama’s daughter by News ET Social 6 years ago 1 minute, 33 seconds 54,400 views",News ET Social,54400,54405,5
5345,"DireTube News - FM brings 118 Ethiopians home by News ET Social 6 years ago 56 seconds 3,339 views",News ET Social,3339,3339,0
5346,"DireTube News - New Hominin Species Discovered in Ethiopia by News ET Social 6 years ago 2 minutes, 42 seconds 2,528 views",News ET Social,2528,2529,1
5347,"DireTube News - The countries where gay men are the happiest by News ET Social 6 years ago 47 seconds 5,017 views",News ET Social,5017,5025,8
5348,"DireTube Comedy - Askalu (አስካሉ) - Musical Ethiopian Comedy by News ET Social 6 years ago 7 minutes, 7 seconds 249,494 views",News ET Social,249494,249650,156
5349,"DireTube News - 65-year-old grandmother gives birth to quadruplets by News ET Social 6 years ago 55 seconds 10,594 views",News ET Social,10594,10594,0
5350,"Kibebew Geda - Shibiru (ሽብሩ) Ethiopian Comedy - DireTube by News ET Social 6 years ago 18 minutes 419,695 views",News ET Social,419695,421853,2158
5351,"DireTube Comedy - Comedian Temesgen Melaku by News ET Social 6 years ago 1 minute, 3 seconds 6,468 views",News ET Social,6468,6473,5
5352,"DireTube Comedy - Comedy by Comedian Temesgen Melaku by News ET Social 6 years ago 5 minutes 13,443 views",News ET Social,13443,13453,10
5353,"DireTube Comedy - Comedy by Comedian Filfilu by News ET Social 6 years ago 35 seconds 12,994 views",News ET Social,12994,12994,0
5354,"DireTube Sport - Real Madrid sack Carlo Ancelotti by News ET Social 6 years ago 1 minute, 6 seconds 1,422 views",News ET Social,1422,1422,0
5355,"DireTube Comedy - Short Ethiopian Comedy Drama by News ET Social 6 years ago 3 minutes, 7 seconds 259,044 views",News ET Social,259044,259176,132
5356,"DireTube News  - Zimbabwe reportedly the biggest condom consumer in the world by News ET Social 6 years ago 1 minute, 28 seconds 2,910 views",News ET Social,2910,2910,0
5357,"DireTube News - Kenya police officers killed in Al-Shabaab attack by News ET Social 6 years ago 42 seconds 3,140 views",News ET Social,3140,3140,0
5358,"DireTube TV - Special program on Biniam Admasu, who died Battling Bale Mountains Park Fire by News ET Social 6 years ago 31 minutes 26,381 views",News ET Social,26381,26382,1
5359,"Abebe Kefeni - Beeken (ቤኬን) [NEW! Ethiopian Afaan Oromoo Music Video 2015] - DireTube by News ET Social 6 years ago 4 minutes, 40 seconds 12,455 views",News ET Social,12455,12468,13
5360,"DireTube News - Massive India heatwave 'kills 500' by News ET Social 6 years ago 1 minute, 10 seconds 5,096 views",News ET Social,5096,5096,0
5361,"DireTube News - The genius 'A Beautiful Mind' mathematician died by News ET Social 6 years ago 1 minute, 48 seconds 1,309 views",News ET Social,1309,1309,0
5362,"DireTube News - Ethiopia to export transformers by News ET Social 6 years ago 54 seconds 3,396 views",News ET Social,3396,3396,0
5363,"DireTube News - Partial finance secured for second expressway by News ET Social 6 years ago 42 seconds 3,438 views",News ET Social,3438,3438,0
5364,"DireTube News - Menged: Taitu Cultural Center to host Literary Arts program at Axum Hotel by News ET Social 6 years ago 1 minute, 39 seconds 1,704 views",News ET Social,1704,1704,0
5365,"DireTube News - EDP’s Chanie: We will find it hard to accept the Sunday’s election results by News ET Social 6 years ago 1 minute, 6 seconds 2,685 views",News ET Social,2685,2685,0
5366,"DireTube News - AU observer team to announce observation report by News ET Social 6 years ago 56 seconds 1,034 views",News ET Social,1034,1034,0
5367,"DireTube News - 5th Ethiopian General Election was Successful - Civic Associationsion by News ET Social 6 years ago 2 minutes, 27 seconds 2,211 views",News ET Social,2211,2211,0
5368,"DireTube Comedy - Funny Stand-Up Comedy by Comedian Temesgen Melaku by News ET Social 6 years ago 5 minutes, 50 seconds 29,880 views",News ET Social,29880,29913,33
5369,"DireTube News - Dangote’s $480m Ethiopian cement factory for inauguration June 5 by News ET Social 6 years ago 58 seconds 4,239 views",News ET Social,4239,4239,0
5370,"DireTube News -  292 Ethiopians return home from Yemen via Saudi Arabia by News ET Social 6 years ago 54 seconds 19,984 views",News ET Social,19984,19991,7
5371,"DireTube News - Industrial Park to Be Constructed in Dire Dawa by News ET Social 6 years ago 56 seconds 2,906 views",News ET Social,2906,2907,1
5372,"DireTube News - Ethiopia‬ denies troops invaded ‪Kenya‬ by News ET Social 6 years ago 48 seconds 3,930 views",News ET Social,3930,3930,0
5373,"DireTube News - AU Observer team say polls ended successfully by News ET Social 6 years ago 1 minute, 50 seconds 1,666 views",News ET Social,1666,1666,0
5374,"DireTube News - President Dr. Mulatu Teshome receives International Organization Excellency Award by News ET Social 6 years ago 57 seconds 2,336 views",News ET Social,2336,2337,1
5375,"DireTube News - Polling stations has started to announce vote results by News ET Social 6 years ago 1 minute, 3 seconds 5,203 views",News ET Social,5203,5203,0
5376,"Lemiwedut (ለሚወዱት) Latest Ethiopian Movie from DireTube Cinema by News ET Social 6 years ago 1 hour, 32 minutes 220,560 views",News ET Social,220560,220604,44
5377,"DireTube Comedy - Short Ethiopian Comedy Drama by News ET Social 6 years ago 15 minutes 124,651 views",News ET Social,124651,124984,333
5378,"DireTube Comedy - Balbola (ባልቦላ) Funny Ethiopian Comedy Drama by News ET Social 6 years ago 5 minutes, 3 seconds 24,152 views",News ET Social,24152,24168,16
5379,"DireTube Comedy - Mirkana (ምርቃና) by comedian Temesgen Melaku by News ET Social 6 years ago 41 seconds 35,540 views",News ET Social,35540,35555,15
5380,"Abebe Kefeni - Jinina (ጂኒና) [NEW! Ethiopian Afaan Oromoo Music Video 2015] - DireTube by News ET Social 6 years ago 5 minutes, 59 seconds 164,423 views",News ET Social,164423,166037,1614
5381,"DireTube News - Ethiopian women must be empowered politically: AU by News ET Social 6 years ago 1 minute, 7 seconds 4,301 views",News ET Social,4301,4301,0
5382,"DireTube News - World Bank Supports the Expansion of Efficient and Safe Transportation Systems by News ET Social 6 years ago 53 seconds 1,136 views",News ET Social,1136,1136,0
5383,"DireTube News - Jordanian gynaecologist leaves cell phone in patient’s abdomen by News ET Social 6 years ago 46 seconds 29,482 views",News ET Social,29482,29484,2
5384,"DireTube News - AU election mission requests review of Ethiopia's controversial legislations by News ET Social 6 years ago 54 seconds 2,959 views",News ET Social,2959,2959,0
5385,"DireTube News - Ethiopia’s economy expected to grow by News ET Social 6 years ago 1 minute, 3 seconds 2,409 views",News ET Social,2409,2409,0
5386,"DireTube News - Court hands prison sentences on suspects in the Hannah Lalongo case by News ET Social 6 years ago 5 minutes 9,976 views",News ET Social,9976,9977,1
5387,"DireTube News - UN investigates Briton on death row in Ethiopia by News ET Social 6 years ago 54 seconds 7,985 views",News ET Social,7985,7985,0
5388,"DireTube News - Ethiopia: Bonga election postponed amid clashes by News ET Social 6 years ago 34 seconds 3,437 views",News ET Social,3437,3437,0
5389,"DireTube TV - Fathers' Day (ክብር ለአባትነት) Bahir Dar, Ethiopia by News ET Social 6 years ago 3 minutes, 41 seconds 4,514 views",News ET Social,4514,4514,0
5390,"Abebe Kefeni - Marimee (መሪሜ) [New Afaan Oromoo Music Video 2015 ] - DireTube by News ET Social 6 years ago 6 minutes, 13 seconds 21,288 views",News ET Social,21288,21308,20
5391,"Yemaydegem Sitota (የማይደገም ስጦታ) Amharic Movie from DireTube Cinema by News ET Social 6 years ago 1 hour, 32 minutes 221,734 views",News ET Social,221734,221763,29
5392,"Lakelesta (ላከለስታ) Latest Ethiopian Movie from DireTube Cinema by News ET Social 6 years ago 1 hour, 35 minutes 98,672 views",News ET Social,98672,98690,18
5393,"DireTube Comedy - Very Funny Ethiopian Comedy by Comedian Teferi and Temesgen by News ET Social 6 years ago 7 minutes, 5 seconds 4,450 views",News ET Social,4450,4461,11
5394,"DireTube Comedy - Comedian Temesgen Melaku: Ethiopian Comedy by News ET Social 6 years ago 1 minute, 25 seconds 1,821 views",News ET Social,1821,1822,1
5395,"DireTube Comedy -  Comedian Daniel Kuncho [Very Funny Ethiopian Comedy] by News ET Social 6 years ago 5 minutes, 24 seconds 30,855 views",News ET Social,30855,30905,50
5396,"Sami Dan - ft. Nhatty Man - Liyew (ልየው) - [NEW! Ethiopian Music Video 2015] - DireTube by News ET Social 6 years ago 4 minutes, 41 seconds 16,600 views",News ET Social,16600,16618,18
5397,"Mirkana 1 (ምርቃና 1) [Funny] DireTube Comedy by News ET Social 6 years ago 43 seconds 14,268 views",News ET Social,14268,14275,7
5398,"DireTube Comedy - Mirkana (ምርቃና) Ethiopian Comedy by News ET Social 6 years ago 1 minute, 35 seconds 62,752 views",News ET Social,62752,62796,44
5399,"DireTube News - US Extends Ethiopia's Agoa Market Access for 10 Years by News ET Social 6 years ago 1 minute, 20 seconds 3,985 views",News ET Social,3985,3985,0
5400,"DireTube News - Ethiopia plans four new wind farm projects by News ET Social 6 years ago 30 seconds 2,707 views",News ET Social,2707,2708,1
5401,"DireTube News - China hands over two standard schools to Ethiopia's capital by News ET Social 6 years ago 32 seconds 2,817 views",News ET Social,2817,2817,0
5402,"DireTube News - Ethiopia signs deal with Khartoum to import oil via Port Sudan by News ET Social 6 years ago 37 seconds 4,546 views",News ET Social,4546,4547,1
5403,"DireTube News - Gayle Smith Slammed For Supporting Africa's Repressive Regimes by News ET Social 6 years ago 1 minute, 42 seconds 1,549 views",News ET Social,1549,1549,0
5404,"DireTube News - 5 Ethiopians killed in coalition strike in Yemen by News ET Social 6 years ago 1 minute, 35 seconds 13,469 views",News ET Social,13469,13470,1
5405,"DireTube Comedy - Comedian Daniel Kuncho: Very Funny Ethiopian Comedy by News ET Social 6 years ago 9 minutes, 30 seconds 47,122 views",News ET Social,47122,47252,130
5406,"Sami Dan - Shegitu (ሸጊቱ) [NEW! Ethiopian Reggae Music Video 2015] - DireTube by News ET Social 6 years ago 5 minutes, 11 seconds 9,253 views",News ET Social,9253,9254,1
5407,"Yewendoch Guday 2 (የወንዶች ጉዳይ 2) Ethiopian Romantic Comedy Film from DireTube Cinema by News ET Social 6 years ago 1 hour, 47 minutes 1,548,576 views",News ET Social,1548576,1561394,12818
5408,"Surprise (ሰርፕራይዝ) Ethiopian Amharic Movie from DireTube Cinema by News ET Social 6 years ago 1 hour, 40 minutes 29,054 views",News ET Social,29054,29243,189
5409,"Habtamu Limenih - Wegenin Filega (ወገንን ፍለጋ) New Ethiopian Music 2015 - DireTube by News ET Social 6 years ago 5 minutes, 31 seconds 3,608 views",News ET Social,3608,3608,0
5410,"DireTube Comedy - Comedian Daniel Kuncho, Funny Ethiopian Comedy by News ET Social 6 years ago 6 minutes, 9 seconds 30,697 views",News ET Social,30697,30746,49
5411,"DireTube News - Ethiopian Airlines to start direct flight to Cape Town and Gaborone by News ET Social 6 years ago 1 minute, 14 seconds 4,515 views",News ET Social,4515,4515,0
5412,"DireTube News - 183 Ethiopians evacuated from Yemen by News ET Social 6 years ago 1 minute, 9 seconds 4,541 views",News ET Social,4541,4541,0
5413,"DireTube News - 1,000 Indian Workers Dead. The Grim Reality Of Qatar's FIFA World Cup Dream by News ET Social 6 years ago 2 minutes, 19 seconds 7,395 views",News ET Social,7395,7396,1
5414,"DireTube News - Operation Fiela – the double-edged sword by News ET Social 6 years ago 1 minute, 31 seconds 8,980 views",News ET Social,8980,8980,0
5415,"DireTube News - China's CREC to complete section of Ethiopia's key railway project by News ET Social 6 years ago 1 minute, 1 second 5,178 views",News ET Social,5178,5178,0
5416,"DireTube News - Ethiopia: AU election observers arrive in the capital by News ET Social 6 years ago 33 seconds 2,443 views",News ET Social,2443,2443,0
5417,"DireTube News - political parties election campaign final day by News ET Social 6 years ago 55 seconds 4,072 views",News ET Social,4072,4072,0
5418,"DireTube News - Chachi International Art: Dream Big Sport Academy by News ET Social 6 years ago 1 minute, 43 seconds 1,416 views",News ET Social,1416,1416,0
5419,"DireTube - Leaders of South Sudan, Egypt, Ethiopia & Chad to attend Bashir’s swearing-in ceremony by News ET Social 6 years ago 48 seconds 2,947 views",News ET Social,2947,2947,0
5420,"DireTube News - Ethiopian Jews hold protest in Tel Aviv against racism by News ET Social 6 years ago 34 seconds 3,346 views",News ET Social,3346,3348,2
5421,"DireTube News - Ethiopia’s electric power coverage reaches 55% by News ET Social 6 years ago 49 seconds 2,824 views",News ET Social,2824,2824,0
5422,"DireTube News - Plans revealed for Ethiopian trans-shipment hub by News ET Social 6 years ago 43 seconds 3,277 views",News ET Social,3277,3277,0
5423,"DireTube News - Indian nurse in coma for 42 years after brutal rape dies by News ET Social 6 years ago 1 minute, 29 seconds 11,350 views",News ET Social,11350,11351,1
5424,"Ethiopia In History - The Time when Col. Mengistu H-Mariam went to Zimbabwe - DireTube by News ET Social 6 years ago 7 minutes, 53 seconds 162,214 views",News ET Social,162214,162383,169
5425,"DireTube News - Ramadi battle: IS militants 'round up enemies' in Iraq by News ET Social 6 years ago 26 seconds 5,147 views",News ET Social,5147,5147,0
5426,"Sami Dan - Anchi Yene (አንቺ የኔ) [NEW! Ethiopian Music Video 2015] - DireTube by News ET Social 6 years ago 4 minutes, 2 seconds 57,688 views",News ET Social,57688,57762,74
5427,"G-Kiristos Teklu (Major) - Tigraweyti Mizer (ትግራወይቲ ሚዘር) [New Tigrigna Music Video 2015] - DireTube by News ET Social 6 years ago 6 minutes, 1 second 4,927 views",News ET Social,4927,4931,4
5428,"DireTube Comedy - TV & Interview (ቲቪና ኢንተርቪው) Funny Ethiopian Comedy by News ET Social 6 years ago 14 minutes, 18 seconds 6,108 views",News ET Social,6108,6108,0
5429,"DireTube News - Ethiopian maid loses execution appeal in Saudi Arabia by News ET Social 6 years ago 1 minute, 10 seconds 63,522 views",News ET Social,63522,63524,2
5430,"DireTube News - Young Ethiopian Israelis want less talk, more action by News ET Social 6 years ago 1 minute, 10 seconds 19,162 views",News ET Social,19162,19163,1
5431,"DireTube News - Injured sea turtle gets 3D printed jaw by News ET Social 6 years ago 1 minute, 14 seconds 3,343 views",News ET Social,3343,3343,0
5432,"DireTube News - Housemaid attacks woman with cleaver by News ET Social 6 years ago 36 seconds 55,317 views",News ET Social,55317,55319,2
5433,"DireTube News - Ethiopia Plans Export Hubs With $10 Billion Factory Parks by News ET Social 6 years ago 38 seconds 4,869 views",News ET Social,4869,4871,2
5434,"DireTube News - Twitter activists freed from jail, but African governments are watching you by News ET Social 6 years ago 1 minute, 4 seconds 22,959 views",News ET Social,22959,22959,0
5435,"Daniel Kuncho - Chewata 1 (ጨዋታ ቁጥር 1) Funny Ethiopian Comedy - DireTube by News ET Social 6 years ago 5 minutes, 47 seconds 16,698 views",News ET Social,16698,16717,19
5436,"DireTube News - Ethiopia Among 15 fastest growing economies in 2015 by News ET Social 6 years ago 1 minute, 35 seconds 3,288 views",News ET Social,3288,3288,0
5437,"DireTube News - Transporters to Import 500 Buses With 70 Percent Bank Loan by News ET Social 6 years ago 50 seconds 7,733 views",News ET Social,7733,7733,0
5438,"DireTube News - Ethiopia detains 200 suspected human traffickers by News ET Social 6 years ago 1 minute, 1 second 7,409 views",News ET Social,7409,7409,0
5439,"DireTube News - UN admires pre election process by News ET Social 6 years ago 2 minutes, 1 second 5,845 views",News ET Social,5845,5845,0
5440,"Hiwet Bedereja (ህይወት በደረጃ) Latest Ethiopian Movie from DireTube Cinema by News ET Social 6 years ago 1 hour, 43 minutes 2,641,789 views",News ET Social,2641789,2664435,22646
5441,"DireTube Comedy - And Ken (አንድ ቀን) - Very Funny Ethiopian Comedy by Daniel Kuncho by News ET Social 6 years ago 8 minutes, 19 seconds 163,070 views",News ET Social,163070,163109,39
5442,"DireTube Video - WATCH! amazing Ethiopian Dance, International Jazz Day, Gion Hotel May 15/2015 by News ET Social 6 years ago 8 minutes, 30 seconds 128,168 views",News ET Social,128168,128180,12
5443,"Bizuayehu Kifle - Tibebish (ጥበብሽ) - [NEW! Ethiopian Music Video 2015] - DireTube by News ET Social 6 years ago 5 minutes, 15 seconds 612,435 views",News ET Social,612435,612957,522
5444,"DireTube News - Egypt executes six convicted Sinai Province militants by News ET Social 6 years ago 43 seconds 6,778 views",News ET Social,6778,6778,0
5445,"DireTube News - Israel failed Ethiopian community, president says at memorial by News ET Social 6 years ago 35 seconds 4,293 views",News ET Social,4293,4294,1
5446,"DireTube News - Ethiopian expats worry over digital passport delays by News ET Social 6 years ago 38 seconds 121,107 views",News ET Social,121107,121114,7
5447,"DireTube News - Israeli government to pay African refugees $3,500 to leave by News ET Social 6 years ago 52 seconds 2,257 views",News ET Social,2257,2257,0
5448,"DireTube News - Ethiopia opposition vows better Eritrea ties by News ET Social 6 years ago 38 seconds 5,600 views",News ET Social,5600,5600,0
5449,"DireTube News - Addis Ababa Sebeta Mieso rail test running begins by News ET Social 6 years ago 54 seconds 5,688 views",News ET Social,5688,5689,1
5450,"DireTube News - UN calls for respecting truce in Yemen by News ET Social 6 years ago 51 seconds 2,902 views",News ET Social,2902,2902,0
5451,"DireTube News - Ethiopia: Special police forces learn about humanitarian principles by News ET Social 6 years ago 48 seconds 2,809 views",News ET Social,2809,2809,0
5452,"DireTube News - Ethiopia pushing to be among top five tourist destinations in Africa by News ET Social 6 years ago 54 seconds 3,377 views",News ET Social,3377,3377,0
5453,"DireTube News - Gang-raped Hana Lalango's Case Final Court Decision by News ET Social 6 years ago 4 minutes, 4 seconds 22,118 views",News ET Social,22118,22118,0
5454,"DireTube Comedy - Comedian Temesgen Melaku, Funny Ethiopian Comedy by News ET Social 6 years ago 1 minute, 3 seconds 12,423 views",News ET Social,12423,12425,2
5455,"DireTube TV - Singer Munit singing at Jazz Appreciation Event, Addis Ababa May 15, 2015 by News ET Social 6 years ago 6 minutes, 6 seconds 2,823 views",News ET Social,2823,2824,1
5456,"DireTube News - Ethiopian nationals return home from Zimbabwe by News ET Social 6 years ago 1 minute, 39 seconds 6,301 views",News ET Social,6301,6302,1
5457,"DireTube News - 20 illegal human traffickers detained by News ET Social 6 years ago 1 minute, 15 seconds 6,898 views",News ET Social,6898,6898,0
5458,DireTube News - Ovarian cancer treatment to be started in 118 hospitals by News ET Social 6 years ago 45 seconds 989 views,News ET Social,989,989,0
5459,"The Mother of ISIS victim Ayalkbet Sinetayehu talking about her Son - DireTube by News ET Social 6 years ago 14 minutes, 8 seconds 24,678 views",News ET Social,24678,24678,0
5460,"Ethiopia in History: The failed coup d'état of May 1989, Derg regime, 26 years ago - DireTube by News ET Social 6 years ago 5 minutes, 53 seconds 43,452 views",News ET Social,43452,43545,93
5461,"DireTube TV -  International Jazz Day: Singer Munit singing Weyzerit Ethiopia by News ET Social 6 years ago 7 minutes, 21 seconds 4,709 views",News ET Social,4709,4710,1
5462,"DireTube News - Nigeria's Maiduguri under curfew after Boko Haram attack by News ET Social 6 years ago 34 seconds 2,793 views",News ET Social,2793,2793,0
5463,"DireTube News - CPJ to release report on global dangers to cartoonists by News ET Social 6 years ago 1 minute, 13 seconds 1,230 views",News ET Social,1230,1230,0
5464,"DireTube News - AU condemned coup attempt in Burundi by News ET Social 6 years ago 50 seconds 1,618 views",News ET Social,1618,1618,0
5465,"DireTube News - Ethiopia sells $3.8bn Nile mega dam bonds like it were the Olympics by News ET Social 6 years ago 2 minutes, 10 seconds 5,365 views",News ET Social,5365,5365,0
5466,"DireTube News - International Jazz Day: Jazz Appreciation Event at African Jazz Village, AddisAbaba by News ET Social 6 years ago 50 seconds 1,236 views",News ET Social,1236,1236,0
5467,"DireTube News - Fighting continues in Yemeni city despite truce by News ET Social 6 years ago 48 seconds 3,150 views",News ET Social,3150,3150,0
5468,"DireTube News - Owner and Founder of Holland Car Speaks on the new Proposal by News ET Social 6 years ago 1 minute, 7 seconds 905 views",News ET Social,905,905,0
5469,"DireTube News - Ethiopia seeks to lure more Chinese investment by News ET Social 6 years ago 1 minute, 9 seconds 2,151 views",News ET Social,2151,2151,0
5470,"DireTube News - Ethiopia to import 500 modern buses for public transport by News ET Social 6 years ago 1 minute, 23 seconds 7,941 views",News ET Social,7941,7943,2
5471,"DireTube News - Another 250 Ethiopians evacuated from Yemen by News ET Social 6 years ago 58 seconds 4,547 views",News ET Social,4547,4547,0
5472,"DireTube News - The Upcoming May 2015 Ethiopian General Election process by News ET Social 6 years ago 1 minute, 57 seconds 3,140 views",News ET Social,3140,3140,0
5473,"DireTube News - The Thorium Car Runs For 100 Years Without Refueling by News ET Social 6 years ago 1 minute, 13 seconds 1,056 views",News ET Social,1056,1056,0
5474,DireTube News - These 14 giant corporations dominate the global auto industry by News ET Social 6 years ago 48 seconds 916 views,News ET Social,916,916,0
5475,"DireTube News - Ethiopia: World Bank Extends Us$350 Million Loan to the Agricultural Sector by News ET Social 6 years ago 1 minute, 22 seconds 1,897 views",News ET Social,1897,1897,0
5476,"DireTube News - Ethiopia To Make Available 2.3 Million Hectares of Land For Investors by News ET Social 6 years ago 57 seconds 2,091 views",News ET Social,2091,2091,0
5477,"MistO-MistO - Ambassel [NEW! Music Video 2015] - DireTube by News ET Social 6 years ago 5 minutes, 51 seconds 61,504 views",News ET Social,61504,61646,142
5478,"First Ever Medical Directory Launched in Ethiopia - DireTube by News ET Social 6 years ago 1 minute, 38 seconds 2,789 views",News ET Social,2789,2789,0
5479,"What Does the International Law say about the Protection of Refugees? DireTube TV by News ET Social 6 years ago 8 minutes, 8 seconds 3,957 views",News ET Social,3957,3958,1
5480,"Owner and Founder of Holland Car Speaks on the NEW Proposal - DireTube by News ET Social 6 years ago 18 minutes 3,007 views",News ET Social,3007,3007,0
5481,"Ato Redwan Hussien Press Conference on Current Issues - DireTube TV by News ET Social 6 years ago 19 minutes 5,348 views",News ET Social,5348,5348,0
5482,"Bre Bright Funga (ፉንጋ) [Music Video 2014] - DireTube by News ET Social 6 years ago 4 minutes, 8 seconds 6,579 views",News ET Social,6579,6580,1
5483,"Yefikir Guday (የፍቅር ጉዳይ) Amharic Ethiopian Movie from DireTube Cinema by News ET Social 6 years ago 1 hour, 17 minutes 235,956 views",News ET Social,235956,236095,139
5484,"Taste of Addis  - Tast od Addis Food & Music Festival at Tropical Garden, April 2015 - DireTube by News ET Social 6 years ago 1 minute, 53 seconds 8,727 views",News ET Social,8727,8727,0
5485,"DireTube News - Gunmen in Pakistan kill 43 in attack on bus carrying religious minority by News ET Social 6 years ago 39 seconds 6,025 views",News ET Social,6025,6025,0
5486,"DireTube News - Ethiopia becomes Africa's largest asylum host by News ET Social 6 years ago 38 seconds 3,609 views",News ET Social,3609,3609,0
5487,"DireTube News - Government, opposition blast at each other ahead of Ethiopia’s General Election by News ET Social 6 years ago 38 seconds 2,557 views",News ET Social,2557,2557,0
5488,"DireTube News - Transport Bureau to Erect Modern Parking Across from Palace by News ET Social 6 years ago 1 minute, 19 seconds 3,351 views",News ET Social,3351,3351,0
5489,"DireTube News - Ethiopia capital Addis Ababa to host summit on global poverty by News ET Social 6 years ago 1 minute 3,125 views",News ET Social,3125,3125,0
5490,"DireTube News - No. 2 Leader of ISIS Killed in U.S.Led Airstrike by News ET Social 6 years ago 1 minute, 9 seconds 19,264 views",News ET Social,19264,19266,2
5491,"DireTube News - Ethiopia eyes foreign companies in housing development by News ET Social 6 years ago 1 minute, 15 seconds 7,466 views",News ET Social,7466,7466,0
5492,"Amran Ethiopian Movie (አምራን) Latest Ethiopian Movie from DireTube Cinema by News ET Social 6 years ago 1 hour, 51 minutes 389,337 views",News ET Social,389337,392160,2823
5493,"DireTube Comedy - Hakimon Yamakru (ሀኪሞን ያማክሩ) Ethiopian Comedy by News ET Social 6 years ago 19 minutes 101,774 views",News ET Social,101774,104083,2309
5494,"DireTube Comedy - Comedian Demsie Wanos and Temesgen, Funny Ethiopian Comedy by News ET Social 6 years ago 1 minute, 27 seconds 5,747 views",News ET Social,5747,5749,2
5495,"DireTube News - 'Ride Me All Day' - Bus Advert Branded 'Abhorrent' And 'Hugely Offensive' by News ET Social 6 years ago 2 minutes, 3 seconds 3,005 views",News ET Social,3005,3005,0
5496,"DireTube News - 220 Ethiopians evacuated from Yemen by News ET Social 6 years ago 1 minute, 7 seconds 1,405 views",News ET Social,1405,1405,0
5497,"DireTube News - Gov't housing programme raises citizens desire for better life, Minister by News ET Social 6 years ago 1 minute, 57 seconds 5,062 views",News ET Social,5062,5062,0
5498,"DireTube News - Ethiopia: Africa’s New China? by News ET Social 6 years ago 1 minute, 17 seconds 7,617 views",News ET Social,7617,7617,0
5499,"DireTube News - Ethiopians Rally Olympic-Style, Chip in on Bonds for Dam by News ET Social 6 years ago 1 minute, 24 seconds 2,147 views",News ET Social,2147,2147,0
5500,"DireTube News - Schoolgirl Sky releases charity video to help Ethiopian children by News ET Social 6 years ago 1 minute, 1 second 1,915 views",News ET Social,1915,1915,0
5501,"DireTube Comedy  - Bochera (ቦቸራ) - Funny Ethiopian Comedy by News ET Social 6 years ago 2 minutes, 57 seconds 267,391 views",News ET Social,267391,267747,356
5502,"DireTube News - North Korea boasts of firing ballistic missile from submarine by News ET Social 6 years ago 40 seconds 2,055 views",News ET Social,2055,2057,2
5503,"DireTube News - Around 10,000 10th round condominium winners signed the agreement by News ET Social 6 years ago 2 minutes, 6 seconds 10,233 views",News ET Social,10233,10233,0
5504,"Sigebagn Litash (ሲገባኝ ልጣሽ) Ethiopian Film Trailer 2015  - DireTube Trailer by News ET Social 6 years ago 1 minute, 33 seconds 24,566 views",News ET Social,24566,24568,2
5505,"DireTube News - China business delegation consisting representatives of companies visiting Ethiopia by News ET Social 6 years ago 1 minute, 43 seconds 1,236 views",News ET Social,1236,1236,0
5506,"DireTube News - NEBE completes distribution of election materials by News ET Social 6 years ago 1 minute, 19 seconds 923 views",News ET Social,923,923,0
5507,"DireTube News - Ethiopia, Rwanda seek closer trade ties in leather industry by News ET Social 6 years ago 31 seconds 1,010 views",News ET Social,1010,1010,0
5508,"DireTube News - Latin America leads world on murder map, but key cities buck deadly trend by News ET Social 6 years ago 2 minutes, 8 seconds 1,039 views",News ET Social,1039,1039,0
5509,"DireTube News - Logistics tops Ethiopia growth risks by News ET Social 6 years ago 1 minute, 52 seconds 1,869 views",News ET Social,1869,1869,0
5510,"DireTube Comedy - Very Funny Ethiopian comedy, Comedian Temesgen, Demsie and Betty by News ET Social 6 years ago 6 minutes, 49 seconds 73,469 views",News ET Social,73469,73527,58
5511,"DireTube Video - Ethiopian Women's Art contest exhibition 2015 at the US Embassy by News ET Social 6 years ago 2 minutes, 3 seconds 1,832 views",News ET Social,1832,1834,2
5512,"DireTube  Comedy - Kedadaw (ቀዳዳው) Ethiopian Comedy Drama by News ET Social 6 years ago 22 minutes 158,914 views",News ET Social,158914,158979,65
5513,"DireTube News - Young Ethiopians are contributing in transformative technology by News ET Social 6 years ago 1 minute, 45 seconds 1,108 views",News ET Social,1108,1108,0
5514,"DireTube News - Dozens dead after another major earthquake centered in Nepal by News ET Social 6 years ago 1 minute, 2 seconds 910 views",News ET Social,910,910,0
5515,"DireTube News - Ethiopian ‎Tourism Night held in Belgium , Brussels by News ET Social 6 years ago 1 minute, 18 seconds 1,030 views",News ET Social,1030,1030,0
5516,"DireTube News - Ethiopia demands explanation from Israel for racism by News ET Social 6 years ago 1 minute, 43 seconds 2,598 views",News ET Social,2598,2601,3
5517,"DireTube News - Trial in Hanna Lalango Case Postponed for May 15, 2015 by News ET Social 6 years ago 33 seconds 1,550 views",News ET Social,1550,1550,0
5518,"DireTube Drama - Sitota (ስጦታ) Ethiopian Romantic Drama by News ET Social 6 years ago 17 minutes 62,248 views",News ET Social,62248,62251,3
5519,"DireTube Video - The inauguration of Ethiopian Film - Lamba (ላምባ), National Theater May 7, 2015 by News ET Social 6 years ago 4 minutes, 18 seconds 10,214 views",News ET Social,10214,10214,0
5520,"DireTube News - Houthi Rebels Agree to 5-Day Cease-Fire in Yemen by News ET Social 6 years ago 52 seconds 1,752 views",News ET Social,1752,1752,0
5521,"DireTube News - EU Commission's quota plan for migrants by News ET Social 6 years ago 1 minute, 6 seconds 4,026 views",News ET Social,4026,4026,0
5522,"DireTube News - New Airport to be built in Nekemt , Oromia Ethiopia by News ET Social 6 years ago 37 seconds 8,512 views",News ET Social,8512,8512,0
5523,"DireTube News - The Development Bank of Africa to appoint its new president by News ET Social 6 years ago 1 minute, 38 seconds 1,151 views",News ET Social,1151,1151,0
5524,"DireTube News - Ethiopian Reinsurance SC under formation by News ET Social 6 years ago 37 seconds 1,573 views",News ET Social,1573,1574,1
5525,"DireTube News - Government to Resume Teff Exports with 180,000ql by Next Fiscal Year by News ET Social 6 years ago 1 minute, 37 seconds 19,047 views",News ET Social,19047,19047,0
5526,"DireTube News - Ethiopian Doctor passed away - he end up as a homeless before he died by News ET Social 6 years ago 36 seconds 9,420 views",News ET Social,9420,9424,4
5527,"DireTube Law - Ekub (የእቁብ ነገር) Shiwenzu Melaku presents - Kidane Mekasha by News ET Social 6 years ago 9 minutes, 49 seconds 8,113 views",News ET Social,8113,8119,6
5528,"DireTube News - Ethiopia’s public diplomacy delegation in Sudan to strengthen friendship by News ET Social 6 years ago 2 minutes, 16 seconds 2,503 views",News ET Social,2503,2504,1
5529,"Umad Ukuri to Sign for Egyptian Side Al Ithihad - DireTube Sport by News ET Social 6 years ago 1 minute, 5 seconds 1,129 views",News ET Social,1129,1129,0
5530,"Jos Hermens: Haile not retiring, got a schedule to run in October by News ET Social 6 years ago 1 minute, 9 seconds 5,111 views",News ET Social,5111,5112,1
5531,"Man Shot Husband Multiple times and Wife who was hiding next room - DireTube News by News ET Social 6 years ago 2 minutes, 47 seconds 3,637 views",News ET Social,3637,3637,0
5532,"DireTube News - 200 smugglers sentenced to 5 up to 20 years in jail by News ET Social 6 years ago 54 seconds 3,629 views",News ET Social,3629,3629,0
5533,"DireTube Sport - Haile Gebrselassie retires after Great Manchester Run by News ET Social 6 years ago 48 seconds 4,122 views",News ET Social,4122,4122,0
5534,"DireTube News - S. African Security Targets Foreigners by News ET Social 6 years ago 57 seconds 15,057 views",News ET Social,15057,15057,0
5535,"DireTube News - Government to Resume Teff Exports with 180,000ql by Next Fiscal Year by News ET Social 6 years ago 47 seconds 1,325 views",News ET Social,1325,1325,0
5536,"DireTube News - Ethiopia demands explanation from Israel for racism by News ET Social 6 years ago 55 seconds 19,396 views",News ET Social,19396,19398,2
5537,"DireTube News - Ethiopians “repatriated not rescued” says Libya official by News ET Social 6 years ago 1 minute, 16 seconds 5,529 views",News ET Social,5529,5529,0
5538,"DireTube News - Conservationist Biniyam Admassu Memorial May 10, 2015 by News ET Social 6 years ago 1 minute, 12 seconds 2,473 views",News ET Social,2473,2473,0
5539,"Visiting Family of Birhanu Getaneh, Father of Two Children who was killed by ISIS by News ET Social 6 years ago 22 minutes 101,069 views",News ET Social,101069,101069,0
5540,"DireTube Comedy - Funny Ethiopian Comedy by comedian Temesgen and Alex by News ET Social 6 years ago 1 minute, 35 seconds 22,108 views",News ET Social,22108,22111,3
5541,"Ethiopian Drama - The President's Secrets (የፕሬዝዳንቱ ሚስጥሮች) Ethiopian Drama - DireTube by News ET Social 6 years ago 26 minutes 9,879 views",News ET Social,9879,9879,0
5542,"DireTube Visits Family of the Seven Dead Ethiopian Migrants by News ET Social 6 years ago 10 minutes, 25 seconds 75,735 views",News ET Social,75735,75736,1
5543,"Chachi Tadesse Emotional Speech at Biniam Admasu Memorial - DireTube by News ET Social 6 years ago 12 minutes, 38 seconds 81,483 views",News ET Social,81483,81494,11
5544,"DireTube News - US, Saudi agree to ceasefire in Yemen fighting by News ET Social 6 years ago 39 seconds 1,742 views",News ET Social,1742,1742,0
5545,"DireTube News - Pakistan helicopter crash kills foreign envoys by News ET Social 6 years ago 38 seconds 1,619 views",News ET Social,1619,1620,1
5546,"DireTube News - Ethiopian evacuees from Libya via Sudan, Khartoum by News ET Social 6 years ago 58 seconds 4,102 views",News ET Social,4102,4104,2
5547,"DireTube News - “Ethio Health Exhibition & Congress” 2015 session by News ET Social 6 years ago 2 minutes, 11 seconds 660 views",News ET Social,660,663,3
5548,"DireTube News - Somaliland: Relations with Ethiopia Go a Notch Higher by News ET Social 6 years ago 1 minute, 12 seconds 1,999 views",News ET Social,1999,1999,0
5549,"DireTube News - Save the Children: Wealth Gap Widens for Urban Mothers by News ET Social 6 years ago 1 minute, 8 seconds 1,672 views",News ET Social,1672,1672,0
5550,"DireTube News - S. Sudanese rebels accuse Ethiopian governor of receiving bribe from Juba by News ET Social 6 years ago 1 minute, 19 seconds 1,971 views",News ET Social,1971,1971,0
5551,"DireTube News - Ethiopians rescued from Libya arrive in Addis Ababa by News ET Social 6 years ago 1 minute, 17 seconds 3,518 views",News ET Social,3518,3518,0
5552,"""Lamba"" Ethiopian Movie Inaugurated - DireTube News by News ET Social 6 years ago 47 seconds 21,327 views",News ET Social,21327,21328,1
5553,"Ethiopia manufacturers 60% of Tram Body Part by News ET Social 6 years ago 58 seconds 3,683 views",News ET Social,3683,3683,0
5554,"Human Trafficker Sentenced to 12 Years in Prison in Ethiopia - DireTube News by News ET Social 6 years ago 1 minute, 13 seconds 4,133 views",News ET Social,4133,4134,1
5555,"Machar’s rebel faction denies accusing Ethiopian governor | DireTube News by News ET Social 6 years ago 40 seconds 1,076 views",News ET Social,1076,1076,0
5556,"Ethiopia Commodity Exchange Mulls Adding Stock, Bond Trading by News ET Social 6 years ago 49 seconds 1,295 views",News ET Social,1295,1296,1
5557,"MIDROC Ethiopia to invest 8 billion Birr on business expansion projects by News ET Social 6 years ago 1 minute, 28 seconds 4,511 views",News ET Social,4511,4514,3
5558,"Ethiopian Orthodox Church gave the title of Martyr to Ethiopian Christians brutally killed by ISIS by News ET Social 6 years ago 1 minute, 1 second 1,015 views",News ET Social,1015,1015,0
5559,"America's Allies Are Funding ISIS - DireTube News by News ET Social 6 years ago 1 minute, 38 seconds 3,097 views",News ET Social,3097,3097,0
5560,"South Sudan holds border consultative meeting with Ethiopia - DireTube News by News ET Social 6 years ago 1 minute, 2 seconds 1,004 views",News ET Social,1004,1004,0
5561,"Things you didn't know about Mother's Day - DireTube News by News ET Social 6 years ago 1 minute, 7 seconds 3,134 views",News ET Social,3134,3134,0
5562,"DireTube Poem - Bere Tenkuakua (በሬ ተንኳኳ) - Ethiopian Poem by Yilma Zerihun by News ET Social 6 years ago 1 minute, 3 seconds 4,598 views",News ET Social,4598,4598,0
5563,"Yilma Zerihun - Musical Poem, Teresto Hatiatu (ተረስቶ ሀጥያቱ) - DireTube Poem by News ET Social 6 years ago 3 minutes, 35 seconds 2,213 views",News ET Social,2213,2214,1
5564,"BeGe'ez (በግዕዝ) Ethiopian Poem by Poet Yilma Zerihun - DireTube Poem by News ET Social 6 years ago 1 minute, 28 seconds 3,210 views",News ET Social,3210,3212,2
5565,"DireTube Poem - Kiterign (ቅጠሪኝ) - Nice Poem by Yilma Zerihun by News ET Social 6 years ago 1 minute, 14 seconds 4,432 views",News ET Social,4432,4435,3
5566,"Yilma Zerihun (ብሔር ማለት ደም ነው) - DireTube Poem by News ET Social 6 years ago 3 minutes, 7 seconds 4,918 views",News ET Social,4918,4921,3
5567,"DireTube Comedy - Liwach (ልዋጭ) - Very Funny Ethiopian Comedy Drama by News ET Social 6 years ago 8 minutes, 12 seconds 67,827 views",News ET Social,67827,67852,25
5568,"DireTube News - Ethiopian maid refuses overdue wages by News ET Social 6 years ago 45 seconds 4,185 views",News ET Social,4185,4185,0
5569,"DireTube News - Britain: Conservatives on course for majority by News ET Social 6 years ago 45 seconds 1,209 views",News ET Social,1209,1209,0
5570,"DireTube News - Ethiopian Commodity Exchange gets new CEO by News ET Social 6 years ago 56 seconds 2,268 views",News ET Social,2268,2268,0
5571,"DireTube News - Delhi's healthcare for the poor fares worse than cities in Rwanda and Ethiopia by News ET Social 6 years ago 53 seconds 2,659 views",News ET Social,2659,2659,0
5572,"DireTube News - Seven Ethiopians among 700 Dead Immigrants at Mediterranean Sea by News ET Social 6 years ago 58 seconds 11,879 views",News ET Social,11879,11880,1
5573,"DireTube News - Other 27 Ethiopian evacuees from Libya arrived in Addis via Egypt by News ET Social 6 years ago 1 minute, 12 seconds 6,584 views",News ET Social,6584,6584,0
5574,"DireTube Comedy - Comedian Betty, Temesgen and Demsie Very funny Ethiopian comedy by News ET Social 6 years ago 3 minutes, 52 seconds 33,230 views",News ET Social,33230,33237,7
5575,"DireTube Video - Press release on Ethiopians coming back from Libya by News ET Social 6 years ago 8 minutes, 36 seconds 3,646 views",News ET Social,3646,3646,0
5576,"KG Man X Eyobed - Wedet Keresh (ወዴት ቀረሽ) - [New Ethiopian Music 2015] - DireTube by News ET Social 6 years ago 3 minutes, 50 seconds 15,660 views",News ET Social,15660,15689,29
5577,"DireTube News - Real life super hero: Hugh Jackman teams up with wife Deborra-Lee Furness by News ET Social 6 years ago 1 minute, 29 seconds 1,665 views",News ET Social,1665,1665,0
5578,"DireTube News - US offers $20m in rewards on 'four IS leaders' by News ET Social 6 years ago 56 seconds 15,388 views",News ET Social,15388,15388,0
5579,"DireTube News - UN praised South Sudan for ratifying the Convention on the Rights of the Child by News ET Social 6 years ago 51 seconds 1,115 views",News ET Social,1115,1115,0
5580,"DireTube News - EU and AU condemn intimidation and violence against journalists by News ET Social 6 years ago 1 minute, 4 seconds 798 views",News ET Social,798,798,0
5581,"DireTube News - Kerry Makes Historic Trip to Somalia in Show of Support by News ET Social 6 years ago 2 minutes, 3 seconds 1,200 views",News ET Social,1200,1201,1
5582,"DireTube News - You forget where you came from, go back to Ethiopia by News ET Social 6 years ago 1 minute, 56 seconds 4,084 views",News ET Social,4084,4084,0
5583,"Yalmekene Fikir (ያልመከነ ፍቅር) Latest Ethiopian Movie from DireTube Cinema by News ET Social 6 years ago 1 hour, 19 minutes 99,334 views",News ET Social,99334,99354,20
5584,"DireTube News - 11 Ethiopians have safely arrived in Addis from Libya via Sudan by News ET Social 6 years ago 2 minutes, 6 seconds 31,872 views",News ET Social,31872,31873,1
5585,"Yemaytareku Kelemat (የማይታረቁ ቀለማት) Latest Ethiopian Movie from DireTube Cinema by News ET Social 6 years ago 1 hour, 34 minutes 213,770 views",News ET Social,213770,213943,173
5586,"KeRas Belay (ከራስ በላይ) Latest Ethiopian Movie from DireTube Cinema by News ET Social 6 years ago 1 hour, 26 minutes 72,346 views",News ET Social,72346,72362,16
5587,"DireTube Video - Ethiopian chef Jordana's new book on food recipes, at Washington Hotel by News ET Social 6 years ago 15 minutes 6,961 views",News ET Social,6961,6961,0
5588,"DireTube Sport - Man Utd delight as David De Gea agrees new contract by News ET Social 6 years ago 3 minutes, 50 seconds 1,063 views",News ET Social,1063,1063,0
5589,"DireTube News - Wealthy people can't find parking for private jets at Mayweather-Pacquiao by News ET Social 6 years ago 1 minute, 20 seconds 2,720 views",News ET Social,2720,2721,1
5590,"DireTube News - Somalia's government ban al-Shabab name from media by News ET Social 6 years ago 57 seconds 2,324 views",News ET Social,2324,2326,2
5591,"DireTube News - Ethiopia offers 100% FDI facility to India for healthcare by News ET Social 6 years ago 20 seconds 1,851 views",News ET Social,1851,1851,0
5592,"DireTube News - Akobo East County to Use Ethiopian Currency Legal In Local Market by News ET Social 6 years ago 37 seconds 1,717 views",News ET Social,1717,1717,0
5593,"DireTube Sport - Floyd Mayweather agree to Manny Pacquiao rematch by News ET Social 6 years ago 2 minutes, 14 seconds 591 views",News ET Social,591,591,0
5594,"DireTube New - The Statue of Afro-American John Robinson inaugurated in Addis by News ET Social 6 years ago 1 minute, 45 seconds 1,926 views",News ET Social,1926,1926,0
5595,"DireTube News - Italian coffee company Illy will open its branch University of Coffee in Ethiopia by News ET Social 6 years ago 1 minute, 3 seconds 1,383 views",News ET Social,1383,1383,0
5596,"DireTube News -  First batch of Ethiopians returning from Libya expected to arrive in Addis by News ET Social 6 years ago 52 seconds 4,805 views",News ET Social,4805,4806,1
5597,"DireTube News - Extension projects in 4 Ethiopian major hospitals inaugurated May 5, 2015 by News ET Social 6 years ago 42 seconds 1,662 views",News ET Social,1662,1664,2
5598,"Yabedkulet (ያበድኩ’ለት) New Ethiopian Movie Trailer 2015 - DireTube Trailer by News ET Social 6 years ago 1 minute, 11 seconds 423,703 views",News ET Social,423703,423948,245
5599,"FBI Part 2 - Full Amharic Film from DireTube Cinema by News ET Social 6 years ago 1 hour, 35 minutes 2,708,441 views",News ET Social,2708441,2722067,13626
5600,"Yegna Band - Great Song from Yegna Film - DireTube by News ET Social 6 years ago 1 minute, 59 seconds 11,309 views",News ET Social,11309,11315,6
5601,"DireTube Sport - Chelsea: Alan Shearer on why the Blues are champions again by News ET Social 6 years ago 3 minutes, 7 seconds 979 views",News ET Social,979,979,0
5602,"Biruk Rak Rak - Alemegnem - DireTube Music 2015 by News ET Social 6 years ago 4 minutes, 40 seconds 3,139 views",News ET Social,3139,3140,1
5603,"DireTube News - Over 200,000 South Sudanese Fled To Ethiopia Since 2013 by News ET Social 6 years ago 1 minute, 10 seconds 7,221 views",News ET Social,7221,7221,0
5604,"DireTube Sport - The new Ethiopia coach Yohannes Sahle start working with the team by News ET Social 6 years ago 2 minutes, 47 seconds 1,683 views",News ET Social,1683,1684,1
5605,"DireTube News - Minister to okay immigration for Ethiopian relatives of IDF veterans by News ET Social 6 years ago 1 minute, 28 seconds 15,279 views",News ET Social,15279,15279,0
5606,"DireTube News - Floyd Mayweather beats Manny Pacquiao in Las Vegas by News ET Social 6 years ago 1 minute, 19 seconds 3,480 views",News ET Social,3480,3480,0
5607,"DireTube News - South African man gets 18 years for killing, eating heart of victim by News ET Social 6 years ago 51 seconds 15,886 views",News ET Social,15886,15886,0
5608,"DireTube News - ‎Ethiopia‬ considering heavier penalties for human smuggling by News ET Social 6 years ago 1 minute, 14 seconds 7,015 views",News ET Social,7015,7015,0
5609,"DireTube News - Defense ministry says Ethio-Eritrea border ‘impenetrable’ by News ET Social 6 years ago 2 minutes, 7 seconds 6,361 views",News ET Social,6361,6361,0
5610,"DireTube News - Thousands of migrants rescued at sea by News ET Social 6 years ago 1 minute 8,600 views",News ET Social,8600,8600,0
5611,"Sisay Z Legehare Amazing Poem for I.S Victims - DireTube by News ET Social 6 years ago 11 minutes, 13 seconds 24,842 views",News ET Social,24842,24844,2
5612,"DireTube News - Jazz music and Fashion show program host at the Lafto Mall, Addis Ababa by News ET Social 6 years ago 1 minute, 2 seconds 2,760 views",News ET Social,2760,2763,3
5613,"DireTube News - Here’s what the media missed with that ISIS video by News ET Social 6 years ago 1 minute, 28 seconds 127,898 views",News ET Social,127898,128026,128
5614,"Ad'el (አድኤል) - New Ethiopian Movie 2015 - DireTube Trailer by News ET Social 6 years ago 2 minutes, 52 seconds 61,973 views",News ET Social,61973,61982,9
5615,"DireTube News - Another Ethiopian ISIS victims identified by News ET Social 6 years ago 1 minute, 34 seconds 39,510 views",News ET Social,39510,39519,9
5616,"Ethiopian Poem - Poet Sisay Zelegehare - Duldum Billa (ዱልዱም ቢላ) by News ET Social 6 years ago 10 minutes, 39 seconds 5,247 views",News ET Social,5247,5249,2
5617,"Siso Man - Immo Laa Immo - ዋንሲሳ ዋና እሞላእሞ DireTube Music 2015 by News ET Social 6 years ago 5 minutes, 56 seconds 6,883 views",News ET Social,6883,6884,1
5618,"Adinas - Trailer #2 - DireTube Trailer by News ET Social 6 years ago 1 minute, 25 seconds 101,515 views",News ET Social,101515,101544,29
5619,"Neway Debebe - Yehim Yalfal [NEW! Music Video 2015] DireTube by News ET Social 6 years ago 5 minutes, 41 seconds 79,604 views",News ET Social,79604,79630,26
5620,"Zeritu Kebede - Seyfehin Ansa (Official Lyric Video) by News ET Social 6 years ago 6 minutes, 42 seconds 82,836 views",News ET Social,82836,82866,30
5621,"DireTube Video - 4th Tana High-Level Forum on Security in Africa, Bahir Dar, Ethiopia by News ET Social 6 years ago 11 minutes, 41 seconds 6,791 views",News ET Social,6791,6791,0
5622,"DireTube News - Ethiopian-Israeli protest against police brutality turns violent by News ET Social 6 years ago 23 seconds 7,659 views",News ET Social,7659,7660,1
5623,"DireTube News - Eritrean Leader Warns Foreign Powers Over S. Sudan Conflict by News ET Social 6 years ago 1 minute, 43 seconds 5,766 views",News ET Social,5766,5766,0
5624,"DireTube News - Indonesia executes eight prisoners for drugs offences by News ET Social 6 years ago 1 minute, 6 seconds 4,393 views",News ET Social,4393,4393,0
5625,"DireTube News - Ethiopian Bank to build tallest building in East Africa by News ET Social 6 years ago 59 seconds 13,711 views",News ET Social,13711,13711,0
5626,"DireTube News - Ethiopian women premier league player took her own life by News ET Social 6 years ago 1 minute, 13 seconds 45,762 views",News ET Social,45762,45762,0
5627,"DireTube News - Ethiopia: Woldiya–Kombolcha–Awash railway line to cost US$1.7bn by News ET Social 6 years ago 1 minute, 42 seconds 6,937 views",News ET Social,6937,6937,0
5628,"DireTube News - Experts from 100 countries storm Ethiopia for E-Learning Africa conference by News ET Social 6 years ago 1 minute, 39 seconds 1,678 views",News ET Social,1678,1678,0
5629,"Teddy Tadesse - Elohe - [New! Ethiopian Music 2015] by News ET Social 6 years ago 3 minutes, 27 seconds 85,861 views",News ET Social,85861,85864,3
5630,"Enkutatash Beshah Tenes Yagere Lije - DireTube Music 2015 by News ET Social 6 years ago 4 minutes, 48 seconds 11,463 views",News ET Social,11463,11463,0
5631,"Bankeru (ባንከሩ) Latest Ethiopian Movie from DireTube Cinema by News ET Social 6 years ago 1 hour, 44 minutes 136,163 views",News ET Social,136163,143241,7078
5632,"DireTube News - MoFA urged Ethiopians in Libya, SA and Yemen not to use invalid phone numbers by News ET Social 6 years ago 2 minutes, 20 seconds 4,031 views",News ET Social,4031,4031,0
5633,"DireTube News - Ethio-Djibouti Railway line reaching at Sebeta area by News ET Social 6 years ago 2 minutes, 40 seconds 3,935 views",News ET Social,3935,3935,0
5634,"DireTube - Over 90 % People Under Serious Mental Illness Don't Get the Necessary Treatment by News ET Social 6 years ago 1 minute, 37 seconds 2,156 views",News ET Social,2156,2157,1
5635,"DireTube News - 3 people imrisoned for kidnapping 5 year old boy by News ET Social 6 years ago 1 minute, 37 seconds 3,682 views",News ET Social,3682,3682,0
5636,"DireTube News - International Labour Day to be celebrated on May 1,2015 by News ET Social 6 years ago 50 seconds 1,667 views",News ET Social,1667,1667,0
5637,"DireTube News - Ethiopia to approve new declaration on immigration by News ET Social 6 years ago 1 minute, 29 seconds 11,583 views",News ET Social,11583,11583,0
5638,"DireTube News - Egypt, Cyprus and Greece agreed to combat terrorism by News ET Social 6 years ago 41 seconds 8,614 views",News ET Social,8614,8614,0
5639,"Gazetegnaw  (ጋዜጠኛው) Latest Ethiopian Movie from DireTube Cinema by News ET Social 6 years ago 1 hour, 27 minutes 43,269 views",News ET Social,43269,43323,54
5640,"Endegena (እንደገና) Latest Ethiopian Movie from DireTube Cinema by News ET Social 6 years ago 1 hour, 17 minutes 225,914 views",News ET Social,225914,226402,488
5641,"Abatu Manew (አባቱ ማነው) Latest Ethiopian Movie from DireTube Cinema by News ET Social 6 years ago 1 hour, 26 minutes 738,963 views",News ET Social,738963,740866,1903
5642,"Manegn (ማን ነኝ?) Latest Ethiopian Movie from DireTube Cinema by News ET Social 6 years ago 1 hour, 11 minutes 123,865 views",News ET Social,123865,124019,154
5643,"Enkutatash Beshah - Eshi Bel - NEW! Music Video 2015 - DireTube by News ET Social 6 years ago 4 minutes, 3 seconds 18,337 views",News ET Social,18337,18339,2
5644,"DireTube Sport - Former Ethiopian National FT Coach Mariano Bareto talking about EFF by News ET Social 6 years ago 24 minutes 3,449 views",News ET Social,3449,3449,0
5645,"Jacky Gosee: HAQ - ጃኪ ጎሴ ሀቅ [NEW! Music 2015] by News ET Social 6 years ago 5 minutes, 39 seconds 223,076 views",News ET Social,223076,224660,1584
5646,"Aleme (ዓለሜ) New Ethiopian Film 2015 - DireTube Trailer by News ET Social 6 years ago 1 minute, 48 seconds 38,057 views",News ET Social,38057,38060,3
5647,"DireTube News - Rule need to be improved to take strong action on illegal human smugglers by News ET Social 6 years ago 2 minutes, 33 seconds 15,717 views",News ET Social,15717,15717,0
5648,"DireTube News - AA City Administration officials express condolences to the families of IS victims by News ET Social 6 years ago 1 minute, 9 seconds 1,860 views",News ET Social,1860,1860,0
5649,"Tewelde Kasahun - Wishta Tsaeda (ውሽጣ ፃዕዳ) [New Ethiopian Music Video 2015] - DireTube by News ET Social 6 years ago 4 minutes, 16 seconds 4,628 views",News ET Social,4628,4628,0
5650,"DireTube News - Love and marriage in the midst of hateful xenophobia by News ET Social 6 years ago 1 minute, 41 seconds 50,683 views",News ET Social,50683,50683,0
5651,"DireTube News - Chinese firm caught making fake condoms for Kenya by News ET Social 6 years ago 1 minute, 34 seconds 3,567 views",News ET Social,3567,3567,0
5652,"DireTube - killing of Ethiopians illustrate the seriousness of the prevailing situation in Libya by News ET Social 6 years ago 48 seconds 1,351 views",News ET Social,1351,1351,0
5653,"DireTube News - Turkey’s public lender Ziraat Bank to become the first foreign bank of Ethiopia by News ET Social 6 years ago 1 minute, 26 seconds 1,722 views",News ET Social,1722,1722,0
5654,"DireTube News - Egypt irrigation minister in Ethiopia for African Climate summit by News ET Social 6 years ago 1 minute, 19 seconds 2,321 views",News ET Social,2321,2321,0
5655,"DireTube News - ISIS chief Abu Bakr al-Baghdadi dead by News ET Social 6 years ago 1 minute, 3 seconds 41,999 views",News ET Social,41999,41999,0
5656,"Tewelde Kasahun - Korirna (ቆሪርና) [New Ethiopian Tigrigna Music 2015] - DireTube by News ET Social 6 years ago 5 minutes, 14 seconds 6,647 views",News ET Social,6647,6649,2
5657,"Mundane (ሙንደን) Latest Ethiopian Movie from DireTube Cinema by News ET Social 6 years ago 1 hour, 39 minutes 466,694 views",News ET Social,466694,467616,922
5658,"DireTube Comedy - Tatek Legese (Taju) - Abet Abet - New Ethiopian Comedy 2015 by News ET Social 6 years ago 5 minutes, 59 seconds 350,848 views",News ET Social,350848,350919,71
5659,"Zeritu Kebede - Seyfehin Anssa [NEW! Song 2015] DireTube by News ET Social 6 years ago 6 minutes, 31 seconds 204,692 views",News ET Social,204692,204732,40
5660,"Yeketerkut (የቀጠርኩት) Latest Ethiopian Movie from DireTube Cinema by News ET Social 6 years ago 1 hour, 43 minutes 546,663 views",News ET Social,546663,547241,578
5661,"DireTube News - Kenya Garissa Health Science college is closed because of low security by News ET Social 6 years ago 50 seconds 2,678 views",News ET Social,2678,2678,0
5662,"DireTube News - Hotel Standardization and customization forum in Addis Ababa by News ET Social 6 years ago 41 seconds 2,162 views",News ET Social,2162,2163,1
5663,"DireTube News - Ethiopia predicts record $1.5bn overseas direct investment in 2015 by News ET Social 6 years ago 1 minute, 22 seconds 2,610 views",News ET Social,2610,2610,0
5664,"DireTube News - Fire damaged Ethiopian Plastic Factory in Addis Ababa by News ET Social 6 years ago 1 minute, 7 seconds 23,986 views",News ET Social,23986,23991,5
5665,"DireTube News - Ethiopian Artists host special program at the National Theater by News ET Social 6 years ago 1 minute, 59 seconds 5,593 views",News ET Social,5593,5593,0
5666,"DireTube Sport - Ethiopia Appointed Yohannes Sahle as Waliya Head Coach by News ET Social 6 years ago 2 minutes, 1 second 2,377 views",News ET Social,2377,2378,1
5667,"DireTube News - ISIS announce their arrival in Yemen by News ET Social 6 years ago 1 minute, 26 seconds 42,310 views",News ET Social,42310,42312,2
5668,"DireTube News - Kuwait and UAE condemn ISIS beheading Ethiopians by News ET Social 6 years ago 1 minute, 16 seconds 63,650 views",News ET Social,63650,63651,1
5669,"DireTube News - Ethiopias Cities Condemn Libya Killings by News ET Social 6 years ago 2 minutes, 28 seconds 2,000 views",News ET Social,2000,2000,0
5670,"DireTube News - The Son of President Zuma Edward Zuma Supports Xenophobia in South Africa by News ET Social 6 years ago 4 minutes, 22 seconds 9,881 views",News ET Social,9881,9881,0
5671,"DireTube News - The mourning week for Ethiopians by News ET Social 6 years ago 2 minutes, 29 seconds 21,009 views",News ET Social,21009,21010,1
5672,"DireTube News - Ethiopian now nonstop to São Paulo by News ET Social 6 years ago 43 seconds 44,739 views",News ET Social,44739,44739,0
5673,"DireTube News - ZTE signed Athlete Haile G-Silassie as its brand ambassador of terminal products by News ET Social 6 years ago 1 minute, 4 seconds 2,452 views",News ET Social,2452,2453,1
5674,"DireTube Video - Ethiopian Patriots' message through DireTube by News ET Social 6 years ago 3 minutes, 55 seconds 4,623 views",News ET Social,4623,4623,0
5675,"DireTube News - Adam Gadahn Was Propagandist for Al Qaeda Who Sold Terror in English by News ET Social 6 years ago 2 minutes, 32 seconds 38,825 views",News ET Social,38825,38828,3
5676,"Kalkidan Hailesilassie - ምነው ወዳጄ Menew Wedadje - DireTube by News ET Social 6 years ago 4 minutes, 48 seconds 4,812 views",News ET Social,4812,4823,11
5677,"Kalkidan Hailesilassie - Mejemeriya [NEW! Music Video 2015] by News ET Social 6 years ago 4 minutes, 15 seconds 1,949 views",News ET Social,1949,1949,0
5678,"Befikadu Yadete - Wegene (ወገኔ) - NEW! Dedicated to Ethiopians Killed by IS by News ET Social 6 years ago 5 minutes, 46 seconds 9,470 views",News ET Social,9470,9470,0
5679,"DireTube Video - China's ZTE launches 4G terminal devices in Ethiopia by News ET Social 6 years ago 6 minutes, 31 seconds 1,834 views",News ET Social,1834,1834,0
5680,"DireTube News - Man arrested in France in plot to attack churches by News ET Social 6 years ago 39 seconds 5,785 views",News ET Social,5785,5785,0
5681,"DireTube News - Memorials for Ethiopian Christians by Religious institutions in Ethiopia by News ET Social 6 years ago 1 minute, 47 seconds 14,536 views",News ET Social,14536,14536,0
5682,"DireTube News - Human Trafickers Mered Medhanie and Ermias Ghermay made £72 Million in Two Years by News ET Social 6 years ago 2 minutes, 30 seconds 38,606 views",News ET Social,38606,38609,3
5683,"DireTube News - Xenophobia in South Africa is under control, says Ambassador Tewelde Mulugeta by News ET Social 6 years ago 2 minutes, 27 seconds 5,683 views",News ET Social,5683,5683,0
5684,"DireTube News - Tsemex Global Enterprise donates 200 thousand birr to the families of ISIS victims by News ET Social 6 years ago 2 minutes, 43 seconds 52,967 views",News ET Social,52967,52967,0
5685,"DireTube News - A 16-year-old Eritrean migrant who escaped captivity under ISIS in Libya by News ET Social 6 years ago 3 minutes, 20 seconds 265,746 views",News ET Social,265746,266019,273
5686,"DireTube News - Ethiopian embassy in UAE opens condolence book for ISIL killings in Libya by News ET Social 6 years ago 1 minute, 23 seconds 31,378 views",News ET Social,31378,31380,2
5687,"Abel Mulugeta - Amazing and Touching Song for I.S Victims by News ET Social 6 years ago 1 minute, 37 seconds 13,209 views",News ET Social,13209,13215,6
5688,"DireTube Sport - Ethiopian Football Federation will miss Goal keepers training opportunity by News ET Social 6 years ago 1 minute, 13 seconds 2,311 views",News ET Social,2311,2311,0
5689,"DireTube Video - Speech by Ethiopian Religious leaders at the ISIS protest by News ET Social 6 years ago 10 minutes, 31 seconds 27,933 views",News ET Social,27933,27939,6
5690,"DireTube News - Foreign Ambassadors Express their Condolences Over Death of Ethiopians by News ET Social 6 years ago 1 minute, 26 seconds 15,645 views",News ET Social,15645,15645,0
5691,"DireTube News - Al-Azhar top Sunni body condemns Ethiopian Christians killings by News ET Social 6 years ago 45 seconds 6,312 views",News ET Social,6312,6312,0
5692,"DireTube News - South Africa to deploy army over anti-immigrant attacks by News ET Social 6 years ago 56 seconds 5,630 views",News ET Social,5630,5630,0
5693,"DireTube News - Ethiopia: Site of the Ark of the Covenant? by News ET Social 6 years ago 45 seconds 6,698 views",News ET Social,6698,6698,0
5694,"DireTube News - 3 Eritrean asylum seekers who left Israel executed by ISIS by News ET Social 6 years ago 2 minutes, 4 seconds 137,395 views",News ET Social,137395,137404,9
5695,"DireTube News - Thousands of Ethiopians march in government rally over IS killings by News ET Social 6 years ago 1 minute, 19 seconds 9,242 views",News ET Social,9242,9242,0
5696,"DireTube Video - Artist Yosef Gebru (Jossy) supports families of the victims of ISIS in Libya by News ET Social 6 years ago 8 minutes, 27 seconds 303,260 views",News ET Social,303260,303267,7
5697,"Mahmoud Ahmed (ማህሙድ አህመድ) Message to Ethiopians on I.S Murder by News ET Social 6 years ago 48 seconds 41,694 views",News ET Social,41694,41696,2
5698,"DireTube Sport - Ethiopia targets 12 Medals at Rio Olympic 2016 by News ET Social 6 years ago 57 seconds 2,354 views",News ET Social,2354,2354,0
5699,"Mass Rally at Mesqel Square - April 22, 2015 by News ET Social 6 years ago 2 minutes, 23 seconds 97,729 views",News ET Social,97729,97729,0
5700,"King Teddy - Natey Kesanetey [NEW! Music Video 2015] by News ET Social 6 years ago 4 minutes, 49 seconds 19,803 views",News ET Social,19803,19805,2
5701,"Abune Lukas and Other from Church Meet Victims Family by News ET Social 6 years ago 9 minutes, 48 seconds 37,330 views",News ET Social,37330,37334,4
5702,"Amharic on Iphone - 2015 KeyMan Free - DireTube by News ET Social 6 years ago 6 minutes, 36 seconds 20,042 views",News ET Social,20042,20042,0
5703,"DireTube News - UN Security council condemns Libya Killings by News ET Social 6 years ago 1 minute, 9 seconds 17,124 views",News ET Social,17124,17124,0
5704,"DireTube Sport - Rotich wins in close finish while Desisa regains Boston Marathon title by News ET Social 6 years ago 1 minute, 5 seconds 550 views",News ET Social,550,550,0
5705,"DireTube News - White House Condemns Islamic State Massacre of Ethiopian Christians by News ET Social 6 years ago 46 seconds 37,266 views",News ET Social,37266,37267,1
5706,"DireTube News - Pesticide the likely cause of Nigeria 'mystery disease' by News ET Social 6 years ago 1 minute, 7 seconds 4,448 views",News ET Social,4448,4448,0
5707,"DireTube News - US Ambassador to Ethiopia condemn ISIS brutal killing by News ET Social 6 years ago 57 seconds 10,545 views",News ET Social,10545,10546,1
5708,"DireTube News - Pope Francis condemns Isis killings of Ethiopian Christians by News ET Social 6 years ago 1 minute, 9 seconds 16,295 views",News ET Social,16295,16296,1
5709,"DireTube News - Ethiopian Orthodox Tewahdo Church condemns claims of IS killings by News ET Social 6 years ago 1 minute, 5 seconds 15,635 views",News ET Social,15635,15635,0
5710,"DireTube News - PM Hailemariam Desalegn condemns massacre of Ethiopians by IS by News ET Social 6 years ago 2 minutes, 24 seconds 29,630 views",News ET Social,29630,29630,0
5711,"Meskel Square Protest After I.S Killed 30 Ethiopians - DireTube by News ET Social 6 years ago 2 minutes, 32 seconds 265,464 views",News ET Social,265464,265480,16
5712,"DireTube Video - Bob Marley's statue inaugurated in Addis Ababa, April 19, 2015 by News ET Social 6 years ago 7 minutes, 13 seconds 34,986 views",News ET Social,34986,34988,2
5713,"DireTube News - 4th Tana High-Level Forum in Bahir Dar completed by News ET Social 6 years ago 1 minute, 18 seconds 2,003 views",News ET Social,2003,2003,0
5714,"DireTube News - Over 250,000 East African refugees trapped in Yemen by News ET Social 6 years ago 1 minute, 24 seconds 29,448 views",News ET Social,29448,29448,0
5715,"DireTube News - Ethiopian Islamic Affairs Supreme Council condemned the killing of Ethiopians by IS by News ET Social 6 years ago 2 minutes, 38 seconds 37,771 views",News ET Social,37771,37772,1
5716,"DireTube News -  Ethiopia Declares three days of National mourning for Ethiopians killed by IS by News ET Social 6 years ago 52 seconds 18,247 views",News ET Social,18247,18249,2
5717,"DireTube News - Hundreds feared dead after boat capsizes by News ET Social 6 years ago 47 seconds 71,502 views",News ET Social,71502,71503,1
5718,"DireTube News - White House Condemns Islamic State Massacre of Ethiopian Christians by News ET Social 6 years ago 1 minute, 19 seconds 11,707 views",News ET Social,11707,11707,0
5719,"Addis Mulat - Tewbelew [New! Ethiopian Music 2014] by News ET Social 6 years ago 4 minutes, 48 seconds 401,530 views",News ET Social,401530,401575,45
5720,"DireTube News - Ethiopia condemns purported executions in Libya of Christians by News ET Social 6 years ago 1 minute, 40 seconds 27,822 views",News ET Social,27822,27822,0
5721,"DireTube News - Ethiopia verifying video claims of IS killings of Christians in Libya by News ET Social 6 years ago 41 seconds 123,978 views",News ET Social,123978,124069,91
5722,"DireTube Documentary - B and C Aluminum - The Aluminum Pioneer by News ET Social 6 years ago 15 minutes 20,325 views",News ET Social,20325,20344,19
5723,"DireTube News - Contraband cell phones not to be functional in the country by News ET Social 6 years ago 1 minute, 24 seconds 13,658 views",News ET Social,13658,13658,0
5724,"DireTube News - National Traffic information center to be built by News ET Social 6 years ago 2 minutes, 15 seconds 1,603 views",News ET Social,1603,1603,0
5725,"Ethiopian Movie 2015 - Chefu 2 - ሼፉ 2 - DireTube Trailer by News ET Social 6 years ago 1 minute, 6 seconds 85,872 views",News ET Social,85872,85887,15
5726,"DireTube News - UNESCO will announce Gibe 3 dam Assessment report by the end of his month by News ET Social 6 years ago 1 minute, 27 seconds 2,134 views",News ET Social,2134,2134,0
5727,"DireTube News - 781 Million People Can’t Read this Story by News ET Social 6 years ago 1 minute, 52 seconds 8,361 views",News ET Social,8361,8361,0
5728,"DireTube News - Kagame and First Lady in Ethiopia for state visit by News ET Social 6 years ago 1 minute, 29 seconds 2,435 views",News ET Social,2435,2435,0
5729,"DireTube News - Ethiopia's Ambassador to SA says stabilization mission for Ethiopians is continued by News ET Social 6 years ago 2 minutes, 31 seconds 16,815 views",News ET Social,16815,16815,0
5730,"DireTube Sport - The contract agreement between EFF and Mr Mariano Barreto is terminated by News ET Social 6 years ago 1 minute, 30 seconds 1,626 views",News ET Social,1626,1626,0
5731,"Ethiopia & IMF ኢትዮጵያና አይ.ኤም.ኤፍ በኢትዮጵያ ሀብት መጠን ላይ እየተወዛገቡ ነው by News ET Social 6 years ago 3 minutes, 34 seconds 13,718 views",News ET Social,13718,13718,0
5732,"KEFI Minerals Signs Gold, Silver Mine Agreement by News ET Social 6 years ago 1 minute, 14 seconds 3,760 views",News ET Social,3760,3760,0
5733,"Lebombo Border post closed, SA trucks attacked in Mozambique by News ET Social 6 years ago 47 seconds 6,626 views",News ET Social,6626,6626,0
5734,"DireTube News - Islamic State, security forces clash in Iraq's largest refinery by News ET Social 6 years ago 56 seconds 2,612 views",News ET Social,2612,2612,0
5735,"DireTube News -  Al-Qaeda takes control of major Yemeni airport, oil terminal by News ET Social 6 years ago 47 seconds 9,917 views",News ET Social,9917,9917,0
5736,"DireTube News - Ethiopian Government Ready To Evacuate Its Citizens - FM Tewodros Adhanom by News ET Social 6 years ago 1 minute, 29 seconds 5,507 views",News ET Social,5507,5507,0
5737,"DireTube News - Government denied the saying that there is high price of the 35,000 condos by News ET Social 6 years ago 1 minute, 43 seconds 5,563 views",News ET Social,5563,5563,0
5738,"DireTube News - Tana High Level Forum on the Theme ""Secularism and Politicized Faith in Africa"" by News ET Social 6 years ago 1 minute, 2 seconds 1,204 views",News ET Social,1204,1204,0
5739,"DireTube News - Ethiopia assessing situation for citizens in South Africa, MoFA says by News ET Social 6 years ago 4 minutes, 33 seconds 8,493 views",News ET Social,8493,8493,0
5740,"DireTube News - Ethiopia sets $1 billion target for textile export by News ET Social 6 years ago 38 seconds 1,938 views",News ET Social,1938,1938,0
5741,"DireTube News - Xenophobic attacks on foreign nationals in South Africa by News ET Social 6 years ago 46 seconds 5,356 views",News ET Social,5356,5357,1
5742,"DireTube News - Ethiopian leader visits LG Display factory by News ET Social 6 years ago 53 seconds 1,834 views",News ET Social,1834,1834,0
5743,"DireTube News - Ethiopia and USA agree to take action on Ginbot 7 by News ET Social 6 years ago 2 minutes, 46 seconds 3,733 views",News ET Social,3733,3733,0
5744,"DireTube News - Ethiopians stage hunger strike in protest at their imprisonment by News ET Social 6 years ago 37 seconds 1,065 views",News ET Social,1065,1066,1
5745,"DireTube News - Ethiopia, Rwanda calls for South Africa end to anti-foreigner violence by News ET Social 6 years ago 1 minute, 51 seconds 9,351 views",News ET Social,9351,9351,0
5746,"DireTube Comedy - Anchor Dokle - New Ethiopian Comedy 2015 by News ET Social 6 years ago 7 minutes, 11 seconds 266,934 views",News ET Social,266934,267910,976
5747,"DireTube Comedy - Comedian Dokle News Hosting  - New Ethiopian Comedy 2015 by News ET Social 6 years ago 1 minute, 54 seconds 12,450 views",News ET Social,12450,12462,12
5748,"Yene Mar (የኔ ማር) New Ethiopian Movie 2015 - DireTube Trailer by News ET Social 6 years ago 1 minute, 11 seconds 185,892 views",News ET Social,185892,185911,19
5749,"Yene Mar (የኔ ማር) New Ethiopian Film 2015 - DireTube Trailer by News ET Social 6 years ago 47 seconds 28,633 views",News ET Social,28633,28636,3
5750,"Tewelde Kasahun - Biruh Zemen (ብሩህ ዘመን) [New Ethiopian Tigrigna Music Video 2015] - DireTube by News ET Social 6 years ago 3 minutes, 55 seconds 3,999 views",News ET Social,3999,3999,0
5751,"Veronika (ቬሮኒካ) Latest Ethiopian Movie from DireTube Cinema by News ET Social 6 years ago 1 hour, 30 minutes 55,538 views",News ET Social,55538,55569,31
5752,"DireTube News -  Kenyan police chief's misuse of plane fuels anger over Garissa massacre by News ET Social 6 years ago 1 minute, 6 seconds 2,976 views",News ET Social,2976,2977,1
5753,"DireTube News - 400 feared dead after migrant boat capsizes by News ET Social 6 years ago 1 minute, 21 seconds 9,281 views",News ET Social,9281,9281,0
5754,"DireTube News - AALR Rules and Regulations to be proclaimed by the end of this month by News ET Social 6 years ago 2 minutes, 13 seconds 2,250 views",News ET Social,2250,2250,0
5755,"DireTube News - Recognition for the outstanding contributors of the construction of GERD by News ET Social 6 years ago 1 minute, 49 seconds 1,312 views",News ET Social,1312,1312,0
5756,"DireTube News - Ethiopia and Sudan to open their border crossings by News ET Social 6 years ago 36 seconds 2,465 views",News ET Social,2465,2466,1
5757,"DireTube News - Ethiopian Airlines makes emergency landing in Mumbai airport by News ET Social 6 years ago 55 seconds 78,471 views",News ET Social,78471,78471,0
5758,"DireTube News - Attack in Downtown Johannesburg on Ethiopians and other Immigrants by News ET Social 6 years ago 2 minutes, 24 seconds 39,759 views",News ET Social,39759,39759,0
5759,"Kahne (ካህኔ) New Ethiopian Film 2015 - DireTube Trailer by News ET Social 6 years ago 1 minute, 21 seconds 11,868 views",News ET Social,11868,11870,2
5760,"DireTube Video - 3rd Ethiopian Music Day to be Celebrated on April 18, 2015 by News ET Social 6 years ago 17 minutes 7,123 views",News ET Social,7123,7123,0
5761,"DireTube Exclusive - Yegna radio program production company Executive Director Solome Tadesse by News ET Social 6 years ago 5 minutes, 39 seconds 4,262 views",News ET Social,4262,4262,0
5762,"DireTube News -  Wife, Husband dead  in Nekemte, Ethiopia house fire by News ET Social 6 years ago 1 minute, 44 seconds 6,047 views",News ET Social,6047,6048,1
5763,"DireTube News - AU appoints first woman Secretary General by News ET Social 6 years ago 49 seconds 1,272 views",News ET Social,1272,1272,0
5764,DireTube News - Russia holding a photo exhibition in Addis to mark victory over Nazis during WW II by News ET Social 6 years ago 37 seconds 834 views,News ET Social,834,834,0
5765,"DireTube News - Al-Shabaab militants kill 10 in attack on Somali education ministry by News ET Social 6 years ago 31 seconds 1,205 views",News ET Social,1205,1205,0
5766,"DireTube News - Healthy baby boy born using sperm extracted from dead man by News ET Social 6 years ago 52 seconds 4,857 views",News ET Social,4857,4857,0
5767,"DireTube News - Ethiopians detained by human traffickers in Sudan freed by News ET Social 6 years ago 1 minute, 4 seconds 3,156 views",News ET Social,3156,3156,0
5768,"College & Beauty (ኮሌጅ እና ውበት) Latest Ethiopian Movie from DireTube Cinema by News ET Social 6 years ago 1 hour, 52 minutes 762,803 views",News ET Social,762803,766752,3949
5769,"Zeleke Gessesse - Don't Let Me Down Ft. Siyamregn & Betty G by News ET Social 6 years ago 4 minutes, 51 seconds 171,523 views",News ET Social,171523,173497,1974
5770,"The Funnies Ethiopian Masinko Player - 2Pac of Ethiopia by News ET Social 6 years ago 12 minutes, 27 seconds 372,644 views",News ET Social,372644,372716,72
5771,"Rivan (ሪቫን) Latest Ethiopian Movie from DireTube Cinema by News ET Social 6 years ago 1 hour, 17 minutes 45,072 views",News ET Social,45072,45081,9
5772,"DireTube Documentary - The agreement between Ethiopia, Egypt and Sudan on Nile river by News ET Social 6 years ago 16 minutes 12,991 views",News ET Social,12991,12995,4
5773,"DireTube Law - Adultery (አመንዝራነት) Shiwenzu Melaku Presents by News ET Social 6 years ago 6 minutes, 58 seconds 2,838 views",News ET Social,2838,2838,0
5774,"Betty G - Na Na Demaye [NEW! Music Video 2015] by News ET Social 6 years ago 5 minutes, 30 seconds 214,460 views",News ET Social,214460,215013,553
5775,"Ephrem & Roha - The Reunion - ኤፍሬምና ሮሀ እንደገና - 2015 by News ET Social 6 years ago 7 minutes, 29 seconds 1,948,454 views",News ET Social,1948454,1949519,1065
5776,"Joni Zarkey Msaki (ጀን ግርማ - ምሳኺ) [NEW Music Video 2015] by News ET Social 6 years ago 5 minutes, 38 seconds 15,518 views",News ET Social,15518,15518,0
5777,"DireTube Exclusive -  Ethiopian King of Laughter Master Belachew Girma with DireTube by News ET Social 6 years ago 21 minutes 12,700 views",News ET Social,12700,12704,4
5778,"Jah Lude - Jew Jew - NEW Single 2015 - DireTube Music by News ET Social 6 years ago 3 minutes, 41 seconds 39,432 views",News ET Social,39432,39445,13
5779,"Gudegna Nech (ጉደኛ ነች) Latest Ethiopian Movie from DireTube Cinema by News ET Social 6 years ago 1 hour, 38 minutes 1,656,810 views",News ET Social,1656810,1658303,1493
5780,"Fitsamew (ፍፃሜው) Latest Ethiopian Movie from DireTube Cinema by News ET Social 6 years ago 1 hour, 41 minutes 887,525 views",News ET Social,887525,888542,1017
5781,"Gudegna Nech - ጉደኛ ነች NEW! Ethiopian Film - DireTube Trailer by News ET Social 6 years ago 1 minute, 11 seconds 108,923 views",News ET Social,108923,108963,40
5782,"Helen Tesfaye - Des Yibeleni (ደስ ይበለኒ) [NEW! Ethiopian Tigrigna Music Video 2015] - DireTube by News ET Social 6 years ago 6 minutes, 16 seconds 268,594 views",News ET Social,268594,268734,140
5783,"DireTube News - DireTube Exclusive: Eng. Yilikal Getnet claims govt banned him from travelling to US by News ET Social 6 years ago 1 minute, 21 seconds 3,683 views",News ET Social,3683,3683,0
5784,"DireTube News - Meeting Cancelled  to establish Sudan National Dialogue by News ET Social 6 years ago 1 minute, 9 seconds 971 views",News ET Social,971,971,0
5785,"DireTube News - Kenya warplanes bombed two al Shabaab camps by News ET Social 6 years ago 2 minutes, 20 seconds 2,707 views",News ET Social,2707,2707,0
5786,"DireTube News - Ethiopia to feature its coffee at America’s expo by News ET Social 6 years ago 59 seconds 2,330 views",News ET Social,2330,2330,0
5787,DireTube Sport - Top Argentine referee faces ban for using television replay to get decision right by News ET Social 6 years ago 47 seconds 699 views,News ET Social,699,699,0
5788,"DireTube News - 137 Egyptian companies invest US$2 billion in Ethiopia by News ET Social 6 years ago 1 minute, 8 seconds 1,087 views",News ET Social,1087,1087,0
5789,"DireTube News - Ethiopia vs Kenya  were drawn together in CHAN draw by News ET Social 6 years ago 1 minute, 2 seconds 3,168 views",News ET Social,3168,3168,0
5790,"DireTube News - Ethiopia launches $2.8m research survey for Nile basin development by News ET Social 6 years ago 53 seconds 2,610 views",News ET Social,2610,2610,0
5791,"DireTube News - Second Group of Ethiopian Evacuee from Yemen Return Home by News ET Social 6 years ago 57 seconds 5,618 views",News ET Social,5618,5618,0
5792,"DireTube News - Fire damaged Adama Medicine funding and supply agency by News ET Social 6 years ago 1 minute, 42 seconds 2,365 views",News ET Social,2365,2365,0
5793,DireTube News - World Red Cross calls for 24-hour ceasefire in Yemen by News ET Social 6 years ago 52 seconds 851 views,News ET Social,851,851,0
5794,"DireTube News - Morsi-era politics damaged Egypt-African relations: Sudanese president Bashir by News ET Social 6 years ago 52 seconds 1,943 views",News ET Social,1943,1943,0
5795,"DireTube News - UAE Ambassador to Ethiopia meets with African Union official by News ET Social 6 years ago 1 minute, 12 seconds 3,019 views",News ET Social,3019,3021,2
5796,"DireTube News - WFP Hands Over Five Warehouses To Ethiopian Cooperative Unions by News ET Social 6 years ago 1 minute, 5 seconds 1,218 views",News ET Social,1218,1218,0
5797,DireTube News - 4th Tana High-Level Forum on Security in Africa to be held in Bahir Dar by News ET Social 6 years ago 59 seconds 954 views,News ET Social,954,955,1
5798,"DireTube News - Bob Marley Statue to be Erected in Addis by News ET Social 6 years ago 1 minute, 14 seconds 1,710 views",News ET Social,1710,1710,0
5799,"DireTube Sport - Birhanu and Melkamu aim for another Ethiopian double in Daegu by News ET Social 6 years ago 1 minute, 19 seconds 2,860 views",News ET Social,2860,2860,0
5800,"Bob Marley Statue to be Erected - Press Release DireTube by News ET Social 6 years ago 19 minutes 5,495 views",News ET Social,5495,5495,0
5801,"Santeyay (ሳንተያይ) - Ethiopian Film 2015 - DireTube Trailer by News ET Social 6 years ago 2 minutes, 49 seconds 338,738 views",News ET Social,338738,338750,12
5802,"DireTube News - New U.S. Peace Corps Volunteers Sworn in at U.S. Embassy by News ET Social 6 years ago 1 minute, 40 seconds 3,007 views",News ET Social,3007,3007,0
5803,"DireTube News - Ethiopian Economy Comes Back with a Vengeance by News ET Social 6 years ago 1 minute, 46 seconds 57,653 views",News ET Social,57653,57654,1
5804,"DireTube News - Ethiopia Ranked on 46 by Military strength (2015) by News ET Social 6 years ago 3 minutes, 24 seconds 5,978 views",News ET Social,5978,5979,1
5805,"DireTube News - Ethiopian Football Federation Fires Coach Mariano Barreto by News ET Social 6 years ago 43 seconds 2,047 views",News ET Social,2047,2048,1
5806,"DireTube News - Addis Light Railway Project Approaches Final Stage by News ET Social 6 years ago 1 minute, 1 second 7,608 views",News ET Social,7608,7608,0
5807,"DireTube News - Ethiopia‬ withdrawing citizens from Yemen by News ET Social 6 years ago 46 seconds 5,269 views",News ET Social,5269,5269,0
5808,"DireTube News - Ethiopian‬ Embassy in Yemen attacked by News ET Social 6 years ago 51 seconds 5,378 views",News ET Social,5378,5378,0
5809,"DireTube Sport - Ethiopian Athletes 2-1 Higher Government Officials by News ET Social 6 years ago 7 minutes, 8 seconds 2,534 views",News ET Social,2534,2534,0
5810,"DireTube News - Ethiopia, Sudan and Djibouti against Al shabaab and Al Qaeda branches by News ET Social 6 years ago 2 minutes, 2 seconds 45,101 views",News ET Social,45101,45104,3
5811,"DireTube News - 4th year anniversary of GERD celebrated at sirbaba by News ET Social 6 years ago 2 minutes, 21 seconds 1,333 views",News ET Social,1333,1333,0
5812,DireTube News - Russian trawler sinks quickly in icy water by News ET Social 6 years ago 38 seconds 789 views,News ET Social,789,789,0
5813,"DireTube News - Ethiopians are returning from Yemen because of Yemen crisis by News ET Social 6 years ago 1 minute, 22 seconds 5,574 views",News ET Social,5574,5574,0
5814,DireTube News - At least 147 dead in Al-Shabab attack on university in Kenya by News ET Social 6 years ago 49 seconds 799 views,News ET Social,799,799,0
5815,"DireTube News -  World Bank grants money to Ethiopia for agricultural productivity by News ET Social 6 years ago 1 minute, 16 seconds 821 views",News ET Social,821,821,0
5816,"DireTube News - DireTube News - Foreign adoptions by Americans reach lowest mark since 1982 by News ET Social 6 years ago 1 minute, 17 seconds 1,209 views",News ET Social,1209,1209,0
5817,"DireTube News - Buhari secures historic election victory in Nigeria by News ET Social 6 years ago 2 minutes, 13 seconds 552 views",News ET Social,552,552,0
5818,"DireTube News - EWLA gives free legal services for more than six thousand women by News ET Social 6 years ago 2 minutes, 27 seconds 974 views",News ET Social,974,974,0
5819,"DireTube News - Over 1000 Ethiopians registered to leave Yemen by News ET Social 6 years ago 1 minute, 38 seconds 1,658 views",News ET Social,1658,1658,0
5820,"DireTube News - Ethiopian maid 'accuses WHO official in Thailand of slavery' by News ET Social 6 years ago 1 minute, 29 seconds 1,917 views",News ET Social,1917,1917,0
5821,"DireTube Comedy - Hotel - New Ethiopian Comedy 2015 - Samuel Legesse by News ET Social 6 years ago 1 minute, 11 seconds 9,091 views",News ET Social,9091,9091,0
5822,"DireTube News - Meles Foundation Recognizes Woredas Reducing Maternal, Child Health by News ET Social 6 years ago 1 minute, 28 seconds 1,159 views",News ET Social,1159,1159,0
5823,"DireTube News - Egypt eyes taking part in Ethiopia’s Key Road Plan, Airport Project by News ET Social 6 years ago 1 minute, 13 seconds 1,982 views",News ET Social,1982,1982,0
5824,DireTube News - Al-Sisi: Ethiopia has right to development with no harm to Egypt’s water interests by News ET Social 6 years ago 41 seconds 623 views,News ET Social,623,623,0
5825,"Aklilu Bereda - Toljutin (ቶልጁትን) [New Ethiopian Guragigna Music Video 2015] - DireTube by News ET Social 6 years ago 5 minutes, 49 seconds 7,779 views",News ET Social,7779,7780,1
5826,"DireTube Comedy - Very Funny New Ethiopian Comedy 2015 - Samuel Legesse by News ET Social 6 years ago 1 minute, 53 seconds 7,192 views",News ET Social,7192,7192,0
5827,"DireTube Poem - Egzern Eserut (እግዜርን እሠሩት) Poet Alex Abreham Recited by Shiwenzu Melaku by News ET Social 6 years ago 6 minutes, 14 seconds 23,053 views",News ET Social,23053,23088,35
5828,"DireTube Law - Heart touching Story of Bishaw Written by Kidane Mekasha, Shiwenzu Presents by News ET Social 6 years ago 14 minutes, 17 seconds 1,738 views",News ET Social,1738,1738,0
5829,"DireTube News - Yemen crisis: Saudi Arabia ready for long campaign against Houthi rebels by News ET Social 6 years ago 54 seconds 2,104 views",News ET Social,2104,2104,0
5830,"DireTube Comedy - Addis Ababa - New Ethiopian Comedy 2015 - Samuel Legesse by News ET Social 6 years ago 51 seconds 2,600 views",News ET Social,2600,2600,0
5831,"DireTube News - PM Hailemariam runs for the upcoming election by News ET Social 6 years ago 1 minute, 40 seconds 3,099 views",News ET Social,3099,3099,0
5832,"DireTube Comedy - Delala (ደላላ) New Ethiopian Short Comedy Drama 2015 by News ET Social 6 years ago 11 minutes, 22 seconds 71,788 views",News ET Social,71788,71812,24
5833,"DireTube Comedy - Funny Interview with Wishetu Defar - New Ethiopian Comedy 2015 by News ET Social 6 years ago 21 minutes 46,115 views",News ET Social,46115,46127,12
5834,"DireTube News -  Ethiopia to Introduce Secondary Government Bonds by News ET Social 6 years ago 1 minute, 28 seconds 448 views",News ET Social,448,448,0
5835,"DireTube News - Bob Geldof: Trade Not Aid for ‪‎Ethiopia‬ by News ET Social 6 years ago 2 minutes, 23 seconds 914 views",News ET Social,914,914,0
5836,"DireTube News - 4th Year Anniversary of GERD to be celebrated at Guba, Ethiopia by News ET Social 6 years ago 1 minute, 14 seconds 1,172 views",News ET Social,1172,1172,0
5837,"DireTube News - Ethiopian Airlines Launches Mobile Payment with Commercial Bank of Ethiopia by News ET Social 6 years ago 44 seconds 2,168 views",News ET Social,2168,2169,1
5838,"DireTube Sport - Yomif Kejelcha will kick off his 2015 Diamond League by News ET Social 6 years ago 50 seconds 7,764 views",News ET Social,7764,7764,0
5839,"DireTube Comedy - China - Very Funny New Ethiopian Comedy 2015 by News ET Social 6 years ago 1 minute, 3 seconds 24,825 views",News ET Social,24825,24826,1
5840,"DireTube Comedy - Very Funny New Ethiopian Comedy 2015 - Samuel Legesse by News ET Social 6 years ago 1 minute, 44 seconds 4,762 views",News ET Social,4762,4764,2
5841,"DireTube Sport - Woldia FC fined 5000 Birr by News ET Social 6 years ago 1 minute, 44 seconds 501 views",News ET Social,501,502,1
5842,"Dagim (ዳግም) Latest Ethiopian Movie from DireTube Cinema by News ET Social 6 years ago 1 hour, 33 minutes 554,538 views",News ET Social,554538,558618,4080
5843,"Dorm 308: Sim Card (ዶርም 308: ሲም ካርዱ) Latest Ethiopian Movie from DireTube Cinema by News ET Social 6 years ago 1 hour, 44 minutes 268,098 views",News ET Social,268098,268836,738
5844,"Nolawit (ኖላዊት) Latest Ethiopian Movie from DireTube Cinema by News ET Social 6 years ago 1 hour, 36 minutes 277,526 views",News ET Social,277526,277767,241
5845,DireTube Sport - Match between Ethiopian National Football Team and Ethiopan Coffee is Cancelled by News ET Social 6 years ago 41 seconds 715 views,News ET Social,715,715,0
5846,DireTube News - EU top officials to visit Tunisia by News ET Social 6 years ago 48 seconds 459 views,News ET Social,459,459,0
5847,"DireTube News - Ethiopia has Taken COMESA Chairmanship by News ET Social 6 years ago 1 minute, 9 seconds 843 views",News ET Social,843,843,0
5848,"Temnet (ተምኔት) Latest Ethiopian Movie from DireTube Cinema by News ET Social 6 years ago 1 hour, 25 minutes 164,581 views",News ET Social,164581,164660,79
5849,"DireTube News - Claims China shipping lethal weapons to Juba via Ethiopia by News ET Social 6 years ago 1 minute, 9 seconds 1,031 views",News ET Social,1031,1031,0
5850,"DireTube News - Gilgel Gibe III to Start Power Generation in Ethiopian Rainy Season by News ET Social 6 years ago 39 seconds 1,446 views",News ET Social,1446,1448,2
5851,"DireTube News - Andargachew Tsige: Ethiopian Brutality, British apathy by News ET Social 6 years ago 59 seconds 1,845 views",News ET Social,1845,1845,0
5852,DireTube News - Dubai Chamber organised Ethiopia Trade Mission discusses bilateral ties by News ET Social 6 years ago 57 seconds 796 views,News ET Social,796,796,0
5853,"DireTube News - Egypt, Ethiopia Nile deal holds potential for future disputes by News ET Social 6 years ago 1 minute, 4 seconds 803 views",News ET Social,803,803,0
5854,"DireTube Comedy - New Ethiopian Comedy by Comedian Dokle 2015 by News ET Social 6 years ago 37 seconds 23,649 views",News ET Social,23649,23659,10
5855,"DireTube Comedy - Very Funny New Ethiopian Comedy 2015 - Sira Felagi by News ET Social 6 years ago 1 minute, 41 seconds 3,734 views",News ET Social,3734,3734,0
5856,"DireTube Comedy - Kine Fez (ኪነ-ፌዝ) New Ethiopian Comedy by Comedian Dokle 2015 by News ET Social 6 years ago 21 minutes 67,847 views",News ET Social,67847,68132,285
5857,DireTube News - Cement price hikes due to transport shortage by News ET Social 6 years ago 50 seconds 870 views,News ET Social,870,870,0
5858,DireTube News - This infographic shows the scope of Internet censorship around the globe by News ET Social 6 years ago 42 seconds 833 views,News ET Social,833,833,0
5859,DireTube News - RSADO asked South Boulder to stop mining in Eritrea by News ET Social 6 years ago 54 seconds 881 views,News ET Social,881,882,1
5860,"DireTube Comedy -  New Ethiopian Comedy 2015 - Beal Akebaber by News ET Social 6 years ago 2 minutes, 11 seconds 13,467 views",News ET Social,13467,13468,1
5861,DireTube News - Kenya Defence Force is on higher alert over possible Terrorism Attack by News ET Social 6 years ago 40 seconds 565 views,News ET Social,565,565,0
5862,"DireTube News - AAU says it is working to be a leading center of excellence in Africa by News ET Social 6 years ago 1 minute, 28 seconds 448 views",News ET Social,448,448,0
5863,"DireTube News - With big projects, Ethiopia shedding famine stereotype by News ET Social 6 years ago 49 seconds 1,650 views",News ET Social,1650,1650,0
5864,"DireTube News - Hailemariam to run against average ‘Abebes’ by News ET Social 6 years ago 35 seconds 1,703 views",News ET Social,1703,1703,0
5865,"DireTube News - Ethiopia-Djibouti Railway Transport Test Running to Start Next October by News ET Social 6 years ago 1 minute, 41 seconds 5,823 views",News ET Social,5823,5824,1
5866,"DireTube Sport -  Genzebe Dibaba Just Misses World Record at Carlsbad 5000 by News ET Social 6 years ago 1 minute, 16 seconds 3,833 views",News ET Social,3833,3833,0
5867,"DireTube News - Tanzania parliament ratifies Nile Basin treaty‏ by News ET Social 6 years ago 1 minute, 10 seconds 769 views",News ET Social,769,769,0
5868,"Dynamite (ዳይናማይት) Latest Ethiopian Movie from DireTube Cinema by News ET Social 6 years ago 1 hour, 26 minutes 615,826 views",News ET Social,615826,625921,10095
5869,"Aschenaki Bekele - Na Na (ናና) [Official! Ethiopian Music Video 2014] - DireTube by News ET Social 6 years ago 4 minutes, 52 seconds 2,647 views",News ET Social,2647,2654,7
5870,"Yeras Ashker (የራስ አሽከር) Latest Ethiopian Movie from DireTube Cinema by News ET Social 6 years ago 1 hour, 36 minutes 210,753 views",News ET Social,210753,211566,813
5871,"Mignot (ምኞት) Latest Ethiopian Movie from DireTube Cinema by News ET Social 6 years ago 1 hour, 37 minutes 100,926 views",News ET Social,100926,100957,31
5872,"Fikr Beyilugnta (ፍቅር በይሉኝታ) Latest Ethiopian Movie from DireTube Cinema by News ET Social 6 years ago 1 hour, 34 minutes 658,838 views",News ET Social,658838,661121,2283
5873,"Lamba - ላምባ Anteneh Haile film - DireTube Trailer by News ET Social 6 years ago 1 minute, 25 seconds 26,228 views",News ET Social,26228,26229,1
5874,"Dawit Firew - Enen Marekeshegn - Vol 2 Instrumental Album by News ET Social 6 years ago 4 minutes, 47 seconds 25,146 views",News ET Social,25146,25181,35
5875,"DireTube - EFDR Deputy PM Demeke Mekonen call for public support for Grand Renascence dam by News ET Social 6 years ago 3 minutes, 9 seconds 2,643 views",News ET Social,2643,2645,2
5876,"DireTube - Boko Haram HQ Gwoza in Nigeria 'retaken' by News ET Social 6 years ago 58 seconds 2,109 views",News ET Social,2109,2109,0
5877,"DireTube - Prime Minister Hailemariam Desalegn Press Conference on Current Issues by News ET Social 6 years ago 1 minute, 43 seconds 5,180 views",News ET Social,5180,5180,0
5878,"DireTube - Ethiopia competition to remain ""intense"" by News ET Social 6 years ago 1 minute, 27 seconds 508 views",News ET Social,508,508,0
5879,"DireTube - Sudanese army says ground troops to join Saudi-led coalition in Yemen by News ET Social 6 years ago 2 minutes, 32 seconds 2,145 views",News ET Social,2145,2145,0
5880,"Bre Bright - Funga (ፉንጋ) [Official Ethiopian Music Video 2014] - DireTube by News ET Social 6 years ago 4 minutes, 8 seconds 151,434 views",News ET Social,151434,151676,242
5881,"Biniam Addis - Hagere Kibre Nesh [ Ethiopian Music Video 2014] - DireTube by News ET Social 6 years ago 5 minutes, 14 seconds 2,189 views",News ET Social,2189,2190,1
5882,"Fikadu Shifera - Dhugaan Lafatti Hafee - [Ethiopia, Afaan Oromoo Music Video 2014] DireTube by News ET Social 6 years ago 6 minutes, 3 seconds 1,583 views",News ET Social,1583,1583,0
5883,"DireTube News - Russia, China Discuss Resuming Talks on North Korea's Nuclear Program by News ET Social 6 years ago 1 minute 1,576 views",News ET Social,1576,1576,0
5884,"DireTube News - Friends decry insanity claim by defendant in Seattle woman’s brutal slaying by News ET Social 6 years ago 1 minute, 3 seconds 4,050 views",News ET Social,4050,4050,0
5885,"DireTube News - Egypt’s Sisi offers olive branch to Ethiopia, demands for Nile water rights by News ET Social 6 years ago 1 minute, 49 seconds 2,771 views",News ET Social,2771,2771,0
5886,"Selamawit Alemayehu - Tew Demam (ተው ደማም) [NEW! Ethiopian Music Video 2015] DireTube by News ET Social 6 years ago 5 minutes, 33 seconds 130,155 views",News ET Social,130155,130177,22
5887,"DireTube News - Former African leaders to hold their forum in Addis Ababa by News ET Social 6 years ago 1 minute, 5 seconds 835 views",News ET Social,835,835,0
5888,"DireTube News - Ethiopian Air in Talks to Set Up African National Carriers by News ET Social 6 years ago 1 minute, 27 seconds 37,427 views",News ET Social,37427,37427,0
5889,"DireTube News - Omani team to explore trade opportunities in Ethiopia by News ET Social 6 years ago 55 seconds 3,164 views",News ET Social,3164,3164,0
5890,"DireTube News - Germanwings plane crash: Co-pilot 'wanted to destroy plane' by News ET Social 6 years ago 1 minute, 29 seconds 2,756 views",News ET Social,2756,2756,0
5891,"DireTube Video - The Miserable Life of Wild Animals in Ethiopia by News ET Social 6 years ago 6 minutes, 18 seconds 14,012 views",News ET Social,14012,14018,6
5892,"DireTube News - Why AGOA Should Be Extended for 15 years: An Ethiopian Case Study by News ET Social 6 years ago 2 minutes, 6 seconds 1,314 views",News ET Social,1314,1314,0
5893,"DireTube News - Power and influence in Africa: Algeria, Egypt, Ethiopia, Nigeria and South Africa by News ET Social 6 years ago 2 minutes, 44 seconds 15,859 views",News ET Social,15859,15863,4
5894,"DireTube News - Egyptian President El-Sisi delivered his speech to Ethiopian parliament by News ET Social 6 years ago 2 minutes, 8 seconds 2,563 views",News ET Social,2563,2564,1
5895,"DireTube News - Russia to build Jordan's first nuclear power plant by News ET Social 6 years ago 58 seconds 2,150 views",News ET Social,2150,2152,2
5896,"DireTube News - Ethiopian Airlines to use Dreamliner on Dublin route by News ET Social 6 years ago 58 seconds 6,981 views",News ET Social,6981,6981,0
5897,"DireTube Sport - Genzebe Dibaba Has One Goal for the Carlsbad 5000: A World Record by News ET Social 6 years ago 1 minute, 21 seconds 5,711 views",News ET Social,5711,5713,2
5898,"DireTube News - OPDO's 25th Anniversary Celebrated at the Ethiopian Stadium by News ET Social 6 years ago 54 seconds 1,814 views",News ET Social,1814,1814,0
5899,"Egyptian journalists from conflict blower in to peace gossipers - DireTube by News ET Social 6 years ago 3 minutes, 54 seconds 1,595 views",News ET Social,1595,1595,0
5900,"Ayalew Nigussie - Dinget Metashibign - [Ethiopian Music Video 2015] - DireTube by News ET Social 6 years ago 6 minutes, 18 seconds 2,586,355 views",News ET Social,2586355,2591463,5108
5901,"Yeneneh Damtew - BeHilme Aychesh [Official Ethiopian Music Video 2014] - DireTube by News ET Social 6 years ago 4 minutes, 55 seconds 1,940 views",News ET Social,1940,1940,0
5902,"DireTube News - Ethiopia prevents foreign currency from Gas price decline by News ET Social 6 years ago 2 minutes, 38 seconds 5,400 views",News ET Social,5400,5400,0
5903,"DireTube News - Israel denies spying on US-Iran nuclear talks by News ET Social 6 years ago 59 seconds 1,724 views",News ET Social,1724,1724,0
5904,"DireTube News - France plane crash: 148 believed on board by News ET Social 6 years ago 40 seconds 1,533 views",News ET Social,1533,1533,0
5905,"DireTube News - Egypt and Ethiopia business delegates discussion by News ET Social 6 years ago 1 minute, 31 seconds 1,123 views",News ET Social,1123,1123,0
5906,"DireTube News - Gold in faeces 'worth millions' by News ET Social 6 years ago 1 minute, 21 seconds 653 views",News ET Social,653,653,0
5907,"DireTube News - Ethiopia's leap toward solar energy by News ET Social 6 years ago 54 seconds 2,946 views",News ET Social,2946,2946,0
5908,"DireTube News - Ethiopian and Egyptian leaders agree to meet annually by News ET Social 6 years ago 1 minute, 25 seconds 2,001 views",News ET Social,2001,2001,0
5909,"Duka (ዱካ) Latest Ethiopian Movie from DireTube Cinema by News ET Social 6 years ago 1 hour, 45 minutes 175,131 views",News ET Social,175131,175298,167
5910,"Fikr Ke America (ፍቅር ከአሜሪካ) Latest Ethiopian Movie from DireTube Cinema by News ET Social 6 years ago 1 hour, 40 minutes 400,015 views",News ET Social,400015,400600,585
5911,"Guantanamo (ጓንታናሞ) Latest Ethiopian Movie from DireTube Cinema by News ET Social 6 years ago 1 hour, 29 minutes 202,353 views",News ET Social,202353,202963,610
5912,"Mesam (መሳም) Latest Ethiopian Movie from DireTube Cinema by News ET Social 6 years ago 1 hour, 26 minutes 379,407 views",News ET Social,379407,380103,696
5913,"Endashaw Negash - Zoma Zoma (ዞማ ዞማ) [Official! Ethiopian  Music Video 2015] - DireTube by News ET Social 6 years ago 5 minutes, 10 seconds 6,411 views",News ET Social,6411,6420,9
5914,"DireTube Sport - Fight Between National League of Cities Football Players by News ET Social 6 years ago 1 minute, 16 seconds 12,618 views",News ET Social,12618,12618,0
5915,"DireTube News - Ethio Telecom’s services deteriorate amid the launch of a 4G network by News ET Social 6 years ago 1 minute, 19 seconds 2,530 views",News ET Social,2530,2531,1
5916,"DireTube News - Egypt, Ethiopia sign on Nile dam agreement by News ET Social 6 years ago 2 minutes, 47 seconds 4,196 views",News ET Social,4196,4196,0
5917,"DireTube News - Ethiopia expands surveillance capacity with German Tech via Lebanon by News ET Social 6 years ago 1 minute, 3 seconds 1,341 views",News ET Social,1341,1341,0
5918,"DireTube News - Egypt, Ethiopia and Sudan sign declaration of principles to resolve Nile dam dispute by News ET Social 6 years ago 1 minute, 24 seconds 3,038 views",News ET Social,3038,3039,1
5919,"Alem G-Ananiya - Afkire (አፍቂረ) [NEW! Ethiopian Tigrigna Music Video 2015] - DireTube by News ET Social 6 years ago 5 minutes, 56 seconds 123,908 views",News ET Social,123908,123924,16
5920,"Alemayehu Tegenu, Minister of Water Irrigation and Energy Speaks on the Agreement by News ET Social 6 years ago 3 minutes, 44 seconds 50,219 views",News ET Social,50219,50220,1
5921,"DireTube News - AMISOM Army capture key port town of Kuday from Al-Shabaab by News ET Social 6 years ago 53 seconds 2,055 views",News ET Social,2055,2055,0
5922,"DireTube News - Injustices eroding the basis for democracy in Africa, Olesegun Obasanjo by News ET Social 6 years ago 1 minute, 2 seconds 591 views",News ET Social,591,591,0
5923,"DireTube News - Tunisia attack: Bardo museum reopening delayed to Sunday by News ET Social 6 years ago 50 seconds 1,053 views",News ET Social,1053,1053,0
5924,"Zelalem Yonas - Emetalehu (እመጣለሁ)  [Ethiopian Official Music Video 2015] - DireTube Music by News ET Social 6 years ago 3 minutes, 32 seconds 11,228 views",News ET Social,11228,11233,5
5925,"DireTube News - ‘Igad Plus’: Juba in fresh demands by News ET Social 6 years ago 1 minute, 32 seconds 1,088 views",News ET Social,1088,1088,0
5926,"DireTube News - 25th Anniversary of OPDO by News ET Social 6 years ago 1 minute, 36 seconds 2,909 views",News ET Social,2909,2911,2
5927,"DireTube Sport - Ethiopians Triumph in Rome Marathon by News ET Social 6 years ago 1 minute 2,010 views",News ET Social,2010,2010,0
5928,"DireTube News - Over 35,Thousand Condos transferred to winners by News ET Social 6 years ago 2 minutes, 1 second 8,183 views",News ET Social,8183,8183,0
5929,"YeTikur Fert (የጥቁር ፈርጥ) 2015 Ethiopian Film - DireTube Trailer by News ET Social 6 years ago 2 minutes, 5 seconds 129,548 views",News ET Social,129548,129562,14
5930,"DireTube Sport - Coach Neyder Dos Santos retire as St.George FC Manager by News ET Social 6 years ago 1 minute, 14 seconds 928 views",News ET Social,928,929,1
5931,"DireTube News - Ethiopian Maid Accuses Building Guard Of Molestation by News ET Social 6 years ago 37 seconds 45,075 views",News ET Social,45075,45076,1
5932,"DireTube News - Ethiopian Airlines Extends Boeing 787 Vienna / Stockholm Operation by News ET Social 6 years ago 48 seconds 2,690 views",News ET Social,2690,2690,0
5933,"DireTube News - Amazon Gets FAA Approval to Begin Testing Delivery Drones by News ET Social 6 years ago 53 seconds 1,416 views",News ET Social,1416,1416,0
5934,"DireTube News - Fire destroyed 2.5 mln Br worth of property in Dilla by News ET Social 6 years ago 53 seconds 1,285 views",News ET Social,1285,1285,0
5935,"DireTube Video - Successful surgery enabled Tejenesh to sit by News ET Social 6 years ago 17 minutes 14,742 views",News ET Social,14742,14742,0
5936,"DireTube News - 'Ebola-proof' tablet device developed by News ET Social 6 years ago 39 seconds 1,129 views",News ET Social,1129,1129,0
5937,"DireTube News - Religion and money: is Islamic banking the way forward for Ethiopians? by News ET Social 6 years ago 1 minute, 26 seconds 1,537 views",News ET Social,1537,1537,0
5938,"DireTube News - S.Sudan rebels accuse government of backing Ethiopian rebels by News ET Social 6 years ago 1 minute, 15 seconds 1,517 views",News ET Social,1517,1517,0
5939,"DireTube News - Political parties debate on Federalism by News ET Social 6 years ago 2 minutes, 38 seconds 1,260 views",News ET Social,1260,1260,0
5940,"DireTube Sport - EFF Vice-President Tekleweyni Assefa with DireTube by News ET Social 6 years ago 7 minutes, 54 seconds 3,375 views",News ET Social,3375,3376,1
5941,"DireTube News - Only 81 thousands are eligible for the Sunday housing transfer by News ET Social 6 years ago 1 minute, 2 seconds 11,545 views",News ET Social,11545,11545,0
5942,"DireTube News - Ethiopian Court Jails Pilot for 19 Years for Hijacking Plane by News ET Social 6 years ago 25 seconds 2,364 views",News ET Social,2364,2364,0
5943,DireTube Sport - Ethiopian primer league result sedama buna take the lead by News ET Social 6 years ago 39 seconds 723 views,News ET Social,723,723,0
5944,"Ethiopia burns ivory stockpile for the First Time in History - DireTube News by News ET Social 6 years ago 6 minutes, 27 seconds 27,305 views",News ET Social,27305,27308,3
5945,"DireTube News - Egyptian president to visit Ethiopia by News ET Social 6 years ago 1 minute, 56 seconds 2,887 views",News ET Social,2887,2887,0
5946,"DireTube Sport - Coach Baretto said four national team players to train at Sporting Lisbon by News ET Social 6 years ago 50 seconds 1,761 views",News ET Social,1761,1761,0
5947,"DireTube News - US drone kills al-Shabab leader in Somalia - Pentagon by News ET Social 6 years ago 50 seconds 31,410 views",News ET Social,31410,31413,3
5948,"DireTube News - 59 Ethiopians added to growing number of imprisoned immigrants by News ET Social 6 years ago 49 seconds 12,986 views",News ET Social,12986,12986,0
5949,"DireTube Sport - Louis van Gaal: Manchester United manager says this is his last job by News ET Social 6 years ago 1 minute, 3 seconds 906 views",News ET Social,906,906,0
5950,"DireTube Exclusive - Interview with Neurosurgeon Dr. Birhanu H-Micheal by News ET Social 6 years ago 25 minutes 5,104 views",News ET Social,5104,5113,9
5951,"DireTube News - Ethio Telecom’s 4G network to launch on Saturday by News ET Social 6 years ago 44 seconds 2,861 views",News ET Social,2861,2862,1
5952,"DireTube News - Egypt's Sisi orders review of Nile dam deal with Ethiopia by News ET Social 6 years ago 1 minute 2,140 views",News ET Social,2140,2140,0
5953,"DireTube News - Ethiopia’s Largest Hydro Plant to Produce Electricity This Year by News ET Social 6 years ago 1 minute, 20 seconds 7,341 views",News ET Social,7341,7341,0
5954,"DireTube Law - Expressing Opinions, Shiwenzu Melaku presents by News ET Social 6 years ago 8 minutes, 12 seconds 1,102 views",News ET Social,1102,1102,0
5955,"DireTube Sport - Heineken Beer Sponsors the Ethiopian National  Football Team by News ET Social 6 years ago 1 minute, 36 seconds 1,347 views",News ET Social,1347,1348,1
5956,"Album (አልበም) Latest Ethiopian Movie from DireTube Cinema by News ET Social 6 years ago 1 hour, 39 minutes 359,024 views",News ET Social,359024,359353,329
5957,"Amnon (አምኖን) Latest Ethiopian Movie from DireTube Cinema by News ET Social 6 years ago 1 hour, 34 minutes 207,929 views",News ET Social,207929,208008,79
5958,"Makbel 2 (ማክቤል ፪) Latest Ethiopian Movie from DireTube Cinema by News ET Social 6 years ago 1 hour, 31 minutes 857,641 views",News ET Social,857641,867112,9471
5959,"Piramid (ፒራሚድ) Latest Ethiopian Movie from DireTube Cinema by News ET Social 6 years ago 1 hour, 28 minutes 394,348 views",News ET Social,394348,394655,307
5960,"Yematbela Wef (የማትበላ ወፍ) Latest Ethiopian Movie from DireTube Cinema by News ET Social 6 years ago 1 hour, 27 minutes 391,333 views",News ET Social,391333,392368,1035
5961,"DireTube News - Ethiopian Airlines open for joint venture, CEO Tewolde said by News ET Social 6 years ago 1 minute, 12 seconds 2,206 views",News ET Social,2206,2206,0
5962,"DireTube Sport - Manuel Pellegrini's time up after Champions League exit - Savage by News ET Social 6 years ago 1 minute, 3 seconds 523 views",News ET Social,523,523,0
5963,"DireTube Sport - The US and Germany are in a battle for an 18-year-old soccer phenom by News ET Social 6 years ago 1 minute, 25 seconds 3,167 views",News ET Social,3167,3167,0
5964,"DireTube News - The U.S Embassy Implements New Visa Application Processes by News ET Social 6 years ago 1 minute, 7 seconds 7,756 views",News ET Social,7756,7794,38
5965,"DireTube News - Two children died of burn due harmful traditional practice by News ET Social 6 years ago 1 minute, 49 seconds 1,368 views",News ET Social,1368,1375,7
5966,"DireTube News - Oil marketer plans $5 bn refinery construction by News ET Social 6 years ago 56 seconds 17,869 views",News ET Social,17869,17872,3
5967,"DireTube News - Ethiopia Reviewing Energy Policy by News ET Social 6 years ago 47 seconds 1,745 views",News ET Social,1745,1745,0
5968,"DireTube Poem - Ene Degmo (እኔ ደግሞ), Poet Alex Abreham Recited by Shiwenzu Melaku by News ET Social 6 years ago 3 minutes, 12 seconds 17,961 views",News ET Social,17961,17980,19
5969,"DireTube News - US embassy sponsors Ethiopian woman art competition by News ET Social 6 years ago 2 minutes, 4 seconds 1,087 views",News ET Social,1087,1087,0
5970,"DireTube News - Ethiopia denies Temesghen Desalegn access to medical care in jail by News ET Social 6 years ago 2 minutes, 40 seconds 2,756 views",News ET Social,2756,2757,1
5971,"DireTube News - China becomes world's number three arms exporter: study by News ET Social 6 years ago 1 minute, 37 seconds 4,011 views",News ET Social,4011,4011,0
5972,"DireTube News - Tariff study for Addis light train submitted to government body by News ET Social 6 years ago 2 minutes, 31 seconds 3,615 views",News ET Social,3615,3615,0
5973,"DireTube News - Inside the secretive state of Eritrea by News ET Social 6 years ago 1 minute, 8 seconds 13,567 views",News ET Social,13567,13568,1
5974,"DireTube News - UNHCR begins relocation of 50,000 South Sudan refugees in Ethiopia by News ET Social 6 years ago 1 minute, 10 seconds 1,109 views",News ET Social,1109,1109,0
5975,"DireTube News - 63 runaway Ethiopians nabbed in Dodoma by News ET Social 6 years ago 1 minute, 6 seconds 4,696 views",News ET Social,4696,4698,2
5976,"Nati Turner and Nahom - Negen Lemayet - [NEW! Ethiopian Music Video 2015] - DireTube by News ET Social 6 years ago 3 minutes, 59 seconds 6,803 views",News ET Social,6803,6804,1
5977,"DireTube Poem - Ene Min Alkuna, Poet Sisay Tadesse Recited by Shiwenzu Melaku by News ET Social 6 years ago 2 minutes, 44 seconds 8,737 views",News ET Social,8737,8745,8
5978,"DireTube Law - Expressing Opinions, Shiwenzu Melaku presents by News ET Social 6 years ago 9 minutes, 37 seconds 976 views",News ET Social,976,976,0
5979,"DireTube News - Man sentenced to death for killing his mother and two family members by News ET Social 6 years ago 3 minutes, 9 seconds 1,726 views",News ET Social,1726,1727,1
5980,"DireTube Law - Warrant, written by Kidane Mekasha Shiwenzu Melaku presents by News ET Social 6 years ago 7 minutes, 44 seconds 1,395 views",News ET Social,1395,1395,0
5981,"DireTube News - Ethiopia sided with Russia and China by News ET Social 6 years ago 42 seconds 5,867 views",News ET Social,5867,5872,5
5982,"DireTube News - Egypt, Ethiopia and Sudan leaders to attend signing ceremony of Renaissance by News ET Social 6 years ago 47 seconds 1,396 views",News ET Social,1396,1396,0
5983,"DireTube News - Ethiopian Airlines to host the annual MRO Africa Conference and Exhibition by News ET Social 6 years ago 47 seconds 6,618 views",News ET Social,6618,6618,0
5984,"DireTube News - Walya Beer to ink sponsorship deal with the Walyas by News ET Social 6 years ago 1 minute, 6 seconds 823 views",News ET Social,823,823,0
5985,"DireTube News - IOM repatriates 71 irregular Ethiopian migrants by News ET Social 6 years ago 1 minute, 2 seconds 6,285 views",News ET Social,6285,6289,4
5986,"DireTube News - Hailemedhin Abera found guilty on one of the charges by News ET Social 6 years ago 2 minutes, 2 seconds 5,730 views",News ET Social,5730,5730,0
5987,"Hiyaw Fikir (ህያው ፍቅር) Latest Ethiopian Movie from DireTube Cinema by News ET Social 6 years ago 1 hour, 40 minutes 342,938 views",News ET Social,342938,343097,159
5988,"Addis Engida (አዲስ እንግዳ) Latest Ethiopian Movie from DireTube Cinema by News ET Social 6 years ago 1 hour, 46 minutes 503,052 views",News ET Social,503052,505096,2044
5989,"DireTube Sport - Ethiopian premier league results and standings by News ET Social 6 years ago 54 seconds 3,260 views",News ET Social,3260,3260,0
5990,"DireTube Sport - Leaders Chelsea held, Rooney delivers knockout blow by News ET Social 6 years ago 59 seconds 1,040 views",News ET Social,1040,1040,0
5991,"DireTube News - South Africans perform first 'successful' penis transplant by News ET Social 6 years ago 1 minute, 32 seconds 1,804 views",News ET Social,1804,1805,1
5992,"Ethiopia: Africa’s new hydropower and air hub - DireTube news by News ET Social 6 years ago 1 minute, 59 seconds 3,900 views",News ET Social,3900,3900,0
5993,"Downstream countries signed a declaration of principles on GERD - DireTube news by News ET Social 6 years ago 1 minute, 4 seconds 488 views",News ET Social,488,488,0
5994,"Traffic Accident in Kersa, Hararge Killed Seven people - DireTube news by News ET Social 6 years ago 1 minute, 31 seconds 2,099 views",News ET Social,2099,2099,0
5995,"DireTube News - Egypt unveils plans to build new capital east of Cairo by News ET Social 6 years ago 1 minute, 34 seconds 2,178 views",News ET Social,2178,2178,0
5996,"DireTube News - Fire that broke out at Fincha Sugar Factory under control by News ET Social 6 years ago 1 minute, 2 seconds 2,161 views",News ET Social,2161,2161,0
5997,"DireTube Law - Long Distance Marriage Shiwenzu Melaku presents, part 2 by News ET Social 6 years ago 7 minutes, 15 seconds 878 views",News ET Social,878,878,0
5998,"DireTube Poem - Best poem written by Alex Abrham Shiwenzu Melaku Presents - Ene Anchin Safekrish by News ET Social 6 years ago 6 minutes, 50 seconds 15,914 views",News ET Social,15914,15922,8
5999,"DireTube Law - Problems with Bureaucracy by Kidane Mekasha by News ET Social 6 years ago 11 minutes, 15 seconds 1,004 views",News ET Social,1004,1004,0
6000,"DireTube Law - Long Distance Marriage Written by Kidane Mekasha, part 1 by News ET Social 6 years ago 5 minutes, 52 seconds 876 views",News ET Social,876,876,0
6001,"DireTube Law - Mental Disorder & Crime by Shiwenzu Melaku by News ET Social 6 years ago 9 minutes, 17 seconds 1,690 views",News ET Social,1690,1690,0
6002,"Sostegna Wegen 3ተኛ ወገን - Latest Film on DireTube Cinema by News ET Social 6 years ago 1 hour, 49 minutes 351,584 views",News ET Social,351584,359835,8251
6003,"Parties begin debate on EBC - DireTube by News ET Social 6 years ago 3 minutes, 14 seconds 2,429 views",News ET Social,2429,2429,0
6004,"AU Boosts Task Force to 10,000 Soldiers - DireTube News by News ET Social 6 years ago 1 minute, 28 seconds 1,564 views",News ET Social,1564,1564,0
6005,"Hareyet ኀረየት 2015 Ethiopian Film - DireTube Trailer by News ET Social 6 years ago 1 minute, 53 seconds 50,416 views",News ET Social,50416,50418,2
6006,"Tejnesh tells how she was raped by three men - DireTube TV by News ET Social 6 years ago 18 minutes 145,590 views",News ET Social,145590,145590,0
6007,South Sudan Leaders Given More Time to Reach Peace Deal - DireTube news by News ET Social 6 years ago 54 seconds 763 views,News ET Social,763,763,0
6008,"Klinsmann wants Arsenal starlet Zelalem in U.S. first team - DireTube news by News ET Social 6 years ago 1 minute, 13 seconds 2,664 views",News ET Social,2664,2664,0
6009,"U.S business giant Dow eyeing Ethiopian market - DireTube news by News ET Social 6 years ago 42 seconds 1,138 views",News ET Social,1138,1138,0
6010,"Ethiopian Man sentenced to Death for killing Lawyer - DireTube News by News ET Social 6 years ago 1 minute, 30 seconds 4,728 views",News ET Social,4728,4728,0
6011,"Rise in number of tourists from Oman to Ethiopia - DireTube news by News ET Social 6 years ago 45 seconds 1,080 views",News ET Social,1080,1080,0
6012,"DireTube News - Ethiopia's sole opposition member won't run in May by News ET Social 6 years ago 1 minute, 35 seconds 3,504 views",News ET Social,3504,3504,0
6013,"DireTube News - Bloom and Flourish: Liya Kebede Looks Homeward with Lemlem by News ET Social 6 years ago 1 minute, 23 seconds 6,535 views",News ET Social,6535,6535,0
6014,"DireTube News - Leading domestic air transport network in Africa by News ET Social 6 years ago 1 minute, 36 seconds 3,416 views",News ET Social,3416,3416,0
6015,"DireTube Sport - Ethiopian premier league will back after 40 days by News ET Social 6 years ago 1 minute, 22 seconds 2,394 views",News ET Social,2394,2394,0
6016,"DireTube Sport - Ancelotti stays, no matter what by News ET Social 6 years ago 1 minute, 1 second 698 views",News ET Social,698,698,0
6017,"DireTube News - Addis Ababa Dembidolo bus crash, 12 dead by News ET Social 6 years ago 58 seconds 13,228 views",News ET Social,13228,13228,0
6018,"DireTube News - Council to Raise 5.5 Million Birr for Gerd From Musical Concert by News ET Social 6 years ago 59 seconds 2,107 views",News ET Social,2107,2107,0
6019,"DireTube News - Mekedonia Humaniterian Organization to host an Event by News ET Social 6 years ago 56 seconds 1,554 views",News ET Social,1554,1555,1
6020,"DireTube News - Egypt, Sudan and Ethiopia inch toward resolving Nile dam crisis by News ET Social 6 years ago 43 seconds 1,640 views",News ET Social,1640,1640,0
6021,"DireTube Video - TPLF 40th Anniversary at Millenium Hall by News ET Social 6 years ago 33 minutes 57,952 views",News ET Social,57952,57973,21
6022,"DireTube News - A developer in China built a complete 57-story skyscraper in just 19 days by News ET Social 6 years ago 1 minute, 41 seconds 9,747 views",News ET Social,9747,9750,3
6023,"DireTube News - The leak AU’s report and IGAD’s threat of sanctions by News ET Social 6 years ago 52 seconds 1,280 views",News ET Social,1280,1280,0
6024,"DireTube Sport - Ethiopian Football Federation's response on coach Barreto by News ET Social 6 years ago 1 minute, 17 seconds 2,675 views",News ET Social,2675,2675,0
6025,"DireTube News - Female candidate goes completely nude in posters by News ET Social 6 years ago 1 minute, 6 seconds 2,103 views",News ET Social,2103,2108,5
6026,"DireTube News - Convicted Terrorist Ethiopian born British citizen was arrested in Tanzania by News ET Social 6 years ago 2 minutes, 10 seconds 67,406 views",News ET Social,67406,67411,5
6027,"DireTube News - Dedebit traveled to Nigeria for African Confederation by News ET Social 6 years ago 1 minute, 2 seconds 1,192 views",News ET Social,1192,1192,0
6028,"DireTube News - New malaria drug could save 140,000 lives each year in the world by News ET Social 6 years ago 57 seconds 1,423 views",News ET Social,1423,1423,0
6029,"DireTube News - Naming consultancy office for Ethiopia dam to take more time by News ET Social 6 years ago 1 minute, 37 seconds 3,388 views",News ET Social,3388,3388,0
6030,"DireTube News - Young Ethiopian Conservationist Died Battling Bale Mountains Park Fire by News ET Social 6 years ago 1 minute, 28 seconds 10,657 views",News ET Social,10657,10658,1
6031,"DireTube News - China Arrest two suspects for spying sensitive military information by News ET Social 6 years ago 48 seconds 2,461 views",News ET Social,2461,2461,0
6032,"DireTube News - Ethiopian tribe starves as dam and land grabs dry up river by News ET Social 6 years ago 1 minute, 11 seconds 2,214 views",News ET Social,2214,2214,0
6033,"DireTube News - South Sudan gov’t warns over fake Salva Kiir social media accounts by News ET Social 6 years ago 45 seconds 1,446 views",News ET Social,1446,1446,0
6034,"DireTube News - Ethiopia Weekly Humanitarian Bulletin, 9 March 2015 by News ET Social 6 years ago 1 minute, 35 seconds 3,904 views",News ET Social,3904,3904,0
6035,"DireTube News - Ethiopia’s ‘Iron Lion Zion’ cats fading fast by News ET Social 6 years ago 1 minute, 33 seconds 6,612 views",News ET Social,6612,6613,1
6036,"DireTube News - 16 primary school students in Addis taken to hospital after fainted by News ET Social 6 years ago 46 seconds 2,378 views",News ET Social,2378,2379,1
6037,"DireTube Video - Water Project for Addis Ababa Inaugurated by News ET Social 6 years ago 17 minutes 2,554 views",News ET Social,2554,2554,0
6038,"DireTube Sport - Ronaldo sets new all-time UEFA scoring record by News ET Social 6 years ago 1 minute, 7 seconds 1,223 views",News ET Social,1223,1223,0
6039,"DireTube News - One final week for Ethiopian National Team coach Barreto by News ET Social 6 years ago 48 seconds 1,635 views",News ET Social,1635,1635,0
6040,"Emaydegem(እማይደገም) - Latest Ethiopian Film from DireTube by News ET Social 6 years ago 1 hour, 38 minutes 271,200 views",News ET Social,271200,271581,381
6041,"Jazzamba Music School to encourage musical Development - DireTube by News ET Social 6 years ago 11 minutes, 49 seconds 6,738 views",News ET Social,6738,6785,47
6042,"DireTube News - The girl who gets gifts from birds by News ET Social 6 years ago 47 seconds 9,295 views",News ET Social,9295,9295,0
6043,"DireTube News - Gov’t considers leasing firefighting aircrafts for Chilalo fire by News ET Social 6 years ago 31 seconds 2,351 views",News ET Social,2351,2351,0
6044,"DireTube News - The awe-inspiring cave churches of Ethiopia by News ET Social 6 years ago 58 seconds 1,694 views",News ET Social,1694,1694,0
6045,"DireTube News- Addis to get electric cabs next year by News ET Social 6 years ago 44 seconds 5,598 views",News ET Social,5598,5599,1
6046,"DireTube News - Addis’ first seven star hotel by News ET Social 6 years ago 45 seconds 20,482 views",News ET Social,20482,20483,1
6047,"DireTube Video - Berhan Zare School's support helps kids survive by News ET Social 6 years ago 9 minutes, 20 seconds 18,122 views",News ET Social,18122,18131,9
6048,"DireTube Sport - Ethiopian Team's Coach Could Be Fired by News ET Social 6 years ago 1 minute, 9 seconds 1,311 views",News ET Social,1311,1311,0
6049,"DireTube Sport -  Manchester United out of the FA Cup by News ET Social 6 years ago 1 minute, 3 seconds 996 views",News ET Social,996,996,0
6050,"DireTube News - Ethiopia is going to launch its own satellite by News ET Social 6 years ago 1 minute, 39 seconds 2,856 views",News ET Social,2856,2856,0
6051,"DireTube News - Pay rise in India hits Ethiopia by News ET Social 6 years ago 44 seconds 2,093 views",News ET Social,2093,2093,0
6052,"DireTube Music - Ethio-Norwegian Dina Matheussen by Etta James song by News ET Social 6 years ago 2 minutes, 45 seconds 11,453 views",News ET Social,11453,11455,2
6053,"DireTube News - Addis Ababa, Ethiopia among Cities of the Future with a bright potential by News ET Social 6 years ago 1 minute 14,635 views",News ET Social,14635,14636,1
6054,"Tesfaye Taye - March 8 Celebration Singing Mehamud Ahmed's song -  DireTube by News ET Social 6 years ago 4 minutes, 46 seconds 3,659 views",News ET Social,3659,3680,21
6055,DireTube News - UN Security Council to visit Addis on March 12 by News ET Social 6 years ago 46 seconds 767 views,News ET Social,767,767,0
6056,"DireTube News - METEC started manufacturing trains for Ethiopia's railway by News ET Social 6 years ago 59 seconds 6,086 views",News ET Social,6086,6086,0
6057,"Netsanet Adamu - Darlign - NEW! Ethiopian Music Video 2015 - DireTube by News ET Social 6 years ago 5 minutes, 46 seconds 18,348 views",News ET Social,18348,18350,2
6058,"Who's The Father(አባቷ ማነው) - Latest Ethiopian Film from DireTube Cinema by News ET Social 6 years ago 1 hour, 26 minutes 1,184,299 views",News ET Social,1184299,1196565,12266
6059,"Samrawi 2(ሳምራዊ) - Latest Ethiopian Film from DireTube Cinema by News ET Social 6 years ago 1 hour, 42 minutes 130,517 views",News ET Social,130517,130687,170
6060,"DireTube TV Exclusive - Woman's Day Special - March 8 Entertainment by News ET Social 6 years ago 26 minutes 25,411 views",News ET Social,25411,25413,2
6061,"DireTube Video - Genet Masresha singing Maritu Kebede's Ambasel Music on March 8 by News ET Social 6 years ago 5 minutes, 41 seconds 6,687 views",News ET Social,6687,6726,39
6062,"Very Funny Fashion Show and Dance by Famous Ethiopian Artists - March 8 Woman's Day by News ET Social 6 years ago 9 minutes, 7 seconds 128,731 views",News ET Social,128731,128755,24
6063,"The Rising Azmari Yeshak Comedy Song on Woman's Day - DireTube by News ET Social 6 years ago 6 minutes, 9 seconds 203,391 views",News ET Social,203391,203465,74
6064,"Mulu Solomon English Poem for Woman's Day - DireTube by News ET Social 6 years ago 2 minutes, 56 seconds 6,235 views",News ET Social,6235,6248,13
6065,"Gang break into prison and kidnap man accused of raping student by News ET Social 6 years ago 3 minutes, 13 seconds 8,043 views",News ET Social,8043,8051,8
6066,"Britain's poorest children have fewer years of good health than Ethiopian youngsters by News ET Social 6 years ago 55 seconds 1,642 views",News ET Social,1642,1643,1
6067,"Appeals Court upholds death for Ethiopian maid in sponsor’s kill by News ET Social 6 years ago 35 seconds 1,146 views",News ET Social,1146,1147,1
6068,"Ethiopian farmer drops case alleging UK aid helped fund evictions by News ET Social 6 years ago 1 minute, 27 seconds 1,693 views",News ET Social,1693,1693,0
6069,"Ethiopia, Sudan and Egypt agree basis of Nile deal | DireTube News by News ET Social 6 years ago 49 seconds 1,814 views",News ET Social,1814,1814,0
6070,"Mekedonia gets 30,000 sqm of land from A.A City - DireTube News by News ET Social 6 years ago 47 seconds 2,622 views",News ET Social,2622,2622,0
6071,"Bemengede Lay (በመንገዴ ላይ) - NEW Movie Trailer 2015 - DireTube Trailer by News ET Social 6 years ago 1 minute, 11 seconds 23,206 views",News ET Social,23206,23208,2
6072,"Comedian Filfilu Stand up Comedy at Gumma Award 2015 - DireTube by News ET Social 6 years ago 12 minutes, 43 seconds 623,884 views",News ET Social,623884,624322,438
6073,"DireTube Sport - 12th African junior championship Addis Ababa celebrates colorfully by News ET Social 6 years ago 1 minute, 14 seconds 8,485 views",News ET Social,8485,8485,0
6074,"DireTube Sport - Ethiopian Kemal qualify for 100 meter final at 12th African junior championship by News ET Social 6 years ago 1 minute, 47 seconds 3,944 views",News ET Social,3944,3944,0
6075,"DireTube News - New charge on Samuel Zemicheal by News ET Social 6 years ago 1 minute, 27 seconds 4,499 views",News ET Social,4499,4501,2
6076,"DireTube News - First Human Jawbone fossil Discovery unveiled at Ethiopian National Museum by News ET Social 6 years ago 1 minute, 4 seconds 1,022 views",News ET Social,1022,1022,0
6077,"DireTube News - South Sudan says UN sanctions will harm peace process by News ET Social 6 years ago 52 seconds 1,358 views",News ET Social,1358,1358,0
6078,"DireTube News - Fire Affected Bale National Park of Ethiopia by News ET Social 6 years ago 50 seconds 5,081 views",News ET Social,5081,5085,4
6079,"DireTube News - Militarization and alternative biofuel drives Ethiopian land-grab by News ET Social 6 years ago 1 minute, 28 seconds 1,845 views",News ET Social,1845,1846,1
6080,"DireTube News - Coring in Ethiopia to create a half million year sedimentary record by News ET Social 6 years ago 1 minute, 2 seconds 1,032 views",News ET Social,1032,1032,0
6081,"DireTube News - Amanuel Mengesha Killed a police office by News ET Social 6 years ago 1 minute, 4 seconds 4,437 views",News ET Social,4437,4437,0
6082,"DireTube Cinema - Ande Alat (አንድ አላት) Ethiopian New! Film by News ET Social 6 years ago 1 hour, 44 minutes 180,772 views",News ET Social,180772,180863,91
6083,"First Human Jawbone fossil Discovery unveiled at Ethiopian National Museum by News ET Social 6 years ago 2 minutes, 20 seconds 5,043 views",News ET Social,5043,5045,2
6084,"DireTube News - Tripartite talks over Ethiopia dam kick off in Khartoum by News ET Social 6 years ago 2 minutes 1,136 views",News ET Social,1136,1136,0
6085,"DireTube News - Ethiopia‬ to build oil and gas pipeline for export by News ET Social 6 years ago 1 minute, 51 seconds 49,945 views",News ET Social,49945,50004,59
6086,"DireTube News - Ethiopia Jazz Beat Goes On by News ET Social 6 years ago 1 minute, 26 seconds 1,184 views",News ET Social,1184,1184,0
6087,"DireTube News - Edward snowden wants to come home by News ET Social 6 years ago 1 minute, 24 seconds 1,308 views",News ET Social,1308,1308,0
6088,"DireTube News - Couldn’t take blame for Ethiopia evictions, the World Bank says by News ET Social 6 years ago 1 minute, 54 seconds 1,450 views",News ET Social,1450,1450,0
6089,"DireTube News - Positive Messaging Helps Revamp Ethiopia's Image by News ET Social 6 years ago 1 minute, 10 seconds 3,748 views",News ET Social,3748,3748,0
6090,"DireTube News - Fire accident killed three children in Addis by News ET Social 6 years ago 1 minute, 9 seconds 7,430 views",News ET Social,7430,7432,2
6091,"DireTube Video - TPLF 40th Anniversary Closing Ceremony at Millenium Hall, Addis Ababa by News ET Social 6 years ago 28 minutes 28,154 views",News ET Social,28154,28163,9
6092,"Mulugeta Mekonen - Na Belegn - [New Ethiopian Music Video 2015] - DireTube by News ET Social 6 years ago 4 minutes, 50 seconds 10,358 views",News ET Social,10358,10365,7
6093,"Yoni Cash (Yohannes Feleke) - Rekon Jeera [NEW! Hot Ethiopian Music Video 2015] by News ET Social 6 years ago 5 minutes, 18 seconds 14,576 views",News ET Social,14576,14579,3
6094,"DireTube Sport - Blessed day for the former National F.C Player Girma Zewde by News ET Social 6 years ago 1 minute, 50 seconds 2,208 views",News ET Social,2208,2208,0
6095,"DireTube News - Clare Hepworth: City Hospital's Ethiopia links work both ways by News ET Social 6 years ago 54 seconds 1,280 views",News ET Social,1280,1280,0
6096,"DireTube News - 10 Year-old Nigerian child accepted in British university by News ET Social 6 years ago 39 seconds 4,844 views",News ET Social,4844,4844,0
6097,"DireTube News - President Pohamba wins the Mo Ibrahim Foundation’s prize by News ET Social 6 years ago 1 minute, 14 seconds 782 views",News ET Social,782,782,0
6098,"DireTube News - Ethiopia procures arms from North Korea by News ET Social 6 years ago 51 seconds 13,420 views",News ET Social,13420,13424,4
6099,"DireTube News - Galama Forest of Chilalo Mountain on Fire by News ET Social 6 years ago 45 seconds 3,274 views",News ET Social,3274,3276,2
6100,"DireTube News - European Union won’t observe the Ethiopian election by News ET Social 6 years ago 1 minute, 34 seconds 1,344 views",News ET Social,1344,1344,0
6101,"DireTube Poem - Atbeyign, Best poem by Yonas Kidane Shiwenzu Melaku Presents by News ET Social 6 years ago 17 minutes 31,293 views",News ET Social,31293,31353,60
6102,"DireTube News - Suspected Al Shabab members charged on plotting to suicide bomb in Addis by News ET Social 6 years ago 1 minute, 41 seconds 7,348 views",News ET Social,7348,7351,3
6103,"DireTube Sport - Manuel Pellegrini is facing uncertain future at Man City by News ET Social 6 years ago 1 minute, 3 seconds 799 views",News ET Social,799,800,1
6104,"DireTube Video -  Yedefere Binor Yimeles - an Interesting story by Yigrem Ashenafi by News ET Social 7 years ago 15 minutes 2,484 views",News ET Social,2484,2484,0
6105,"DireTube Sport - St. George football club two new records by News ET Social 7 years ago 54 seconds 4,946 views",News ET Social,4946,4948,2
6106,"DireTube News - Egypt to support S Sudan's power generation project by News ET Social 7 years ago 1 minute, 47 seconds 1,716 views",News ET Social,1716,1716,0
6107,"DireTube News - Couple Married for 67 Years Die Together While Holding Hands by News ET Social 7 years ago 50 seconds 1,971 views",News ET Social,1971,1971,0
6108,"DireTube News - Wondi Mack may face copyright lawsuit over his single release by News ET Social 7 years ago 1 minute, 3 seconds 40,566 views",News ET Social,40566,40567,1
6109,"DireTube News - Iraq launches major assault to retake Tikrit from IS by News ET Social 7 years ago 51 seconds 1,533 views",News ET Social,1533,1534,1
6110,"Fikren Yayachu - NEW! Ethiopian Movie from DireTube Cinema by News ET Social 7 years ago 1 hour, 43 minutes 1,446,136 views",News ET Social,1446136,1448871,2735
6111,"Zerihun Tesfaye - Wane Wane [NEW! Ethiopian Music Video 2015] by News ET Social 7 years ago 4 minutes, 15 seconds 18,250 views",News ET Social,18250,18253,3
6112,"Bado Neber - Ethiopian Movie from DireTube Cinema by News ET Social 7 years ago 1 hour, 44 minutes 1,198,019 views",News ET Social,1198019,1200408,2389
6113,"DireTube Law -  Leaking Secret - by Kidane Mekasha by News ET Social 7 years ago 5 minutes, 27 seconds 1,389 views",News ET Social,1389,1389,0
6114,"A NEW Book Launched by Journalist Henok Seyoum - DireTube by News ET Social 7 years ago 5 minutes, 45 seconds 1,820 views",News ET Social,1820,1821,1
6115,"Redwan Husien Talking about UDJ (Andnet) party - DireTube News by News ET Social 7 years ago 1 minute, 54 seconds 842 views",News ET Social,842,843,1
6116,"ISIS destroys historic sites in Iraq and Syria - DireTube News by News ET Social 7 years ago 1 minute, 24 seconds 16,823 views",News ET Social,16823,16827,4
6117,Machar calls on Kiir to engage in direct negotiations in Addis Ababa - DireTube by News ET Social 7 years ago 55 seconds 421 views,News ET Social,421,421,0
6118,"Ethiopia, Sudan to Commence Public Transportation within 45 days  -  DireTube by News ET Social 7 years ago 1 minute, 4 seconds 10,426 views",News ET Social,10426,10429,3
6119,Ethiopia to build research center to boost rice production - DireTube by News ET Social 7 years ago 1 minute 799 views,News ET Social,799,800,1
6120,"Solomon Haile - Bealti Mado by News ET Social 7 years ago 6 minutes, 42 seconds 610,652 views",News ET Social,610652,611639,987
6121,"Arsema Tadesse - Bayeh [NEW! Ethiopian Music Video 2015 by News ET Social 7 years ago 3 minutes, 49 seconds 61,059 views",News ET Social,61059,61060,1
6122,"Yeteseten [NEW! Ethoipian Movie 2015 on DireTube] DireTube by News ET Social 7 years ago 1 hour, 32 minutes 249,330 views",News ET Social,249330,249380,50
6123,"Ataklti Assefa - Hedemoy [New! Tigrigna Music Video 2015] by News ET Social 7 years ago 6 minutes, 8 seconds 32,255 views",News ET Social,32255,32257,2
6124,"Atakelti Assefa - Aytetehaleli [NEW! Tigrigna Music Video 2015] by News ET Social 7 years ago 5 minutes, 38 seconds 10,852 views",News ET Social,10852,10853,1
6125,"Endashaw Negash - Zoma Zoma [NEW! Wollo Bahilawi Song 20015] by News ET Social 7 years ago 5 minutes, 10 seconds 16,335 views",News ET Social,16335,16343,8
6126,"Tedros Adhanom & Beritu Jaleta Joint Press Conference at Foreign Minister Office by News ET Social 7 years ago 5 minutes, 10 seconds 24,600 views",News ET Social,24600,24605,5
6127,"DireTube News - Anbessa City Bus to change course off the light railway line by News ET Social 7 years ago 1 minute, 3 seconds 15,337 views",News ET Social,15337,15341,4
6128,"DireTube News - Defeat At Home To Sudan Proves Barreto Has Overstayed His Welcome by News ET Social 7 years ago 58 seconds 1,410 views",News ET Social,1410,1410,0
6129,"DireTube TV - Redwan Husien talking about Egypt by News ET Social 7 years ago 1 minute, 35 seconds 740 views",News ET Social,740,740,0
6130,"DireTube News - UAE accomplishes 1st phase of Suqia Campaign in Ethiopia by News ET Social 7 years ago 55 seconds 1,900 views",News ET Social,1900,1900,0
6131,"DireTube News - UK man behind Isis beheadings identified as Mohammed Emwazi by News ET Social 7 years ago 59 seconds 184,472 views",News ET Social,184472,184500,28
6132,"DireTube Sport - Inflatable banana thrown at Feyenoord-Roma game by News ET Social 7 years ago 40 seconds 1,441 views",News ET Social,1441,1441,0
6133,DireTube News - Three-person babies approved in UK by News ET Social 7 years ago 44 seconds 831 views,News ET Social,831,831,0
6134,"DireTube Sport - Liverpool lost their first European penalty shootout by News ET Social 7 years ago 1 minute, 4 seconds 914 views",News ET Social,914,914,0
6135,DireTube News - UK support to Ethiopia by News ET Social 7 years ago 1 minute 730 views,News ET Social,730,730,0
6136,"Tsion Silehamsa - Yante Lihun Na [NEW! Music Video 2015] by News ET Social 7 years ago 4 minutes, 42 seconds 42,442 views",News ET Social,42442,42444,2
6137,"GUMMA AWARD at National Theater on February 23, 2015 - Part 2 by News ET Social 7 years ago 52 minutes 92,834 views",News ET Social,92834,92841,7
6138,"DireTube Video - Redwan Husien Talking about UDJ (Andnet) party by News ET Social 7 years ago 3 minutes, 40 seconds 1,520 views",News ET Social,1520,1520,0
6139,"DireTube News - Solome Tadesse and Eng. Yilikal Getinet Cancelled from Candidacy by News ET Social 7 years ago 1 minute, 47 seconds 12,797 views",News ET Social,12797,12797,0
6140,"Yednekachew Tsegaye - Alew Neger [NEW! Ethiopian Music Video] by News ET Social 7 years ago 5 minutes, 12 seconds 63,167 views",News ET Social,63167,63167,0
6141,"DireTube News - PM performs ground breaking of Awash-Woldia-Hara Gebeya Railway by News ET Social 7 years ago 1 minute, 1 second 6,327 views",News ET Social,6327,6327,0
6142,Redwan Hussine Talks about Leaked Aljazeera Cable - DireTube by News ET Social 7 years ago 28 seconds 551 views,News ET Social,551,551,0
6143,"Redwan Husien Talks about Cancelled Election Candidates by News ET Social 7 years ago 8 minutes, 28 seconds 2,799 views",News ET Social,2799,2799,0
6144,"DireTube News - Ethiopian Democratic party declared its manifesto by News ET Social 7 years ago 1 minute, 23 seconds 973 views",News ET Social,973,973,0
6145,"DireTube News - Nigeria suicide bus blasts kill 27 by News ET Social 7 years ago 50 seconds 1,195 views",News ET Social,1195,1197,2
6146,DireTube News - Leaked cable says assassins attempted to kill AU Chair Dlamini Zuma by News ET Social 7 years ago 50 seconds 748 views,News ET Social,748,748,0
6147,"Redwan Hussien Talks about The Delay in Political Debate - DireTube by News ET Social 7 years ago 2 minutes, 7 seconds 675 views",News ET Social,675,675,0
6148,"Egypt and Ethiopia - GERD Dam Progress - DireTube by News ET Social 7 years ago 4 minutes, 35 seconds 1,294 views",News ET Social,1294,1294,0
6149,"DireTube Video - Guma Film Award at National Theater on February 23,2015 by News ET Social 7 years ago 30 minutes 28,047 views",News ET Social,28047,28047,0
6150,"DireTube News - Awash-Weldia-Hara Gebeya railway project at the starting stage by News ET Social 7 years ago 1 minute, 31 seconds 2,544 views",News ET Social,2544,2545,1
6151,"DireTube News - Ethiopia, Sudan discussing operationalization of surface transport by News ET Social 7 years ago 1 minute, 20 seconds 1,286 views",News ET Social,1286,1286,0
6152,"DireTube Comedy - Comedian Abiy (Jammy) Stand-up Comedy at Guma Film Award by News ET Social 7 years ago 20 minutes 146,363 views",News ET Social,146363,146388,25
6153,"DireTube News - Kenya to Start Port Lamu Construction by News ET Social 7 years ago 1 minute, 3 seconds 2,059 views",News ET Social,2059,2059,0
6154,"DireTube News - Ethiopia Poised For Continued Growth by News ET Social 7 years ago 1 minute, 21 seconds 2,114 views",News ET Social,2114,2114,0
6155,"DireTube News - EU increases assistance to Ethiopia to 1 bln Euros by News ET Social 7 years ago 1 minute, 24 seconds 830 views",News ET Social,830,830,0
6156,DireTube Sport - Barcelona beat Manchester City 2-1 in their Champions League by News ET Social 7 years ago 45 seconds 822 views,News ET Social,822,822,0
6157,"DireTube News - Debates between Political Parties to start on March 13th by News ET Social 7 years ago 1 minute, 2 seconds 756 views",News ET Social,756,756,0
6158,"DireTube Sport - England will benefit from Staging the 2022 World Cup in November and December by News ET Social 7 years ago 1 minute, 4 seconds 605 views",News ET Social,605,605,0
6159,"Yigerem Assefa - Hay Bay - NEW! Ethiopian Music Video 2015 - DireTube by News ET Social 7 years ago 5 minutes, 55 seconds 234,882 views",News ET Social,234882,234925,43
6160,"DireTube News - Final South Sudan peace talks to resume in Addis on Monday by News ET Social 7 years ago 1 minute, 31 seconds 1,002 views",News ET Social,1002,1002,0
6161,"DireTube News - S Sudan mediators to refer warring faction to UN Security Council, African Union by News ET Social 7 years ago 1 minute, 28 seconds 525 views",News ET Social,525,525,0
6162,"DireTube News - HRW urged World Bank to address Ethiopia findings on forced displacements by News ET Social 7 years ago 1 minute, 7 seconds 925 views",News ET Social,925,925,0
6163,"DireTube News - Egypt, Sudan, Ethiopia receive offers for Nile dam studies by News ET Social 7 years ago 39 seconds 1,031 views",News ET Social,1031,1031,0
6164,"DireTube News - 35mn voters registered for Ethiopia poll by News ET Social 7 years ago 44 seconds 1,091 views",News ET Social,1091,1091,0
6165,DireTube Sport - Man City to face Barcelona on today's champions league matches by News ET Social 7 years ago 53 seconds 933 views,News ET Social,933,933,0
6166,"DireTube Cinema - Janderebaw (ጃንደረባው) - Watch! The Movie Online by News ET Social 7 years ago 1 hour, 50 minutes 316,227 views",News ET Social,316227,316538,311
6167,"DireTube Sport - Genzebe Dibaba Targets 5000m Bejing World Champion by News ET Social 7 years ago 50 seconds 8,362 views",News ET Social,8362,8362,0
6168,"DireTube News -  Cardinal Berhane Eyesus Back to Ethiopia by News ET Social 7 years ago 2 minutes, 54 seconds 1,942 views",News ET Social,1942,1942,0
6169,"DireTube News - Haji Mahamed Amin Jamal the new President of EIASC by News ET Social 7 years ago 2 minutes, 39 seconds 1,210 views",News ET Social,1210,1210,0
6170,"DireTube News - ECA to cover cost of cancer treatment for women by News ET Social 7 years ago 1 minute, 5 seconds 582 views",News ET Social,582,582,0
6171,"DireTube News - Ethiopia-Djibouti railway to start next October by News ET Social 7 years ago 1 minute, 45 seconds 5,174 views",News ET Social,5174,5174,0
6172,"Ethiopia 1 - 2 Sudan - All Africa Game Goals and Highlight - DireTube Sport by News ET Social 7 years ago 5 minutes, 56 seconds 9,081 views",News ET Social,9081,9081,0
6173,"DireTube Law - Adera (አደራ) Shiwenzu Melaku Presents by News ET Social 7 years ago 9 minutes, 32 seconds 3,915 views",News ET Social,3915,3915,0
6174,"DireTube Poem - ህልሞቻችሁን ፈልጉ Written and Narrated by Solomon Moges by News ET Social 7 years ago 5 minutes, 39 seconds 8,481 views",News ET Social,8481,8486,5
6175,"Interview with Ethiopia's Cyclist Tsigabu Tsigabu Gebremariam Girmay by News ET Social 7 years ago 23 minutes 17,906 views",News ET Social,17906,17914,8
6176,"Jose Mourinho 'ashamed' of Chelsea fans in Paris incident - DireTube Sport by News ET Social 7 years ago 1 minute, 7 seconds 2,800 views",News ET Social,2800,2800,0
6177,"Ethiopian Women Vs Cameroon for Qualification at All-Africa Games by News ET Social 7 years ago 30 seconds 14,709 views",News ET Social,14709,14713,4
6178,"Ethiopians deserve a free press - DireTube News by News ET Social 7 years ago 1 minute, 12 seconds 4,982 views",News ET Social,4982,4982,0
6179,"Sufian Ahmed among candidates for AfDB chief - DireTube News by News ET Social 7 years ago 1 minute, 32 seconds 1,246 views",News ET Social,1246,1247,1
6180,"Ermias Amelga Returns to Addis Abeba - DireTube News by News ET Social 7 years ago 51 seconds 2,267 views",News ET Social,2267,2268,1
6181,"11 Ethiopian immigrants fined for illegal entry - DireTube News by News ET Social 7 years ago 37 seconds 2,562 views",News ET Social,2562,2562,0
6182,"Solomon Habte - Fegeg Bey [NEW! Ethiopian Music Video 2015] by News ET Social 7 years ago 5 minutes, 44 seconds 96,492 views",News ET Social,96492,96501,9
6183,"DireTube Video - Remembering Ethiopian Patriots by News ET Social 7 years ago 5 minutes, 42 seconds 17,410 views",News ET Social,17410,17419,9
6184,"DireTube Poem - Merenu Ene (መረኑ እኔ) - Poet Abere Ayalew Recited by Shiwenzu Melaku by News ET Social 7 years ago 4 minutes, 30 seconds 12,670 views",News ET Social,12670,12683,13
6185,"DireTube News - AAU to host debate between political parties by News ET Social 7 years ago 1 minute, 44 seconds 1,744 views",News ET Social,1744,1744,0
6186,"DireTube News - The terrorist group ISIS is selling human body parts by News ET Social 7 years ago 1 minute, 50 seconds 67,405 views",News ET Social,67405,67405,0
6187,"DireTube News - Angry Indian bride marries wedding guest by News ET Social 7 years ago 59 seconds 4,603 views",News ET Social,4603,4603,0
6188,"DireTube News - South Sudanese rebels’ military spokesman claims defection from Machar’s camp by News ET Social 7 years ago 45 seconds 1,300 views",News ET Social,1300,1300,0
6189,"DireTube Sport - Gerrard takes swipe at Balotelli over penalty row by News ET Social 7 years ago 1 minute, 8 seconds 1,970 views",News ET Social,1970,1970,0
6190,DireTube News - UK transports an Ebola suspect citizen back home by News ET Social 7 years ago 46 seconds 395 views,News ET Social,395,395,0
6191,"DireTube Law - Bozenenet (ቦዘኔነት) by Shiwenzu Melaku by News ET Social 7 years ago 7 minutes, 33 seconds 2,409 views",News ET Social,2409,2410,1
6192,DireTube News - Firms in Ethiopia likely to be credit constrained than elsewhere in the world by News ET Social 7 years ago 54 seconds 807 views,News ET Social,807,807,0
6193,"DireTube News - Kagame Says Ethiopia Is Africa's Beacon for Self-Reliance by News ET Social 7 years ago 1 minute, 16 seconds 1,907 views",News ET Social,1907,1907,0
6194,"DireTube Sport -  Ronaldo has 58 goals in 58 Champions League games by News ET Social 7 years ago 1 minute, 3 seconds 818 views",News ET Social,818,818,0
6195,"DireTube Sport - Dire Dawa to host Ethiopia Vs Sudan National Football Match by News ET Social 7 years ago 43 seconds 1,679 views",News ET Social,1679,1679,0
6196,DireTube News - Giant Chinese Corporation Seals 339m Br Power Contract by News ET Social 7 years ago 57 seconds 798 views,News ET Social,798,798,0
6197,"DireTube News - Haiti Carnival Accident Kills 20 By Electrocution by News ET Social 7 years ago 1 minute, 2 seconds 1,337 views",News ET Social,1337,1338,1
6198,"DireTube News - Israel admits Ethiopian women were given birth control shots by News ET Social 7 years ago 1 minute, 3 seconds 3,980 views",News ET Social,3980,3983,3
6199,"DireTube News - Mombasa detectives arrest 11 Ethiopian enroute to South Africa by News ET Social 7 years ago 33 seconds 1,890 views",News ET Social,1890,1890,0
6200,"DireTube News Ethiopian spa resort company to build site on island in Djibouti by News ET Social 7 years ago 1 minute, 2 seconds 2,411 views",News ET Social,2411,2411,0
6201,"DireTube News - Ethiopia and Djibouti Agreed to Construct Oil Pipeline by News ET Social 7 years ago 1 minute, 3 seconds 30,155 views",News ET Social,30155,30160,5
6202,"DireTube News - Princess Mary makes humanitarian visit to Ethiopia by News ET Social 7 years ago 1 minute, 2 seconds 1,026 views",News ET Social,1026,1026,0
6203,"DireTube Poem - Poet Selomon Sahle Hulet Mot (ሁለት ሞት) - Recited by Shiwenzu Melaku by News ET Social 7 years ago 2 minutes, 20 seconds 4,320 views",News ET Social,4320,4324,4
6204,"DireTube Cinema - Ayderegim (አይደረግም) - Ethiopian Film NEW! by News ET Social 7 years ago 1 hour, 29 minutes 443,747 views",News ET Social,443747,444032,285
6205,"DireTube Health - Unstable Personality Disorder written by Wendimu Negash by News ET Social 7 years ago 13 minutes, 15 seconds 2,074 views",News ET Social,2074,2074,0
6206,"DireTube Law - Legal Rights (ህጋዊነትና መብት ማስከበር) - Written by Kidane Mekasha Etsegenet Yilma presents by News ET Social 7 years ago 13 minutes, 36 seconds 671 views",News ET Social,671,674,3
6207,DireTube News - Japan to give $15.5 million for anti-terror efforts by News ET Social 7 years ago 54 seconds 403 views,News ET Social,403,403,0
6208,"DireTube News - Tendaho Project 93 Percent Complete by News ET Social 7 years ago 1 minute, 17 seconds 5,772 views",News ET Social,5772,5774,2
6209,"DireTube Cinema - Leyekl (ለየቅል) - Ethiopian Film by News ET Social 7 years ago 1 hour, 38 minutes 1,039,731 views",News ET Social,1039731,1043179,3448
6210,"DireTube News - Ethiopian Cardinal on his nomination: “A total surprise and a humbling experience by News ET Social 7 years ago 1 minute, 57 seconds 3,008 views",News ET Social,3008,3008,0
6211,"DireTube News - Ethiopia Plans To Become Light Manufacturing Leader by News ET Social 7 years ago 39 seconds 1,605 views",News ET Social,1605,1605,0
6212,"DireTube Sport - Chelsea were fortunate, admits Mourinho by News ET Social 7 years ago 1 minute, 27 seconds 416 views",News ET Social,416,416,0
6213,DireTube News - Blue blasts board for candidates’ cancellation by News ET Social 7 years ago 55 seconds 922 views,News ET Social,922,922,0
6214,"DireTube News - 12 people killed in a tragic traffic accident at Burayu town by News ET Social 7 years ago 45 seconds 2,884 views",News ET Social,2884,2886,2
6215,"DireTube News - C’ttee presents interim report on Ethiopian cargo plane crash by News ET Social 7 years ago 50 seconds 4,710 views",News ET Social,4710,4711,1
6216,DireTube Sport -  FA Cup sixth round draw: Arsenal to face Manchester United by News ET Social 7 years ago 33 seconds 635 views,News ET Social,635,635,0
6217,"DireTube Sport - Tsgabu Girmay Becomes First Ethiopian Cyclist To Reach Olympics In 44 Years by News ET Social 7 years ago 50 seconds 5,613 views",News ET Social,5613,5616,3
6218,"DireTube Law -  Quest Marketing written by Kidane Mekasha Etsegenet Yilma presents by News ET Social 7 years ago 6 minutes, 50 seconds 1,972 views",News ET Social,1972,1973,1
6219,"DireTube News - Egypt launches airstrike on ISIS after militants beheaded 21 Egyptians by News ET Social 7 years ago 1 minute, 4 seconds 118,255 views",News ET Social,118255,118262,7
6220,DireTube News - South Africa ban on foreign land ownership by News ET Social 7 years ago 53 seconds 743 views,News ET Social,743,743,0
6221,"DireTube News - Ethiopian filmmaker Salem Mekuria at ICES by News ET Social 7 years ago 50 seconds 1,483 views",News ET Social,1483,1485,2
6222,"DireTube News - Ethiopia to Use Somaliland’s Berbera Port by News ET Social 7 years ago 46 seconds 5,825 views",News ET Social,5825,5828,3
6223,"DireTube News - Tony Blair: Ethiopia, Rwanda and Mozambique top investment destinations in Africa by News ET Social 7 years ago 48 seconds 930 views",News ET Social,930,930,0
6224,"DireTube News - Cyber bank robbers steal $1bn, says Kaspersky report by News ET Social 7 years ago 1 minute, 27 seconds 466 views",News ET Social,466,467,1
6225,"DireTube Video - History of the first rail transport in Ethiopia by News ET Social 7 years ago 17 minutes 11,524 views",News ET Social,11524,11528,4
6226,"DireTube News - Helping others during Ethiopian Easter Fasting by News ET Social 7 years ago 1 minute, 49 seconds 2,482 views",News ET Social,2482,2482,0
6227,"DireTube News - Meles Zenawi’s statue inaugurated by News ET Social 7 years ago 1 minute, 47 seconds 15,976 views",News ET Social,15976,15977,1
6228,DireTube Sport - Dedebit beat Seychelles' club by News ET Social 7 years ago 48 seconds 812 views,News ET Social,812,812,0
6229,"DireTube News - Grand airport project to cost 40 bln birr by News ET Social 7 years ago 3 minutes, 39 seconds 37,379 views",News ET Social,37379,37379,0
6230,"DireTube News - Mohamed Morsi in Court accused of leaking Secrets to Qatar by News ET Social 7 years ago 39 seconds 1,845 views",News ET Social,1845,1845,0
6231,DireTube Sport - England manager Roy Hodgson will make the draw for the FA Cup quarter-final by News ET Social 7 years ago 42 seconds 335 views,News ET Social,335,335,0
6232,"DireTube News - Salva Kirr struggling to find place for Machar by News ET Social 7 years ago 1 minute, 5 seconds 704 views",News ET Social,704,704,0
6233,"DireTube News - A U.S official said Ethiopia remains a challenge to the United Sates by News ET Social 7 years ago 52 seconds 4,870 views",News ET Social,4870,4870,0
6234,"DireTube Sport - Zlatan Ibrahimovic tattooed names of 50 starving people on his body by News ET Social 7 years ago 1 minute, 4 seconds 2,824 views",News ET Social,2824,2825,1
6235,"DireTube News - New bill prepared that restrict chat and shisha use by News ET Social 7 years ago 1 minute, 16 seconds 5,523 views",News ET Social,5523,5524,1
6236,"DireTube News - rules to handle Addis Rail damage by News ET Social 7 years ago 1 minute, 21 seconds 1,457 views",News ET Social,1457,1457,0
6237,"DireTube News - Minister of council approved the agreement to establish East African Standby Force by News ET Social 7 years ago 1 minute, 59 seconds 1,006 views",News ET Social,1006,1006,0
6238,"DireTube News - The Ethiopian government’s duty is to protect all of its citizens by News ET Social 7 years ago 50 seconds 12,013 views",News ET Social,12013,12013,0
6239,"DireTube Sport - Short sport stories of the day by News ET Social 7 years ago 43 seconds 1,027 views",News ET Social,1027,1027,0
6240,"DireTube News - World 800 Champion Mohammed Aman Joins Oregon Track Club by News ET Social 7 years ago 53 seconds 8,697 views",News ET Social,8697,8698,1
6241,"DireTube News - Niger defence force killed 269 Boko Haram militants by News ET Social 7 years ago 53 seconds 2,197 views",News ET Social,2197,2197,0
6242,"DireTube Sport - Usain Bolt reveals his desire to be the greatest athlete of all time by News ET Social 7 years ago 1 minute, 16 seconds 1,290 views",News ET Social,1290,1290,0
6243,"DireTube News - Addis Ababa road authority took an action on people who damaged roads in the City by News ET Social 7 years ago 1 minute, 23 seconds 3,609 views",News ET Social,3609,3609,0
6244,"DireTube News - Ethiopian Airlines pondering on a new route to Argentina by News ET Social 7 years ago 41 seconds 4,949 views",News ET Social,4949,4949,0
6245,"DireTube News - Ethiopia, Egypt and Sudan discuss GERD by News ET Social 7 years ago 42 seconds 1,675 views",News ET Social,1675,1675,0
6246,"DireTube Law - Kidane Mekasha Corruption, Presented by Shiwenzu Melaku by News ET Social 7 years ago 6 minutes, 45 seconds 1,046 views",News ET Social,1046,1047,1
6247,"DireTube Sport - Four Dedebit Football players Back to Ethiopia by News ET Social 7 years ago 1 minute, 5 seconds 1,503 views",News ET Social,1503,1503,0
6248,"DireTube Sport - St. George to face MC El Eulma in CAF Champions League by News ET Social 7 years ago 1 minute, 25 seconds 2,080 views",News ET Social,2080,2081,1
6249,"DireTube Video -Blood Donation on the day of Valentine’s Day: Happy Valentine's Day by News ET Social 7 years ago 2 minutes, 15 seconds 2,227 views",News ET Social,2227,2227,0
6250,DireTube News - Ethiopia tipped for tourism surge by News ET Social 7 years ago 39 seconds 781 views,News ET Social,781,781,0
6251,"DireTube News - Two Ethiopians Killed in Durban, South Africa by News ET Social 7 years ago 33 seconds 9,229 views",News ET Social,9229,9229,0
6252,"DireTube News - Family of Abebe Bikila Sues Shoe company Vibram by News ET Social 7 years ago 58 seconds 3,316 views",News ET Social,3316,3322,6
6253,"DireTube News - Egypt, Ethiopia, Sudan to meet in March over Renaissance Dam by News ET Social 7 years ago 1 minute, 15 seconds 1,617 views",News ET Social,1617,1617,0
6254,"DireTube News - Egypt’s Foreign Minister heads in sudden visit to Ethiopia by News ET Social 7 years ago 1 minute, 20 seconds 560 views",News ET Social,560,560,0
6255,"DireTube Health - Wendmu Negash - Anxiety Disorders presented by Shiwenzu Melaku by News ET Social 7 years ago 10 minutes, 29 seconds 5,537 views",News ET Social,5537,5538,1
6256,"DireTube News - Container truck plowed into Addis Ababa Railway  protective barriers around Gotera by News ET Social 7 years ago 2 minutes, 36 seconds 6,626 views",News ET Social,6626,6626,0
6257,"DireTube News - Money transfers cut off to Somalia by News ET Social 7 years ago 43 seconds 3,642 views",News ET Social,3642,3642,0
6258,"DireTube News - Ethiopian Man’s body found in Canda could have been there for 5 years by News ET Social 7 years ago 1 minute, 35 seconds 11,309 views",News ET Social,11309,11309,0
6259,"DireTube Law - Kidane Mekasha - Amenzranet (አመንዝራነት) by News ET Social 7 years ago 6 minutes, 54 seconds 1,702 views",News ET Social,1702,1702,0
6260,"DireTube News - Obama warns Putin over deepening Ukraine crisis by News ET Social 7 years ago 32 seconds 1,437 views",News ET Social,1437,1438,1
6261,DireTube News - Egypt's Sisi reassures Gulf leaders after alleged derisive audio leaks by News ET Social 7 years ago 45 seconds 427 views,News ET Social,427,427,0
6262,DireTube News - US supporting West African countries to fight against Boko Haram by News ET Social 7 years ago 38 seconds 600 views,News ET Social,600,600,0
6263,DireTube Sport - Barcelona recorded their 10th victory in a row by beating Villarreal by News ET Social 7 years ago 44 seconds 595 views,News ET Social,595,595,0
6264,"DireTube News - Ethiopian Patriarch Mathias Returned to Ethiopia from Egypt by News ET Social 7 years ago 45 seconds 1,595 views",News ET Social,1595,1595,0
6265,"DireTube News - World Cancer Day 2015 in Ethiopia by News ET Social 7 years ago 1 minute, 5 seconds 378 views",News ET Social,378,378,0
6266,"DireTube News - Ethiopian political parties to start campaigns for the 2007 election by News ET Social 7 years ago 47 seconds 3,027 views",News ET Social,3027,3027,0
6267,"DireTube Sport - Roberto Martinez accuses Chelsea's players of trying to sway the referee by News ET Social 7 years ago 55 seconds 1,460 views",News ET Social,1460,1460,0
6268,"DireTube News - Ethiopia to send extra peacekeeping troops to three neighboring countries by News ET Social 7 years ago 2 minutes, 32 seconds 1,263 views",News ET Social,1263,1263,0
6269,"DireTube Exclusive - SewLeSew TV Drama Award Winners with DireTube by News ET Social 7 years ago 13 minutes, 35 seconds 167,395 views",News ET Social,167395,167421,26
6270,"DireTube News - GREENLIGHT PLANET announces $10M financing to light up 100 million off-grid homes by News ET Social 7 years ago 1 minute, 17 seconds 1,109 views",News ET Social,1109,1109,0
6271,"DireTube News - Putin visits Egypt in bid to expand influence by News ET Social 7 years ago 1 minute, 57 seconds 2,311 views",News ET Social,2311,2313,2
6272,"DireTube News - Bids over rope that hung Saddam Hussein reach $7 million by News ET Social 7 years ago 1 minute, 11 seconds 120,619 views",News ET Social,120619,122179,1560
6273,"DireTube News - Crown Princess set to visit Ethiopia by News ET Social 7 years ago 57 seconds 1,346 views",News ET Social,1346,1346,0
6274,"DireTube News - According to court decision Elille Hotel to get 1696 Sq meters of land by News ET Social 7 years ago 1 minute, 57 seconds 548 views",News ET Social,548,548,0
6275,"DireTube News - Soccer fans clash with the police in Cairo; at least 19 dead by News ET Social 7 years ago 51 seconds 1,202 views",News ET Social,1202,1202,0
6276,"DireTube News - Europeans inconsistent to solve the crisis in Ukraine by News ET Social 7 years ago 1 minute, 17 seconds 922 views",News ET Social,922,922,0
6277,"DireTube News - One Marathons in One Hundred Days by News ET Social 7 years ago 1 minute, 2 seconds 549 views",News ET Social,549,549,0
6278,"DireTube News - PM Hailemariam: Ethiopia and Djibouti surfing in same boat by News ET Social 7 years ago 1 minute, 5 seconds 3,221 views",News ET Social,3221,3221,0
6279,"DireTube News - Ethiopia refuses allow access to imprisoned British citizen, Andargachew Tsige by News ET Social 7 years ago 48 seconds 2,881 views",News ET Social,2881,2884,3
6280,"DireTube Sport - Update On Sánchez, Wilshere, Arteta And Others Ahead Of Leicester City Match by News ET Social 7 years ago 46 seconds 546 views",News ET Social,546,546,0
6281,"DireTube News - Ethiopia is the second country by having most journalists in exile in the world by News ET Social 7 years ago 1 minute, 15 seconds 892 views",News ET Social,892,892,0
6282,"DireTube Sport - Brazilian club Recife train 30 mothers to discourage fans from fighting by News ET Social 7 years ago 45 seconds 4,356 views",News ET Social,4356,4357,1
6283,"DireTube News - The president denied that he resigns from his position by News ET Social 7 years ago 1 minute, 58 seconds 1,016 views",News ET Social,1016,1016,0
6284,"DireTube News - The Most Dangerous Journey on Earth by News ET Social 7 years ago 52 seconds 1,843 views",News ET Social,1843,1843,0
6285,DireTube News - Global report named Development Research Institute top think tank in Ethiopia by News ET Social 7 years ago 50 seconds 263 views,News ET Social,263,263,0
6286,"DireTube News - Ethiopian to order 20 wide-body aircraft by News ET Social 7 years ago 59 seconds 1,637 views",News ET Social,1637,1637,0
6287,DireTube News - Ministry to grant mining license to Ascom Mining by News ET Social 7 years ago 54 seconds 979 views,News ET Social,979,979,0
6288,"DireTube News - Judge Ato Sheleme Bekele and Zone 9 Bloggers by News ET Social 7 years ago 1 minute, 12 seconds 2,255 views",News ET Social,2255,2255,0
6289,DireTube News - Korean Education Minister to visit Ethiopia and the UAE by News ET Social 7 years ago 46 seconds 426 views,News ET Social,426,426,0
6290,"DireTube News - Ethiopia ranks 4th in troop, police contribution to UN peacekeeping operations by News ET Social 7 years ago 49 seconds 2,297 views",News ET Social,2297,2299,2
6291,"DireTube News - Djibouti, Ethiopia accuse Eritrea of undermining stability by News ET Social 7 years ago 1 minute, 3 seconds 8,150 views",News ET Social,8150,8150,0
6292,"DireTube Sport - Africa Cup of Nations: Morocco banned from next two tournaments by News ET Social 7 years ago 48 seconds 1,947 views",News ET Social,1947,1947,0
6293,DireTube Sport - Africa Cup of Nations riot: DR Congo's Zakuani wants game off by News ET Social 7 years ago 55 seconds 255 views,News ET Social,255,255,0
6294,"DireTube News : FAA removes prohibitions over Ethiopian territory for US planes by News ET Social 7 years ago 29 seconds 3,077 views",News ET Social,3077,3077,0
6295,DireTube News EU: little progress in South Sudan after the Addis signing by News ET Social 7 years ago 33 seconds 851 views,News ET Social,851,851,0
6296,"DireTube News : Ethiopia population projected to hit 90mn this year by News ET Social 7 years ago 41 seconds 5,902 views",News ET Social,5902,5903,1
6297,"DireTube News : Ethiopia to construct 11 new universities by News ET Social 7 years ago 45 seconds 1,348 views",News ET Social,1348,1348,0
6298,"DireTube News Brazilian girl, 6, 'eaten' by piranhas and found dead by News ET Social 7 years ago 50 seconds 4,501 views",News ET Social,4501,4505,4
6299,"DireTube News : Amnesty begs PM get involved in Ethiopian-Canadian's plight behind bars by News ET Social 7 years ago 54 seconds 1,851 views",News ET Social,1851,1851,0
6300,"DireTube News : Ethiopian orphan fulfills dream of becoming IDF officer by News ET Social 7 years ago 41 seconds 9,219 views",News ET Social,9219,9220,1
6301,"DireTube Sport : Africa Cup of Nations: Semi-final was 'war zone', says Ghana FA by News ET Social 7 years ago 1 minute, 17 seconds 962 views",News ET Social,962,962,0
6302,"DireTube News :  Mummified 200-year-old monk 'NOT dead' but in 'very deep meditation' by News ET Social 7 years ago 1 minute, 5 seconds 8,238 views",News ET Social,8238,8239,1
6303,"DireTube News : A home at last for the dog abandoned at a train station by News ET Social 7 years ago 40 seconds 5,998 views",News ET Social,5998,5998,0
6304,DireTube News : Weather database to commence operation by News ET Social 7 years ago 43 seconds 539 views,News ET Social,539,539,0
6305,"DireTube News : Ethiopia to Deploy Extra Peace-keeping Forces to Somalia, South Sudan and Abiye by News ET Social 7 years ago 33 seconds 2,847 views",News ET Social,2847,2848,1
6306,"DireTube News Family’s agony over Upper Holloway dad’s death sentence by News ET Social 7 years ago 54 seconds 2,491 views",News ET Social,2491,2491,0
6307,"DireTube Video Yegna Girl Band Abet (አቤት) Best Live Performance by News ET Social 7 years ago 4 minutes, 45 seconds 379,148 views",News ET Social,379148,379180,32
6308,"DireTube News : Fuel tanker driver found guilty of arson and other charges by News ET Social 7 years ago 2 minutes, 12 seconds 5,019 views",News ET Social,5019,5019,0
6309,"DireTube News : Oil price drop is a good news for Ethiopia infrastructure boom by News ET Social 7 years ago 1 minute, 7 seconds 1,369 views",News ET Social,1369,1369,0
6310,"DireTube News : 21 miles to work every day on foot by News ET Social 7 years ago 1 minute, 9 seconds 1,397 views",News ET Social,1397,1397,0
6311,"DireTube News TransAsia Plane Hits Bridge, Crashes in Taipei by News ET Social 7 years ago 45 seconds 1,406 views",News ET Social,1406,1406,0
6312,"DireTube Jordan executes ISIS jihadists as ISIS torched to death Jordanian pilot in a cage by News ET Social 7 years ago 52 seconds 99,447 views",News ET Social,99447,99473,26
6313,"DireTube News : Twenty-seven Al-Shabaab fighters killed in airstrikes in Lower Jubba region by News ET Social 7 years ago 42 seconds 1,124 views",News ET Social,1124,1124,0
6314,"DireTube Health : Sara (ልዕልት የመሰለች ልጅ ወልጄ .. ) Short Story - Wendemu Negash by News ET Social 7 years ago 7 minutes, 51 seconds 2,498 views",News ET Social,2498,2499,1
6315,"DireTube Poem : Lerkshew Wede (ለረከሽው ውዴ) Written by Mesfin Wondwosen by News ET Social 7 years ago 2 minutes, 30 seconds 5,087 views",News ET Social,5087,5096,9
6316,"DireTube Law Teklekle Alu (ተከለከለ አሉ) Written by Kidane Mekasha by News ET Social 7 years ago 10 minutes, 17 seconds 1,317 views",News ET Social,1317,1318,1
6317,"DireTube News - Court adjourns to rule on the complaints raised by the terror suspects by News ET Social 7 years ago 1 minute, 16 seconds 806 views",News ET Social,806,806,0
6318,"DireTube News - Marsabit politicians accused of importing Ethiopians for 2017 polls by News ET Social 7 years ago 55 seconds 2,135 views",News ET Social,2135,2135,0
6319,"DireTube News - Long-Awaited Hotel Grading Begins for 600 Hotels in Ethiopia by News ET Social 7 years ago 50 seconds 1,493 views",News ET Social,1493,1494,1
6320,DireTube Sport - Africa Cup of Nations referee banned for controversial Equatorial Guinea penalty by News ET Social 7 years ago 56 seconds 659 views,News ET Social,659,659,0
6321,"DireTube News - Rules and Regulations to be proclaimed soon for the rail way by News ET Social 7 years ago 1 minute, 18 seconds 4,327 views",News ET Social,4327,4327,0
6322,DireTube Sport - This is our best chance to win a title! Van Gaal by News ET Social 7 years ago 54 seconds 297 views,News ET Social,297,297,0
6323,DireTube News - Ethiopian Nominated for ATW Awards by News ET Social 7 years ago 43 seconds 775 views,News ET Social,775,775,0
6324,"DireTube News - Civil Servant service buses to give public transport service in Addis Ababa by News ET Social 7 years ago 1 minute, 16 seconds 3,342 views",News ET Social,3342,3344,2
6325,"DireTube News - Ethiopian refugee wins entrepreneur of year prize by News ET Social 7 years ago 55 seconds 1,121 views",News ET Social,1121,1121,0
6326,"DireTube Video - Africa-American Music Group - Sweet Honey In The Rock by News ET Social 7 years ago 5 minutes, 2 seconds 1,227 views",News ET Social,1227,1228,1
6327,"DireTube Poem - Hisabena Hasabe (ሒሳብና ሀሳብ) Written and Recited by Belay Bekele Weya by News ET Social 7 years ago 4 minutes, 6 seconds 5,435 views",News ET Social,5435,5439,4
6328,"DireTube News - Africa’s illicit financial flows up to USD 148bln per annum by News ET Social 7 years ago 1 minute, 24 seconds 955 views",News ET Social,955,955,0
6329,"DireTube Sport - Tunisia FA head resigns from CAF in protest by News ET Social 7 years ago 42 seconds 1,022 views",News ET Social,1022,1022,0
6330,"DireTube News - Court postpones defense witness hearing date on the murder case of Shiek Nur Imam by News ET Social 7 years ago 1 minute, 50 seconds 668 views",News ET Social,668,668,0
6331,"DireTube Video - Yegna Music Band at American Embassy: Black African Month by News ET Social 7 years ago 5 minutes, 9 seconds 28,808 views",News ET Social,28808,28809,1
6332,"DireTube Sport - Transfer deadline day: Juan Cuadrado headlines spending by News ET Social 7 years ago 1 minute, 14 seconds 309 views",News ET Social,309,309,0
6333,"DireTube News- American Led military intervention against ISIS 34 airstrikes by News ET Social 7 years ago 48 seconds 9,469 views",News ET Social,9469,9469,0
6334,"DireTube Health - Many people do not understand how they become addicted to drugs by News ET Social 7 years ago 14 minutes, 54 seconds 1,203 views",News ET Social,1203,1203,0
6335,DireTube News - Court Rules Against Chinese Makers of Geotel Mobile in Absentia by News ET Social 7 years ago 57 seconds 512 views,News ET Social,512,512,0
6336,DireTube News - Ministry withdraws incentives as foreign companies abuse export privilege by News ET Social 7 years ago 54 seconds 155 views,News ET Social,155,157,2
6337,"DireTube News - ISIS Says It Has Killed 2nd Japanese Hostage by News ET Social 7 years ago 1 minute, 4 seconds 32,808 views",News ET Social,32808,32812,4
6338,"DireTube News - Ethiopia is the recipient of the 2015 ALMA Award for Excellence in Innovation by News ET Social 7 years ago 1 minute, 20 seconds 1,022 views",News ET Social,1022,1022,0
6339,DireTube News S. Sudan’s rival leaders ink power-sharing deal in Ethiopia by News ET Social 7 years ago 1 minute 317 views,News ET Social,317,317,0
6340,"DireTube News Ethiopian-Israeli rapper featured in documentary killed by car bomb in Rehovot by News ET Social 7 years ago 44 seconds 2,550 views",News ET Social,2550,2550,0
6341,DireTube News African Union threatens South Sudan warring factions with sanctions by News ET Social 7 years ago 50 seconds 168 views,News ET Social,168,168,0
6342,DireTube News Ethiopia earns over $191 mln from manufacturing by News ET Social 7 years ago 50 seconds 603 views,News ET Social,603,603,0
6343,"DireTube News - IOM and Ethiopia to tackle country’s migration issues by News ET Social 7 years ago 43 seconds 4,307 views",News ET Social,4307,4307,0
6344,"DireTube News - 'Honest' companies import wouldn't be checked by News ET Social 7 years ago 1 minute, 15 seconds 1,441 views",News ET Social,1441,1441,0
6345,"DireTube Exclusive - Addis Ababa City Light Train Test Ride - Feb 1, 2015 by News ET Social 7 years ago 2 minutes, 41 seconds 117,556 views",News ET Social,117556,117562,6
6346,"DireTube News : Press Conference The 2nd Gumma Award - Celebrate Excellence in Ethiopian Cinema by News ET Social 7 years ago 10 minutes, 24 seconds 2,713 views",News ET Social,2713,2713,0
6347,"DireTube African Union calls for 7,500-strong force to fight Boko Haram by News ET Social 7 years ago 52 seconds 931 views",News ET Social,931,931,0
6348,"DireTube News South Sudan rivals meet for peace talks in Ethiopia by News ET Social 7 years ago 32 seconds 1,292 views",News ET Social,1292,1292,0
6349,"DireTube News Egypt's Sisi cuts short Ethiopia visit after 30 killed in Sinai by News ET Social 7 years ago 44 seconds 3,925 views",News ET Social,3925,3925,0
6350,"DireTube Zimbabwe President Robert Mugabe new African Union chairman by News ET Social 7 years ago 30 seconds 1,140 views",News ET Social,1140,1140,0
6351,"DireTube News Don't cling to power, UN chief tells African leader by News ET Social 7 years ago 39 seconds 466 views",News ET Social,466,466,0
6352,DireTube News Security challenges dominate African Union leaders meeting by News ET Social 7 years ago 58 seconds 405 views,News ET Social,405,405,0
6353,DireTube Sport : Rita Jeptoo has been handed a 2 year ban after testing positive by News ET Social 7 years ago 59 seconds 825 views,News ET Social,825,825,0
6354,"DireTube News : Opening of the 24th AU summit by News ET Social 7 years ago 5 minutes, 44 seconds 3,064 views",News ET Social,3064,3064,0
6355,"DireTube Law : Kidane Mekasha The case of being guilty and parole by News ET Social 7 years ago 8 minutes, 10 seconds 960 views",News ET Social,960,960,0
6356,"DireTube Sport : AFCON 2015: Caf to look at ways to avoid drawing of lots by News ET Social 7 years ago 1 minute, 20 seconds 872 views",News ET Social,872,872,0
6357,DireTube Russian girl takes her own life after parents find pornography on her computer by News ET Social 7 years ago 35 seconds 875 views,News ET Social,875,875,0
6358,DireTube News : Dlamini- Zuma: Boko- Haram criminal gang spreading into West and Central Africa by News ET Social 7 years ago 28 seconds 421 views,News ET Social,421,421,0
6359,DireTube News : AU and China agree to implement ‘project of the century’ by News ET Social 7 years ago 46 seconds 878 views,News ET Social,878,878,0
6360,"DireTube News : Ethiopia says new railway to Djibouti to start in early 2016 by News ET Social 7 years ago 43 seconds 1,710 views",News ET Social,1710,1710,0
6361,"DireTube News : Bob Marley’s Statue to be erected in Addis two months later by News ET Social 7 years ago 1 minute, 12 seconds 1,097 views",News ET Social,1097,1097,0
6362,"DireTube News : ERCA paid 18 mln Br to informants by News ET Social 7 years ago 1 minute, 13 seconds 1,594 views",News ET Social,1594,1596,2
6363,"DireTube News : Election board makes final decision on UDJ, AEUP leadership by News ET Social 7 years ago 39 seconds 1,045 views",News ET Social,1045,1046,1
6364,"Andinet Party Press Conference on the Banned Demonstration - DireTube by News ET Social 7 years ago 17 minutes 4,529 views",News ET Social,4529,4529,0
6365,"DireTube TV : Interview with Ethio-Italian Artist Gabriella Ghermandi by News ET Social 7 years ago 35 minutes 12,937 views",News ET Social,12937,12939,2
6366,"DireTube Lebanon unions denounce labor minister's 'backwards' maid protection proposal by News ET Social 7 years ago 1 minute, 6 seconds 1,377 views",News ET Social,1377,1377,0
6367,DireTube News : Ethiopian officials learning Korea’s food reserves policy by News ET Social 7 years ago 33 seconds 479 views,News ET Social,479,479,0
6368,"DireTube News : AAWSA to Get MeTEC Made Br30 Million Mobile Toilets by News ET Social 7 years ago 1 minute, 1 second 1,922 views",News ET Social,1922,1923,1
6369,"DireTube News Conjoined twin born in Ethiopia by News ET Social 7 years ago 50 seconds 10,506 views",News ET Social,10506,10507,1
6370,"DireTube Ethiopian and Liege Airport renew their successful partnership in Air Cargo by News ET Social 7 years ago 40 seconds 1,338 views",News ET Social,1338,1338,0
6371,"DireTube News Ethiopia, Egypt Fms Assess 'Technical Progress' On Nile Dam by News ET Social 7 years ago 55 seconds 758 views",News ET Social,758,758,0
6372,"DireTube Sport : Top Sport Story From DireTube Sport Jan 29, 2015 by News ET Social 7 years ago 1 minute, 27 seconds 417 views",News ET Social,417,417,0
6373,"DireTube Sport Brian Umony joins Ethiopia’s St George FC by News ET Social 7 years ago 55 seconds 1,432 views",News ET Social,1432,1432,0
6374,"DireTube News The 24th AU summit urges action against Boko Haram by News ET Social 7 years ago 1 minute, 2 seconds 497 views",News ET Social,497,497,0
6375,"DireTube News Baby miracle for 56-year-old Ethiopian immigrant by News ET Social 7 years ago 44 seconds 7,576 views",News ET Social,7576,7576,0
6376,"DireTube News : Addis to get modern museum by News ET Social 7 years ago 42 seconds 2,637 views",News ET Social,2637,2637,0
6377,"DireTube News 14-year-old killed in a kitchen collapse in Addis by News ET Social 7 years ago 57 seconds 1,256 views",News ET Social,1256,1256,0
6378,"DireTube Poem : Abay Addis Zebrerek Tefetro Recited by Shiwenzu Melaku by News ET Social 7 years ago 3 minutes, 5 seconds 4,454 views",News ET Social,4454,4458,4
6379,"DireTube A 40-a-day smoker has moved to Ethiopia to chase his dream of running for Ireland by News ET Social 7 years ago 49 seconds 1,412 views",News ET Social,1412,1412,0
6380,"DireTube More than 800 million Birr donated for the construction of GERD in six months by News ET Social 7 years ago 40 seconds 1,661 views",News ET Social,1661,1661,0
6381,"DireTube Gabriel Paulista gets work permit, to complete £13m Arsenal move by News ET Social 7 years ago 47 seconds 664 views",News ET Social,664,664,0
6382,DireTube Sport : Sepp Blatter calls for Uefa to show 'courage' and challenge him by News ET Social 7 years ago 52 seconds 298 views,News ET Social,298,298,0
6383,"DireTube News Ethiopian Airlines Gears up for Dreamliner Number 11 by News ET Social 7 years ago 38 seconds 8,851 views",News ET Social,8851,8851,0
6384,"DireTube News Africa to hold 17 elections in 2015, Zambia leading the way by News ET Social 7 years ago 35 seconds 789 views",News ET Social,789,789,0
6385,"DireTube Poem : Lemesale Written and Recited by Belaye Bekele Weya by News ET Social 7 years ago 3 minutes, 41 seconds 7,301 views",News ET Social,7301,7304,3
6386,"DireTube News UK diplomats clash over Briton on death row in Ethiopia by News ET Social 7 years ago 56 seconds 6,018 views",News ET Social,6018,6019,1
6387,DireTube News Africa’s first insulin factory construction to launch in April by News ET Social 7 years ago 55 seconds 706 views,News ET Social,706,707,1
6388,"DireTube News AALRP carried out an electro-mechanical test by News ET Social 7 years ago 37 seconds 9,375 views",News ET Social,9375,9375,0
6389,"DireTube News Police hold Ethiopians despite end of jail term by News ET Social 7 years ago 31 seconds 1,152 views",News ET Social,1152,1152,0
6390,"DireTube News Stephen Harper urged to intervene as Canadian languishes in Ethiopian prison by News ET Social 7 years ago 46 seconds 1,588 views",News ET Social,1588,1588,0
6391,"Helen Berhe Perfoming Live at Selam Ethiopia Festival - DireTube by News ET Social 7 years ago 39 minutes 428,511 views",News ET Social,428511,429162,651
6392,"DireTube News Saudi King Abdullah bin Abdulaziz has died by News ET Social 7 years ago 58 seconds 24,553 views",News ET Social,24553,24555,2
6393,"DireTube News Yemen crisis: President resigns as rebels tighten hold by News ET Social 7 years ago 55 seconds 1,467 views",News ET Social,1467,1467,0
6394,"DireTube News Police officers who confiscate and sold Shishas illegally sentenced to prison by News ET Social 7 years ago 1 minute, 42 seconds 1,254 views",News ET Social,1254,1255,1
6395,"DireTube News Six Eritrean journalists released after nearly six years in prison by News ET Social 7 years ago 53 seconds 1,215 views",News ET Social,1215,1215,0
6396,"DireTube Health Sad &  Short Story (Depression) Narrated by Shiwenzu Melaku by News ET Social 7 years ago 20 minutes 3,380 views",News ET Social,3380,3380,0
6397,"DireTube Poem : Getem Yerabachew Written by Mengistu Zegeye by News ET Social 7 years ago 1 minute, 56 seconds 2,973 views",News ET Social,2973,2980,7
6398,"DireTube A renewed call for the release of Eritrean Patriarch, Abune Antonios by News ET Social 7 years ago 1 minute, 26 seconds 20,036 views",News ET Social,20036,20042,6
6399,"DireTube News Half of ERC Trains Being Assembled in Addis Ababa by News ET Social 7 years ago 40 seconds 24,562 views",News ET Social,24562,24564,2
6400,"DireTube News : Ethiopian Airlines to start flying from Dublin by News ET Social 7 years ago 42 seconds 4,633 views",News ET Social,4633,4633,0
6401,"DireTube Sport Lemi Berhanu Wins Dubai Marathon, Kenenisa Dropped out! by News ET Social 7 years ago 59 seconds 1,519 views",News ET Social,1519,1521,2
6402,DireTube International coffee experts travel the world to find the best tasting cup Ethiopia by News ET Social 7 years ago 51 seconds 455 views,News ET Social,455,455,0
6403,"DireTube News US Visa Initiative for Ethiopian Seafarers by News ET Social 7 years ago 56 seconds 3,893 views",News ET Social,3893,3895,2
6404,"DireTube Ethiopia and Turkey agree to increase trade volume to USD 500mln by News ET Social 7 years ago 46 seconds 2,473 views",News ET Social,2473,2473,0
6405,"DireTube Law : Yekleb Neger Presented by Shiwenzu Melaku by News ET Social 7 years ago 13 minutes, 54 seconds 1,403 views",News ET Social,1403,1406,3
6406,"DireTube Health : Extreme Shifts in Mood Ranging - Eden Short Story - by News ET Social 7 years ago 13 minutes, 2 seconds 2,356 views",News ET Social,2356,2357,1
6407,"DireTube News A Man Beaten to Death by 4 People by News ET Social 7 years ago 1 minute, 12 seconds 2,250 views",News ET Social,2250,2250,0
6408,DireTube Cuba asked America to be off the list of terrorism sponsor nations by News ET Social 7 years ago 48 seconds 755 views,News ET Social,755,755,0
6409,"DireTube News Ethiopian textile firm to export products to Europe & US by News ET Social 7 years ago 37 seconds 1,303 views",News ET Social,1303,1303,0
6410,DireTube News : National Blood Bank achieves 92 per cent of six month plan by News ET Social 7 years ago 51 seconds 914 views,News ET Social,914,914,0
6411,"DireTube News UN said 63 million adolescents are denied their right to education by News ET Social 7 years ago 1 minute, 6 seconds 278 views",News ET Social,278,278,0
6412,"DireTube Video: Interview with Dina Matheussen - 11 Year Old Dancer by News ET Social 7 years ago 23 minutes 77,190 views",News ET Social,77190,77194,4
6413,"DireTube News IGAD regional water resources policy endorsed by News ET Social 7 years ago 1 minute, 28 seconds 199 views",News ET Social,199,199,0
6414,"DireTube News ISIS threatens to kill 2 Japanese hostages by News ET Social 7 years ago 56 seconds 44,836 views",News ET Social,44836,44839,3
6415,"DireTube News Egypt, Ethiopia to ink 'political deal' over Nile water by News ET Social 7 years ago 43 seconds 1,242 views",News ET Social,1242,1242,0
6416,"DireTube TV : Historic Taitu Hotel Reopened after Fire Damage by News ET Social 7 years ago 14 minutes, 55 seconds 11,418 views",News ET Social,11418,11419,1
6417,"DireTube Sport : Ethiopian Women Premier League First Round Evaluation by News ET Social 7 years ago 1 minute, 31 seconds 435 views",News ET Social,435,435,0
6418,"DireTube Kenenisa Bekele would face strong race in tomorrow’s Dubai Marathon by News ET Social 7 years ago 1 minute, 7 seconds 2,548 views",News ET Social,2548,2548,0
6419,"DireTube News IOM Ethiopia Moves Eritrean Refugees to Safety by News ET Social 7 years ago 41 seconds 3,821 views",News ET Social,3821,3824,3
6420,"DireTube News Kenya police fire tear gas on playground protest by News ET Social 7 years ago 47 seconds 1,537 views",News ET Social,1537,1537,0
6421,"DireTube Delays in new sugar factory projects blamed for ethanol shortage by News ET Social 7 years ago 1 minute, 5 seconds 1,075 views",News ET Social,1075,1075,0
6422,"DireTube News Poverty in Ethiopia down 33 percent since 2000 by News ET Social 7 years ago 1 minute, 9 seconds 900 views",News ET Social,900,900,0
6423,"DireTube A record high profit for Ethiopian Airlines by News ET Social 7 years ago 41 seconds 1,480 views",News ET Social,1480,1480,0
6424,"DireTube Mumbai Marathon: It’s Ethiopians Abera, Dinknesh’s day out by News ET Social 7 years ago 48 seconds 1,730 views",News ET Social,1730,1731,1
6425,"DireTube News ADPI to submit report on mega airport project by News ET Social 7 years ago 40 seconds 1,539 views",News ET Social,1539,1539,0
6426,"DireTube PM Hailemariam invited to take part at Egypt’s economic conference by News ET Social 7 years ago 27 seconds 1,140 views",News ET Social,1140,1140,0
6427,"DireTube News Karuturi under the spotlight by News ET Social 7 years ago 46 seconds 1,392 views",News ET Social,1392,1393,1
6428,DireTube News Julphar to build Africa’s largest injectable medicine plant by News ET Social 7 years ago 36 seconds 727 views,News ET Social,727,727,0
6429,"DireTube Kenya, Ethiopia becoming heroin trafficking routes to Europe by News ET Social 7 years ago 40 seconds 1,459 views",News ET Social,1459,1459,0
6430,"DireTube KIA accident: Ethiopian plane had flat tyres by News ET Social 7 years ago 43 seconds 11,842 views",News ET Social,11842,11843,1
6431,"Aster Aweke Winner of the 2006 DireTube Award Life Time Achivement by News ET Social 7 years ago 3 minutes, 44 seconds 14,014 views",News ET Social,14014,14016,2
6432,"Soli Tessema Performing Helo at DireTube Award 2006 by News ET Social 7 years ago 4 minutes, 50 seconds 59,068 views",News ET Social,59068,59069,1
6433,"DireTube News New Hominid fossils found in Ethiopia by News ET Social 7 years ago 29 seconds 6,968 views",News ET Social,6968,6972,4
6434,"DireTube Court to pass verdict on Hana Lalango's rape murder case on Jan 26 by News ET Social 7 years ago 1 minute, 5 seconds 1,384 views",News ET Social,1384,1384,0
6435,"DireTube Genzebe Dibaba to chase world indoor 5000m record in Stockholm by News ET Social 7 years ago 46 seconds 8,877 views",News ET Social,8877,8878,1
6436,"DireTube German Police Investigate Murder of Eritrean Refugee in Dresden by News ET Social 7 years ago 1 minute 10,086 views",News ET Social,10086,10087,1
6437,"DireTube Ghana to probe crash-landing of Ethiopia plane by News ET Social 7 years ago 40 seconds 2,201 views",News ET Social,2201,2201,0
6438,"DireTube New flights from Addis Ababa to Goma widen Ethiopian’s Africa network by News ET Social 7 years ago 26 seconds 1,920 views",News ET Social,1920,1920,0
6439,"DireTube News Malian Mulim ""hero"" of Paris attacks gets French nationality by News ET Social 7 years ago 24 seconds 1,735 views",News ET Social,1735,1735,0
6440,"DireTube The 30th edition of the Africa Cup of Nations will kick off on Saturday by News ET Social 7 years ago 1 minute, 14 seconds 978 views",News ET Social,978,978,0
6441,"DireTube Sport st.george football club promote youth player for senior team by News ET Social 7 years ago 1 minute, 2 seconds 755 views",News ET Social,755,755,0
6442,"DireTubeStudy: South Sudan conflict could cost $158 billion over next 20 years by News ET Social 7 years ago 39 seconds 1,313 views",News ET Social,1313,1344,31
6443,"DireTube Faulty wiring blamed for devastating fire at Taitu Hotel by News ET Social 7 years ago 26 seconds 1,203 views",News ET Social,1203,1221,18
6444,"DireTube Conference and Training On Digital Diplomacy Opened in Addis Ababa by News ET Social 7 years ago 23 seconds 1,658 views",News ET Social,1658,1665,7
6445,"DireTube Ethiopia, Italy sign cooperation agreement by News ET Social 7 years ago 30 seconds 1,095 views",News ET Social,1095,1108,13
6446,"DireTube Ethiopia Sentences Three Britons to Jail on Terrorism Charges by News ET Social 7 years ago 47 seconds 1,862 views",News ET Social,1862,1867,5
6447,"DireTube British MPs to visit Ethiopia in bid to secure release of Andy Tsege by News ET Social 7 years ago 46 seconds 2,716 views",News ET Social,2716,2778,62
6448,"DireTube Ethiopian Opposition Faces Difficulty in Entering Upcoming Elections by News ET Social 7 years ago 55 seconds 1,467 views",News ET Social,1467,1471,4
6449,"DireTube News Coke Launched New Advertisement Campaign by News ET Social 7 years ago 24 seconds 1,823 views",News ET Social,1823,1823,0
6450,"DireTube News Ethiopian Airlines set to fly to Tokyo by News ET Social 7 years ago 26 seconds 1,970 views",News ET Social,1970,1970,0
6451,"Manchester City's £28m purchase of Swansea's Ivory Coast striker Wilfried Bony by News ET Social 7 years ago 45 seconds 1,028 views",News ET Social,1028,1028,0
6452,DireTube Ethiopia to Send Weapons to Somalia to Counter al-Shabaab by News ET Social 7 years ago 39 seconds 814 views,News ET Social,814,814,0
6453,HRC calls on Ethiopian authorities to release detained Somaliland journalist by News ET Social 7 years ago 45 seconds 581 views,News ET Social,581,581,0
6454,DireTube Sport Yaya Toure: Respect needed from media in dealing with religion by News ET Social 7 years ago 55 seconds 944 views,News ET Social,944,944,0
6455,"DireTube News Very soon Ethiopian food will rule the world by News ET Social 7 years ago 33 seconds 1,866 views",News ET Social,1866,1870,4
6456,"DireTube News Egyptian President Sisi Affirms Ethiopia’s Right to the Nile by News ET Social 7 years ago 26 seconds 1,289 views",News ET Social,1289,1291,2
6457,"DireTube Video Current Status & Quick Facts About Ethiopia Railway  Project by News ET Social 7 years ago 9 minutes, 44 seconds 14,293 views",News ET Social,14293,14293,0
6458,"DireTube Prison verdicts to suspects convicted of attempting to set up Islamic State in Ethiopia by News ET Social 7 years ago 57 seconds 1,609 views",News ET Social,1609,1610,1
6459,"DireTube Sport Cristiano Ronaldo wins Ballon d’Or over Lionel Messi & Manuel Neuer by News ET Social 7 years ago 56 seconds 1,023 views",News ET Social,1023,1023,0
6460,DireTube News Bad beer kills at least 69 people in Mozambique by News ET Social 7 years ago 30 seconds 822 views,News ET Social,822,823,1
6461,DireTube News AU condemns latest Boko Haram attacks by News ET Social 7 years ago 31 seconds 583 views,News ET Social,583,584,1
6462,DireTube World’s top Hotel Executives to congregate in Addis for the second year in a row by News ET Social 7 years ago 26 seconds 672 views,News ET Social,672,673,1
6463,DireTube News Nation to Open 11 New Universities in Second GTP Period by News ET Social 7 years ago 27 seconds 654 views,News ET Social,654,658,4
6464,"DireTube News Heineken's hopes for beer market growth by News ET Social 7 years ago 45 seconds 1,020 views",News ET Social,1020,1023,3
6465,DireTube News Lucy to be exhibited in Gondar by News ET Social 7 years ago 45 seconds 639 views,News ET Social,639,640,1
6466,"DireTube News Ethiopian police arrested more than five foreigners by News ET Social 7 years ago 1 minute, 14 seconds 2,628 views",News ET Social,2628,2628,0
6467,"DireTube Video - Fire destroyed the the first Ethiopian Taitu Hotel by News ET Social 7 years ago 15 minutes 5,258 views",News ET Social,5258,5259,1
6468,"DireTube Interview with Wendimu Negash - Talks about the Human Brain by News ET Social 7 years ago 27 minutes 2,232 views",News ET Social,2232,2233,1
6469,"DireTube Exclusive Interview with Dr. Mahlet Tesfaye by News ET Social 7 years ago 25 minutes 21,248 views",News ET Social,21248,21255,7
6470,"DireTube News Ethiopia imports cotton to meet textile industry demand by News ET Social 7 years ago 46 seconds 1,944 views",News ET Social,1944,1944,0
6471,Court hands down prison sentences to 26 suspects for displacing ethnic Amharas from Benishangul by News ET Social 7 years ago 58 seconds 768 views,News ET Social,768,768,0
6472,"DireTube News Ethiopian Airlines to expand its Indian market by News ET Social 7 years ago 46 seconds 9,695 views",News ET Social,9695,9695,0
6473,"DireTube News Top 20 Largest Private Companies in Ethiopia by News ET Social 7 years ago 55 seconds 2,038 views",News ET Social,2038,2043,5
6474,"A Man Carries A Donkey on his back in an Attempt to Hold Record by News ET Social 7 years ago 4 minutes, 3 seconds 7,164 views",News ET Social,7164,7165,1
6475,"Court Adjourns Ethiopian Bloggers’ Trial for 15th Time - DireTube by News ET Social 7 years ago 56 seconds 1,422 views",News ET Social,1422,1422,0
6476,"Diaspora Housing Registration in Final Stage | DireTube by News ET Social 7 years ago 44 seconds 2,084 views",News ET Social,2084,2084,0
6477,"Construction of the Transformer Company 95 % completed - DireTube by News ET Social 7 years ago 1 minute, 2 seconds 295 views",News ET Social,295,295,0
6478,"Ethiopian Maid in coma after jumping from flat in Sharjah - DireTube by News ET Social 7 years ago 51 seconds 235,147 views",News ET Social,235147,235151,4
6479,"Spectacular Ethiopian Epiphany comes to Liverpool Cathedral - DireTube by News ET Social 7 years ago 44 seconds 2,566 views",News ET Social,2566,2566,0
6480,"DireTube Cinema Kemeten Belay (ከመጠን በላይ) - Ethiopian Film by News ET Social 7 years ago 1 hour, 47 minutes 733,705 views",News ET Social,733705,734942,1237
6481,"DireTube Award 2006 - Sheraton Addis by News ET Social Streamed 7 years ago 1 hour, 6 minutes 11,777 views",News ET Social,11777,11778,1
6482,"DireTube  Law Killing in Self-Defense in Ethiopian Criminal Law by Kidane Mekash by News ET Social 7 years ago 9 minutes, 35 seconds 2,869 views",News ET Social,2869,2881,12
6483,"DireTube News Ethiopia is leading in Africa in giving amnesty to convicts by News ET Social 7 years ago 56 seconds 1,095 views",News ET Social,1095,1095,0
6484,"DireTube Gondar University is conducting community - relevant research by News ET Social 7 years ago 50 seconds 1,039 views",News ET Social,1039,1039,0
6485,"DireTube Exclusive: An Eritrean opposition group threatens an Australian mining giant by News ET Social 7 years ago 1 minute, 7 seconds 35,365 views",News ET Social,35365,35365,0
6486,"DireTube News - 2-year-old kills mother with her own gun at Idaho Wal-Mart by News ET Social 7 years ago 43 seconds 2,186 views",News ET Social,2186,2186,0
6487,"DireTube Poem - Yeshirubaw Tinebit (የሽሩባው ትንቢት) Written and Narrated by Efrem Seyoum by News ET Social 7 years ago 10 minutes, 11 seconds 10,256 views",News ET Social,10256,10266,10
6488,"DireTube News - Ethiopia is gearing up to deploy about 2000 strong forces to South Sudan by News ET Social 7 years ago 36 seconds 30,733 views",News ET Social,30733,30733,0
6489,"DireTube Health - People need to kill oneself due to stress by Wendmu Negash by News ET Social 7 years ago 19 minutes 1,370 views",News ET Social,1370,1371,1
6490,"DireTube News - Egypt, Ethiopia settle dispute over Nile dam study by News ET Social 7 years ago 55 seconds 3,360 views",News ET Social,3360,3360,0
6491,"DireTube News - DNA links two felons to Capitol Hill rape by News ET Social 7 years ago 54 seconds 42,906 views",News ET Social,42906,42906,0
6492,"DireTube News - Ethiopia: ERA, EEA Agreed for Partnership by News ET Social 7 years ago 49 seconds 2,833 views",News ET Social,2833,2833,0
6493,"DireTube News - El-Sisi to visit Ethiopia, Kuwait, Bahrain and UAE in January by News ET Social 7 years ago 42 seconds 1,314 views",News ET Social,1314,1314,0
6494,"DireTube Law  Kidane Mekasha - National Anthem of Ethiopia Narrated by Shiwenzu Melaku by News ET Social 7 years ago 9 minutes, 18 seconds 2,003 views",News ET Social,2003,2003,0
6495,"DireTube Sport Top Sport News From DireTube Sport Dec 31, 2014 by News ET Social 7 years ago 2 minutes, 17 seconds 1,476 views",News ET Social,1476,1477,1
6496,"DireTube News El-Sisi to visit Ethiopia, Kuwait, Bahrain and UAE in January by News ET Social 7 years ago 57 seconds 2,130 views",News ET Social,2130,2131,1
6497,"DireTube News Water filling for Gilgel Gibe III to commence after 15 days by News ET Social 7 years ago 55 seconds 5,083 views",News ET Social,5083,5083,0
6498,"DireTube News Superstitions Still Killing Children in Southwest Ethiopia by News ET Social 7 years ago 1 minute, 8 seconds 2,132 views",News ET Social,2132,2132,0
6499,"DireTube News Intercontinental Hotel Won World Luxury Hotel Award by News ET Social 7 years ago 42 seconds 2,507 views",News ET Social,2507,2507,0
6500,"DireTube News Ethiopia building station to launch rocket by News ET Social 7 years ago 48 seconds 3,659 views",News ET Social,3659,3659,0
6501,"Aba Sahle - Monk who died kneeling for a prayer 110 years Ago | DireTube by News ET Social 7 years ago 15 minutes 62,821 views",News ET Social,62821,62842,21
6502,"DireTube - Everymove is Politics - By Belay Bekele by News ET Social 7 years ago 2 minutes, 47 seconds 8,779 views",News ET Social,8779,8782,3
6503,"Exclusive Interview with Shimeles Abera Joro - DireTube by News ET Social 7 years ago 20 minutes 6,167 views",News ET Social,6167,6177,10
6504,"DireTube Poem Tizebet Written & Narrated By Endale Alem by News ET Social 7 years ago 4 minutes, 39 seconds 2,639 views",News ET Social,2639,2641,2
6505,"DireTube Ethiopian opposition figure downplays reports of job dismissal by News ET Social 7 years ago 41 seconds 2,420 views",News ET Social,2420,2420,0
6506,"DireTube Dr. Fetien Abay Wins the AU Kwame Nkrumah Scientific Award by News ET Social 7 years ago 41 seconds 1,354 views",News ET Social,1354,1354,0
6507,"DireTube kaki Tesfaye given three years suspended sentence by News ET Social 7 years ago 1 minute, 33 seconds 5,158 views",News ET Social,5158,5159,1
6508,"DireTube World Vision Receives DOL Grant to Combat Exploitative Child Labor by News ET Social 7 years ago 48 seconds 1,046 views",News ET Social,1046,1046,0
6509,"DireTube Ethiopia Supports African Nations Mass Withdrawal from ICC by News ET Social 7 years ago 45 seconds 3,045 views",News ET Social,3045,3045,0
6510,"DireTube Ethiopian government hasn’t tried for the return of combat helicopter from Eritrea by News ET Social 7 years ago 50 seconds 14,340 views",News ET Social,14340,14340,0
6511,"Mahmoud Ahmed's Guragigna Live Performance @Selam Festival by News ET Social 7 years ago 6 minutes, 15 seconds 8,490 views",News ET Social,8490,8515,25
6512,"DireTube News “I married my little sister” – Ortis Wiliki reveals by News ET Social 7 years ago 1 minute, 19 seconds 3,068 views",News ET Social,3068,3068,0
6513,"DireTube Ethiopian to provide premium charter flight service with light aircraft by News ET Social 7 years ago 1 minute, 14 seconds 43,326 views",News ET Social,43326,43326,0
6514,"DireTube 20 years sentence for man convicted of sexually assaulting a five year old boy by News ET Social 7 years ago 1 minute, 31 seconds 950 views",News ET Social,950,950,0
6515,"DireTube News Ethiopia struggles to help its 5.5mn child laborers by News ET Social 7 years ago 1 minute, 6 seconds 1,435 views",News ET Social,1435,1435,0
6516,"DireTube News UNWTO to star rate 400 hotels in Ethiopia by News ET Social 7 years ago 1 minute, 5 seconds 778 views",News ET Social,778,778,0
6517,"DireTube Video Ras Kawintseb Live  Performance @ Reggae Night by News ET Social 7 years ago 5 minutes, 56 seconds 805 views",News ET Social,805,806,1
6518,"Wegene (ወገኔ) - Produced by Zeleman | Sponsored by Meta Abo Brewery S.C by News ET Social 7 years ago 4 minutes, 39 seconds 7,685 views",News ET Social,7685,7687,2
6519,"DireTube News Artistic Works of Adis Gebru of Ethiopia by News ET Social 7 years ago 49 seconds 1,227 views",News ET Social,1227,1229,2
6520,"DireTube News Prosecutor amended his charge on rape murder of Hana Lalango by News ET Social 7 years ago 1 minute, 45 seconds 2,780 views",News ET Social,2780,2780,0
6521,"DireTube News Ethiopia To Complete Soon Power Transmission Line Project To Supply The South by News ET Social 7 years ago 44 seconds 1,659 views",News ET Social,1659,1660,1
6522,"DireTube News Death of British tourist won’t affect industry: Ethiopian Minister by News ET Social 7 years ago 45 seconds 1,014 views",News ET Social,1014,1014,0
6523,Ethiopia expected to grant lots of patent in the next five years | DireTube News by News ET Social 7 years ago 59 seconds 469 views,News ET Social,469,469,0
6524,"Mesfin Bekele - Asham Addis Ababa [Hot! NEW Ethiopian Music 2015] by News ET Social 7 years ago 4 minutes, 54 seconds 39,939 views",News ET Social,39939,39947,8
6525,"Hijacked Ethiopian attack helicopter landed in Eritrea |DireTube News by News ET Social 7 years ago 56 seconds 7,759 views",News ET Social,7759,7759,0
6526,"Ethiopia says ready to boost Somalia troops after Sierra Leone exit | DireTube News by News ET Social 7 years ago 45 seconds 2,179 views",News ET Social,2179,2182,3
6527,"Africa should stop relying on West aid over Ebola |DireTube News by News ET Social 7 years ago 38 seconds 2,045 views",News ET Social,2045,2045,0
6528,"DireTube News I Never Recommended Assab Belonged to Ethiopia: Ambassador Hermen Cohen by News ET Social 7 years ago 1 minute, 25 seconds 4,403 views",News ET Social,4403,4403,0
6529,DireTube News Body of deceased British citizen arrived in Addis by News ET Social 7 years ago 34 seconds 945 views,News ET Social,945,945,0
6530,"DireTube Ethiopia will soon lift the travel ban to the Middle East countries by News ET Social 7 years ago 56 seconds 31,511 views",News ET Social,31511,31511,0
6531,"DireTube ICSA President :Western Sahara’s issue with Morocco need to be resolved at the UN by News ET Social 7 years ago 53 seconds 1,992 views",News ET Social,1992,1992,0
6532,"DireTube Poem Poet Mel'eti Kiros Melese Alba Teyake Best Poem by News ET Social 7 years ago 5 minutes, 11 seconds 15,770 views",News ET Social,15770,15788,18
6533,"DireTube News Africa Hall, 1st complex of ECA to be museum by News ET Social 7 years ago 42 seconds 1,204 views",News ET Social,1204,1204,0
6534,"DireTube News Ethiopian woman stabbed to death in Israel, husband hanged himself nearby by News ET Social 7 years ago 49 seconds 922 views",News ET Social,922,923,1
6535,DireTube News ICSA: new material that can contain and destroy Ebola under testing by News ET Social 7 years ago 55 seconds 300 views,News ET Social,300,300,0
6536,"DireTube News Ethiopia, Sudan Sign 3 Media Agreements by News ET Social 7 years ago 32 seconds 379 views",News ET Social,379,379,0
6537,DireTube News New NBE’s Machine Converts Old Currency Notes into Bricks by News ET Social 7 years ago 49 seconds 669 views,News ET Social,669,669,0
6538,DireTube Mother who threw her new born sentenced to three years in prison by News ET Social 7 years ago 56 seconds 913 views,News ET Social,913,913,0
6539,"DireTube Video Alemayehu Eshete Performing Live @ Selam Music Festival by News ET Social 7 years ago 5 minutes, 50 seconds 2,888 views",News ET Social,2888,2890,2
6540,"DireTube Health Wendemu Negash Etsegenet Yilma Narrated Heartbreaking Story Schizophrenia by News ET Social 7 years ago 12 minutes, 45 seconds 2,559 views",News ET Social,2559,2561,2
6541,"DireTube Poem YeBandera Gemed Written by Gemechu Merera & Recited by Shiwenzu Melaku by News ET Social 7 years ago 2 minutes, 44 seconds 3,113 views",News ET Social,3113,3115,2
6542,"DireTube Health Wendemu Negash Short Sad Story of Alcoholic Men Presented by Shiwenzu Melaku by News ET Social 7 years ago 13 minutes, 46 seconds 1,692 views",News ET Social,1692,1693,1
6543,"DireTube Law Kidane Mekasha : wrongful conviction review in Ethiopia Presented by Shiwenzu Melaku by News ET Social 7 years ago 4 minutes, 24 seconds 2,221 views",News ET Social,2221,2222,1
6544,"DireTube EY Ethiopia’s Zemedeneh Negatu Among Africa’s Top 15 CEOs to Watch in 2015 by News ET Social 7 years ago 1 minute, 6 seconds 1,722 views",News ET Social,1722,1723,1
6545,DireTube Puntland Security forces capture more than 200 Ethiopian Immigrants by News ET Social 7 years ago 47 seconds 836 views,News ET Social,836,837,1
6546,"DireTube News Argentina town bans 'sexist' beauty competitions by News ET Social 7 years ago 51 seconds 1,546 views",News ET Social,1546,1546,0
6547,"DireTube News Ethiopia to register six additional heritages under UNESCO by News ET Social 7 years ago 53 seconds 1,929 views",News ET Social,1929,1931,2
6548,"DireTube Israeli energy company AORA brings hybrid solar power to off-grid locations in Ethiopia by News ET Social 7 years ago 1 minute, 2 seconds 1,942 views",News ET Social,1942,1943,1
6549,"DireTube News Hijacked Ethiopian attack helicopter landed in Eritrea by News ET Social 7 years ago 28 seconds 48,384 views",News ET Social,48384,48392,8
6550,"DireTube Government has to fetch help for GERD from the Ethiopian diaspora: MP Girma Seifu by News ET Social 7 years ago 7 minutes, 36 seconds 7,522 views",News ET Social,7522,7522,0
6551,"DireTube News An Ethiopian leader in India: Malik Ambar (1548 - 1626) by News ET Social 7 years ago 45 seconds 1,740 views",News ET Social,1740,1744,4
6552,"DireTube Health Ministry ordered an investigation on an Indian eye care center OIA by News ET Social 7 years ago 1 minute, 18 seconds 377 views",News ET Social,377,377,0
6553,"DireTube News  Ethiopian public diplomacy delegates speak about their diplomatic mission in Egypt by News ET Social 7 years ago 19 minutes 3,481 views",News ET Social,3481,3483,2
6554,"DireTube News Egypt receives 10 Apache helicopters from U.S by News ET Social 7 years ago 57 seconds 29,096 views",News ET Social,29096,29096,0
6555,"DireTube Video A Public Diplomacy Delegation - Dr.Hirut W-Mariam by News ET Social 7 years ago 7 minutes, 36 seconds 2,664 views",News ET Social,2664,2666,2
6556,"DireTube News Interpol set to open its first office in Africa by News ET Social 7 years ago 1 minute, 2 seconds 715 views",News ET Social,715,715,0
6557,"DireTube News Sponsors pay SR400,000 arrears to housemaids by News ET Social 7 years ago 38 seconds 39,942 views",News ET Social,39942,39943,1
6558,"DireTube News Authority launches upgrading Dire Dawa-Dewele road by News ET Social 7 years ago 37 seconds 2,247 views",News ET Social,2247,2250,3
6559,"DireTube Video  Meet World Laureate Dr. Tibebe YemaneBerhan a public diplomacy delegation by News ET Social 7 years ago 10 minutes, 38 seconds 3,101 views",News ET Social,3101,3103,2
6560,"DireTube Law Contract of Loan for use in Ethiopian Law by News ET Social 7 years ago 6 minutes, 46 seconds 4,374 views",News ET Social,4374,4379,5
6561,Directive on law banning smoking at public spaces enacted in Ethiopia | DireTube by News ET Social 7 years ago 51 seconds 732 views,News ET Social,732,732,0
6562,Ethiopia launches Africa Against Ebola SMS fundraising Campaign | DireTube by News ET Social 7 years ago 40 seconds 282 views,News ET Social,282,282,0
6563,"UN probe uncovers targeting of civilians, abductions and sexual violence in South Sudan by News ET Social 7 years ago 40 seconds 109 views",News ET Social,109,109,0
6564,Ethiopia says bond will not finance GERD | DireTube News by News ET Social 7 years ago 40 seconds 451 views,News ET Social,451,451,0
6565,UDJ launches election campaign dubbed “2007 for Change” | DireTube News by News ET Social 7 years ago 37 seconds 571 views,News ET Social,571,571,0
6566,Ethiopian cargo qualifies for EU security regulation | DireTube News by News ET Social 7 years ago 37 seconds 688 views,News ET Social,688,688,0
6567,EPRDF to run uncontested in Harari | DireTube News by News ET Social 7 years ago 34 seconds 322 views,News ET Social,322,322,0
6568,"DireTube News 2400 Refugees Return to Blue Nile from Ethiopia by News ET Social 7 years ago 38 seconds 1,964 views",News ET Social,1964,1964,0
6569,"DireTube AU donated 100,000 dollars to Cape Verde in the aftermath of a major volcanic eruption by News ET Social 7 years ago 53 seconds 1,487 views",News ET Social,1487,1487,0
6570,"DireTube News Egypt open to River Nile negotiations – Official by News ET Social 7 years ago 1 minute, 12 seconds 1,230 views",News ET Social,1230,1230,0
6571,"DireTube News Protest Held in Bahirdar over controversial construction site by News ET Social 7 years ago 50 seconds 2,856 views",News ET Social,2856,2857,1
6572,"DireTube News Diaspora Housing Development Program Near Final by News ET Social 7 years ago 47 seconds 7,215 views",News ET Social,7215,7215,0
6573,"DireTube News CPJ: Ethiopia remains one of the worst places to be a journalist by News ET Social 7 years ago 1 minute, 6 seconds 1,975 views",News ET Social,1975,1975,0
6574,"DireTube News Ethiopia’s projects won’t harm anyone: Egypt’s Pope Tawadros II by News ET Social 7 years ago 35 seconds 2,647 views",News ET Social,2647,2647,0
6575,"DireTube Law Alternative Dispute Resolution (ADR) Techniques by Kidane Mekasha by News ET Social 7 years ago 13 minutes, 21 seconds 340 views",News ET Social,340,340,0
6576,"DireTube News Fight about money led to strangulation death by News ET Social 7 years ago 1 minute, 57 seconds 1,537 views",News ET Social,1537,1537,0
6577,"DireTube Poem Etebekatalhu Written by Poet Gebre Kristos Desta & Recited by Shiwenzu Melaku by News ET Social 7 years ago 3 minutes, 54 seconds 19,031 views",News ET Social,19031,19064,33
6578,DireTube Ericsson snatches more than half of China's ZTE telecom deal by News ET Social 7 years ago 58 seconds 754 views,News ET Social,754,754,0
6579,"DireTube News Arab Contractors will participate in Ethiopian road project by News ET Social 7 years ago 54 seconds 2,698 views",News ET Social,2698,2699,1
6580,"DireTube News Ethiopian rabbis accuse Israeli rabbinate of racial discrimination by News ET Social 7 years ago 1 minute, 1 second 3,258 views",News ET Social,3258,3258,0
6581,"DireTube N ews Foreign companies are to join the rapidly expanding housing program in Addis Ababa by News ET Social 7 years ago 50 seconds 5,772 views",News ET Social,5772,5772,0
6582,DireTube NewsAgency to Install Modern Radar that Protects River Nile Basin by News ET Social 7 years ago 45 seconds 602 views,News ET Social,602,602,0
6583,"DireTube News China is world's worst jailer of the press; global tally second worst on record by News ET Social 7 years ago 1 minute, 2 seconds 1,030 views",News ET Social,1030,1030,0
6584,"DireTube - The Invisible War by Tewdros Tadesse by News ET Social 7 years ago 15 minutes 1,869 views",News ET Social,1869,1869,0
6585,"DireTube - Aben Man Yewres - Kidane Mekasha by News ET Social 7 years ago 10 minutes, 18 seconds 345 views",News ET Social,345,345,0
6586,"DireTube News NBE to Print Banknotes in Ethiopia by News ET Social 7 years ago 1 minute, 23 seconds 85,156 views",News ET Social,85156,85173,17
6587,"DireTube News UN commission asks for Ebola debt forgiveness by News ET Social 7 years ago 45 seconds 4,487 views",News ET Social,4487,4487,0
6588,"DireTube News Yoga may guard against heart disease, study finds by News ET Social 7 years ago 47 seconds 668 views",News ET Social,668,668,0
6589,"DireTube News 20% of Egypt's Nile water share lost through ‘misuse by News ET Social 7 years ago 42 seconds 1,189 views",News ET Social,1189,1189,0
6590,"DireTube News Fatal gang rape suspects of Hanna Lalango to be charged by News ET Social 7 years ago 1 minute, 12 seconds 802 views",News ET Social,802,802,0
6591,"DireTube Exclusive: Interview with Footballer Abebaw Butako by News ET Social 7 years ago 19 minutes 1,902 views",News ET Social,1902,1904,2
6592,"DireTube Poem Erub Gudaye Poet Solomon Sahele's Love Poem by News ET Social 7 years ago 3 minutes, 3 seconds 22,618 views",News ET Social,22618,22686,68
6593,"DireTube News Kenenisa Bekele Confirmed For Standard Chartered Dubai Marathon by News ET Social 7 years ago 35 seconds 26,923 views",News ET Social,26923,26924,1
6594,DireTube News Ethiopia and The Gambia most repressive; South Africa and Kenya freest by News ET Social 7 years ago 50 seconds 774 views,News ET Social,774,774,0
6595,DireTube News Ethiopia’s Agriculture ministry rolls out specialized phone service for farmers by News ET Social 7 years ago 51 seconds 495 views,News ET Social,495,495,0
6596,"DireTube News The first year anniversary of the onset of the conflict in South Sudan by News ET Social 7 years ago 48 seconds 1,042 views",News ET Social,1042,1042,0
6597,"DireTube News Ethiopia and The Gambia most repressive by News ET Social 7 years ago 45 seconds 1,260 views",News ET Social,1260,1260,0
6598,DireTube News Commission Licenses 224 New Investments by News ET Social 7 years ago 46 seconds 670 views,News ET Social,670,670,0
6599,"DireTube Law Declaration of absence in Ethiopian law by News ET Social 7 years ago 8 minutes, 26 seconds 5,962 views",News ET Social,5962,5966,4
6600,"DireTube Poem Yehe Getime Written and Narrated by Poet Ferzer Admasu by News ET Social 7 years ago 3 minutes, 47 seconds 3,095 views",News ET Social,3095,3099,4
6601,"DireTube News Government Communication Office Launches Portal Web Page by News ET Social 7 years ago 12 minutes, 8 seconds 1,001 views",News ET Social,1001,1001,0
6602,"DireTube News Airports enterprise to construct three new airports by News ET Social 7 years ago 39 seconds 7,285 views",News ET Social,7285,7286,1
6603,"DireTube News Ethiopian Named Best Airline to Africa by News ET Social 7 years ago 1 minute, 2 seconds 6,950 views",News ET Social,6950,6950,0
6604,"DireTube News House committee warns Adama University over budget misuse by News ET Social 7 years ago 1 minute, 7 seconds 2,283 views",News ET Social,2283,2283,0
6605,"DireTube News Fuel distribution quandary hits nation by News ET Social 7 years ago 1 minute, 4 seconds 1,228 views",News ET Social,1228,1228,0
6606,"DireTube News Ethiopia will receive 13 Million Praziquantel Tablets in 2015 by News ET Social 7 years ago 48 seconds 1,707 views",News ET Social,1707,1710,3
6607,"DireTube News Ethiopia’s Gibe III dam 87% complete by News ET Social 7 years ago 43 seconds 7,322 views",News ET Social,7322,7322,0
6608,DireTube News Ethiopian popular delegation to visit Cairo on Sunday by News ET Social 7 years ago 37 seconds 775 views,News ET Social,775,775,0
6609,DireTube News Top 30 Coffees of 2014 by News ET Social 7 years ago 55 seconds 252 views,News ET Social,252,252,0
6610,"DireTube News 10 Trams for AALR reach Addis by News ET Social 7 years ago 51 seconds 2,706 views",News ET Social,2706,2706,0
6611,"DireTube News A public bank branch to open in Ethiopia by News ET Social 7 years ago 1 minute, 18 seconds 377 views",News ET Social,377,377,0
6612,"DireTube Video 9th Ethiopian NNPD celebration at Guba & Asosa City. by News ET Social 7 years ago 8 minutes, 49 seconds 4,660 views",News ET Social,4660,4681,21
6613,"DireTube Law Kidane Mekash What is Justice? Philosophy and Justice by News ET Social 7 years ago 17 minutes 5,003 views",News ET Social,5003,5003,0
6614,DireTube News 17 parties will not be taking part in the May election by News ET Social 7 years ago 54 seconds 582 views,News ET Social,582,582,0
6615,"DireTube News Youth who brutally killed his sister fled away by News ET Social 7 years ago 1 minute, 10 seconds 859 views",News ET Social,859,859,0
6616,DireTube News ICAO to audit Ethiopian civil aviation authority by News ET Social 7 years ago 50 seconds 980 views,News ET Social,980,981,1
6617,"DireTube News Ethiopia-Kenya pact targets communities at the border by News ET Social 7 years ago 45 seconds 1,248 views",News ET Social,1248,1248,0
6618,DireTube News Italian garment firm to set up manufacturing in Ethiopia by News ET Social 7 years ago 46 seconds 794 views,News ET Social,794,795,1
6619,"DireTube News 185 hospitals across Ethiopia to be operational by News ET Social 7 years ago 48 seconds 1,319 views",News ET Social,1319,1319,0
6620,"DireTube Health: Wendemu Negash Is a Stress-free Life Possible? by News ET Social 7 years ago 20 minutes 4,175 views",News ET Social,4175,4180,5
6621,"Poet Abere Ayalew YeHilina Chuhet Recited by Shiwenzu Melaku by News ET Social 7 years ago 5 minutes, 19 seconds 5,646 views",News ET Social,5646,5656,10
6622,"DireTube News Ethiopian Women killed in Juba South Sudan by News ET Social 7 years ago 48 seconds 52,613 views",News ET Social,52613,52618,5
6623,DireTube News Ethiopia seeks Indian help to revitalise higher education by News ET Social 7 years ago 32 seconds 717 views,News ET Social,717,717,0
6624,DireTube News South Sudanese Students Win Scholarships to Ethiopia by News ET Social 7 years ago 35 seconds 759 views,News ET Social,759,759,0
6625,"DireTube News Economic growth boosting Ethiopia’s ability to use ports in Djibouti by News ET Social 7 years ago 52 seconds 1,608 views",News ET Social,1608,1608,0
6626,"DireTube News Eurobonds and potash will boost Ethiopia and Africa’s food security by News ET Social 7 years ago 51 seconds 1,082 views",News ET Social,1082,1082,0
6627,"DireTube News Difret is Ethiopia’s Official Selection for the Academy Awards by News ET Social 7 years ago 44 seconds 11,216 views",News ET Social,11216,11216,0
6628,"DireTube News Press Conference on Ambo's Charity Project Show You Care! by News ET Social 7 years ago 12 minutes, 1 second 3,045 views",News ET Social,3045,3046,1
6629,"DireTube Poem Tazebgne Written by Poet Zewdu Yesake & Presented by Shiwenzu Melaku by News ET Social 7 years ago 2 minutes, 54 seconds 2,361 views",News ET Social,2361,2366,5
6630,"DireTube Local UN body, Ethiopian Airlines sign accord for library project by News ET Social 7 years ago 34 seconds 584 views",News ET Social,584,584,0
6631,"DireTube News Saudi arrests Ethiopian Man on terrorism charges by News ET Social 7 years ago 42 seconds 132,026 views",News ET Social,132026,132029,3
6632,"DireTube Ethiopian Maid fell from a building attempting to escape from her sponsor by News ET Social 7 years ago 39 seconds 95,368 views",News ET Social,95368,95369,1
6633,"DireTube News 70 Ethiopian migrants die in boat disaster near Yemen by News ET Social 7 years ago 34 seconds 14,956 views",News ET Social,14956,14959,3
6634,"DireTube News Ethiopia’s Bentonite Trail: A Development Path? by News ET Social 7 years ago 35 seconds 1,528 views",News ET Social,1528,1531,3
6635,"DireTube Heath Wendemu Negash What are the types of Jealousy? by News ET Social 7 years ago 9 minutes, 14 seconds 10,397 views",News ET Social,10397,10403,6
6636,DireTube News - UN condemned latest attacks in Somalia's Baidoa town by News ET Social 7 years ago 56 seconds 459 views,News ET Social,459,460,1
6637,"DireTube News - Beloved two-faced cat that was only meant to live a few days dies of cancer aged 15 by News ET Social 7 years ago 1 minute, 6 seconds 498 views",News ET Social,498,498,0
6638,DireTube - Expansion of Ashegoda Wind Farm to help Ethiopia add 40MW of power by News ET Social 7 years ago 49 seconds 774 views,News ET Social,774,774,0
6639,"DireTube News - Saudi border guards kill Ethiopian smugglers by News ET Social 7 years ago 47 seconds 1,682 views",News ET Social,1682,1684,2
6640,"DireTube News - Ethiopia scored world record in biggest concrete pour at Renaissance Dam by News ET Social 7 years ago 1 minute, 24 seconds 4,238 views",News ET Social,4238,4238,0
6641,DireTube News - Ethiopia among top 10 worst countries for Internet freedom by News ET Social 7 years ago 52 seconds 652 views,News ET Social,652,652,0
6642,"DireTube Entertainment Ethio Color Music Album Release Party @ Fendika by News ET Social 7 years ago 16 minutes 1,004 views",News ET Social,1004,1005,1
6643,"DireTube Poem Tizeta Ena Tesfa Written and Narrated by Poet Ferzer Admasu by News ET Social 7 years ago 6 minutes, 16 seconds 12,044 views",News ET Social,12044,12058,14
6644,"DireTube News Ethiopia receives US$1.4bn petro pipeline project proposal by News ET Social 7 years ago 35 seconds 15,567 views",News ET Social,15567,15573,6
6645,"DireTube News Jimma University, KOFIH sign MoU by News ET Social 7 years ago 36 seconds 2,259 views",News ET Social,2259,2260,1
6646,"DireTube News IOM aims to curb migration through highlighting hardships in Europe by News ET Social 7 years ago 44 seconds 1,133 views",News ET Social,1133,1133,0
6647,"DireTube News UC Berkeley freshman Selam Sekuar dies at 19 by News ET Social 7 years ago 42 seconds 24,755 views",News ET Social,24755,24757,2
6648,"DireTube News Insurance for Ethiopian herders aims to combat drought, conflict - TRFN by News ET Social 7 years ago 1 minute, 5 seconds 1,942 views",News ET Social,1942,1942,0
6649,"DireTube Law Kidane Mekasha Divorce in Ethiopian Law by News ET Social 7 years ago 5 minutes, 47 seconds 5,695 views",News ET Social,5695,5707,12
6650,"DireTube Exclusive Interview with Designer Sara Mohammed by News ET Social 7 years ago 23 minutes 14,146 views",News ET Social,14146,14161,15
6651,"DireTube News Ato Aschalew Belay with Golden Tulip Hotels - Hotel Management Agreement Ceremon by News ET Social 7 years ago 7 minutes, 4 seconds 861 views",News ET Social,861,862,1
6652,"DireTube News : Yegna Band Press Conference by News ET Social 7 years ago 4 minutes, 2 seconds 57,075 views",News ET Social,57075,57075,0
6653,"DireTube Poem Poet Gemechu Merera Afere new Recited by Shiwenzu Melaku by News ET Social 7 years ago 4 minutes, 9 seconds 7,483 views",News ET Social,7483,7498,15
6654,"DireTube Video Sensation Brand Ambassadors 2014 - Mihret and Anteneh by News ET Social 7 years ago 5 minutes, 53 seconds 21,537 views",News ET Social,21537,21542,5
6655,"DireTube News Offers to study Ethiopia's dam expected mid-December by News ET Social 7 years ago 1 minute, 13 seconds 3,474 views",News ET Social,3474,3474,0
6656,"DireTube News ERC inks contracts with Chinese companies for AA-LRT management by News ET Social 7 years ago 1 minute, 4 seconds 1,881 views",News ET Social,1881,1881,0
6657,"DireTube News African mobile network operators launched the ‘Africa Against Ebola SMS’ campaign by News ET Social 7 years ago 1 minute, 6 seconds 409 views",News ET Social,409,409,0
6658,"DireTube News Founder of Whiz Kids Ethiopia, Bruktawit Tigabu, Awarded 2014 Tremplin Prize by News ET Social 7 years ago 1 minute, 20 seconds 1,300 views",News ET Social,1300,1300,0
6659,"DireTube News Ethiopia sees record coffee exports after Brazil's drought by News ET Social 7 years ago 1 minute, 12 seconds 1,602 views",News ET Social,1602,1603,1
6660,"DireTube News China Picks Ethiopia, Tanzania and Mozambique As Investment Model by News ET Social 7 years ago 34 seconds 1,291 views",News ET Social,1291,1291,0
6661,"DireTube Exclusive:Yirgalem Hadish, Miss World Ethiopia 2014 by News ET Social 7 years ago 6 minutes, 25 seconds 4,448 views",News ET Social,4448,4450,2
6662,"DireTube Entertainment: Yegna Band - Ye Hewan Tibebe Live Performance by News ET Social 7 years ago 2 minutes, 56 seconds 28,363 views",News ET Social,28363,28366,3
6663,"DireTube Entertainment The Return Art Show by Seifu Abebe by News ET Social 7 years ago 3 minutes, 6 seconds 1,437 views",News ET Social,1437,1437,0
6664,"DireTube Exclusive Interview with EMA President and Roha Band Member Ato Dawit Yefru by News ET Social 7 years ago 50 minutes 5,901 views",News ET Social,5901,5904,3
6665,"DireTube Health: How to Help Someone with PTSD (Can Occur After a traumatic Event) by News ET Social 7 years ago 11 minutes, 27 seconds 4,012 views",News ET Social,4012,4015,3
6666,"DireTube Exclusive Interview with Artist Jah Lude by News ET Social 7 years ago 24 minutes 134,121 views",News ET Social,134121,134199,78
6667,"DireTube TV Meskel Celebration 2014 after UNESCO Declared it as a World Heritage by News ET Social 7 years ago 7 minutes, 22 seconds 631 views",News ET Social,631,631,0
6668,"DireTube Exclusive Interview with Artist Gedion Daniel by News ET Social 7 years ago 26 minutes 195,276 views",News ET Social,195276,195447,171
6669,"Diretube Sport  Dawit Estifanos, Player of Ethiopian Coffee FC by News ET Social 7 years ago 22 minutes 4,630 views",News ET Social,4630,4635,5
6670,"DireTube Exclusive Interview with Artist Fitsum Tsegaye by News ET Social 7 years ago 48 minutes 140,330 views",News ET Social,140330,140384,54
6671,"DireTube Exclusive Interview with Jossy Gebre by News ET Social 7 years ago 29 minutes 225,374 views",News ET Social,225374,225413,39
6672,"Health Tips : Wendemu Negash Short Sad Story on Panic Anxiety Disorder by News ET Social 7 years ago 11 minutes, 5 seconds 6,229 views",News ET Social,6229,6233,4
6673,DireTube News Gunmen kill dozens in attack on Kenya mine by News ET Social 7 years ago 38 seconds 629 views,News ET Social,629,629,0
6674,DireTube News 250 Nigerian Health Professionals to be Deployed to the Ebola Affected Countries by News ET Social 7 years ago 40 seconds 578 views,News ET Social,578,578,0
6675,"DireTube News Ethiopia plans to build 960,000 houses in the next 10 years by News ET Social 7 years ago 35 seconds 1,625 views",News ET Social,1625,1626,1
6676,"DireTube News Kelowna Physicians Aid Burn Victims in Ethiopia by News ET Social 7 years ago 52 seconds 1,177 views",News ET Social,1177,1177,0
6677,"DireTube News Moyale Road to open up trade, says Kenya National Highways Authority by News ET Social 7 years ago 44 seconds 4,632 views",News ET Social,4632,4633,1
6678,"DireTube News Dozens support appeal of Israeli who killed alleged rapist by News ET Social 7 years ago 1 minute, 9 seconds 351 views",News ET Social,351,351,0
6679,"The 2nd Gumma Award Press Conference - Celebrate Excellence in Ethiopian Cinema by News ET Social 7 years ago 5 minutes, 8 seconds 3,100 views",News ET Social,3100,3101,1
6680,"Wendemu Negash - How to Find True Happiness and Peace - DireTube by News ET Social 7 years ago 6 minutes, 55 seconds 8,731 views",News ET Social,8731,8736,5
6681,Ethiopian awarded title of Best Airline of the Year from Africa by News ET Social 7 years ago 51 seconds 641 views,News ET Social,641,642,1
6682,"DireTube Video - Addis Foto Fest 2014 by News ET Social 7 years ago 4 minutes, 47 seconds 4,591 views",News ET Social,4591,4593,2
6683,"DireTube Video - Press Conference Great Ethiopian Run 2014 by News ET Social 7 years ago 5 minutes, 3 seconds 897 views",News ET Social,897,897,0
6684,"Shimeles Abera (Joro) Speaks about his Recent Health Condition - DireTube Exclusive by News ET Social 7 years ago 15 minutes 26,241 views",News ET Social,26241,26261,20
6685,"Great Ethiopian Run 2014 - DireTube Video by News ET Social 7 years ago 9 minutes, 34 seconds 4,177 views",News ET Social,4177,4178,1
6686,"በክሩዝ ሚሳኤል የጀመረው ፑቲን በኒውክሌር ቦንብ ሊቋጫው ነው by Nuro Bezede ኑሮ በዘዴ 2 days ago 10 minutes, 47 seconds 2,534 views",Nuro Bezede ኑሮ በዘዴ,2534,2878,344
6687,"አዋጊው ታወቀ! ምስጢራዊው የተባበሩት መንግስት ሴራ by Nuro Bezede ኑሮ በዘዴ 10 days ago 9 minutes, 28 seconds 1,023 views",Nuro Bezede ኑሮ በዘዴ,1023,1072,49
6688,"ኮነሬል በዛብህ የሁለት ጀብዱዎች ባለቤት አስገራሚ እውነታዎች by Nuro Bezede ኑሮ በዘዴ 1 month ago 9 minutes, 39 seconds 944 views",Nuro Bezede ኑሮ በዘዴ,944,958,14
6689,"ምስጢራዊው የህወሃት ዓለማቀፋዊ ማስተር ማይንዶች ማህበር ሴራ by Nuro Bezede ኑሮ በዘዴ 1 month ago 10 minutes, 41 seconds 1,020 views",Nuro Bezede ኑሮ በዘዴ,1020,1025,5
6690,"የአብይና ባይደን አዲሱ ወዳጅነት ከድርድር እስከ ነፃነት by Nuro Bezede ኑሮ በዘዴ 1 month ago 9 minutes, 50 seconds 1,288 views",Nuro Bezede ኑሮ በዘዴ,1288,1291,3
6691,"በጦርነቱ ፍፃሜ ማግስት ይህ ይሆናል by Nuro Bezede ኑሮ በዘዴ 1 month ago 10 minutes, 12 seconds 1,635 views",Nuro Bezede ኑሮ በዘዴ,1635,1640,5
6692,"ፃድቃን አመነ፤ “ህወሀትን ሳንቀብር አንመለስም”- መንግስት ወሰነ! by Nuro Bezede ኑሮ በዘዴ 2 months ago 9 minutes, 1 second 1,430 views",Nuro Bezede ኑሮ በዘዴ,1430,1434,4
6693,"Ethiopia - የህወሀት ሰራዊት አስክሬን ይዞ ሸሸ - ቻይና እና ሩሲያ በአሜሪካ ላይ የሰነዘሩት ጥቃት! by Nuro Bezede ኑሮ በዘዴ 2 months ago 12 minutes, 22 seconds 1,404 views",Nuro Bezede ኑሮ በዘዴ,1404,1411,7
6694,"መቀሌ መግብያ ላይ የተደረገዉ ጦርነት እና ደብረፅዮን ለቱርክ የላከዉ መልዕክት! by Nuro Bezede ኑሮ በዘዴ 2 months ago 10 minutes, 27 seconds 1,700 views",Nuro Bezede ኑሮ በዘዴ,1700,1701,1
6695,"Ethiopia - ሰበር ዜና የምስራች እንኳን ደስ አላችሁ ወልዲያ ነፃ ሆናለች by Nuro Bezede ኑሮ በዘዴ 2 months ago 14 minutes, 27 seconds 3,547 views",Nuro Bezede ኑሮ በዘዴ,3547,3550,3
6696,"ጠላት ያራወጠዉ የዶ/ር አብይ ድንገተኛ የቱርክ ጉዞ እና ሚስጥራዊ አላማዉ! by Nuro Bezede ኑሮ በዘዴ 2 months ago 9 minutes, 28 seconds 1,167 views",Nuro Bezede ኑሮ በዘዴ,1167,1175,8
6697,"ጆ ባይደን አለም ግራ ያጋባ ዉሳኔ ወሰኑ - ቴዎድሮስ የራያን ህዝብ ስለማስጨፍጨፍ የሰራዉ ሴራ! by Nuro Bezede ኑሮ በዘዴ 2 months ago 11 minutes, 9 seconds 1,659 views",Nuro Bezede ኑሮ በዘዴ,1659,1664,5
6698,"Ethiopia - ድሮኗ ከሱማሊያ አልሸባብ እስከ ላሊበላ ረፈረፈቻቸዉ - ታሪክ የማይረሳዉ የቱርክ ዉለታ! by Nuro Bezede ኑሮ በዘዴ 2 months ago 8 minutes, 11 seconds 1,174 views",Nuro Bezede ኑሮ በዘዴ,1174,1177,3
6699,"Ethiopia - አስደንጋጭ መረጃ! ከህወሀት ጥፋት ጀርባ ያልተጠበቀች ሀገር ተገኘች - ጣልያን! by Nuro Bezede ኑሮ በዘዴ 2 months ago 10 minutes, 22 seconds 1,395 views",Nuro Bezede ኑሮ በዘዴ,1395,1398,3
6700,"የ2 ቀኑ የዝግ አዳራሽ ዱለታ - በአሜሪካ! by Nuro Bezede ኑሮ በዘዴ 2 months ago 10 minutes, 5 seconds 998 views",Nuro Bezede ኑሮ በዘዴ,998,1001,3
6701,"የአሜሪካ ቅሌት በአደባባይ ሲገለጥ - በደሴ የሆነ አሳዛኝ ታሪክ! by Nuro Bezede ኑሮ በዘዴ 2 months ago 9 minutes, 40 seconds 1,660 views",Nuro Bezede ኑሮ በዘዴ,1660,1662,2
6702,"የኦነግ አስደንጋጭ መግለጫ - ዘመቻ ቴዎድሮስን ማጥፋት! by Nuro Bezede ኑሮ በዘዴ 2 months ago 9 minutes, 22 seconds 3,074 views",Nuro Bezede ኑሮ በዘዴ,3074,3076,2
6703,"ላሊበላ ምን ተፈጠረ… የአሜሪካ የአዞ እንባ! by Nuro Bezede ኑሮ በዘዴ 2 months ago 8 minutes, 41 seconds 1,267 views",Nuro Bezede ኑሮ በዘዴ,1267,1275,8
6704,"የህወሀት የሱዳን ክንፍ - የሳምሪ ቡድን አደገኛዉ ተልዕኮ! by Nuro Bezede ኑሮ በዘዴ 2 months ago 8 minutes, 22 seconds 1,995 views",Nuro Bezede ኑሮ በዘዴ,1995,1995,0
6705,"Ethiopia - ዶ/ር አብይ ከዘመቻ መልስ በስችዌሽን ሩም የመሩት ዉግያ እና የሱዳን ኮሪደር! by Nuro Bezede ኑሮ በዘዴ 2 months ago 11 minutes, 46 seconds 5,493 views",Nuro Bezede ኑሮ በዘዴ,5493,5503,10
6706,"ጌታቸዉ እና ጀነራሎቹ ወደ ቆላ ተምቤን - የሽምቅ ዉግያ ጅማሮ! by Nuro Bezede ኑሮ በዘዴ 2 months ago 10 minutes, 3 seconds 1,706 views",Nuro Bezede ኑሮ በዘዴ,1706,1707,1
6707,"ጠቅላዩ ወደ ቢሮ ተመለሱ - ሰበር መግለጫ! by Nuro Bezede ኑሮ በዘዴ 2 months ago 9 minutes, 41 seconds 1,479 views",Nuro Bezede ኑሮ በዘዴ,1479,1479,0
6708,"ዘመቻ ፍፃሜ - ጣምራ በር ላይ ህወሀት ከጥምር ጦሩ! by Nuro Bezede ኑሮ በዘዴ 2 months ago 9 minutes, 13 seconds 2,090 views",Nuro Bezede ኑሮ በዘዴ,2090,2091,1
6709,"“አብይ እና ፑቲን” ኢትዮጲያን ወደ ቀደመ ክብሯ! by Nuro Bezede ኑሮ በዘዴ 2 months ago 10 minutes, 35 seconds 1,704 views",Nuro Bezede ኑሮ በዘዴ,1704,1709,5
6710,"Ethiopia - ለእሁድ የታሰበዉ ታላቅ ብስራት ምንድነዉ?    ከዉልደቱ እስከ ሞቱ! by Nuro Bezede ኑሮ በዘዴ 2 months ago 11 minutes, 17 seconds 10,825 views",Nuro Bezede ኑሮ በዘዴ,10825,10825,0
6711,"“ቀዩ ዘንዶ”በህወሃት ሽንፈት ዋዜማ ወደ አፍሪካ ቀንድ አሜሪካ የምታዘምተው ሰራዊት by Nuro Bezede ኑሮ በዘዴ 3 months ago 9 minutes, 38 seconds 1,913 views",Nuro Bezede ኑሮ በዘዴ,1913,1917,4
6712,"“ስልታዊ ማፈግፈግ” - ህወሀት ወደ ጉድጓዱ ገባ! by Nuro Bezede ኑሮ በዘዴ 3 months ago 9 minutes, 4 seconds 10,026 views",Nuro Bezede ኑሮ በዘዴ,10026,10031,5
6713,"አሜሪካን ያስበረገጋት የሩሲያ ዉሳኔ / የአዲስአበባዉ የሽብር ጥንስስ! by Nuro Bezede ኑሮ በዘዴ 3 months ago 10 minutes, 34 seconds 2,583 views",Nuro Bezede ኑሮ በዘዴ,2583,2583,0
6714,"አሜሪካን የሚያሰጋት በአፍሪካ የተሰማራዉ ሀያሉ የኢ/ያ ጦር! by Nuro Bezede ኑሮ በዘዴ 3 months ago 10 minutes, 14 seconds 2,423 views",Nuro Bezede ኑሮ በዘዴ,2423,2424,1
6715,"ባይደን አብይን የሚፈራበት እና ከህወሀት ጋር ያቆመዉ ሚስጥር! by Nuro Bezede ኑሮ በዘዴ 3 months ago 10 minutes, 10 seconds 1,871 views",Nuro Bezede ኑሮ በዘዴ,1871,1871,0
6716,"በጦርነት ዘምተዉ ድል ያደረጉ መሪዎች እና የጠቅላዩ ተግባር በግንባር! by Nuro Bezede ኑሮ በዘዴ 3 months ago 9 minutes, 56 seconds 3,403 views",Nuro Bezede ኑሮ በዘዴ,3403,3404,1
6717,"ህወሀትን ስቦ ሸዋ ያመጣዉ አስገራሚ የጦር ታክቲክ! የመጨረሻው ዘመቻ! by Nuro Bezede ኑሮ በዘዴ 3 months ago 10 minutes, 16 seconds 4,579 views",Nuro Bezede ኑሮ በዘዴ,4579,4583,4
6718,"ከሰሜን ወሎ እና ደቡብ ወሎ የተፈናቀሉ ወገኖች ለኢትዮጲያ ህዝብ ያስተላለፉት የድረሱልኝ ጥሪ by Nuro Bezede ኑሮ በዘዴ 4 months ago 14 minutes, 20 seconds 2,575 views",Nuro Bezede ኑሮ በዘዴ,2575,2577,2
6719,"መልካም ዜና የደቡበ ውሎ አስተዳደር ሀይቅ ከተማ ከጁነታው ነፃ መሆኑን አረጋገጡ | Ethiopia by Nuro Bezede ኑሮ በዘዴ 4 months ago 13 minutes, 53 seconds 4,433 views",Nuro Bezede ኑሮ በዘዴ,4433,4433,0
6720,"Ethiopia - አያ ምክትል - ደመቀ ከፈረስቤት እስከ ቤተመንግስት! by Nuro Bezede ኑሮ በዘዴ 4 months ago 11 minutes, 30 seconds 2,494 views",Nuro Bezede ኑሮ በዘዴ,2494,2495,1
6721,"መታየት ያለበት ቪዲዮ - የአማራ ፋኖ በጨጨሆ ግንባር ያለውን እውነታ ነገሩን! by Nuro Bezede ኑሮ በዘዴ 6 months ago 16 minutes 5,553 views",Nuro Bezede ኑሮ በዘዴ,5553,5562,9
6722,"ሊያስገድሉኝ ነበር / ልጅ ሚካኤል አልበሜን ዘረፈኝ / ጊልዶ ጉድ ሠራኝ!አወዛጋቢው ኪኒኔ! | Ethiopia by Nuro Bezede ኑሮ በዘዴ 7 months ago 26 minutes 168,975 views",Nuro Bezede ኑሮ በዘዴ,168975,170431,1456
6723,"ታሪክ ተሰራ - ልዩ ሀይል የለ ታንክ የለ ፍቅር ብቻ ቴዲ በፍቅር ሰበሰበን! | Ethiopia | Teddy Afro by Nuro Bezede ኑሮ በዘዴ 7 months ago 12 minutes, 37 seconds 40,622 views",Nuro Bezede ኑሮ በዘዴ,40622,40632,10
6724,"የብዙዎችን ልብ የነካው እናታችን እዳዬ የክብር ሸኝት! | Ethiopia by Nuro Bezede ኑሮ በዘዴ 7 months ago 20 minutes 8,591 views",Nuro Bezede ኑሮ በዘዴ,8591,8592,1
6725,"እማማ ፊሽካ ዶ/ር አብይ የጫወቷቸውን ሚስጥር ነገሩን! | Ethiopia by Nuro Bezede ኑሮ በዘዴ 8 months ago 34 minutes 13,419 views",Nuro Bezede ኑሮ በዘዴ,13419,13440,21
6726,"ለአቡሽ ለመጀመሪያ ጊዜ ያልተጠበቀ ሽልማት ተሰጠው | ታሪኩ ተናገረ | ""በነፃ ሰርቼ ስገባ ለአጎቴ አልነግረውም ይቆጣል!"" | Tariku Gankisi by Nuro Bezede ኑሮ በዘዴ 8 months ago 20 minutes 182,986 views",Nuro Bezede ኑሮ በዘዴ,182986,183009,23
6727,"“በህይወቴ ሰውን ሰው ሲበላ አይቼ አላውቅም” የአጣዬ እናቶች ልብ የሚሰብር ለቅሶ! | Ethiopia by Nuro Bezede ኑሮ በዘዴ 8 months ago 32 minutes 12,965 views",Nuro Bezede ኑሮ በዘዴ,12965,12978,13
6728,"ህይወት ታደሰ በልደት በዓሏ  መሰረት መብራቴን በ1 ሚሊዮን ብር ሰርፕራይዝ! ""ወዳጆቼ ይህቺን መልካም ሴት መርቁልኝ!"" | Ethiopia by Nuro Bezede ኑሮ በዘዴ 8 months ago 17 minutes 13,626 views",Nuro Bezede ኑሮ በዘዴ,13626,13628,2
6729,"የሚረዳው አጥቶ 17 አመት ሙሉ የአልጋ ቁራኛ የሆነ ሰው ተመልከቱኝ ይላል!! | በተሻገር ጣሰው!! | Ethiopia by Nuro Bezede ኑሮ በዘዴ 8 months ago 18 minutes 9,646 views",Nuro Bezede ኑሮ በዘዴ,9646,9647,1
6730,"Ethiopia - የታዋቂ ሰዎች ሚስጥር አዋቂ    አቤ ከቤ ከአሰላ ጋር የተደረገ ቆይታ! by Nuro Bezede ኑሮ በዘዴ 8 months ago 40 minutes 10,982 views",Nuro Bezede ኑሮ በዘዴ,10982,10989,7
6731,"የላሊበላው አባት ለኢትዮጲያዊያን ያስተላለፉት ጥብቅ መልእክት | ከ27 በላይ ቤተክርስቲያን አሰርቻለሁ!! | Ethiopia by Nuro Bezede ኑሮ በዘዴ 9 months ago 1 hour, 30 minutes 4,299 views",Nuro Bezede ኑሮ በዘዴ,4299,4299,0
6732,"የጋዜጠኛ ሰለሞን ሃ/እየሱስ ሚስት የተፈተነችበት የመልስ ስነስርዓት!! | Ethiopia by Nuro Bezede ኑሮ በዘዴ 9 months ago 35 minutes 113,506 views",Nuro Bezede ኑሮ በዘዴ,113506,113571,65
6733,"በአሰቃቂ ሁኔታ የተገደለችው የሃይማኖት በዳዳ አባት በመጨረሻ አንድ ሚስጢር አፈነዱ!! | Ethiopia by Nuro Bezede ኑሮ በዘዴ 9 months ago 58 minutes 70,841 views",Nuro Bezede ኑሮ በዘዴ,70841,70881,40
6734,"በታዋቂ ሰዎች የደመቀው የጋዜጠኛ ሰለሞን ሃ/እየሱስ አስደናቂ የሰርግ ስነ-ስርዓት!! | Ethiopia by Nuro Bezede ኑሮ በዘዴ 9 months ago 52 minutes 214,820 views",Nuro Bezede ኑሮ በዘዴ,214820,214901,81
6735,"ሞቷል ተብሎ የተለቀሰለት ዝነኛው አርቲስት አንተነህ ድረሱልኝ ይላል በተሻገር ጣሰው | Ethiopia by Nuro Bezede ኑሮ በዘዴ 9 months ago 42 minutes 219,004 views",Nuro Bezede ኑሮ በዘዴ,219004,219046,42
6736,"ህዝቡን በእምባ ያራጨው ዝክረ መስፍን ጌታቸው በብሄራዊ ቴአትር በወዳጆቹ አንደበት ሲገለፅ | Ethiopia by Nuro Bezede ኑሮ በዘዴ 9 months ago 1 hour 6,230 views",Nuro Bezede ኑሮ በዘዴ,6230,6232,2
6737,"""አዳነች አበቤ ትመልከተን""      33 ዓመት ሙሉ ከኖርንበት ቤት ተፈናቅለን ጎዳና ወጣን"" | ተሻገር ጣሰው ከጎተራ | Ethiopia by Nuro Bezede ኑሮ በዘዴ 9 months ago 38 minutes 21,347 views",Nuro Bezede ኑሮ በዘዴ,21347,21351,4
6738,"በዒድ ዋዜማ አስደሳች ዜና!! | ኑሮ የጨለመባቸው ቤተሰቦች ከ1.3 ሚሊዮን ብር? | Ethiopia by Nuro Bezede ኑሮ በዘዴ 9 months ago 47 minutes 51,036 views",Nuro Bezede ኑሮ በዘዴ,51036,51071,35
6739,"የመስቀል አደባባዩ የኢፍጣር ፕሮግራም ምን ይመስል ነበር? | Ethiopia by Nuro Bezede ኑሮ በዘዴ 9 months ago 12 minutes, 33 seconds 11,395 views",Nuro Bezede ኑሮ በዘዴ,11395,11398,3
6740,"ህዝቡ ንቅል ብሎ ወጥቷል ከሜሲኮ  -ባንቢስ የሚደርሰው የአፍጥር ዝግጅት !!    ተሻገር ጣሰው ከመስቀል አደባባይ | Ethiopia by Nuro Bezede ኑሮ በዘዴ 9 months ago 23 minutes 28,955 views",Nuro Bezede ኑሮ በዘዴ,28955,28959,4
6741,"""ልጆቼ ራበኝ ሲሉኝ ምን ላብላቸው""? 4 መንታ ልጆችን የወለደችው አካል ጉዳተኛ!! ተሻገር ጣሰው ከአዳማ! | Ethiopia by Nuro Bezede ኑሮ በዘዴ 9 months ago 30 minutes 79,029 views",Nuro Bezede ኑሮ በዘዴ,79029,79080,51
6742,"እግዚኦ!! 2 ወንድማማቾች በአንድ ቀን ፓራላይዝ ሆኑ ቢባሉ ምን ይሰማዎታል? | ተሻገር ጣሰው ከአላባ!! | Ethiopia by Nuro Bezede ኑሮ በዘዴ 9 months ago 27 minutes 13,825 views",Nuro Bezede ኑሮ በዘዴ,13825,13829,4
6743,"ሙሉ ቤተሰቤን በር ዘግተው  ነው ያቃጠሉብኝ! | “ጥቃቱ መከላከያ ቆሞ ነው የተፈፀመው” | Ethiopia by Nuro Bezede ኑሮ በዘዴ 9 months ago 23 minutes 28,325 views",Nuro Bezede ኑሮ በዘዴ,28325,28360,35
6744,"የትንሳዔ በአልን ከተሻገር ጣሰው ጋር!!  | Ethiopia by Nuro Bezede ኑሮ በዘዴ 10 months ago 12 minutes, 25 seconds 3,982 views",Nuro Bezede ኑሮ በዘዴ,3982,3982,0
6745,"ይፋ የሆነው አሰቃቂ የአጣዬ ከተማ ውድመት ሙሉ ቪዲዮ እና ነዋሪዎቹ ያን የጭንቅ ሰዓታት እንዴት አለፉት? by Nuro Bezede ኑሮ በዘዴ 10 months ago 43 minutes 48,526 views",Nuro Bezede ኑሮ በዘዴ,48526,48534,8
6746,"የልጃቸው መቃብር ላይ በየቀኑ የሚያለቅሱት አዛሳኝ እናት ምን ገጥሟቸው ነው? | Ethiopia by Nuro Bezede ኑሮ በዘዴ 10 months ago 13 minutes, 29 seconds 79,532 views",Nuro Bezede ኑሮ በዘዴ,79532,79570,38
6747,"ዓለም የተረባረበላት ዘይቱና አሳዛኝ መረጃ ከኮሪያ ሆስፒታል ሰማች!! | Ethiopia by Nuro Bezede ኑሮ በዘዴ 10 months ago 33 minutes 142,926 views",Nuro Bezede ኑሮ በዘዴ,142926,142954,28
6748,"ደስ የሚል የሆሳዕና በዓል አከባበር በእንጦጦ ራጉዔል!! | በተሻገር ጣሰው | Ethiopia by Nuro Bezede ኑሮ በዘዴ 10 months ago 14 minutes, 11 seconds 5,663 views",Nuro Bezede ኑሮ በዘዴ,5663,5665,2
6749,"አገር ጉድ ያስባለው ለስራ አረብ ሃገር ሄዳ 2 አይኗ ጠፍቶ የመጣችው እህታችን! | Ethiopia by Nuro Bezede ኑሮ በዘዴ 10 months ago 50 minutes 13,355 views",Nuro Bezede ኑሮ በዘዴ,13355,13355,0
6750,"የአዲስ አበባ ዩኒቨርስቲ መምህሩ እየተሰቃየው ነው ይላል? | በተሻገር ጣሰው!! | Ethiopia by Nuro Bezede ኑሮ በዘዴ 10 months ago 27 minutes 24,787 views",Nuro Bezede ኑሮ በዘዴ,24787,24824,37
6751,"ከ 4 የአእምሮ ህመምተኛ ጋር የሚኖሩት እናት አስደሳች ዜና ከዲላ ተሰማ!!   ተሻገር ጣሰው ከዲላ!! | Ethiopia by Nuro Bezede ኑሮ በዘዴ 10 months ago 45 minutes 32,867 views",Nuro Bezede ኑሮ በዘዴ,32867,32913,46
6752,"ሂዊ የምለው መልዕክት አለኝ ትላለች | ""እግዚአብሄር ይመስገን እየተፅናናሁ ነው"" | Ethiopia by Nuro Bezede ኑሮ በዘዴ 10 months ago 24 minutes 68,453 views",Nuro Bezede ኑሮ በዘዴ,68453,68465,12
6753,"""ኑ በረመዳን ህይወት እናድን"" | ለ8 አመታት የአልጋ ቁራኛ የሆነችው እህታችን የድረሱልኝ ጥሪ! | Ethiopia by Nuro Bezede ኑሮ በዘዴ 10 months ago 12 minutes, 43 seconds 24,409 views",Nuro Bezede ኑሮ በዘዴ,24409,24411,2
6754,"የፈጣሪ ድንቅ ስራ 4 መንታ ልጆችን የተገላገለችው አስደናቂዋ እናት የምለው አለኝ ትላለች! | በተሻገር ጣሰው!! | Ethiopia by Nuro Bezede ኑሮ በዘዴ 10 months ago 15 minutes 35,153 views",Nuro Bezede ኑሮ በዘዴ,35153,35165,12
6755,"አስደሳች የምስራች ተሰማ! | ዓለም የተረባረበላት ዘይቱና በኮሪያ ሆስፒታል ህክምናዋን ጀመረች!! | Ethiopia by Nuro Bezede ኑሮ በዘዴ 10 months ago 22 minutes 89,082 views",Nuro Bezede ኑሮ በዘዴ,89082,89097,15
6756,"ሰበር ቪዲዮ - ዘኪ ከከንቲባዋ ያልተጠበቀ የምስራች ደረሰው! | ""የምበላው አጥቼ የፈረስ ገለባ በልቻለሁ!"" | Ethiopia by Nuro Bezede ኑሮ በዘዴ 10 months ago 25 minutes 75,130 views",Nuro Bezede ኑሮ በዘዴ,75130,75134,4
6757,"Ethiopia - አስደሳች ዜና ታዋቂው አርቲስት ሰለሞን ቦጋለ የዘመናት ህልሙ ተሳካለት!! by Nuro Bezede ኑሮ በዘዴ 10 months ago 44 minutes 18,116 views",Nuro Bezede ኑሮ በዘዴ,18116,18118,2
6758,"Ethiopia - የተወዳጁ አርቲስት ሰለሞን ያሰማው የድረሱልኝ ጥሪ!!  በተሻገር ጣሰው by Nuro Bezede ኑሮ በዘዴ 10 months ago 31 minutes 79,430 views",Nuro Bezede ኑሮ በዘዴ,79430,79457,27
6759,"ታላቅ የምስራች ተሰማ - ከአረብ አገር መጥታ ፓራላይዝ የሆነችው  ዘይቱና 4 ሚሊዬን ብር??? | Ethiopia by Nuro Bezede ኑሮ በዘዴ 11 months ago 48 minutes 125,216 views",Nuro Bezede ኑሮ በዘዴ,125216,125230,14
6760,"ሰበር ቪዲዮ ዋልያዎቹ ለአፍሪካ ዋንጫ በማለፋቸው የአዲስ አበባ ህዝብ ደስታ!! | Ethiopia by Nuro Bezede ኑሮ በዘዴ 11 months ago 9 minutes, 57 seconds 7,069 views",Nuro Bezede ኑሮ በዘዴ,7069,7069,0
6761,"የክህነት ባለቤቷን በድንገት የተነጠቀችው ከ 2 ልጆቿ ጋር ጎዳና ወጣች!! | Ethiopia by Nuro Bezede ኑሮ በዘዴ 11 months ago 18 minutes 15,382 views",Nuro Bezede ኑሮ በዘዴ,15382,15387,5
6762,"ዲያቆን ዳንኤል ክብረት ስለሚወዳደርበት ምርጫ ለመጀመሪያ ጊዜ ተናገረ!! | Ethiopia by Nuro Bezede ኑሮ በዘዴ 11 months ago 10 minutes, 28 seconds 1,983 views",Nuro Bezede ኑሮ በዘዴ,1983,1984,1
6763,"በአነጋጋሪው የጉማ ሽልማት ላይ ያልተጠበቁ ክስተቶች | Ethiopia by Nuro Bezede ኑሮ በዘዴ 11 months ago 27 minutes 17,452 views",Nuro Bezede ኑሮ በዘዴ,17452,17452,0
6764,"ኑሮ የጨለመባቸው አሳዛኝ ቤተሰቦች ድረሱልን ይላሉ!!ተሻገር ጣሰው ከጉራጌ ዞን | Ethiopia by Nuro Bezede ኑሮ በዘዴ 11 months ago 22 minutes 34,701 views",Nuro Bezede ኑሮ በዘዴ,34701,34729,28
6765,"Ethiopia ያልፍልኛል ብዬ... ከአረብ ሃገር መጥታ ፓራላይዝድ የሆነችው እህታችን ድረሱልኝ ትላለች!!     ተሻገር ጣሰው ከጉራጌ ዞን by Nuro Bezede ኑሮ በዘዴ 11 months ago 22 minutes 37,704 views",Nuro Bezede ኑሮ በዘዴ,37704,37733,29
6766,"የቴዲ እጮኛ ለመጀመሪያ ጊዜ ድምጿን አሰማች by Nuro Bezede ኑሮ በዘዴ 11 months ago 13 minutes, 19 seconds 27,454 views",Nuro Bezede ኑሮ በዘዴ,27454,27461,7
6767,"ከ 4 የአእምሮ ህመምተኛ ልጆች ጋር የምትኖረው አሳዛኝ እናት!! | ተሻገር ጣሰው ከዲላ | Ethiopia by Nuro Bezede ኑሮ በዘዴ 11 months ago 33 minutes 36,619 views",Nuro Bezede ኑሮ በዘዴ,36619,36632,13
6768,"ሰውን በማረድ በመግደል ድል የለም መመህር መህረተ አብ | በብላቴናው ቴዲ ቀብር ላይ ለህዝቡ ያስተላለፈው መልዕክት | Ethiopia | Mihretab Asefa by Nuro Bezede ኑሮ በዘዴ 11 months ago 17 minutes 30,514 views",Nuro Bezede ኑሮ በዘዴ,30514,30519,5
6769,"አስደንጋጭ ቪዲዮ የሙሽራው ቴዲ አሟሟት ሚስጢር ቴዲን ማን ገደለው?  | Ethiopia by Nuro Bezede ኑሮ በዘዴ 11 months ago 39 minutes 204,371 views",Nuro Bezede ኑሮ በዘዴ,204371,204393,22
6770,"አስደንጋጭ ምስጢር ወጣ ግብጽና ሱዳን ጦር ሊማዘዙ ነው! by Nuro Bezede ኑሮ በዘዴ 1 year ago 12 minutes, 56 seconds 63,194 views",Nuro Bezede ኑሮ በዘዴ,63194,63196,2
6771,"ከመተከል ጭፍጨፋ ጀርባ ያለው ምስጢር ተጋለጠ፣ ቄሱ ዘግናኝ ግድያ ተፈጸመባቸው! by Nuro Bezede ኑሮ በዘዴ 1 year ago 12 minutes, 5 seconds 3,105 views",Nuro Bezede ኑሮ በዘዴ,3105,3105,0
6772,"ጥብቅ መረጃ - ጃልመሮን ማን ገደለው? ከመጋረጃው  ከጀርባ ያለው ምስጢር! | Ethiopia by Nuro Bezede ኑሮ በዘዴ 1 year ago 12 minutes, 42 seconds 26,831 views",Nuro Bezede ኑሮ በዘዴ,26831,26837,6
6773,"የግብጽ ሴራ ከወደቀው ስልክ የተገኘውና ግድቡን ስለማፍረስ የሚያወራው ከባድ ምስጢር ተጋለጠ!! by Nuro Bezede ኑሮ በዘዴ 1 year ago 10 minutes, 47 seconds 7,840 views",Nuro Bezede ኑሮ በዘዴ,7840,7842,2
6774,"ሰበር ጀግናው አላሩሲ እውነቱን አፈረጠው፣ ሱዳን የግብጽን ሴራ አጋለጠች!! by Nuro Bezede ኑሮ በዘዴ 1 year ago 10 minutes, 53 seconds 52,040 views",Nuro Bezede ኑሮ በዘዴ,52040,52040,0
6775,"ጠ/ሩ አስደንጋጭ እርምጃ ወሰዱ፣ መተከልን የደም መሬት ያደረጉት ሀይሎች ተደመሰሱ! | Ethiopia by Nuro Bezede ኑሮ በዘዴ 1 year ago 11 minutes 11,322 views",Nuro Bezede ኑሮ በዘዴ,11322,11323,1
6776,"ሰበር መረጃ በአማራና በአፋር አዋሳኝ ቦታ ያልተጠበቀ ግጭት ተነሳ - ጌታቸዉ ረዳ አዲስ ቀልድ ለቀቀ! by Nuro Bezede ኑሮ በዘዴ 1 year ago 15 minutes 8,544 views",Nuro Bezede ኑሮ በዘዴ,8544,8545,1
6777,"ህጻናቱን ከሞት መንጋጋ እየፈለቀቀ የሚያወጣው ታላቅ አርበኛ by Nuro Bezede ኑሮ በዘዴ 1 year ago 13 minutes, 42 seconds 3,930 views",Nuro Bezede ኑሮ በዘዴ,3930,3930,0
6778,"እስከ ቡድኖቿ በቁጥጥር ስር የዋለችው የመለስ ዜናዊ ልጅ ፍቅረኛዋን አስያዘችው! by Nuro Bezede ኑሮ በዘዴ 1 year ago 12 minutes, 4 seconds 66,512 views",Nuro Bezede ኑሮ በዘዴ,66512,66522,10
6779,"ያልተገለጡት  የስብሃት ነጋ ልጅ  ነዉሮችና ለደርግ ባለስልጣናት የተደረገው ይቅርታ!! by Nuro Bezede ኑሮ በዘዴ 1 year ago 11 minutes, 54 seconds 5,036 views",Nuro Bezede ኑሮ በዘዴ,5036,5036,0
6780,"ኦነግ ሸኔ አበቃለት! የመረረው ህዝብ  ነቅሎ ወጣ/ ሴትና ህጻናት ሳይቀሩ ገጀራ እና ጦር ታጥቀዉ ወጥተዋል by Nuro Bezede ኑሮ በዘዴ 1 year ago 11 minutes, 9 seconds 10,299 views",Nuro Bezede ኑሮ በዘዴ,10299,10378,79
6781,"አስጨናቂው የኢትጵያና ሱዳን የጦር ፍጥጫ፣  የታላቁ አርቲስት ሞትና ሽኝት!!| Ethiopia by Nuro Bezede ኑሮ በዘዴ 1 year ago 11 minutes, 17 seconds 2,180 views",Nuro Bezede ኑሮ በዘዴ,2180,2180,0
6782,"የመላጦች አብዮት - ልዩ መሰናዶ! ሰይፉ ፋንታውን በጸጉር ንቅለ ተከላው ይገረምንና አስፋው መሸሻን ሊከተል ነው?! | Ethiopia by Nuro Bezede ኑሮ በዘዴ 1 year ago 10 minutes, 54 seconds 2,861 views",Nuro Bezede ኑሮ በዘዴ,2861,2861,0
6783,"በሞት አፋፍ ላይ ሆና የተያዘችው ጁንታና በንጹሃን ደም የጨቀየው የገበሬዎች ማሳ| Ethiopia by Nuro Bezede ኑሮ በዘዴ 1 year ago 11 minutes, 55 seconds 4,160 views",Nuro Bezede ኑሮ በዘዴ,4160,4161,1
6784,"ልዩ መረጃ ከ አባቱ ጋር ዘምቶ የታገተው የ 5 አመት ህጻንና ከሞት አፋፍ የተረፈበት ምስጢር| Ethiopia by Nuro Bezede ኑሮ በዘዴ 1 year ago 10 minutes, 29 seconds 7,607 views",Nuro Bezede ኑሮ በዘዴ,7607,7608,1
6785,"ሰበር መረጃ - 470 ኪሎ ወርቅ ዘርፈው የፈረጠጡት ጁንታዎችና የጀኔራሉ የድል ዜና ከመቀሌ | Ethiopia by Nuro Bezede ኑሮ በዘዴ 1 year ago 10 minutes, 12 seconds 9,786 views",Nuro Bezede ኑሮ በዘዴ,9786,9786,0
6786,"ሰራዊቱ ተንበሸበሸ! ጁንታዉ በ120 ህጻናትና ሴቶች ላይ ያደረገዉ ዘግናኝ በደል! | Ethiopia by Nuro Bezede ኑሮ በዘዴ 1 year ago 11 minutes, 34 seconds 7,240 views",Nuro Bezede ኑሮ በዘዴ,7240,7240,0
6787,"የዳንኤል ክብረት ከባድ ማስጠንቀቂያና የጋዜጠኛው አሳዛኝ ገጠመኝ by Nuro Bezede ኑሮ በዘዴ 1 year ago 12 minutes, 10 seconds 4,032 views",Nuro Bezede ኑሮ በዘዴ,4032,4032,0
6788,"አመራሮቹ ተለቅመው ተያዙ፣ በጥይት የቆሰሉ እና የሞቱም አሉ! by Nuro Bezede ኑሮ በዘዴ 1 year ago 10 minutes, 30 seconds 82,197 views",Nuro Bezede ኑሮ በዘዴ,82197,82200,3
6789,"የደፂ ቀኝ እጅ ዋናዉ ጁንታ አለምገብረዋህድ ተገደለ by Nuro Bezede ኑሮ በዘዴ 1 year ago 14 minutes, 1 second 11,009 views",Nuro Bezede ኑሮ በዘዴ,11009,11011,2
6790,"የድልዜና! ዋሻ ውስጥ ያለው ጁንታ ተደመሰሰ፣ ያልተሰማው የህወሃት በደል by Nuro Bezede ኑሮ በዘዴ 1 year ago 16 minutes 37,491 views",Nuro Bezede ኑሮ በዘዴ,37491,37491,0
6791,"ሰበር ዜና ከጌታቸው ቤት የተገኘው ጉድና  ከጁንታው ዋሻ  የወጣውምስጢር | Ethiopia by Nuro Bezede ኑሮ በዘዴ 1 year ago 13 minutes, 38 seconds 20,919 views",Nuro Bezede ኑሮ በዘዴ,20919,20920,1
6792,"Ethiopia - ጁንታዎቹ ለማመልጥ ያልታሰበ የቡድን ስራ ጀመሩ by Nuro Bezede ኑሮ በዘዴ 1 year ago 10 minutes, 38 seconds 18,672 views",Nuro Bezede ኑሮ በዘዴ,18672,18673,1
6793,"ከሀዲውን ኮሎኔል ማርካ ተአምር የሰራችው ጀግናና ጁንታውን የሚያድነው ልዩ ኮማንዶ! | Ethiopia by Nuro Bezede ኑሮ በዘዴ 1 year ago 13 minutes, 9 seconds 10,509 views",Nuro Bezede ኑሮ በዘዴ,10509,10511,2
6794,"ሰበር ዋናው ጁንታ እስከ ቤተሰቡ ተያዘ፣ ሰላያቸውም በቁጥጥር ስር ዋለ! | Ethiopia by Nuro Bezede ኑሮ በዘዴ 1 year ago 12 minutes, 35 seconds 47,323 views",Nuro Bezede ኑሮ በዘዴ,47323,47337,14
6795,"Ethiopia - ጦሩ ጁንታው እስከ ልጆቹ ወዳለበት ዋሻ እየሄደ ነው/ አስመሳዩ መነኩሴ ከነግብረ አበሩ ተያዘ! by Nuro Bezede ኑሮ በዘዴ 1 year ago 11 minutes, 52 seconds 68,204 views",Nuro Bezede ኑሮ በዘዴ,68204,68206,2
6796,"ጁንታው ጠቅላዩ ላይ ያደረሰው መከራ፣ የተያዙት ጁንታዎችና ኢትዮጵያን ለማፍረስ የተደራጀው 30 ሽህ ልዩ ሃይል! | Ethiopia by Nuro Bezede ኑሮ በዘዴ 1 year ago 15 minutes 19,845 views",Nuro Bezede ኑሮ በዘዴ,19845,19847,2
6797,"አርቲስቶቹ የኢትዮጵያን ህዝብ ይቅርታ ጠየቁ by Nuro Bezede ኑሮ በዘዴ 1 year ago 41 minutes 11,866 views",Nuro Bezede ኑሮ በዘዴ,11866,11866,0
6798,"ህወሓት ቤተክርስቲያን ውስጥ ያከማቸው የጦር መሳሪያ - ተአምረኞቹ ሚግ 23 እና 29 ጀቶች! | Ethiopia by Nuro Bezede ኑሮ በዘዴ 1 year ago 10 minutes, 55 seconds 21,650 views",Nuro Bezede ኑሮ በዘዴ,21650,21651,1
6799,"ሰበር መረጃ ፡ Game Over! ትግራይ ነጻ ወጣች፣ የጁንታው የእስር ሂወት ተጀመረ! | Ethiopia by Nuro Bezede ኑሮ በዘዴ 1 year ago 14 minutes, 39 seconds 26,873 views",Nuro Bezede ኑሮ በዘዴ,26873,26874,1
6800,"ሰበር መረጃ ህወሃት 5ሽህ እስረኞችን  ፈቶ ወደ ጦር ሊያሰማራ ነው፣ የሮኬቶቹ ምስጢርና ያልተሰማው የማይካድራ ጉድ! by Nuro Bezede ኑሮ በዘዴ 1 year ago 12 minutes, 12 seconds 11,022 views",Nuro Bezede ኑሮ በዘዴ,11022,11022,0
6801,"Ethiopia - ሰበር መረጃ - የመቀሌ ነጻነት ብስራት!  በሰላም እጃቸውን ሲሰጡ ጀነራሉ ከሀገር ወጣ! by Nuro Bezede ኑሮ በዘዴ 1 year ago 16 minutes 37,192 views",Nuro Bezede ኑሮ በዘዴ,37192,37193,1
6802,"ሰበር መረጃ አመራሮቹን ሊያስመልጣቸው የነበረው ተያዘ፣ የዉቅሮ ነፃነት እና 6ቱ የህወሃት ዋሻዎች! | Ethiopia by Nuro Bezede ኑሮ በዘዴ 1 year ago 11 minutes, 1 second 38,735 views",Nuro Bezede ኑሮ በዘዴ,38735,38739,4
6803,"በባለ ዘጠኝ ጎራሽ ቢኤምና መድፍ የታገዘው መከላከያ ተራራ ላይ የመሸገውን ጁንታ ደመሰሰው! | Ethiopia by Nuro Bezede ኑሮ በዘዴ 1 year ago 14 minutes, 44 seconds 21,091 views",Nuro Bezede ኑሮ በዘዴ,21091,21092,1
6804,"ጌታቸው እጅ እንዲሰጥ ከእህቱ የደረሰው  ልዩ መልእክትና ለተ.መ.ድ የተላከው የጠ/ሩ  ማስጠንቀቂያ! by Nuro Bezede ኑሮ በዘዴ 1 year ago 14 minutes, 44 seconds 7,838 views",Nuro Bezede ኑሮ በዘዴ,7838,7838,0
6805,"የደብረ ጽዮን እጅ መስጠትና  የሰሜን እዝ ክስተት ትዝታዎች በሰራዊቱ አንደበት! | Ethiopia by Nuro Bezede ኑሮ በዘዴ 1 year ago 11 minutes, 30 seconds 31,608 views",Nuro Bezede ኑሮ በዘዴ,31608,31609,1
6806,"በሞዴሏ ፍቅር የከነፉት የሮማው ጳጳስና የሞዴሏ አስደናቂ መልስ! | Ethiopia by Nuro Bezede ኑሮ በዘዴ 1 year ago 15 minutes 15,427 views",Nuro Bezede ኑሮ በዘዴ,15427,15428,1
6807,"ሰበር መረጃ ውቅሮ ማርያም የተደበቀው የህወሃት ቡድን ተያዘ!! | Ethiopia by Nuro Bezede ኑሮ በዘዴ 1 year ago 14 minutes, 36 seconds 112,135 views",Nuro Bezede ኑሮ በዘዴ,112135,112143,8
6808,"መከላከያ ሰራዊት የመጨረሻውን እርምጃ ሊወስድ ነው!! | Ethiopia by Nuro Bezede ኑሮ በዘዴ 1 year ago 13 minutes, 52 seconds 15,389 views",Nuro Bezede ኑሮ በዘዴ,15389,15389,0
6809,"የጦሩ ፈጣን ግስጋሴ፣ የተደረሰበት ያመራሮቹ ምሽግና የትግራይ ጊዜያዊ መንግስት የስራ ጅማሮ | Ethiopia by Nuro Bezede ኑሮ በዘዴ 1 year ago 12 minutes, 12 seconds 15,598 views",Nuro Bezede ኑሮ በዘዴ,15598,15598,0
6810,"ህወሃት እጅ ሰጠ - መዉጫ  ያጣው  ቡድን  ወደ ኤርትራ ድንበር እየሸሸ ነው! | Ethiopia by Nuro Bezede ኑሮ በዘዴ 1 year ago 14 minutes, 52 seconds 90,153 views",Nuro Bezede ኑሮ በዘዴ,90153,90156,3
6811,"ትግራይ የገባው ባለ ቀይ መለዮ ኮማንዶ  እና ደፂን ያርበተበተዉ የአየር ሀይሉ ድንቅ ቴክኖሎጂ! | Ethiopia by Nuro Bezede ኑሮ በዘዴ 1 year ago 12 minutes, 44 seconds 47,978 views",Nuro Bezede ኑሮ በዘዴ,47978,47979,1
6812,"መጋቢ ሐዲስ እሸቱ ስለ ህወሃት የተናገሩት አስደናቂ ትንቢትና የህወሃት መንኮታኮት! | Ethiopia by Nuro Bezede ኑሮ በዘዴ 1 year ago 12 minutes, 33 seconds 22,269 views",Nuro Bezede ኑሮ በዘዴ,22269,22270,1
6813,"ወጋገን ባንክ የተጋለጠበት ገመና/ የህወሃት የእስር ምእራፍ ተጀመረ! by Nuro Bezede ኑሮ በዘዴ 1 year ago 19 minutes 5,256 views",Nuro Bezede ኑሮ በዘዴ,5256,5257,1
6814,"የፊጥኝ ታስረው የተረሸኑት የመከላከያ አባላት - አስደንጋጩ የም/ቤት ውሳኔ! | Ethiopia by Nuro Bezede ኑሮ በዘዴ 1 year ago 11 minutes, 33 seconds 8,693 views",Nuro Bezede ኑሮ በዘዴ,8693,8695,2
6815,"በህወሃት የታፈነው ጀነራል በግዳጅ ያስተላለፈው መልእክት፣ by Nuro Bezede ኑሮ በዘዴ 1 year ago 12 minutes, 47 seconds 24,558 views",Nuro Bezede ኑሮ በዘዴ,24558,24559,1
6816,"ጀነራሉ በድብቅ ለህወሃት የላከው ጦር መሳሪያ፣ የምርኮኞቹ መልእክትና የትግራይ ህዝብ አስደናቂ መልስ by Nuro Bezede ኑሮ በዘዴ 1 year ago 15 minutes 61,177 views",Nuro Bezede ኑሮ በዘዴ,61177,61179,2
6817,"‹‹እራሳችን ልናጠፋ ነበር!›› በጀነራሉ አንደበት ‹ከጦርነቱ መነሻ እስከ ሁመራ አየር ማረፊያ ምርኮ› by Nuro Bezede ኑሮ በዘዴ 1 year ago 19 minutes 16,577 views",Nuro Bezede ኑሮ በዘዴ,16577,16578,1
6818,"የደብረ ጽዮን የእርቅ ተማጽኖ፣ የባንክ ዝርፊያና የተያዘው ጦር መሳሪያ! | Ethiopia by Nuro Bezede ኑሮ በዘዴ 1 year ago 12 minutes, 26 seconds 9,023 views",Nuro Bezede ኑሮ በዘዴ,9023,9023,0
6819,"ህወሃትን አትንኩት! ዶ/ር ቴድሮስ አድሃኖም በኢትዮጵያ ላይ ከባድ ክህደት ሲፈጽሙ ተያዙ! | Ethiopia by Nuro Bezede ኑሮ በዘዴ 1 year ago 12 minutes, 10 seconds 12,831 views",Nuro Bezede ኑሮ በዘዴ,12831,12832,1
6820,"ኦነግ ሸኔ አማራን- አማራ ህወሃትን!! | Ethiopia by Nuro Bezede ኑሮ በዘዴ 1 year ago 12 minutes, 41 seconds 4,653 views",Nuro Bezede ኑሮ በዘዴ,4653,4653,0
6821,"ሰበር መረጃ - ጆ ባይደን አሸነፉ - የአዲሱ ፕሬዚደንት ጆባይደን የማሸነፍ ታላቅ ምስጢር! | Ethiopia by Nuro Bezede ኑሮ በዘዴ 1 year ago 10 minutes, 48 seconds 41,455 views",Nuro Bezede ኑሮ በዘዴ,41455,41455,0
6822,"ተሸንፌያለው… ህወሃት ሽንፈቷን አመነች! የአየር መቀዋወሚያው ከጥቅም ዉጭ ሆኗል! | Ethiopia by Nuro Bezede ኑሮ በዘዴ 1 year ago 14 minutes, 59 seconds 25,039 views",Nuro Bezede ኑሮ በዘዴ,25039,25042,3
6823,"የተማረኩት የህወሃት ህጻናት ወታደሮች አስደናቂ መልእክት! | Ethiopia by Nuro Bezede ኑሮ በዘዴ 1 year ago 12 minutes, 33 seconds 56,846 views",Nuro Bezede ኑሮ በዘዴ,56846,56848,2
6824,"የፍጹም አስፋው ተማጽኖ! ከባድ ሀዘን ደርሶብናል፣ ባለቤቴን አጽናኑልኝ! | Ethiopia by Nuro Bezede ኑሮ በዘዴ 1 year ago 11 minutes, 8 seconds 10,138 views",Nuro Bezede ኑሮ በዘዴ,10138,10144,6
6825,"ሰበር ዜና! - ህወሃት ተከፋፍሏል! በሽዎች የሚቆጠር ወታደር ወደ ኤርትራ ሸሸ! | Ethiopia by Nuro Bezede ኑሮ በዘዴ 1 year ago 15 minutes 14,486 views",Nuro Bezede ኑሮ በዘዴ,14486,14489,3
6826,"ቤተ መንግስት በር ላይ እሳት ተነስቷል!! ቤተእምነቶችን የማቃጠል አላማና አማራ ላይ የቀጠለው ጥቃት! | Ethiopia by Nuro Bezede ኑሮ በዘዴ 1 year ago 12 minutes, 59 seconds 8,784 views",Nuro Bezede ኑሮ በዘዴ,8784,8784,0
6827,"የጌታቸዉ ረዳ የፍፃሜዉ ደብዳቤ እና የመከላከያ ድንገተኛ ከበባ! | Ethiopia by Nuro Bezede ኑሮ በዘዴ 1 year ago 12 minutes, 51 seconds 27,115 views",Nuro Bezede ኑሮ በዘዴ,27115,27115,0
6828,"አማራ ላይ ያነጣጠረው የኦነግ ሸኔ ቀጣይ የጥቃት እቅዶችና የመከላከያ ዝግጅት | Ethiopia by Nuro Bezede ኑሮ በዘዴ 1 year ago 14 minutes, 15 seconds 8,212 views",Nuro Bezede ኑሮ በዘዴ,8212,8215,3
6829,"ዘግናኙ የጅምላ ጭፍጨፋ በወለጋና ከጀርባ ያለው ስውር ሀይል by Nuro Bezede ኑሮ በዘዴ 1 year ago 11 minutes, 17 seconds 6,883 views",Nuro Bezede ኑሮ በዘዴ,6883,6884,1
6830,"የህወሃት ክህደትና የመከላከያ ሰራዊት ከባድ ቁጣ! | Ethiopia by Nuro Bezede ኑሮ በዘዴ 1 year ago 18 minutes 7,196 views",Nuro Bezede ኑሮ በዘዴ,7196,7196,0
6831,"ህወሃት የመከላከያ ሰራዊት  ብርጋዴር ጀነራሉን አገተ! | Ethiopia by Nuro Bezede ኑሮ በዘዴ 1 year ago 14 minutes, 46 seconds 10,772 views",Nuro Bezede ኑሮ በዘዴ,10772,10773,1
6832,"ደመቀ አብን ቴዲ እና አማራ - መዉጫ ያጣዉ የታፈነ እዉነት! by Nuro Bezede ኑሮ በዘዴ 1 year ago 22 minutes 7,364 views",Nuro Bezede ኑሮ በዘዴ,7364,7368,4
6833,"""ህዳሴውን ማፍረስ ሰማይ ማረስ ነው"" ግድቡን ሚሳኤል እንዳይመታው የተሠራው ስራ! | Ethiopia by Nuro Bezede ኑሮ በዘዴ 1 year ago 11 minutes, 11 seconds 34,287 views",Nuro Bezede ኑሮ በዘዴ,34287,34338,51
6834,"ትራምፕን ያበሳጨችው ኢትዮጵያዊት ህጻን! ተስፈኛዋ የአሜሪካ ፕሬዝደንት ሶፊ ማነች? by Nuro Bezede ኑሮ በዘዴ 1 year ago 12 minutes, 37 seconds 119,012 views",Nuro Bezede ኑሮ በዘዴ,119012,119027,15
6835,"የእስራኤሉ ባለስልጣን ስለግድቡ ያወጡት አስደናቂ መረጃና የእስራኤልና አሜሪካ ሴራ! | Ethiopia by Nuro Bezede ኑሮ በዘዴ 1 year ago 16 minutes 38,745 views",Nuro Bezede ኑሮ በዘዴ,38745,38752,7
6836,"የጠላትን ዓላማ ለማምከን መከላከያ የፈጠራቸዉ 2 አዳዲስ እዞች! | Ethiopia by Nuro Bezede ኑሮ በዘዴ 1 year ago 11 minutes, 31 seconds 3,158 views",Nuro Bezede ኑሮ በዘዴ,3158,3158,0
6837,"ትራምፕን ያስጨነቀው ኢትዮያዊነትና የአዉሮፓ ህብረት ዉግዘት! | Ethiopia by Nuro Bezede ኑሮ በዘዴ 1 year ago 12 minutes, 8 seconds 31,292 views",Nuro Bezede ኑሮ በዘዴ,31292,31292,0
6838,"Ethiopia ""የኢትዮጲያ ህዝብ ካልደረሰልን በረሀብ ማለቃችን ነው"" የብዙዎችን ልብ የነካው የወሎ ራያ ገበሬዎች ለቅሶ by Nuro Bezede ኑሮ በዘዴ 1 year ago 33 minutes 7,387 views",Nuro Bezede ኑሮ በዘዴ,7387,7388,1
6839,"ህወሃት ያስገባቸው የጦር መሳሪያወች፣ያቀዳቸው ተንኮሎች ያሰለጠናቸው ኮማንዶዎች! | Ethiopia by Nuro Bezede ኑሮ በዘዴ 1 year ago 11 minutes, 48 seconds 15,165 views",Nuro Bezede ኑሮ በዘዴ,15165,15166,1
6840,"Ethiopia የወርቅ ዝርፊያው እና ተመሳስሎ የተሰራው አዲስ ብር by Nuro Bezede ኑሮ በዘዴ 1 year ago 11 minutes, 17 seconds 14,819 views",Nuro Bezede ኑሮ በዘዴ,14819,14824,5
6841,"በዘረገፈው ጉድ የታሰረው ጋዜጠኛ ተመስገን ቶሎ የመፈታቱ ምስጢር?? | Ethiopia by Nuro Bezede ኑሮ በዘዴ 1 year ago 15 minutes 28,405 views",Nuro Bezede ኑሮ በዘዴ,28405,28405,0
6842,"የአብይ አስደንጋጭ ንግግር የፈጠረው ክስተትና የኢሳያስ የጉብኝት አንድምታዎች! | Ethiopia by Nuro Bezede ኑሮ በዘዴ 1 year ago 13 minutes, 48 seconds 19,396 views",Nuro Bezede ኑሮ በዘዴ,19396,19396,0
6843,"Ethiopia የአሜሪካ ምክር ቤት በኢትዮጲያ ላይ ያልተጠበቀ ረቂቅ ውሳኔዎችን አወጣ by Nuro Bezede ኑሮ በዘዴ 1 year ago 13 minutes, 14 seconds 14,219 views",Nuro Bezede ኑሮ በዘዴ,14219,14219,0
6844,"የህወሃቱ በቀቀን ኦሮሚያን እንደ ህወሃት! የዳዉድ ኢብሳና የህወሀት ቀጣይ ሴራዎች by Nuro Bezede ኑሮ በዘዴ 1 year ago 15 minutes 13,551 views",Nuro Bezede ኑሮ በዘዴ,13551,13551,0
6845,"Ethiopia አራት ጦሮች በህወሃት ላይ - ከ 30 በኋላ ህወሃት አይኖርም!!! | TPLF by Nuro Bezede ኑሮ በዘዴ 1 year ago 14 minutes, 17 seconds 38,914 views",Nuro Bezede ኑሮ በዘዴ,38914,38914,0
6846,"Ethiopia አስደንጋጭ ሴራ በግድቡ ላይ፤ በአየር ክልሉ በረራ ማድረግ ለምን ተከለከለ? by Nuro Bezede ኑሮ በዘዴ 1 year ago 12 minutes, 57 seconds 20,478 views",Nuro Bezede ኑሮ በዘዴ,20478,20478,0
6847,"የፌደራል መንግሰት ጸጥታ ሃይሉን ትግራይ ክልል ሊያሰማራ ነው! | Ethiopia by Nuro Bezede ኑሮ በዘዴ 1 year ago 13 minutes, 13 seconds 85,226 views",Nuro Bezede ኑሮ በዘዴ,85226,85229,3
6848,"የፈጣሪ ድንቅ ስራ በአንድ ወሊድ 4 ልጆችን ከተገላገለችዉ ሸምስያ ጋር ልዩ ቃለመጠይቅ by Nuro Bezede ኑሮ በዘዴ 1 year ago 26 minutes 4,352 views",Nuro Bezede ኑሮ በዘዴ,4352,4353,1
6849,"ከአየር ሀይል ለግብፅ የተላከ ቆፍጣና መልዕክት | Ethiopia by Nuro Bezede ኑሮ በዘዴ 1 year ago 18 minutes 8,673 views",Nuro Bezede ኑሮ በዘዴ,8673,8674,1
6850,"ሰበር ዜና - ኢሬቻን በደም ለማጨቅየት ሲዘጋጁ የተያዙ ሽብርተኞች ሚስጥር አወጡ! | Ethiopia by Nuro Bezede ኑሮ በዘዴ 1 year ago 10 minutes, 45 seconds 39,299 views",Nuro Bezede ኑሮ በዘዴ,39299,39299,0
6851,"Ethiopia ሰበር ዜና! አዲስ አበባን  ክልል የማድረግ ስራ ተጀመረ! by Nuro Bezede ኑሮ በዘዴ 1 year ago 12 minutes, 53 seconds 13,436 views",Nuro Bezede ኑሮ በዘዴ,13436,13437,1
6852,"Ethiopia የኢትዮጵያ ፈታኝ ቀን መስከረም 25 ህወሃት ሊያደርግ ያቀዳቸው  ሴራዎች ሲጋለጡ! by Nuro Bezede ኑሮ በዘዴ 1 year ago 10 minutes, 51 seconds 28,119 views",Nuro Bezede ኑሮ በዘዴ,28119,28120,1
6853,"አዲሱን 100 ሺህ ብር በዱሮው 500 ሽህ ብር የሚቀይሩ ወንጀለኞች ተጋለጡ! | Ethiopia by Nuro Bezede ኑሮ በዘዴ 1 year ago 10 minutes, 34 seconds 53,524 views",Nuro Bezede ኑሮ በዘዴ,53524,53524,0
6854,"ህዝቡን ያስደነቀው የደመራ በአል ላይ የሊቃውንቱ ልዩ ትእይንት በመስቀል አደባባይ by Nuro Bezede ኑሮ በዘዴ 1 year ago 12 minutes, 27 seconds 10,093 views",Nuro Bezede ኑሮ በዘዴ,10093,10093,0
6855,"በመስቀል አደባባይ የሊቃውንቱ ልዩ የወረብ ስነ—ስርዓት by Nuro Bezede ኑሮ በዘዴ 1 year ago 9 minutes, 22 seconds 3,459 views",Nuro Bezede ኑሮ በዘዴ,3459,3459,0
6856,"ህወሃት ባሸባሪነት እንዲፈረጅ ተጠየቀ፤ ከኢትዮጵያ ፖለተካ እንዲሰረዙ ተመክሯል | Ethiopia by Nuro Bezede ኑሮ በዘዴ 1 year ago 11 minutes, 53 seconds 26,113 views",Nuro Bezede ኑሮ በዘዴ,26113,26113,0
6857,"የተጠርጣሪዋ መጨረሻ ዶናልድ ትራምፕ አስደንጋጭ የግድያ ሙከራ ተደረገባቸው! | Ethiopia by Nuro Bezede ኑሮ በዘዴ 1 year ago 11 minutes, 48 seconds 4,725 views",Nuro Bezede ኑሮ በዘዴ,4725,4725,0
6858,"17 ጥይት ነበር የያዘዉ! | የፌደራል ፖሊስ አባሉ 4 ቤተሰቦቻቸዉን የቀጠፈባቸዉ አሳዛኝ ልጆች! by Nuro Bezede ኑሮ በዘዴ 1 year ago 37 minutes 73,690 views",Nuro Bezede ኑሮ በዘዴ,73690,73692,2
6859,"Ethiopia ጀዋር በግብጽ የሚያሰለጥናቸው ወታደሮችና ማህበረ ቅዱሳንን የማጥፋት ዘመቻው! by Nuro Bezede ኑሮ በዘዴ 1 year ago 11 minutes, 24 seconds 9,693 views",Nuro Bezede ኑሮ በዘዴ,9693,9693,0
6860,"ህወሃትን  ያሸበረ  የመከላከያ ሰራዊት መቀሌ ገብቶ አደረ! | Ethiopia | TPLF by Nuro Bezede ኑሮ በዘዴ 1 year ago 12 minutes, 13 seconds 345,534 views",Nuro Bezede ኑሮ በዘዴ,345534,345549,15
6861,"ለጠቅላይ ሚኒስትሩ  የተዘረጋው አደገኛ ወጥመድ እና ከጀርባ ያለው ድብቅ ቁማር | Ethiopia by Nuro Bezede ኑሮ በዘዴ 1 year ago 11 minutes, 41 seconds 10,117 views",Nuro Bezede ኑሮ በዘዴ,10117,10117,0
6862,"“በቻይናዊዉ ባለሀብት ከደቡብ አፍሪካዉ አፓርታይድ ለይተን የማናየዉ በደል ተፈፅሞብናል”የፀሀይ ሪልስቴት ቤት ባለንብረቶች | Ethiopia by Nuro Bezede ኑሮ በዘዴ 1 year ago 26 minutes 1,864 views",Nuro Bezede ኑሮ በዘዴ,1864,1868,4
6863,"Ethiopia አንጀቱ የተቆረጠበት አሳዛኝ ህፃን እና እረዳት አልባ እናቱ - ድረሱልን ይላሉ! by Nuro Bezede ኑሮ በዘዴ 1 year ago 34 minutes 6,318 views",Nuro Bezede ኑሮ በዘዴ,6318,6318,0
6864,"ያገረሸዉ ሿሿ አዲሱ የኮንዶሚኒየም ዘረፋ ታክቲክ ባዲሷ ምክትል ከንቲባ | Ethiopia by Nuro Bezede ኑሮ በዘዴ 1 year ago 10 minutes, 54 seconds 11,224 views",Nuro Bezede ኑሮ በዘዴ,11224,11225,1
6865,"Ethiopia የኒውክሌሩና የሳተላይቷ ምስጢረ-ጥምረት የሩስያ መንግስት የምስራች አበሰረን! by Nuro Bezede ኑሮ በዘዴ 1 year ago 11 minutes, 25 seconds 18,074 views",Nuro Bezede ኑሮ በዘዴ,18074,18078,4
6866,"የመንግስትን ራስ ምታት ያስታገሰው መግለጫ - ጠ/ሩ ያሾፉባቸዉ ባለስልጣናት ያልታሰበ መላ ተዘየደባቸዉ! by Nuro Bezede ኑሮ በዘዴ 1 year ago 11 minutes, 58 seconds 77,771 views",Nuro Bezede ኑሮ በዘዴ,77771,77771,0
6867,"Ethiopia የአብን ሊቀመንበር እና የአቃቤ ህጉ ዱላ ቀረሽ ዘለፋ -  የእስክንድር ክስ ሴራዎች! by Nuro Bezede ኑሮ በዘዴ 1 year ago 10 minutes, 55 seconds 12,212 views",Nuro Bezede ኑሮ በዘዴ,12212,12212,0
6868,"የብር ኖት ቅያሬውና ያልተጠበቀ ስውር አንድምታው | Ethiopia by Nuro Bezede ኑሮ በዘዴ 1 year ago 12 minutes, 8 seconds 77,850 views",Nuro Bezede ኑሮ በዘዴ,77850,77851,1
6869,"ዳውድ ኢብሳ ከህወሃት ጋር ሲያሴር  እጅ ከፍንጅ ተያዘ! | Ethiopia by Nuro Bezede ኑሮ በዘዴ 1 year ago 11 minutes, 40 seconds 18,451 views",Nuro Bezede ኑሮ በዘዴ,18451,18452,1
6870,"ኢትዮጵያዊያን ትጣራለች  - ከወንዶች ጉዳይ ንግስቷ (ቀጮ) ጋር አባይ ላይ! ልዩ ቃለ መጠይቅ by Nuro Bezede ኑሮ በዘዴ 1 year ago 24 minutes 2,868 views",Nuro Bezede ኑሮ በዘዴ,2868,2870,2
6871,"አዲስ አመትን በቀደምት አራዶቹ መንደር ፒያሳ | Ethiopia by Nuro Bezede ኑሮ በዘዴ 1 year ago 23 minutes 2,641 views",Nuro Bezede ኑሮ በዘዴ,2641,2641,0
6872,"ቀዌው ሰዉዬ ለክብር ታጩ! የዶ/ር አብይ እና ትራምፕ ፍጥጫ እዚህ ደረሰ! | Ethiopia by Nuro Bezede ኑሮ በዘዴ 1 year ago 10 minutes, 1 second 5,801 views",Nuro Bezede ኑሮ በዘዴ,5801,5801,0
6873,"በምርጫው እለት ዶ/ር አብይ ለትግራይ ህዝብ የላኩት ጥብቅ መልእክት! | Ethiopia | TPLF by Nuro Bezede ኑሮ በዘዴ 1 year ago 12 minutes, 40 seconds 16,786 views",Nuro Bezede ኑሮ በዘዴ,16786,16786,0
6874,"ጃዋር መሀመድ  እና በቀለ ገርባ በድርድር ሊለቀቁ ነው? | Ethiopia by Nuro Bezede ኑሮ በዘዴ 1 year ago 10 minutes, 15 seconds 5,310 views",Nuro Bezede ኑሮ በዘዴ,5310,5310,0
6875,"Ethiopia ኢትዮጲያ የአሜሪካን ድብቅ ሴራ አከሸፈች! by Nuro Bezede ኑሮ በዘዴ 1 year ago 12 minutes, 54 seconds 14,873 views",Nuro Bezede ኑሮ በዘዴ,14873,14874,1
6876,"ኢትዮጵያዉያንን  ያስፈነደቀው የ መሀመድ አል-አሩሲ ታላቅ ሽልማት | Ethiopia by Nuro Bezede ኑሮ በዘዴ 1 year ago 12 minutes, 23 seconds 9,268 views",Nuro Bezede ኑሮ በዘዴ,9268,9269,1
6877,"ተወዳጅ አርቲስቶች ወደ በባህርዳር ጣና ያልጠበቁት ገጠማቸው! መኮንን ላከ አስደናቂ መልዕክት አለዉ! | Ethiopia by Nuro Bezede ኑሮ በዘዴ 1 year ago 35 minutes 11,258 views",Nuro Bezede ኑሮ በዘዴ,11258,11260,2
6878,"ጀማነሽ ሰለሞን አነጋሪ ስለሆነዉ የቀሚሷ ጥለት ምላሽ ሰጠች! የ666 አርማ ወይስ የኤልያስ ቀስተደመና? by Nuro Bezede ኑሮ በዘዴ 1 year ago 50 minutes 9,987 views",Nuro Bezede ኑሮ በዘዴ,9987,10035,48
6879,"Ethiopia ሰበር ቪዲዮ ከኢትዮጲያ ኦርቶዶክስ ተዋህዶ ቤተክርስቲያን የተሰጠ ጥብቅ መግለጫ by Nuro Bezede ኑሮ በዘዴ 1 year ago 34 minutes 4,321 views",Nuro Bezede ኑሮ በዘዴ,4321,4322,1
6880,"ጠ/ሚኒስትሩ ቤተ መንግስት አስጠርቶ ፊቴ ላይ ተፍቶብኛል! ፓርላማዉ መሀይም ነዉ ስላለ አሳዛኝ ግፍ የደረሰበት እንዳለ | Ethiopia by Nuro Bezede ኑሮ በዘዴ 1 year ago 58 minutes 9,481 views",Nuro Bezede ኑሮ በዘዴ,9481,9484,3
6881,"Ethiopia ለጀዋር ሚዲያ መዋጮ ያላዋጡ ሰዎች ንብረት ነዉ የወደመዉ! by Nuro Bezede ኑሮ በዘዴ 1 year ago 45 minutes 10,754 views",Nuro Bezede ኑሮ በዘዴ,10754,10754,0
6882,"“ለጀዋር ገንዘብ አዋጣ ተብዬ እምቢ ብያቸዉ ነበር!“ መምህር ዮሀንስ ያመቁትን ሚስጥር አፈረጡት ክፍል 2 | Ethiopia by Nuro Bezede ኑሮ በዘዴ 1 year ago 45 minutes 30,683 views",Nuro Bezede ኑሮ በዘዴ,30683,30685,2
6883,"Ethiopia ኩላሊቱን ወንድሜ ይሰጠኛል.... | ሁለት ኩላሊቶቹ ፌል ያደረጉበት አንተነህ ጌታቸዉ ከሞት አድኑኝ እያለ ነዉ! by Nuro Bezede ኑሮ በዘዴ 1 year ago 26 minutes 15,819 views",Nuro Bezede ኑሮ በዘዴ,15819,15819,0
6884,"Ethiopia የባለስልጣናቱ አሳፋሪ ገመና | በሻሸመኔ የሉሲ አካዳሚ ባለቤት ጥቃት የፈፀሙባቸዉን ሰዎች ማንነት በግልፅ ተናገሩ! by Nuro Bezede ኑሮ በዘዴ 1 year ago 43 minutes 34,262 views",Nuro Bezede ኑሮ በዘዴ,34262,34263,1
6885,"Ethiopia ለጣና የተሰዋዉ ጋዜጠኛ ካሳሁን የ40 ቀን መታሰብያ ላይ የቤተሰቦቹ ልብ የሚነካ መልዕክት by Nuro Bezede ኑሮ በዘዴ 1 year ago 23 minutes 23,787 views",Nuro Bezede ኑሮ በዘዴ,23787,23787,0
6886,"Ethiopia “የታሰሩት ከተፈቱ እኛም በሀይል እንደራጃለን” ሻሸመኔ በቤተክርስትያን የተጠለሉ ሀዘንተኞች by Nuro Bezede ኑሮ በዘዴ 1 year ago 39 minutes 82,282 views",Nuro Bezede ኑሮ በዘዴ,82282,82290,8
6887,"Ethiopia  ያልተሰማው የዝዋይ ጉድ! 5 ቤተሰቦቼን በገጀራና በሜንጫ ቆራርጠው ገደሏቸው! by Nuro Bezede ኑሮ በዘዴ 1 year ago 25 minutes 23,874 views",Nuro Bezede ኑሮ በዘዴ,23874,23904,30
6888,"Ethiopia ባለቤቴን በኢትዮጲያ ባንዲራ አስረዉ ነዉ ያረዱት! ፖሊስ ራሳችሁን አስመልጡ አንረዳችሁም አለን! by Nuro Bezede ኑሮ በዘዴ 1 year ago 12 minutes, 45 seconds 90,046 views",Nuro Bezede ኑሮ በዘዴ,90046,90061,15
6889,"Ethiopia እግዚኦ! በሻሸመኔ ነብሰጡር ባለቤቱ በአሰቃቂ ሁኔታ የተገደለችበት የምለው አለኝ ይላል! by Nuro Bezede ኑሮ በዘዴ 1 year ago 16 minutes 48,491 views",Nuro Bezede ኑሮ በዘዴ,48491,48514,23
6890,"Ethiopia ሸገር ላይ ወጣቶች ቀዉጢ እያደረጉት ነዉ፤ አዲስአበባ ሰርግ እና ምላሽ ሆኗል! ""አባይ እና አብይ አንድ ናቸዉ!"" by Nuro Bezede ኑሮ በዘዴ 1 year ago 22 minutes 20,918 views",Nuro Bezede ኑሮ በዘዴ,20918,20921,3
6891,"Ethiopia ""ለግብፅ አድርሱልን"" አዲስ አበቤዎች በደስታ ተሞልተዉ ስለ አባይ ዉሀ ሙሌት ይናገራሉ! by Nuro Bezede ኑሮ በዘዴ 1 year ago 39 minutes 4,418 views",Nuro Bezede ኑሮ በዘዴ,4418,4418,0
6892,"Ethiopia እንኳን ደስ አላችሁ! በኢትዮጲያ ጎዳናዎች ላይ የተደረገዉ አስደሳች የደስታ መግለጫ by Nuro Bezede ኑሮ በዘዴ 1 year ago 13 minutes, 17 seconds 16,478 views",Nuro Bezede ኑሮ በዘዴ,16478,16478,0
6893,"የኢትዮጵያ አርቲስቶችና ጋዜጠኞች ጣና ሃይቅ ተገኝተው የሰሩት አኩሪ ተግባር!! | Ethiopia by Nuro Bezede ኑሮ በዘዴ 1 year ago 53 minutes 27,489 views",Nuro Bezede ኑሮ በዘዴ,27489,27489,0
6894,"ኢትዮጵያውያን አርቲስቶች ጣና ሃይቅ ተጉዘው የገጠማቸውን አሳዛኝ ጉዳይ ተናገሩ!! | Ethiopia by Nuro Bezede ኑሮ በዘዴ 1 year ago 25 minutes 58,439 views",Nuro Bezede ኑሮ በዘዴ,58439,58441,2
6895,"በግማሽ የሚያስከፍለው የከተማችን አነጋገሪው ስጋ ቤት!! በተሻገር ጣሰው | Ethiopia by Nuro Bezede ኑሮ በዘዴ 1 year ago 25 minutes 20,800 views",Nuro Bezede ኑሮ በዘዴ,20800,20803,3
6896,"ከመንግስት ማሳሰቢያ ተሰጠ - ሰኔ 14 በኢትዮጵያ የሚከሰተውን የፀሃይ ግርዶሽ መመልከት ለአይነስውርነት ያጋልጣል ተባለ! | Ethiopia by Nuro Bezede ኑሮ በዘዴ 1 year ago 30 minutes 12,515 views",Nuro Bezede ኑሮ በዘዴ,12515,12515,0
6897,"Ethiopia: በቫይረሱ ስጋት ምክንያት በቤት ውስጥ ላላችሁ ብቻ ይህን ፕሮግራም ተመልከቱ! by Nuro Bezede ኑሮ በዘዴ 1 year ago 1 hour, 26 minutes 5,484 views",Nuro Bezede ኑሮ በዘዴ,5484,5485,1
6898,"በ700 ሚሊዮን ብር የተገነባው ግዙፋ የውሃ ፋብሪካ አፍሪካ ውሃ ኢትዮጵያን ተቀላቀለ!! | Ethiopia by Nuro Bezede ኑሮ በዘዴ 1 year ago 54 minutes 16,797 views",Nuro Bezede ኑሮ በዘዴ,16797,16799,2
6899,"የእባብ ስጋ አብልተውኛል ልጄንም ደፍረውብኛል የሚለው አሳዛኝ አባት ከተሻገር ጋር ያደረገው ቆይታ | Ethiopia by Nuro Bezede ኑሮ በዘዴ 1 year ago 47 minutes 84,780 views",Nuro Bezede ኑሮ በዘዴ,84780,84784,4
6900,"አሳዛኝ ቃለመጠይቅ! - በማዕከላዊ እስር ቤት በደረሰበት ሰቆቃ በየሰዓቱ ዳይፐር የሚቀይረው አሳዛኝ ኢንጂነር! by Nuro Bezede ኑሮ በዘዴ 1 year ago 51 minutes 59,624 views",Nuro Bezede ኑሮ በዘዴ,59624,59636,12
6901,"ኢትዮጲያዊነት እንዲህ ነው - የላፍቶ ኮንዶሚኒም ነዋሪዎች የሰሩት አስደናቂ በጎ ተግባር!! | Ethiopia by Nuro Bezede ኑሮ በዘዴ 1 year ago 26 minutes 10,765 views",Nuro Bezede ኑሮ በዘዴ,10765,10765,0
6902,"Ethiopia: ሰኔና ሰኞ ገጠመ አስከ መስከረም 24 የሚያጋጥመውን ችግር መምህር ሰለሞን ይናገራሉ!! by Nuro Bezede ኑሮ በዘዴ 1 year ago 47 minutes 121,193 views",Nuro Bezede ኑሮ በዘዴ,121193,121197,4
6903,"Ethiopia: ድምፃዊ ቀመር የሱፍ በሃይማኖት በዳዳ ቤት ህዝቡን በእንባ ያራጨ ንግግር አደረገ! by Nuro Bezede ኑሮ በዘዴ 1 year ago 34 minutes 214,527 views",Nuro Bezede ኑሮ በዘዴ,214527,214548,21
6904,"የሀይማኖት አባት ለኢትዮጲያ ህዝብ የምለው አለኝ ይላሉ ቪዲዮውን ይመልከቱ | Ethiopia by Nuro Bezede ኑሮ በዘዴ 1 year ago 14 minutes, 42 seconds 114,852 views",Nuro Bezede ኑሮ በዘዴ,114852,114853,1
6905,"እውነታው ይህ ነው! ዉዝግብ ያስነሱት የ65 አመቷ ወላድ እናት ስለ እድሜያቸዉ ሚስጥር እዉነቱን ተናገሩ! | Ethiopia by Nuro Bezede ኑሮ በዘዴ 1 year ago 52 minutes 175,982 views",Nuro Bezede ኑሮ በዘዴ,175982,176030,48
6906,"ጭካኔው እዚህ ደርሷል - ከ3 ልጆቿ ጋር የባሏ ቤተሰቦች ጎዳና የጣሏት አሳዛኝ እናት! | Ethiopia by Nuro Bezede ኑሮ በዘዴ 1 year ago 38 minutes 61,983 views",Nuro Bezede ኑሮ በዘዴ,61983,62001,18
6907,"የወጣቶቹ አስደናቂ ድርጊት! በህመም የሚሰቃዩ ቤተሰቦችን በየቤቱ እየሄዱ የሚረዱት የካዛንቺስ ወጣቶች!! | Ethiopia by Nuro Bezede ኑሮ በዘዴ 1 year ago 18 minutes 23,426 views",Nuro Bezede ኑሮ በዘዴ,23426,23426,0
6908,"ከ6 ዓመት ልጇ ጋር ከሞቀ ቤቷ አባረው ቤቱን ለሌላ ግለሰብ የተሰጠባት አሳዛኝ እናት!! | Ethiopia by Nuro Bezede ኑሮ በዘዴ 1 year ago 30 minutes 40,983 views",Nuro Bezede ኑሮ በዘዴ,40983,40986,3
6909,"የፈጣሪ ድንቅ ስራ! የ65 አመቷ አዛውንት ወንድ ልጅ ተገላገሉ! | ልዩ ቃለ-መጠይቅ | Ethiopia by Nuro Bezede ኑሮ በዘዴ 1 year ago 33 minutes 474,456 views",Nuro Bezede ኑሮ በዘዴ,474456,474793,337
6910,"ለስምንት አመታት የአልጋ ቁራኛ የሆነኑት  አባት የምለው አለኝ ይላሉ | Ethiopia by Nuro Bezede ኑሮ በዘዴ 1 year ago 28 minutes 49,882 views",Nuro Bezede ኑሮ በዘዴ,49882,49910,28
6911,"የሀይማኖት በዳዳ ቤተሰቦች የምንለው አለ ይላሉ | በተሻገር ጣሰው | Ethiopia by Nuro Bezede ኑሮ በዘዴ 1 year ago 1 hour, 13 minutes 397,986 views",Nuro Bezede ኑሮ በዘዴ,397986,398300,314
6912,"ልዩ ቃለ መጠይቅ የእህተ ማርያም ልጆች ከተሻገር ጋር ያደረጉት ቆይታ | Ethiopia Exclusive interview by Nuro Bezede ኑሮ በዘዴ 1 year ago 24 minutes 199,882 views",Nuro Bezede ኑሮ በዘዴ,199882,202047,2165
6913,"በእህተማርያም ተከታዮች እና በሟቹ ባሏ ዘመዶች መሀል ፍጥጫዉ ተካሯል | ""ባሏ ሲሞትበአይኔ አይቼያለሁ!"" | Ethiopia by Nuro Bezede ኑሮ በዘዴ 1 year ago 49 minutes 92,487 views",Nuro Bezede ኑሮ በዘዴ,92487,94175,1688
6914,"ልዩ የዒድ ሰርፕራይዝ - ልጃቸው በነርቭ ምክንያት ፓራላይዝ የሆነው የሙባረክ ቤተሰብ | Ethiopia by Nuro Bezede ኑሮ በዘዴ 1 year ago 48 minutes 47,685 views",Nuro Bezede ኑሮ በዘዴ,47685,47691,6
6915,"“ወንድሜን ከነ ነብሱ ነው የቀበረችው” የሟቹ የእህተ ማርያም ባል ወንድም ሚስጥሩን አወጣዉ! | Ethiopia by Nuro Bezede ኑሮ በዘዴ 1 year ago 22 minutes 509,733 views",Nuro Bezede ኑሮ በዘዴ,509733,519125,9392
6916,"የሟች ቤተሰቦች የእህተማርያምን ሚስጥር አወጡት - ከነነብሱ ቀብራዋለች። ሙሉ ቪዲዮ ከሰአታት በኋላ ይለቀቃል ይጠብቁ by Nuro Bezede ኑሮ በዘዴ 1 year ago 2 minutes, 7 seconds 4,533 views",Nuro Bezede ኑሮ በዘዴ,4533,4533,0
6917,"በአርቲስት ታማኝ በየነ የሚመራው ግሎባል አሊያንስ የ11 ሚሊዮን ብር ቁሳቁስ አበረከተ! | Ethiopia by Nuro Bezede ኑሮ በዘዴ 1 year ago 19 minutes 2,120 views",Nuro Bezede ኑሮ በዘዴ,2120,2120,0
6918,"የሲዳማ አዲስ ዓመት ፍቼ ጨንበላላ ለመጀመሪያ ጊዜ በቤት ውስጥ እየተከበረ ነው! | Ethiopia by Nuro Bezede ኑሮ በዘዴ 1 year ago 13 minutes, 4 seconds 1,048 views",Nuro Bezede ኑሮ በዘዴ,1048,1048,0
6919,"ብዙዎችን በእምባ ያራጨው በነርቭ ህመም የሚሰቃየው የ10 ዓመት ታዳጊ መድሃኒት ግዙልኝ ይላል! | Ethiopia by Nuro Bezede ኑሮ በዘዴ 1 year ago 23 minutes 28,249 views",Nuro Bezede ኑሮ በዘዴ,28249,28282,33
6920,"የእህተ ማርያም (ስንዱ) እና የእናቷ ገመና | Ethiopia by Nuro Bezede ኑሮ በዘዴ 1 year ago 12 minutes, 27 seconds 81,191 views",Nuro Bezede ኑሮ በዘዴ,81191,81677,486
6921,"የአባይ ፖለቲካ ና የባዕዳን ተልዕኮ ሚስጥር! | Ethiopia by Nuro Bezede ኑሮ በዘዴ 1 year ago 13 minutes, 27 seconds 2,953 views",Nuro Bezede ኑሮ በዘዴ,2953,2954,1
6922,"የጆሲ ኢንዘሃውስ ቀኝ እጅ አንጋፋው ጋዜጠኛ አባተ ማንደፍሮ በጠና ታሟል እንድረስለት! | Ethiopia by Nuro Bezede ኑሮ በዘዴ 1 year ago 31 minutes 17,200 views",Nuro Bezede ኑሮ በዘዴ,17200,17212,12
6923,"ለፍቅረኛው ሲል ሃብት ንብረቱን ሽጦ ጎዳና የወደቀው ወጣት ካፈቀረት ሴት ፎቶ ጋር ቅበሩኝ ይላል!! | Ethiopia by Nuro Bezede ኑሮ በዘዴ 1 year ago 45 minutes 4,054 views",Nuro Bezede ኑሮ በዘዴ,4054,4056,2
6924,"የግብፅ ጦር ኢትዮጵያ ላይ እያንዣበበ ነው!! | Ethiopia by Nuro Bezede ኑሮ በዘዴ 1 year ago 13 minutes, 9 seconds 43,259 views",Nuro Bezede ኑሮ በዘዴ,43259,43260,1
6925,"Ethiopia: ኢንጂነር ታከለ ኡማ 15 ሚሊዮን ብር የሚገመት ንብረት  ለጎተራ ህዝብ አንበሸበሹት! by Nuro Bezede ኑሮ በዘዴ 1 year ago 10 minutes, 58 seconds 16,446 views",Nuro Bezede ኑሮ በዘዴ,16446,16446,0
6926,"ከ 450 በላይ በችግር ላይ የወደቁ ወገኖችን የሚያስተዳድረው ካሌብ ፋውንዴሽን የወገን ያለ እያለ ነው | Ethiopia by Nuro Bezede ኑሮ በዘዴ 1 year ago 14 minutes, 22 seconds 4,960 views",Nuro Bezede ኑሮ በዘዴ,4960,4960,0
6927,"ከነማህተቧ ልጅ የወለደችው እናት በደረሰባት ጫና ማዕተቡን መበጠሷ ተሰማ! | Ethiopia by Nuro Bezede ኑሮ በዘዴ 1 year ago 21 minutes 5,601 views",Nuro Bezede ኑሮ በዘዴ,5601,5601,0
6928,"የኢትዮጵያዊነት ጥግ ዑስታዝ አቡበከር ለ184 ወገኖች ለረመዳን ማፍጠሪያ የሚሆን ድጋፍ አደረ! by Nuro Bezede ኑሮ በዘዴ 1 year ago 11 minutes, 27 seconds 1,427 views",Nuro Bezede ኑሮ በዘዴ,1427,1427,0
6929,"ነብስ ይማር - አሳዛኝ ዜና ሙሽራው በ3 ጥይት ተገደለ! | Ethiopia by Nuro Bezede ኑሮ በዘዴ 1 year ago 10 minutes, 7 seconds 16,523 views",Nuro Bezede ኑሮ በዘዴ,16523,16525,2
6930,"ህዝብ የሚሻማባቸው የየመን ተወዳጅ ምግቦች በቦሌ ሚካኤል | Ethiopia by Nuro Bezede ኑሮ በዘዴ 1 year ago 23 minutes 7,683 views",Nuro Bezede ኑሮ በዘዴ,7683,7687,4
6931,"Ethiopia: ሰበር ዜና የጆሲ ሰራተኞች ያልተጠበቀ ነገር ገጠማቸው! by Nuro Bezede ኑሮ በዘዴ 1 year ago 10 minutes, 24 seconds 3,563 views",Nuro Bezede ኑሮ በዘዴ,3563,3563,0
6932,"እራሷን ቅድስት አርሴማ ባለቤቷን ደግሞ ቅዱስ ገብርዔል ብላ የሰየመችው ሴት ከቦታው መረጃ! by Nuro Bezede ኑሮ በዘዴ 1 year ago 10 minutes, 8 seconds 8,817 views",Nuro Bezede ኑሮ በዘዴ,8817,8818,1
6933,"ተአምር ነው! ፈጣሪ ለ2ኛ ጊዜ ተገለጠ ማህተብ አስራ የተወለደች ህፃን በድጋሚ ተወለደች | Ethiopia by Nuro Bezede ኑሮ በዘዴ 1 year ago 10 minutes, 15 seconds 32,041 views",Nuro Bezede ኑሮ በዘዴ,32041,32054,13
6934,"Ethiopia | ከኢትዮጵያ አየር መንገድ የተሰጠ መግለጫ! by Nuro Bezede ኑሮ በዘዴ 1 year ago 12 minutes, 14 seconds 6,070 views",Nuro Bezede ኑሮ በዘዴ,6070,6070,0
6935,"“ በሚስጥር ከህወሓት ጋር ለመወያየት ዝግጁ ነን” ጠቅላይ ሚኒስቴር ዐቢይ አህመድ | Ethiopia by Nuro Bezede ኑሮ በዘዴ 1 year ago 10 minutes, 12 seconds 2,079 views",Nuro Bezede ኑሮ በዘዴ,2079,2079,0
6936,"ኢትዮጵያዊነት እንዲህ ነው።ጫካ ቡና በየቀኑ ለ300 ሰዎች በየቀኑ እየመገበ ነው! | Ethiopia by Nuro Bezede ኑሮ በዘዴ 1 year ago 30 minutes 2,348 views",Nuro Bezede ኑሮ በዘዴ,2348,2349,1
6937,"በሺህ የሚቆጠሩ በቤሩት የሚገኙ ኢትዮጵያውያን መንግስት እንዲደርስላቸው ጥሪ አቀረቡ! by Nuro Bezede ኑሮ በዘዴ 1 year ago 10 minutes, 21 seconds 2,589 views",Nuro Bezede ኑሮ በዘዴ,2589,2589,0
6938,"""ልጁ በነገራችን ላይ ቀልዱን አይደለም "" ዶ/ር ምንተስኖት! | Ethiopia by Nuro Bezede ኑሮ በዘዴ 1 year ago 10 minutes, 18 seconds 13,630 views",Nuro Bezede ኑሮ በዘዴ,13630,13631,1
6939,"ሙስሊም ሳይሆኑ የረመዳንን ፆም የሚፆሙት የፓርላማ አባል እያነጋገሩ ነው! by Nuro Bezede ኑሮ በዘዴ 1 year ago 10 minutes, 51 seconds 2,262 views",Nuro Bezede ኑሮ በዘዴ,2262,2263,1
6940,"በስደት በተለያዩ ሃገሮች የሚኖሩ ኢትዮጵያውን የሰሩት አስደናቂ በጎ ተግባር! | Ethiopia by Nuro Bezede ኑሮ በዘዴ 1 year ago 14 minutes, 9 seconds 4,472 views",Nuro Bezede ኑሮ በዘዴ,4472,4472,0
6941,"ደጉና ርህሩህ አርቲስት ሰለሞን ቦጋለ ታሪክ ሰራ | ሌሎች አርቲስቶች ከሱ ተማሩ!!  በተሻገር ጣሰው | Ethiopia by Nuro Bezede ኑሮ በዘዴ 1 year ago 21 minutes 48,341 views",Nuro Bezede ኑሮ በዘዴ,48341,48343,2
6942,"የዑስታዝ አቡበከር መልዕክትና የፋኖ አርበኛ መሳፍንት ከመንግስት ጋር ድርድር! | Ethiopia by Nuro Bezede ኑሮ በዘዴ 1 year ago 10 minutes, 55 seconds 2,611 views",Nuro Bezede ኑሮ በዘዴ,2611,2618,7
6943,"መታየት ያለበት! ከቤሩት መጥታ በኮሮና ከተያዘችው ኢትዮጵያዊት ጋር የተደረገ ቆይታ | Ethiopia by Nuro Bezede ኑሮ በዘዴ 1 year ago 12 minutes, 24 seconds 38,508 views",Nuro Bezede ኑሮ በዘዴ,38508,38510,2
6944,"ትንቢት ተናጋሪው ስለ ኢትዮጵያ እየተናገረ ነው።ተመልከቱት! | ክፍል2 | Ethiopia by Nuro Bezede ኑሮ በዘዴ 1 year ago 58 minutes 121,457 views",Nuro Bezede ኑሮ በዘዴ,121457,121470,13
6945,"የፋሲካ ቀን በኤሌክትሪክ አደጋ ህይወታቸው ያለፈውየጎዳና ልጆች አሳዛኝ ታሪክ! | በተሻገር ጣሰው | Ethiopia by Nuro Bezede ኑሮ በዘዴ 1 year ago 18 minutes 72,781 views",Nuro Bezede ኑሮ በዘዴ,72781,72789,8
6946,"የበዓል ልዩ የስጦታ ፕሮግራምና ከሜቆዶንያ መሰራች ቢኒያም ጋር ቆይታ! | Ethiopia by Nuro Bezede ኑሮ በዘዴ 1 year ago 24 minutes 10,645 views",Nuro Bezede ኑሮ በዘዴ,10645,10645,0
6947,"""አባት ሆይ የሚያደርጉትን አያውቁምና ይቅር በላቸው""  በተሻገር ጣሰው | Ethiopia by Nuro Bezede ኑሮ በዘዴ 1 year ago 12 minutes, 2 seconds 2,040 views",Nuro Bezede ኑሮ በዘዴ,2040,2046,6
6948,"አስቸኳይ ጊዜ አዋጁን የተላለፋ 50 ሰዎች በቁጥጥር ስር ዋሉ! by Nuro Bezede ኑሮ በዘዴ 1 year ago 10 minutes, 12 seconds 3,135 views",Nuro Bezede ኑሮ በዘዴ,3135,3135,0
6949,"መታየት ያለበት - ኢትዮጵያዊው የቦይንግ 737 አውሮፕላን ሆቴል ባለቤት በየቀኑ ለድሆች እየመገቡ ነው!! | Ethiopia by Nuro Bezede ኑሮ በዘዴ 1 year ago 33 minutes 16,275 views",Nuro Bezede ኑሮ በዘዴ,16275,16277,2
6950,"""ተራርቃችሁ ተቀመጡ"" ብሎ ምክር የለገሰው ወጣት በ4 ወጣቶችተገደለ! | Ethiopia by Nuro Bezede ኑሮ በዘዴ 1 year ago 10 minutes, 12 seconds 3,552 views",Nuro Bezede ኑሮ በዘዴ,3552,3552,0
6951,"አዲስ አበባ ውስጥ በቫይረሱተይዣለው ያለው የአይሱዙ ሹፌር መኪናውን ጥሎ ጠፉ!  | Ethiopia by Nuro Bezede ኑሮ በዘዴ 1 year ago 10 minutes, 13 seconds 6,993 views",Nuro Bezede ኑሮ በዘዴ,6993,6993,0
6952,"በበሽታው ምክንያት ድባቡ የጠፋው የሆሳዕና በዓል! | ETHIOPIA by Nuro Bezede ኑሮ በዘዴ 1 year ago 11 minutes, 1 second 2,616 views",Nuro Bezede ኑሮ በዘዴ,2616,2618,2
6953,"በአዲስ አበባ ዝርፊያ ተበራክቷል | ረሃብ ከሚገለን ቫይረሱይግደለን! | Ethiopia by Nuro Bezede ኑሮ በዘዴ 1 year ago 10 minutes, 18 seconds 8,175 views",Nuro Bezede ኑሮ በዘዴ,8175,8175,0
6954,"10 ጨቅላ ህፃናት በዶክተሮች በቫይረሱተለከፉ በቫይረሱከተያዙ ምን መመገብ አለብዎ? by Nuro Bezede ኑሮ በዘዴ 1 year ago 10 minutes, 54 seconds 2,590 views",Nuro Bezede ኑሮ በዘዴ,2590,2590,0
6955,"ሰበር መረጃ 150  የሳውዲ ንጉሳዊ ቤተሰቦች በአንድ ግቢ ውስጥ በቫይረሱ ተያዙ! by Nuro Bezede ኑሮ በዘዴ 1 year ago 12 minutes, 36 seconds 7,736 views",Nuro Bezede ኑሮ በዘዴ,7736,7736,0
6956,"ሰበር ዜና ጠቅላይ ሚኒስቴር ዐቢይ አህመድ የአስቸኳይ ጊዜ አዋጅ አወጁ! by Nuro Bezede ኑሮ በዘዴ 1 year ago 10 minutes, 33 seconds 3,855 views",Nuro Bezede ኑሮ በዘዴ,3855,3855,0
6957,"የሙፍቲህ አስደናቂ ንግግርና ቻይና በ 24 ሰዓት ውስጥ ከበሽታው ነፃ ሆነች! by Nuro Bezede ኑሮ በዘዴ 1 year ago 10 minutes, 8 seconds 7,515 views",Nuro Bezede ኑሮ በዘዴ,7515,7515,0
6958,"የበሽታው የተከሰተበት ወር ኮከብና አስትሮሎጂ ምን ይላል? | Ethiopia by Nuro Bezede ኑሮ በዘዴ 1 year ago 10 minutes, 42 seconds 3,727 views",Nuro Bezede ኑሮ በዘዴ,3727,3735,8
6959,"አስደሳች ዜና በቫይረሱየታየዙት የ85 ዓመት አዛውንት ከበሽታው አገገሙ! | Ethiopia by Nuro Bezede ኑሮ በዘዴ 1 year ago 12 minutes, 22 seconds 2,544 views",Nuro Bezede ኑሮ በዘዴ,2544,2544,0
6960,"የኢትዮጵያ አየር መንገድ ሆስተስ በሆቴል የደረሰባትን መንገላታት ይፋ አደረገች! | Ethiopia by Nuro Bezede ኑሮ በዘዴ 1 year ago 17 minutes 14,222 views",Nuro Bezede ኑሮ በዘዴ,14222,14227,5
6961,"ከጆንሆፒክንስ ዩኒቨርስቲ በበሽታው ዙሪያ ላይ ተመራማሪዎች መፍትሄ አቀረቡ!! | Ethiopia by Nuro Bezede ኑሮ በዘዴ 1 year ago 10 minutes, 38 seconds 2,889 views",Nuro Bezede ኑሮ በዘዴ,2889,2889,0
6962,"ጊፍት ሪል ስቴት ለሜቄዶንያና አጋር  ለሌላቸው ድጋፍ አደረገ! | Ethiopia by Nuro Bezede ኑሮ በዘዴ 1 year ago 25 minutes 1,039 views",Nuro Bezede ኑሮ በዘዴ,1039,1039,0
6963,"ሐኪም አበበች ሽፈራውና መጋቤ አዲስ ሮዳስ ታደሰ ስለ ግኝቱ ምን ይላሉ? | Ethiopia by Nuro Bezede ኑሮ በዘዴ 1 year ago 10 minutes, 24 seconds 2,055 views",Nuro Bezede ኑሮ በዘዴ,2055,2055,0
6964,"የመፈንቅለ-መንግስት ሴራ የተሞከረባቸዉ ሙስጠፌ ይሄን ብለዉ ነበር! by Nuro Bezede ኑሮ በዘዴ 1 year ago 13 minutes, 12 seconds 2,152 views",Nuro Bezede ኑሮ በዘዴ,2152,2154,2
6965,"የዕለቱ አጫጭር መረጃዎች በተሻገር ጣሰው - በበሽታው ምክንያት የአሜሪካ የሽጉጥ የጉልት ገበያ! | Ethiopia by Nuro Bezede ኑሮ በዘዴ 1 year ago 10 minutes, 30 seconds 2,358 views",Nuro Bezede ኑሮ በዘዴ,2358,2358,0
6966,"50 ሚሊዮን ህዝብ የጨረሰው ከእንፍሌዛ በሽታ ምን እንማር? | Ethiopia by Nuro Bezede ኑሮ በዘዴ 1 year ago 10 minutes, 7 seconds 2,099 views",Nuro Bezede ኑሮ በዘዴ,2099,2099,0
6967,"የዕለቱ አጫጭር መረጃዎች በተሻገር ጣሰው - 2 ጳጳሳት ህይወታቸው አለፈ!! | | Ethiopia by Nuro Bezede ኑሮ በዘዴ 1 year ago 10 minutes, 16 seconds 18,112 views",Nuro Bezede ኑሮ በዘዴ,18112,18113,1
6968,"አስደሳች ዜና - ለይቶ ማቆያ የገቡት የቫይረሱ ተጠቂዎች ማገገም ጀምረዋል!!! | Nuro Daily News Ethiopia by Nuro Bezede ኑሮ በዘዴ 1 year ago 10 minutes, 9 seconds 3,353 views",Nuro Bezede ኑሮ በዘዴ,3353,3353,0
6969,"አለምን ያስገረሙ (በቫይረሱዙርያ) የተሰራው ፊልም እና ያልተሰሙ እውነታዎች! | by Nuro Bezede ኑሮ በዘዴ 1 year ago 20 minutes 3,500 views",Nuro Bezede ኑሮ በዘዴ,3500,3500,0
6970,"በበሽታውየሞቱና የተያዙ 100 ታዋቂ መሪዎችና ሰዎች እነማናቸው? | By Teshager Tassew by Nuro Bezede ኑሮ በዘዴ 1 year ago 10 minutes, 17 seconds 4,718 views",Nuro Bezede ኑሮ በዘዴ,4718,4720,2
6971,"የ22 ተማሪዎች ህይወት አደጋ ላይ ነዉ የታከለ ኡማ የገደብ ጭምጭምታ! by Nuro Bezede ኑሮ በዘዴ 1 year ago 10 minutes, 9 seconds 7,224 views",Nuro Bezede ኑሮ በዘዴ,7224,7224,0
6972,"መጋቢ አዲስ እሸቱ ለይቶ ማቆያ ገብተዋል! | Nuro Daily News Ethiopia by Nuro Bezede ኑሮ በዘዴ 1 year ago 11 minutes, 39 seconds 2,238 views",Nuro Bezede ኑሮ በዘዴ,2238,2238,0
6973,"ያለምንም የጥይት ድምፅ ዓለምን ያስጨነቀው በሽታበዛሬው ዕለት ያለበት ሁኔታ! | Ethiopia by Nuro Bezede ኑሮ በዘዴ 1 year ago 10 minutes, 1 second 1,802 views",Nuro Bezede ኑሮ በዘዴ,1802,1802,0
6974,"""ጃወር መሃመድ በሚቀጥለው ምርጫ አይወዳደርም"" መምህር ሰለሞን ተሾመ | Ethiopia by Nuro Bezede ኑሮ በዘዴ 1 year ago 40 minutes 71,129 views",Nuro Bezede ኑሮ በዘዴ,71129,71143,14
6975,"Nuro Daily News Ethiopia | ዶ/ር አብይ ለድንገተኛ ዝግጅት ደሞዛቸዉን አበረከቱ! by Nuro Bezede ኑሮ በዘዴ 1 year ago 11 minutes, 57 seconds 1,705 views",Nuro Bezede ኑሮ በዘዴ,1705,1705,0
6976,"""11 ሰው በበሽ.ታውተጠረጥረው ወደ ማቆያ ተወስደዋል""!! | Ethiopia by Nuro Bezede ኑሮ በዘዴ 1 year ago 31 minutes 3,138 views",Nuro Bezede ኑሮ በዘዴ,3138,3138,0
6977,"ልደቱ አያሌው ብልፅግና የኮነኑበት ባለ 26 ገፅ ያቀረቡት ጦማር! | Lidetu Ayalew | Ethiopia by Nuro Bezede ኑሮ በዘዴ 1 year ago 10 minutes, 3 seconds 676 views",Nuro Bezede ኑሮ በዘዴ,676,676,0
6978,"የዕለቱ ዜናዎች - በኢትዮጲያውያን እልቂት ልቤ አዝኗል አብይ አህመድ! | Nuro Daily News Ethiopia by Nuro Bezede ኑሮ በዘዴ 1 year ago 11 minutes, 41 seconds 18,181 views",Nuro Bezede ኑሮ በዘዴ,18181,18183,2
6979,"ጆሲ በአዋሳና አዳማ ከተሞች ግዙፍ ሆቴሎች እያስገነባ መሆኑን ተናገረ! | Jossy in the house | JTV Ethiopia by Nuro Bezede ኑሮ በዘዴ 1 year ago 10 minutes, 12 seconds 31,497 views",Nuro Bezede ኑሮ በዘዴ,31497,31501,4
6980,"ኢትዮጲያዉያኑ ስደተኞች በሰዉ ሀገር በአየር እጦት ህይወታቸዉ አለፈ! Nuro Daily News Ethiopia by Nuro Bezede ኑሮ በዘዴ 1 year ago 12 minutes, 38 seconds 4,595 views",Nuro Bezede ኑሮ በዘዴ,4595,4595,0
6981,"Nuro Daily News Ethiopia | ዶ/ር አብይ ያስተላለፍኩት መልዕክት እየተፈፀሙ አይደለም! by Nuro Bezede ኑሮ በዘዴ 1 year ago 10 minutes, 5 seconds 2,314 views",Nuro Bezede ኑሮ በዘዴ,2314,2314,0
6982,"በሰው ድርቅ  የተመታው ከ60 ሺህ በላይ እናቶችን ያከሙት የዶ/ር ካትሪን የሽኝት ስነ ስርዓት! | Ethiopia by Nuro Bezede ኑሮ በዘዴ 1 year ago 21 minutes 6,945 views",Nuro Bezede ኑሮ በዘዴ,6945,6945,0
6983,"የቻይና መልዓከ-ሞት ስደተኛ አይጦች ከጣልያን እስከ ኢትዮጲያ! | Ethiopia | Italy by Nuro Bezede ኑሮ በዘዴ 1 year ago 18 minutes 3,397 views",Nuro Bezede ኑሮ በዘዴ,3397,3397,0
6984,"በአዲስ አበባ 2 ባለሃብቶች በርካታ የውሃ ታንከር አስቀመጡ ለምን? | Ethiopia by Nuro Bezede ኑሮ በዘዴ 1 year ago 23 minutes 16,376 views",Nuro Bezede ኑሮ በዘዴ,16376,16376,0
6985,"የኢትዮጵያ ሆቴል ባለሙያዎች በበሽ.ታው,ዙሪያ ላይ ተሰባስበው ስጋታቸውን ገለፁ!! | Ethiopia by Nuro Bezede ኑሮ በዘዴ 1 year ago 19 minutes 1,334 views",Nuro Bezede ኑሮ በዘዴ,1334,1334,0
6986,"በቄሮ ሆቴላቸው ለተቃጠለባቸው ግለሰብ 2 ባለሃብቶች 15 ሚሊዮን ሰጡ! | Ethiopia by Nuro Bezede ኑሮ በዘዴ 1 year ago 33 minutes 20,368 views",Nuro Bezede ኑሮ በዘዴ,20368,20373,5
6987,"የዶክተሮች ጥሪ “ከጓንት ይልቅ እጅን መታጠብ ተመራጭ ነው” | Ethiopia by Nuro Bezede ኑሮ በዘዴ 1 year ago 13 minutes, 41 seconds 3,723 views",Nuro Bezede ኑሮ በዘዴ,3723,3723,0
6988,"Nuro Daily News Ethiopia | ኢትዮጲያ ከ 30 ሀገራት በላይ በረራዋን አቋረጠች! by Nuro Bezede ኑሮ በዘዴ 1 year ago 10 minutes, 28 seconds 6,121 views",Nuro Bezede ኑሮ በዘዴ,6121,6121,0
6989,"በተሻገር ጣሰው - ጃፓናዊው የረገጠባቸው 4 ከተሞች ቀይመስቀል ይፋ  አደረገ!እነማናቸው? | Ethiopia by Nuro Bezede ኑሮ በዘዴ 1 year ago 23 minutes 4,704 views",Nuro Bezede ኑሮ በዘዴ,4704,4704,0
6990,"የኪነጥበብ ባለሙያዎች በበሽ.ታውዙሪያ ላይ መልዕክት አለን ይላሉ! | Ethiopia | Ethiopian celebrities by Nuro Bezede ኑሮ በዘዴ 1 year ago 35 minutes 2,790 views",Nuro Bezede ኑሮ በዘዴ,2790,2790,0
6991,"በስትሮክ ህመም ምክንያት የሚሰቃየው አሳዛኝ ግለሰብ!! ተሻገር ከግለሰቡ ጋር ያደረገዉ ልብ የሚነካ ልዩ ቆይታ | Ethiopia by Nuro Bezede ኑሮ በዘዴ 1 year ago 14 minutes, 9 seconds 6,456 views",Nuro Bezede ኑሮ በዘዴ,6456,6456,0
6992,"የቀድሞ ጦር ሰራዊት በአባይ ጉዳይ አንደራደርም አሉ! | Ethiopia by Nuro Bezede ኑሮ በዘዴ 1 year ago 31 minutes 18,899 views",Nuro Bezede ኑሮ በዘዴ,18899,18899,0
6993,"ሰበር ዜና - አለምን ያስጨነቀው ኢትዮጲያ ውስጥ ገባ!! | የጤና ሚኒስቴር የሰጠው መግለጫ | Ethiopia by Nuro Bezede ኑሮ በዘዴ 1 year ago 13 minutes, 52 seconds 3,212 views",Nuro Bezede ኑሮ በዘዴ,3212,3212,0
6994,"የአካል ጉዳተኛ አባታቸዉን ነፍስ የበሉት ሶስቱ ወንድማማቾች! | Ethiopia by Nuro Bezede ኑሮ በዘዴ 1 year ago 56 minutes 207,764 views",Nuro Bezede ኑሮ በዘዴ,207764,207824,60
6995,"ከፍተኛ የመንግስት ባለስልጠናት ተንበርክከው የኢትዮጵያን ህዝብ ተማፀኑ!! | Ethiopia by Nuro Bezede ኑሮ በዘዴ 1 year ago 18 minutes 25,484 views",Nuro Bezede ኑሮ በዘዴ,25484,25490,6
6996,"ቻቺ ታደሰ በአባይ ግድብ አልደራደርም ስትል ተናገረች!!  | Ethiopia by Nuro Bezede ኑሮ በዘዴ 1 year ago 32 minutes 4,229 views",Nuro Bezede ኑሮ በዘዴ,4229,4229,0
6997,"የእናት ባንክ ጥበቃ 2 ሰዎችን ገድሎ እራሱን አጠፋ!! | Ethiopia by Nuro Bezede ኑሮ በዘዴ 1 year ago 10 minutes, 8 seconds 6,785 views",Nuro Bezede ኑሮ በዘዴ,6785,6785,0
6998,"ከ 52 ሺህ በላይ  ማስታወቂያዎችን የሰሩት የአቶ ውብሸት ወርቃለማው የሽኝት ስነ ስርዓት ተፈፀመ!! | Ethiopia by Nuro Bezede ኑሮ በዘዴ 1 year ago 18 minutes 37,104 views",Nuro Bezede ኑሮ በዘዴ,37104,37105,1
6999,"ዶ/ር ደብረፅዮን አድዋ ላይ ያስተላለፉት መልዕክት! | Ethiopia | Debre tesion speech by Nuro Bezede ኑሮ በዘዴ 1 year ago 26 minutes 1,832 views",Nuro Bezede ኑሮ በዘዴ,1832,1834,2
7000,"የአድዋ ጦርነት የተካሄደባቸው አስደናቂው የአድዋ ተራሮች ምን ይመስላሉ?     ተሻገር ጣሰው ከአድዋ!! by Nuro Bezede ኑሮ በዘዴ 2 years ago 20 minutes 1,777 views",Nuro Bezede ኑሮ በዘዴ,1777,1778,1
7001,"አፄ ምኒሊክ የክተት አዋጅ ባወጁበት በወሎ ወረኢሉ ተገኘን !! | ተሻገር ጣሰው ከወረኢሉ | Ethiopia by Nuro Bezede ኑሮ በዘዴ 2 years ago 19 minutes 8,262 views",Nuro Bezede ኑሮ በዘዴ,8262,8287,25
7002,"300 አባቶች የተሰወሩበትና መሃን እናቶች የሚወልዱበት የሾላ ዛፍ!! by Nuro Bezede ኑሮ በዘዴ 2 years ago 14 minutes, 7 seconds 24,037 views",Nuro Bezede ኑሮ በዘዴ,24037,24038,1
7003,"የአድዋ ድል በዓል  አከባበር ሽለላ በአማርኛና በኦሮምኛ ቋንቋ !! | Ethiopia by Nuro Bezede ኑሮ በዘዴ 2 years ago 17 minutes 7,089 views",Nuro Bezede ኑሮ በዘዴ,7089,7091,2
7004,"""አብይ መጣብኝ እንጂ እኔ አልሄድኩበትም"" ደበበ እሸቱ! | Ethiopia | Abiy Ahemd by Nuro Bezede ኑሮ በዘዴ 2 years ago 11 minutes, 39 seconds 4,617 views",Nuro Bezede ኑሮ በዘዴ,4617,4667,50
7005,"ቴዲ አፍሮ ማር እስከ ጧፍ በቀጥታ ስርጭት በጥራት | Teddy afro live Concert Part 1 of 4 by Nuro Bezede ኑሮ በዘዴ 2 years ago 12 minutes, 44 seconds 107,395 views",Nuro Bezede ኑሮ በዘዴ,107395,107414,19
7006,"የአዲስ አበባ ወጣት ለንጉሱ ያለውን ፍቅር ተመልከቱ የዛሬው ልዩ ነው | Teddy Afro Live Concert Part 2 of 4 by Nuro Bezede ኑሮ በዘዴ 2 years ago 12 minutes, 1 second 216,170 views",Nuro Bezede ኑሮ በዘዴ,216170,216224,54
7007,"አስደናቂ የህዝብ ጎርፍ በቴዲ ኮንሰርት ላይ ከመስቀል አደባባይ | Teddy Afro Live Concert Part 3 of 4 by Nuro Bezede ኑሮ በዘዴ 2 years ago 10 minutes, 48 seconds 179,158 views",Nuro Bezede ኑሮ በዘዴ,179158,179284,126
7008,"ህዝቡ ከቴዲ ጋር በኢትዮጲያዊነት መንፈስ ሲቀውጠው ❤ | Teddy Afro Live Concert Part 4 of 4 by Nuro Bezede ኑሮ በዘዴ 2 years ago 11 minutes, 46 seconds 38,702 views",Nuro Bezede ኑሮ በዘዴ,38702,38710,8
7009,"የቴዲ አፍሮ ኮንሰርት ከመስቀል አደባባይ | Teddy Afro Live Concert by Nuro Bezede ኑሮ በዘዴ Streamed 2 years ago 10 minutes, 3 seconds 20,022 views",Nuro Bezede ኑሮ በዘዴ,20022,20023,1
7010,"አስገራሚው  የ ቴዲ አፍሮ  ኮንሰርት ዝግጅቱ ምን ይመስላል? ተሻገር ጣሰው ከመስቀል አደባባይ | Ethiopia by Nuro Bezede ኑሮ በዘዴ 2 years ago 21 minutes 42,125 views",Nuro Bezede ኑሮ በዘዴ,42125,42131,6
7011,"5 ሚሊዮን ብር በማውጣት ቤተክርስቲያን ያስገነባው 1 ግለሰብ (ስልጤ ዞን) | በተሻገር ጣሰው | Ethiopia by Nuro Bezede ኑሮ በዘዴ 2 years ago 43 minutes 11,762 views",Nuro Bezede ኑሮ በዘዴ,11762,11766,4
7012,"ሰበር ዜና በቻይና ተማሪ ልጅ ያላቸው ቤተሰቦች ሠልፍ ወጡ! | Ethiopia by Nuro Bezede ኑሮ በዘዴ 2 years ago 16 minutes 13,402 views",Nuro Bezede ኑሮ በዘዴ,13402,13402,0
7013,"ሰበር ዜና (ቪዲዮ)  በሞጣ ለተቃጠሉት 4 መስጊዶች ማሰሪያ የሚሆን ከ209 ሚሊዮን ብር ተሰበሰበ!! | Ethiopia by Nuro Bezede ኑሮ በዘዴ 2 years ago 10 minutes, 5 seconds 3,231 views",Nuro Bezede ኑሮ በዘዴ,3231,3231,0
7014,"Ethiopia - ከቴዲ አፍሮ ስጦታ የተበረከተለት ግለሰብ ""ቴዲ አፍሮ የተፈታው በኔ ፀሎት ነው"" !! በተሻገር ጣሰው by Nuro Bezede ኑሮ በዘዴ 2 years ago 30 minutes 120,183 views",Nuro Bezede ኑሮ በዘዴ,120183,120193,10
7015,"ተወዳጁ ድምጻዊ ይሁኔ በላይ በእንጂባራ ያቀረበው  አስደናቂ ኮንሰርት | Ethiopia | Yehune Belay by Nuro Bezede ኑሮ በዘዴ 2 years ago 12 minutes, 54 seconds 14,009 views",Nuro Bezede ኑሮ በዘዴ,14009,14017,8
7016,"አሁን የደረሰን አሳዛኝ ቪዲዮ! የኢትዮጲያዉያን ተማሪዎች አሳዛኝ ኑሮ በቻይና! | Ethiopia by Nuro Bezede ኑሮ በዘዴ 2 years ago 29 minutes 20,713 views",Nuro Bezede ኑሮ በዘዴ,20713,20713,0
7017,"በጎንደር በጌምድር በየአመቱ በድምቀት የሚከበረው የመርቆሪዎስ በዓል!! | ተሻገር ጣሰው ከደብረታቦር | Ethiopia by Nuro Bezede ኑሮ በዘዴ 2 years ago 36 minutes 4,415 views",Nuro Bezede ኑሮ በዘዴ,4415,4415,0
7018,"ወጣቱ ቁጣውን እና ሀዘኑን በዝማሬ ገለፀ የሰማዕታቱ የሽኝት ስነ ስርዓት | Ethiopia by Nuro Bezede ኑሮ በዘዴ 2 years ago 22 minutes 5,760 views",Nuro Bezede ኑሮ በዘዴ,5760,5760,0
7019,"የሰማዕታቱ የፍትሀት ስነ ስርዓት በቦሌ መድሀኒአለም ቤተ ክርስቲያን! | Ethiopia by Nuro Bezede ኑሮ በዘዴ 2 years ago 23 minutes 2,141 views",Nuro Bezede ኑሮ በዘዴ,2141,2142,1
7020,"{ቪዲዮ} ልጆቻቸዉን ለትምህርት ቻይና የላኩ ወላጆች መንግስትን በአደባባይ ተማፀኑ! | በተሻገር ጣሰው | Ethiopia by Nuro Bezede ኑሮ በዘዴ 2 years ago 17 minutes 25,548 views",Nuro Bezede ኑሮ በዘዴ,25548,25548,0
7021,"""አማራ የኦሮሞ ደም የኔ ደም ነው። ያለው ሃገር ለመመስረት ነው""ኦባንግ ሜቶ | Ethiopia by Nuro Bezede ኑሮ በዘዴ 2 years ago 11 minutes, 52 seconds 3,709 views",Nuro Bezede ኑሮ በዘዴ,3709,3709,0
7022,"ከዝነኛው የቴክኖሎጂ ባለሙያ ለጠ/ሚ ዶ/ር የተላከ ተማፅኖ! | Ethiopia by Nuro Bezede ኑሮ በዘዴ 2 years ago 20 minutes 2,386 views",Nuro Bezede ኑሮ በዘዴ,2386,2386,0
7023,"ድንቅ የፈጣሪ  ስራ አስገራሚው አይነስውር ፈረስ ጋላቢ | ተሻገር ጣሰው ከእንጂባራ | Ethiopia by Nuro Bezede ኑሮ በዘዴ 2 years ago 13 minutes, 8 seconds 10,978 views",Nuro Bezede ኑሮ በዘዴ,10978,10996,18
7024,"አስደናቂዉ የጌዴኦ ዘመን መለወጫ ክብረ-በዓል! | Ethiopia by Nuro Bezede ኑሮ በዘዴ 2 years ago 55 minutes 1,449 views",Nuro Bezede ኑሮ በዘዴ,1449,1449,0
7025,"[አሁን ከጎንደር የደረስን ቪዲዮ] 10 ሰዎች ያለ-ቁበትና 250 ሰዎች የተጎዱበት የጎንደሩ አደጋ ሙሉ ቪዲዮ!! | በተሻገር ጣሰው | Ethiopia by Nuro Bezede ኑሮ በዘዴ 2 years ago 15 minutes 51,290 views",Nuro Bezede ኑሮ በዘዴ,51290,51290,0
7026,"ጀዋር በዜግነቱ ምክንያት ከኦፌኮ ያልጠበቀው ማሳሰቢያ ደረሰው! | Ethiopian News by Nuro Bezede ኑሮ በዘዴ 2 years ago 10 minutes, 23 seconds 4,643 views",Nuro Bezede ኑሮ በዘዴ,4643,4643,0
7027,"[ሊያመልጣችሁ የማይገባ] ልዩ ያሬዳዊ ዝማሬ ከአምስት ኪሎ | Ethiopia by Nuro Bezede ኑሮ በዘዴ 2 years ago 17 minutes 5,120 views",Nuro Bezede ኑሮ በዘዴ,5120,5120,0
7028,"[ያልታየው] ልዩ የራያ ባህላዊ ጨዋታ በጥምቀት በዓል ላይ ❤ | Ethiopia by Nuro Bezede ኑሮ በዘዴ 2 years ago 14 minutes, 7 seconds 22,541 views",Nuro Bezede ኑሮ በዘዴ,22541,22577,36
7029,"መንፈስን የሚያድስ የወጣቶች ድንቅ የበገና ዝማሬ ክጃን ሜዳ እስከ 4ኪሎ | Ethiopia by Nuro Bezede ኑሮ በዘዴ 2 years ago 18 minutes 6,970 views",Nuro Bezede ኑሮ በዘዴ,6970,6978,8
7030,"የተክለ ሀይማኖት ወጣቶች በጥምቀት በዓል ታሪክ ሰሩ | Ethiopia by Nuro Bezede ኑሮ በዘዴ 2 years ago 12 minutes, 3 seconds 5,068 views",Nuro Bezede ኑሮ በዘዴ,5068,5068,0
7031,"ጥምቀቱን ያላችሁ እስቲ እንያችሁ | Ethiopia | by Nuro Bezede ኑሮ በዘዴ 2 years ago 17 minutes 3,765 views",Nuro Bezede ኑሮ በዘዴ,3765,3765,0
7032,"የጥምቀት በዓል ልዩ ዝማሬ በሰንበት ተማሪዎች አንደበት by Nuro Bezede ኑሮ በዘዴ 2 years ago 10 minutes, 8 seconds 3,808 views",Nuro Bezede ኑሮ በዘዴ,3808,3808,0
7033,"የጥምቀት በዓል በቀጥታ ከብስራተ ገብርኤል | Ethiopia | Epiphany by Nuro Bezede ኑሮ በዘዴ 2 years ago 11 minutes, 22 seconds 5,104 views",Nuro Bezede ኑሮ በዘዴ,5104,5104,0
7034,"የድቀሞው ጠቅላይ ሚኒስተር ቤተሰብን ስም የማጥፋት ሴራ ለምን አስፈለገ? | Ethiopia by Nuro Bezede ኑሮ በዘዴ 2 years ago 11 minutes, 31 seconds 1,604 views",Nuro Bezede ኑሮ በዘዴ,1604,1604,0
7035,"አዲስ መረጃ - እስራኤል ዜጎቿ ወደ ኢትዮጵያ እንዳይሄዱ አገደች! | Ethiopian News! by Nuro Bezede ኑሮ በዘዴ 2 years ago 10 minutes, 33 seconds 9,668 views",Nuro Bezede ኑሮ በዘዴ,9668,9671,3
7036,ለመቄዶንያ የአረጋዊያን መርጃ በባህርዳር ልዩ ስጦታ ተበረከተ! | Ethiopia by Nuro Bezede ኑሮ በዘዴ 2 years ago 15 minutes 662 views,Nuro Bezede ኑሮ በዘዴ,662,662,0
7037,"በኢትዮጵያ እራሳቸውን የሚያጠፉ ሰዎች ብዛት አስደንግጧል | Ethiopia by Nuro Bezede ኑሮ በዘዴ 2 years ago 10 minutes, 21 seconds 3,673 views",Nuro Bezede ኑሮ በዘዴ,3673,3673,0
7038,"ቴዲ አፍሮ በምስጋና የተንበሸበሸበት የዳዊት ፅጌ አዲስ አልበም! Dawit Tesge by Nuro Bezede ኑሮ በዘዴ 2 years ago 42 minutes 23,890 views",Nuro Bezede ኑሮ በዘዴ,23890,23913,23
7039,"ህወሀት ተሳካለት፤ ሌላ ኢህአዴግ መሰረተ ! by Nuro Bezede ኑሮ በዘዴ 2 years ago 10 minutes, 37 seconds 37,758 views",Nuro Bezede ኑሮ በዘዴ,37758,37778,20
7040,"ኢትዮጵያ እና ግብጽ በመጨረሻም ተስማሙ! | Ethiopian News! by Nuro Bezede ኑሮ በዘዴ 2 years ago 10 minutes, 26 seconds 2,934 views",Nuro Bezede ኑሮ በዘዴ,2934,2934,0
7041,"“የልጆቻችንን እንኳን ማየት ድምጻቸውንም አልሰማንም“ by Nuro Bezede ኑሮ በዘዴ 2 years ago 11 minutes, 13 seconds 2,276 views",Nuro Bezede ኑሮ በዘዴ,2276,2276,0
7042,"ህወሃትና ኢዜማ የምርጫ ሰሌዳውን እየተቃወሙት ነው! | Ethiopian News! by Nuro Bezede ኑሮ በዘዴ 2 years ago 10 minutes, 35 seconds 19,193 views",Nuro Bezede ኑሮ በዘዴ,19193,19193,0
7043,"ጃል መሮ እውን መቀሌ ሸሽጓልን? ሳውዲም እነደ-ትራመፕ በአብይ ቀንታለች by Nuro Bezede ኑሮ በዘዴ 2 years ago 10 minutes, 18 seconds 22,584 views",Nuro Bezede ኑሮ በዘዴ,22584,22587,3
7044,"ሁለት የትግራይ ቲቪ ጋዜጠኞች ታስረዋል! | Nuro Bezede Ethiopian News by Nuro Bezede ኑሮ በዘዴ 2 years ago 10 minutes, 54 seconds 1,768 views",Nuro Bezede ኑሮ በዘዴ,1768,1768,0
7045,"አቶ በቀለ ገርባ  ከስድስት ወራት በኋላ መንግሥት እንመሰርታለን አሉ | Ethiopian News by Nuro Bezede ኑሮ በዘዴ 2 years ago 12 minutes, 16 seconds 4,195 views",Nuro Bezede ኑሮ በዘዴ,4195,4195,0
7046,"የእስክንድር ነጋ  አዲሱ ፓርቲ  ምርጫ ቦርድ ተቀብሎታል | Ethiopian News by Nuro Bezede ኑሮ በዘዴ 2 years ago 12 minutes, 5 seconds 4,979 views",Nuro Bezede ኑሮ በዘዴ,4979,4979,0
7047,"ሀይለማርያም ደሳለኝ እና ደመቀ መኮነን ፍ/ቤት ይቀርባሉ ተባለ! | Ethiopian News by Nuro Bezede ኑሮ በዘዴ 2 years ago 11 minutes, 57 seconds 2,844 views",Nuro Bezede ኑሮ በዘዴ,2844,2846,2
7048,"17 የአማራ ተማሪዎች በኦነግ ታጣ ቂዎች ታግ ተዋል! | Ethiopian News by Nuro Bezede ኑሮ በዘዴ 2 years ago 12 minutes, 38 seconds 6,211 views",Nuro Bezede ኑሮ በዘዴ,6211,6211,0
7049,"180 ሰዉ የገደ ለዉ አውሮፕላ ን በኢ ራን ሚሳኤ ል ተመቶ ነው የወደቀው ተባለ | Ethiopian News by Nuro Bezede ኑሮ በዘዴ 2 years ago 11 minutes, 28 seconds 4,466 views",Nuro Bezede ኑሮ በዘዴ,4466,4466,0
7050,"እስክንድር አዲስ አበባ ሲገባ የተደረገለት አቀባበል እና ያስተላለፈዉ አነጋጋሪ መልዕክት! | Ethiopia | Eskender Nega by Nuro Bezede ኑሮ በዘዴ 2 years ago 14 minutes, 49 seconds 7,721 views",Nuro Bezede ኑሮ በዘዴ,7721,7721,0
7051,"መጅሊሱ በአቶ ተመስገን ጥሩነህ ንግግር ተቆጥቷል! | Ethiopian News by Nuro Bezede ኑሮ በዘዴ 2 years ago 10 minutes, 58 seconds 5,938 views",Nuro Bezede ኑሮ በዘዴ,5938,5938,0
7052,"ኢትዮ ቴሌኮምን ለማዳከም የተጀመረው አሳዛኝ ግድያ እና የስርቆት ዘመቻ | Ethiopian News! by Nuro Bezede ኑሮ በዘዴ 2 years ago 13 minutes, 13 seconds 5,156 views",Nuro Bezede ኑሮ በዘዴ,5156,5156,0
7053,"የጀዋር የሁለት ሀገር ዜግነት ጉዳይ መጨረሻው ታወቀ!! | Ethiopian News by Nuro Bezede ኑሮ በዘዴ 2 years ago 12 minutes, 31 seconds 17,116 views",Nuro Bezede ኑሮ በዘዴ,17116,17118,2
7054,"ሰበር ዜና ቦይንግ ተከሰ ከሰ | ሶስተኛው የአለም ጦ ርነት ሊጀመር ይችላል የሚል ስጋት | Ethiopian News by Nuro Bezede ኑሮ በዘዴ 2 years ago 13 minutes, 22 seconds 22,134 views",Nuro Bezede ኑሮ በዘዴ,22134,22139,5
7055,"ደስ የሚል ልዩ የገና በዓል ዋዜማ ከአዲስ አበባ | Ethiopia by Nuro Bezede ኑሮ በዘዴ 2 years ago 11 minutes, 23 seconds 13,385 views",Nuro Bezede ኑሮ በዘዴ,13385,13385,0
7056,"መኪና የሰራው አስደናቂ ወጣት ለመጀመሪያ ጊዜ ከተሻገር ጣሰው ጋር ያደረገው ቆይታ | Ethiopia by Nuro Bezede ኑሮ በዘዴ 2 years ago 25 minutes 131,219 views",Nuro Bezede ኑሮ በዘዴ,131219,131268,49
7057,"650 ህፃናት አሳዳጊዋ ወ/ሮ ሙዳይ ልብ የሚነካ የድረሱልኝ ጥሪ! | በተሻገር ጣሰው | Ethiopia by Nuro Bezede ኑሮ በዘዴ 2 years ago 12 minutes, 53 seconds 12,558 views",Nuro Bezede ኑሮ በዘዴ,12558,12562,4
7058,"ሰበር ዜና - በሞጣ ቃጠ ሎ የተሳተፉ ባለስልጣናት እየታሰሩ ነው! | Ethiopian News! by Nuro Bezede ኑሮ በዘዴ 2 years ago 11 minutes, 5 seconds 4,931 views",Nuro Bezede ኑሮ በዘዴ,4931,4931,0
7059,"የናይጀሪያ ወንዶች የእኛን ሴቶችን  እያማለሉ የመዝረፍ ዘመቻ Ethiopian News by Nuro Bezede ኑሮ በዘዴ 2 years ago 13 minutes, 34 seconds 3,051 views",Nuro Bezede ኑሮ በዘዴ,3051,3051,0
7060,"አዲስ ተመራቂዎቹ የኦሮሚያ ልዩ ሀይል አባላት ግራ እያጋቡ ነዉ! | Ethiopia by Nuro Bezede ኑሮ በዘዴ 2 years ago 12 minutes, 10 seconds 15,498 views",Nuro Bezede ኑሮ በዘዴ,15498,15501,3
7061,"ልዩ የገና በዓል ዋዜማ ከጎዳና ልጆች ጋር በተሻገር ጣሰው | Ethiopia by Nuro Bezede ኑሮ በዘዴ 2 years ago 34 minutes 14,087 views",Nuro Bezede ኑሮ በዘዴ,14087,14088,1
7062,"ጃዋር መሃመድ የተቀላቀለው  ፓርቲ የቱ እነደሆነ ተነገረ | Ethiopia by Nuro Bezede ኑሮ በዘዴ 2 years ago 13 minutes, 39 seconds 2,695 views",Nuro Bezede ኑሮ በዘዴ,2695,2695,0
7063,"ድሬዳዋ እንዴት አረፈደች? ሚኒስተሮች ስልጣን የመልቀቅ ዘመቻ ላይ ናቸው! Ethiopian news by Nuro Bezede ኑሮ በዘዴ 2 years ago 10 minutes, 46 seconds 9,470 views",Nuro Bezede ኑሮ በዘዴ,9470,9471,1
7064,"የተለያዩ የሴቶች አልባሳትና የሂውማን ሄር አዳዲስ ዋጋዎች | Ethiopia by Nuro Bezede ኑሮ በዘዴ 2 years ago 25 minutes 40,190 views",Nuro Bezede ኑሮ በዘዴ,40190,40243,53
7065,"ኢትዮጵያ የባህር ሀይሏን በቀይ ባህር ልታቋቁም ነው | Ethiopian News by Nuro Bezede ኑሮ በዘዴ 2 years ago 11 minutes, 46 seconds 12,335 views",Nuro Bezede ኑሮ በዘዴ,12335,12335,0
7066,"አዲስ መረጃ - ኢ/ር አዜብ አስናቀ በህዳሴ ግድብ ሙስና ወንጀል ተጠርጥረው ተይዘዋል | Ethiopian News by Nuro Bezede ኑሮ በዘዴ 2 years ago 13 minutes, 44 seconds 6,530 views",Nuro Bezede ኑሮ በዘዴ,6530,6531,1
7067,"12 ኢትዮጵያዊያን በገበያ መሀል ተገድ ለዋል፤ ነፍስ ይማር! | Ethiopian news by Nuro Bezede ኑሮ በዘዴ 2 years ago 11 minutes, 48 seconds 7,446 views",Nuro Bezede ኑሮ በዘዴ,7446,7446,0
7068,"ኢሳያስ አፈወርቂ በአዳማ ልዩ ስጦታ ተሠጣቸው Ethiopian news by Nuro Bezede ኑሮ በዘዴ 2 years ago 12 minutes, 21 seconds 14,563 views",Nuro Bezede ኑሮ በዘዴ,14563,14563,0
7069,"የብረሃኑ ነጋ እና የልደቱ አያሌው አዲሱ ፍጥጫ | Birhanu Nega | Lidetu Ayalew by Nuro Bezede ኑሮ በዘዴ 2 years ago 10 minutes, 17 seconds 8,892 views",Nuro Bezede ኑሮ በዘዴ,8892,8894,2
7070,"ጠ/ሚ አብይ ከትራምፕ ጋር በአለም ተፅዕኖ ፈጣሪዎች ተርታ ተሰለፉ! | Ethiopian News by Nuro Bezede ኑሮ በዘዴ 2 years ago 12 minutes, 51 seconds 3,880 views",Nuro Bezede ኑሮ በዘዴ,3880,3880,0
7071,"ዶ/ር  አብይ አሕመድ የፍርድ ቤት መጥሪያ ተልኮላቸዋል! | Ethiopian News by Nuro Bezede ኑሮ በዘዴ 2 years ago 10 minutes, 23 seconds 6,933 views",Nuro Bezede ኑሮ በዘዴ,6933,6934,1
7072,"ሰበር መረጃ | ፕሬዚዳንት ኢሳያስ አፈወርቂ በድንገት አዲስ አበባ ገቡ | Ethiopian News! by Nuro Bezede ኑሮ በዘዴ 2 years ago 11 minutes, 37 seconds 33,500 views",Nuro Bezede ኑሮ በዘዴ,33500,33500,0
7073,"ጃኖ ባንድ በኤርትራ ያልታሰበ ነገር ገጠማቸዉ! | Ethiopia by Nuro Bezede ኑሮ በዘዴ 2 years ago 12 minutes, 14 seconds 7,249 views",Nuro Bezede ኑሮ በዘዴ,7249,7249,0
7074,"በማጥናት ላይ እያለ ሰወነቱ ፖራላይዝ የሆነው ጂኒየስ ተማሪ | በተሻገር ጣሰው Ethiopia by Nuro Bezede ኑሮ በዘዴ 2 years ago 20 minutes 24,401 views",Nuro Bezede ኑሮ በዘዴ,24401,24404,3
7075,"በሞጣ መስጂድ ያቃጠሉ 22 ግለሰቦች ተያዙ! | Nuro Bezede Ethiopian news by Nuro Bezede ኑሮ በዘዴ 2 years ago 11 minutes, 22 seconds 17,247 views",Nuro Bezede ኑሮ በዘዴ,17247,17253,6
7076,"ወላይታ በመ ከላኪያ ተከባለች፤ ውጥረት በከተማዋ ሰፍኖ ይገኛል | Nuro Bezede Ethiopian News! by Nuro Bezede ኑሮ በዘዴ 2 years ago 10 minutes, 43 seconds 8,973 views",Nuro Bezede ኑሮ በዘዴ,8973,8973,0
7077,"ሰበር ዜና እንኳን ደስ አለን! | ሳተላይቷ በሰላም ከታሰበበት ስፍራ ደርሳለች! | Ethiopia by Nuro Bezede ኑሮ በዘዴ 2 years ago 12 minutes, 28 seconds 4,557 views",Nuro Bezede ኑሮ በዘዴ,4557,4557,0
7078,"በሳተላይቷ ሽኝት ላይ የተገኙ የአዲስአበባ ነዋሪዎች ደስታቸዉን ገለፁ! | Ethiopia by Nuro Bezede ኑሮ በዘዴ 2 years ago 25 minutes 2,999 views",Nuro Bezede ኑሮ በዘዴ,2999,2999,0
7079,"Nuro Bezede Ethiopian News! | የኢትዮጵያ መከላከያ ባልተጠበቀ ምክንያት ዩኒፎርሙን ሊቀይር ነው by Nuro Bezede ኑሮ በዘዴ 2 years ago 12 minutes, 55 seconds 18,473 views",Nuro Bezede ኑሮ በዘዴ,18473,18476,3
7080,"Nuro Bezede Ethiopian News! | ባለስልጣኗ እኔ የጠ/ሚሩ ተላላኪ አልነበርኩም አሉ! | by Nuro Bezede ኑሮ በዘዴ 2 years ago 11 minutes, 39 seconds 2,178 views",Nuro Bezede ኑሮ በዘዴ,2178,2178,0
7081,"ፖለቲከኛው በቀለ ገርባ ያልተጠበቀ ተግባር ፈፀሙ! |  | Nuro Bezede Ethiopian News! by Nuro Bezede ኑሮ በዘዴ 2 years ago 12 minutes, 59 seconds 5,381 views",Nuro Bezede ኑሮ በዘዴ,5381,5381,0
7082,"መሰረት መብራቴ ለሰራችው በጎ ስራ ያልጠበቀችው እውቅና ተሰጣት | Nuro Bezede Ethiopian News! by Nuro Bezede ኑሮ በዘዴ 2 years ago 12 minutes, 11 seconds 3,042 views",Nuro Bezede ኑሮ በዘዴ,3042,3042,0
7083,"ጀዋር ሙሃመድ ባልተጠበቀ ስብሰባ ላይ መገኘቱ አስገርሟል by Nuro Bezede ኑሮ በዘዴ 2 years ago 11 minutes, 24 seconds 7,105 views",Nuro Bezede ኑሮ በዘዴ,7105,7105,0
7084,"የመኪና አደ- ጋ 2 እግሮቹን የነጠቀበት ወጣት አንጀት የሚበላ አሳዛኝ ታሪክ | ከደብረ ማርቆስ | በተሻገር ጣሰው | Ethiopia by Nuro Bezede ኑሮ በዘዴ 2 years ago 20 minutes 16,343 views",Nuro Bezede ኑሮ በዘዴ,16343,16344,1
7085,"ፕ/ት ሳህለወርቅ ዘዉዴ በአለም መድረክ ሀገራቸዉን አስጠርተዋል! | Nuro Bezede Ethiopian News! by Nuro Bezede ኑሮ በዘዴ 2 years ago 11 minutes, 29 seconds 3,348 views",Nuro Bezede ኑሮ በዘዴ,3348,3348,0
7086,"“ፀሐይሽ አትጠልቅም” በሚሊኒየም አዳራሽ ታላቅ የምህላና ፀሎት ፕሮግራም | Ethiopia by Nuro Bezede ኑሮ በዘዴ 2 years ago 14 minutes, 49 seconds 15,167 views",Nuro Bezede ኑሮ በዘዴ,15167,15168,1
7087,"ኢትዮጲያ ለምን ተከሰሰች….? | Ethiopia by Nuro Bezede ኑሮ በዘዴ 2 years ago 17 minutes 3,210 views",Nuro Bezede ኑሮ በዘዴ,3210,3210,0
7088,"ታከለ ኡማ ባልጠበቁት ሁኔታ ሰፕራይዝ ተደረጉ! | Nuro Bezede Ethiopian News! by Nuro Bezede ኑሮ በዘዴ 2 years ago 14 minutes, 22 seconds 3,633 views",Nuro Bezede ኑሮ በዘዴ,3633,3633,0
7089,"""በጦ -ርነት መሀል አልፌያለሁ"" ዶ/ር አብይ አህመድ | Dr. Abiy Ahmed | Ethiopia by Nuro Bezede ኑሮ በዘዴ 2 years ago 10 minutes, 58 seconds 9,300 views",Nuro Bezede ኑሮ በዘዴ,9300,9300,0
7090,"ፕሮፌሰር ፍቅሬ ቶሎሳ አብይ በቤተመንግስት የነገሯቸዉን ሚስጥር ይፋ አደረጉ! | Ethiopia by Nuro Bezede ኑሮ በዘዴ 2 years ago 12 minutes, 2 seconds 27,341 views",Nuro Bezede ኑሮ በዘዴ,27341,27341,0
7091,"በኢትዮጲያ እና ኤርትራ መሀል አዲስ የምስራች ተሰምቷል! | Nuro Bezede Ethiopian News! by Nuro Bezede ኑሮ በዘዴ 2 years ago 11 minutes, 24 seconds 34,452 views",Nuro Bezede ኑሮ በዘዴ,34452,34452,0
7092,"የሸፈተው የኦነግ ጦር መሪ ጃል መሮ አብይን የተናገራቸዉ ምንድነዉ? | Nuro Bezede Ethiopian News Dec 13 by Nuro Bezede ኑሮ በዘዴ 2 years ago 11 minutes, 3 seconds 19,851 views",Nuro Bezede ኑሮ በዘዴ,19851,19853,2
7093,"ፈረሰኞቹ በቤተመንግሥት በዶ/ር አብይ ያላሰቡት ገጠማቸው | Ethiopia Nuro Bezede News! by Nuro Bezede ኑሮ በዘዴ 2 years ago 11 minutes, 12 seconds 61,698 views",Nuro Bezede ኑሮ በዘዴ,61698,61699,1
7094,"አብይ  በተለያዩ ከተሞች በተደረገዉ ድጋፍ | ስለ ጥምቀት በዓል የተሰማው አስደሳች ዜና | Nuro Bezede news December 12 by Nuro Bezede ኑሮ በዘዴ 2 years ago 12 minutes, 24 seconds 7,631 views",Nuro Bezede ኑሮ በዘዴ,7631,7634,3
7095,"ዶ/ር አብይ “አቢቹ” የሚባሉት ለምንድነዉ…  
ዛሬ ያፈተለከዉ አስገራሚ እዉነት! | Dr. Abiy Ahmed | Ethiopia by Nuro Bezede ኑሮ በዘዴ 2 years ago 27 minutes 101,635 views",Nuro Bezede ኑሮ በዘዴ,101635,101663,28
7096,"በጉጉት ሲጠበቅ የነበረው የጀግና አቀባበል | በአቀባበሉ ላይ የተገኙ ደስታቸውን የገለፁበት መንገድ! | Ethiopia by Nuro Bezede ኑሮ በዘዴ 2 years ago 28 minutes 44,185 views",Nuro Bezede ኑሮ በዘዴ,44185,44185,0
7097,"የሰላም ሎሬት ዶ/ር አብይ ሀገራቸዉ ሲገቡ የተደረገላቸዉ ደማቅ አቀባበል! | Ethiopian News by Nuro Bezede ኑሮ በዘዴ 2 years ago 11 minutes, 31 seconds 20,472 views",Nuro Bezede ኑሮ በዘዴ,20472,20472,0
7098,"የፈጣሪ ድንቅ ስራ ተመልከቱ | ማህተብ አድርጋ የተወለደችው ህፃን እናት እውነታውን ተናገረች | Ethiopia by Nuro Bezede ኑሮ በዘዴ 2 years ago 37 minutes 233,526 views",Nuro Bezede ኑሮ በዘዴ,233526,233626,100
7099,"ጠቅላይ ሚኒስትር አብይ አህመድ የጀግና አቀባበል ይጠብቃቸዋል ተባለ! | Nuro Bezede Ethiopian News! by Nuro Bezede ኑሮ በዘዴ 2 years ago 11 minutes, 20 seconds 7,620 views",Nuro Bezede ኑሮ በዘዴ,7620,7621,1
7100,"ህወሀት በመጨረሻም ያልተጠበቀ ውህደት አደረገ! by Nuro Bezede ኑሮ በዘዴ 2 years ago 10 minutes, 21 seconds 5,753 views",Nuro Bezede ኑሮ በዘዴ,5753,5753,0
7101,"ስለ ኮንዶሚኒየም እድለኞች የተሰማው ነገር | በቂሊንጦ ማረሚያ ምን ተፈጠረ? | Nuro Bezede Ethiopian News! by Nuro Bezede ኑሮ በዘዴ 2 years ago 11 minutes, 28 seconds 4,697 views",Nuro Bezede ኑሮ በዘዴ,4697,4697,0
7102,"""እያጫረሰ ያለው ህገመንግስቱ ነው"" ህገመንግስቱ መቀየር አለበት!! | ኦባንግ ሜቶ የሰብዓዊ መብት ተሟጋች | Ethiopia by Nuro Bezede ኑሮ በዘዴ 2 years ago 11 minutes, 14 seconds 2,746 views",Nuro Bezede ኑሮ በዘዴ,2746,2746,0
7103,"ጀዋር በኢንተርፖ-ል ፖሊ-ስ ክ-ትትል ስር | Ethiopia | Jawar Mohammed by Nuro Bezede ኑሮ በዘዴ 2 years ago 21 minutes 49,279 views",Nuro Bezede ኑሮ በዘዴ,49279,49279,0
7104,"""ለኢትዮጵያ የምሮጠው ኦሮሚያ ነፃ ስትወጣ ነው” አትሌት  ሲፈን ሐሰን | Ethiopia by Nuro Bezede ኑሮ በዘዴ 2 years ago 10 minutes, 10 seconds 4,271 views",Nuro Bezede ኑሮ በዘዴ,4271,4271,0
7105,"ኢትዮጲያዊው ቅዱስ መሪ! 
ሊታወቅ የሚገባው አስገራሚ እዉነት! | Ethiopia by Nuro Bezede ኑሮ በዘዴ 2 years ago 16 minutes 9,289 views",Nuro Bezede ኑሮ በዘዴ,9289,9289,0
7106,"የፖለቲ-ካ እስረኞ-ች መንግስትን እያስፈ-ራሩ ነዉ! | Nuro Bezede Ethiopian News! by Nuro Bezede ኑሮ በዘዴ 2 years ago 11 minutes, 7 seconds 6,640 views",Nuro Bezede ኑሮ በዘዴ,6640,6640,0
7107,"ደብረጺዮን ሚስጥር አወጣለሁ ባሉበት ስብሰባ የማን ሚስጥር ወጣ? | Nuro Bezede Ethiopian News by Nuro Bezede ኑሮ በዘዴ 2 years ago 11 minutes, 10 seconds 12,229 views",Nuro Bezede ኑሮ በዘዴ,12229,12229,0
7108,"ፕ/ር መረራ እስክንድርን ምን አሉት? ቆሼ ሊደረመስ ይችላል!| Nuro Bezede Ethiopian News! by Nuro Bezede ኑሮ በዘዴ 2 years ago 10 minutes, 52 seconds 4,739 views",Nuro Bezede ኑሮ በዘዴ,4739,4739,0
7109,"ሞ-ተ-ዋል የተባሉ 3 ልጆችን በሠላም የተገላገለችው እናት ሠርፕራይዝ ተደረገች! | Ethiopia | Hawassa by Nuro Bezede ኑሮ በዘዴ 2 years ago 22 minutes 21,211 views",Nuro Bezede ኑሮ በዘዴ,21211,21211,0
7110,"ኤርትራዊው ተወዳጅ ድምጻዊ በሸገር አስደ -ንጋጭ ጥ- ቃት ደረሰበት | Nuro Bezede Ethiopian News by Nuro Bezede ኑሮ በዘዴ 2 years ago 18 minutes 10,503 views",Nuro Bezede ኑሮ በዘዴ,10503,10503,0
7111,"አባ ገዳው በለማ መገርሳ ጉዳይ አዲስ ሚስጥር አሾልከዋል | Nuro Bezede Ethiopian News by Nuro Bezede ኑሮ በዘዴ 2 years ago 16 minutes 3,695 views",Nuro Bezede ኑሮ በዘዴ,3695,3695,0
7112,"ወፍ እና ጀ-ት የማይለዩት የሜቴክ አስገራሚ ራ-ዳሮች | Nuro Bezede Ethiopian News! by Nuro Bezede ኑሮ በዘዴ 2 years ago 15 minutes 10,473 views",Nuro Bezede ኑሮ በዘዴ,10473,10473,0
7113,"አስደሳች ዜና - የአ-ስ-ከ-ሬን ማውጫ የተፃፈለት ታደጊ እናት በተሰጣት መኖሪያ ቤት ኑሮዋን ጀመረች!! | በተሻገር ጣሰው | Ethiopia by Nuro Bezede ኑሮ በዘዴ 2 years ago 21 minutes 19,903 views",Nuro Bezede ኑሮ በዘዴ,19903,19903,0
7114,"ጠ/ሚ አብይ ዝምታቸውን ሰበሩ ፡ 
ለቄሮ እና ፋኖ ሰፕራይዝ ይዘዋል! | Nuro Bezede Ethiopian News by Nuro Bezede ኑሮ በዘዴ 2 years ago 17 minutes 45,047 views",Nuro Bezede ኑሮ በዘዴ,45047,45047,0
7115,"እስክንድር ነጋ እና ኢሳትን ዱላ ያማዘዛቸው ምንድን ነዉ | Nuro Bezede Ethiopian News! by Nuro Bezede ኑሮ በዘዴ 2 years ago 17 minutes 18,647 views",Nuro Bezede ኑሮ በዘዴ,18647,18647,0
7116,"ቄሮ ህጋዊ ድርጅት ሊሆን ነው! የሙፈሪያት አስደንጋጭ ውሳኔ! | Nuro Bezede Ethiopian News! by Nuro Bezede ኑሮ በዘዴ 2 years ago 16 minutes 38,244 views",Nuro Bezede ኑሮ በዘዴ,38244,38245,1
7117,"""ኢትዮጵያ ህመሟ ብሶባት የሞት አፋፍ ላይ ትገኛለች"" ምሁራን | Ethiopia by Nuro Bezede ኑሮ በዘዴ 2 years ago 27 minutes 7,999 views",Nuro Bezede ኑሮ በዘዴ,7999,7999,0
7118,"2 እጆች ሳይኖራት ከሰው በላይ የምትሰራዋ ወጣት በድጋሚ የምለው አለኝ ትላለች!! | በተሻገር ጣሰው | Ethiopia by Nuro Bezede ኑሮ በዘዴ 2 years ago 14 minutes, 47 seconds 52,304 views",Nuro Bezede ኑሮ በዘዴ,52304,52312,8
7119,"ህወሀት ለአብይ ሽምግልና ላከ | በትግራይ የተቃውሞ ሰልፍ ሊካሄድ ነው | Nuro Bezede Ethiopian News by Nuro Bezede ኑሮ በዘዴ 2 years ago 15 minutes 7,236 views",Nuro Bezede ኑሮ በዘዴ,7236,7236,0
7120,"አባዱላ ገመዳ ስለልጃቸው የተናግሩት አሳዛኝ ታሪክ | Ethiopia | Abadula Gemeda by Nuro Bezede ኑሮ በዘዴ 2 years ago 27 minutes 12,324 views",Nuro Bezede ኑሮ በዘዴ,12324,12327,3
7121,"የ3ቱ አይነ-ስውራን እናትና ልጆች አስደሳች ሰርፕራይዝ!! | በተሻገር ጣሰው | Amazing Surprise | Ethiopia by Nuro Bezede ኑሮ በዘዴ 2 years ago 1 hour, 23 minutes 48,351 views",Nuro Bezede ኑሮ በዘዴ,48351,48351,0
7122,"ጀዋርን በዴንቨር ኢትዮጲያውያን ፊት ለፊት አሸማቀቁት! | Nuro Bezede Ethiopian News by Nuro Bezede ኑሮ በዘዴ 2 years ago 16 minutes 11,293 views",Nuro Bezede ኑሮ በዘዴ,11293,11293,0
7123,"60 ጊዜ ትዳር የመሰረተው ግለሰብ መጨረሻው አሳዝኗል | Nuro Bezede Ethiopian News! by Nuro Bezede ኑሮ በዘዴ 2 years ago 15 minutes 22,352 views",Nuro Bezede ኑሮ በዘዴ,22352,22353,1
7124,"አነጋጋሪው የህወሀት የፍቺ ደብዳቤ/80ቸዉን በአደባባይ ቀደዱ! | Nuro Bezede Ethiopian News by Nuro Bezede ኑሮ በዘዴ 2 years ago 16 minutes 25,773 views",Nuro Bezede ኑሮ በዘዴ,25773,25774,1
7125,"እግዚኦ ያስብላል! - 3 አይነ-ስውራን ወንድማማቾች በአንድ ቤተሰብ ውስጥ… | በተሻገር ጣሰው | Ethiopia by Nuro Bezede ኑሮ በዘዴ 2 years ago 17 minutes 80,844 views",Nuro Bezede ኑሮ በዘዴ,80844,80850,6
7126,"በሲዳማ ህዝበ ዉሳኔ ስም የጠፋዉ በሚሊየኖች የሚቆጠር ገንዘብ | Nuro Bezede Ethiopian News by Nuro Bezede ኑሮ በዘዴ 2 years ago 15 minutes 14,793 views",Nuro Bezede ኑሮ በዘዴ,14793,14793,0
7127,"ዘመናዊ ጦ-ር መ-ሳ-ሪያ የመታተቅ እሽቅድድም በግብጽና በኢትዮጵያ  | Nuro Bezede News Now! by Nuro Bezede ኑሮ በዘዴ 2 years ago 15 minutes 105,332 views",Nuro Bezede ኑሮ በዘዴ,105332,105332,0
7128,"ታከለ ኡማ በሚስጥር ቤት ላደሏቸዉ የንግድ ሱቅ ጨመሩላቸው! | Nuro Bezede News Now! by Nuro Bezede ኑሮ በዘዴ 2 years ago 14 minutes, 19 seconds 14,802 views",Nuro Bezede ኑሮ በዘዴ,14802,14803,1
7129,"ሐኪሞች በእናትየው ሆድ ውስጥ ሞ-ተ-ዋ-ል ያሏቸው 3 ህፃናት በሰላም ተወለዱ!! | በተሻገር ጣሰው | Ethiopia by Nuro Bezede ኑሮ በዘዴ 2 years ago 20 minutes 143,751 views",Nuro Bezede ኑሮ በዘዴ,143751,143763,12
7130,"የጃዋር “ተከብቤያለሁኝን” በአዝናኝ መልኩ የገለፁት የአዲስ አበባ ወጣቶች | Funny Moments | Nuro Bezede Interview by Nuro Bezede ኑሮ በዘዴ 2 years ago 20 minutes 134,843 views",Nuro Bezede ኑሮ በዘዴ,134843,134865,22
7131,"ሙስጠፌ መሀመድ ለጠቅላይ ሚኒስትርነት እንዲታጩ ተጠየቀ! | Ethiopia by Nuro Bezede ኑሮ በዘዴ 2 years ago 14 minutes, 17 seconds 77,263 views",Nuro Bezede ኑሮ በዘዴ,77263,77267,4
7132,"የኦሮሞ እና አማራ ፓረቲዎች በአንድ ተሰበሰቡ! | Nuro Bezede Ethiopian News by Nuro Bezede ኑሮ በዘዴ 2 years ago 15 minutes 6,246 views",Nuro Bezede ኑሮ በዘዴ,6246,6246,0
7133,"ምርጫዉ ከተራዘመ ትግራይ ትገነጠላለች ተባለ! | Nuro Bezede Ethiopian News by Nuro Bezede ኑሮ በዘዴ 2 years ago 16 minutes 33,368 views",Nuro Bezede ኑሮ በዘዴ,33368,33368,0
7134,"ከኦርቶዶክስ ቤተ ክርስቲያን ከስራ የተባረሩ አባቶች ጥሪ! | Nuro Bezede Ethiopian News by Nuro Bezede ኑሮ በዘዴ 2 years ago 16 minutes 17,227 views",Nuro Bezede ኑሮ በዘዴ,17227,17227,0
7135,"3 ድርጅቶች ጃዋር ለፍርድ እንዲቀርብ አዲስ ዘመቻ ጀመሩ! | Nuro Bezede Ethiopian News by Nuro Bezede ኑሮ በዘዴ 2 years ago 15 minutes 75,691 views",Nuro Bezede ኑሮ በዘዴ,75691,75691,0
7136,"5 ወር ሙሉ የማዕከላዊ እስ-ር ቤት አ-ሰ-ቃቂ ግ-ፎ-ች በግ-ፍ ተቀባይዋ አንደበት! by Nuro Bezede ኑሮ በዘዴ 2 years ago 48 minutes 94,677 views",Nuro Bezede ኑሮ በዘዴ,94677,94680,3
7137,"የመቀሌ ሴቶች የህወሀትን ገመና በአደባባይ ገለጡ! | Nuro Bezede Ethiopian News by Nuro Bezede ኑሮ በዘዴ 2 years ago 17 minutes 25,518 views",Nuro Bezede ኑሮ በዘዴ,25518,25519,1
7138,"በአሰ-ቃቂ ሁኔታ የተገ-ደ-ሉት 2ቱ የአዳማ እህትማማቾች ቤተሰብ በ40 ቀናቸው ከአሜሪካ ሰርፕራይዝ ተደረጉ! | Ethiopia by Nuro Bezede ኑሮ በዘዴ 2 years ago 17 minutes 186,838 views",Nuro Bezede ኑሮ በዘዴ,186838,186839,1
7139,"ባለስልጣናቱ ስልጣን የመልቀቅ ዘመቻ እያካሔዱ ነው ! | Ethiopian News by Nuro Bezede ኑሮ በዘዴ 2 years ago 16 minutes 96,217 views",Nuro Bezede ኑሮ በዘዴ,96217,96218,1
7140,"አሁን የደረሰን ቪዲዮ - በሰኔ 15ቱ ጥቃ-ት የታሰረው ወጣት የምነግራችሁ አለኝ ይላል! | Ethiopia by Nuro Bezede ኑሮ በዘዴ 2 years ago 23 minutes 20,815 views",Nuro Bezede ኑሮ በዘዴ,20815,20816,1
7141,"በአዲስ አበባ ዘረኝነት የወደመበት አኩሪ ተግባር ተፈፀመ!! | በተሻገር ጣሰው | Ethiopia by Nuro Bezede ኑሮ በዘዴ 2 years ago 28 minutes 55,343 views",Nuro Bezede ኑሮ በዘዴ,55343,55344,1
7142,"የትራምፕ ሽምግልና በግድባችን የፈጠረው አዲስ ውዝግብ! | Nuro Bezede Ethiopian News! by Nuro Bezede ኑሮ በዘዴ 2 years ago 15 minutes 6,993 views",Nuro Bezede ኑሮ በዘዴ,6993,6993,0
7143,"ስለ ኢትየጵያ ኡጋንዳዊው ሰላይ ያወጣው አስደን-ጋጭ ሚስጥር | Nuro Bezede Ethiopian News by Nuro Bezede ኑሮ በዘዴ 2 years ago 13 minutes, 58 seconds 14,805 views",Nuro Bezede ኑሮ በዘዴ,14805,14806,1
7144,"በጄነራል ሳአረ መኮንን ግድ-ያ የተጠረጠረው ጠባቂ የት ገባ? | Nuro Bezede | Ethiopian News by Nuro Bezede ኑሮ በዘዴ 2 years ago 15 minutes 12,559 views",Nuro Bezede ኑሮ በዘዴ,12559,12559,0
7145,"እጆች ሳይኖራት ከባለእጆች በላይ የምትሰራዉ አስደናቂ ወጣት| በተሻገር ጣሰው | Ethiopia by Nuro Bezede ኑሮ በዘዴ 2 years ago 17 minutes 108,540 views",Nuro Bezede ኑሮ በዘዴ,108540,108549,9
7146,"አነጋጋሪው የአብይ መግለጫ ያልተጠበቀ ትችት ገጠመው | Nuro Bezede Ethiopian news by Nuro Bezede ኑሮ በዘዴ 2 years ago 18 minutes 14,648 views",Nuro Bezede ኑሮ በዘዴ,14648,14649,1
7147,"Ethiopia: 9 ወልዳ 4ቱ የሞ-ቱባት 3ቱ አይነ-ስውር የሆኑባት አሳዛ-ኝ እናት!! | በተሻገር ጣሰው!! | Ethiopia by Nuro Bezede ኑሮ በዘዴ 2 years ago 24 minutes 56,077 views",Nuro Bezede ኑሮ በዘዴ,56077,56085,8
7148,"የሃገራችን ታዋቂ አርቲስቶች የምንለው አለን ይላሉ!! | በተሻገር ጣሰው | Ethiopia by Nuro Bezede ኑሮ በዘዴ 2 years ago 44 minutes 4,523 views",Nuro Bezede ኑሮ በዘዴ,4523,4523,0
7149,"“አማራ የኦሮሞ ረዳት እንጂ ሰባሪው አልነበረም” ፕሮፌሰር ፍቅሬ ቶሎሳ | Ethiopia by Nuro Bezede ኑሮ በዘዴ 2 years ago 18 minutes 4,824 views",Nuro Bezede ኑሮ በዘዴ,4824,4824,0
7150,"የዕለቱ አበይት ክስተቶች - OMN ቴሌቪዥን በ 5 ቀን መልስ እንዲሰጥ ተጠየቀ! by Nuro Bezede ኑሮ በዘዴ 2 years ago 17 minutes 13,390 views",Nuro Bezede ኑሮ በዘዴ,13390,13390,0
7151,"ዶ/ር አብይ ህዝቡን ሸወዱት ወይስ በብልጠት ሠላም አወረዱ?  | Ethiopia by Nuro Bezede ኑሮ በዘዴ 2 years ago 22 minutes 18,418 views",Nuro Bezede ኑሮ በዘዴ,18418,18419,1
7152,"Ethiopia: 18 ዓመት ሙሉ ህመምተኛ ልጃቸውን በጀርባቸው አዝለው የሚጓዙት እናት!! - በተሻገር ጣሰው by Nuro Bezede ኑሮ በዘዴ 2 years ago 21 minutes 32,137 views",Nuro Bezede ኑሮ በዘዴ,32137,32143,6
7153,"የዕለቱ አበይት ክስተቶች - ዶ/ር አብይና ለማ መገርሳ ከሀረር ህዝብ የገጠሙት ሰጣ ገባ! | Nuro Bezede Ethiopian News by Nuro Bezede ኑሮ በዘዴ 2 years ago 12 minutes, 27 seconds 8,578 views",Nuro Bezede ኑሮ በዘዴ,8578,8578,0
7154,"የታማኝ ድንገተኛ ዛቻ ያልተጠበቀ ነገር ፈጠረ! | Ethiopia | Tamagn Beyene by Nuro Bezede ኑሮ በዘዴ 2 years ago 10 minutes, 5 seconds 134,262 views",Nuro Bezede ኑሮ በዘዴ,134262,134270,8
7155,"የዕለቱ አበይት ክስተቶች | ታከለ ኡማ 10 ሺ እናቶችን ሳይታሰብ ሰርፕራይዝ አደረጉ! | Nuro Bezede Ethiopian News by Nuro Bezede ኑሮ በዘዴ 2 years ago 16 minutes 28,829 views",Nuro Bezede ኑሮ በዘዴ,28829,28831,2
7156,"የሊቀ ጳጳስ ብጹዕ አቡነ ኤሊያስ ህዝቡን በእምባ ያራጨ ንግግር | Ethiopia by Nuro Bezede ኑሮ በዘዴ 2 years ago 23 minutes 6,678 views",Nuro Bezede ኑሮ በዘዴ,6678,6686,8
7157,"7ት አመት ሙሉ ከቤት ያልወጣው ግለሰብ አስገራሚ ሰርፕራይዝ ተደረገ!! | በተሻገር ጣሰው!! | Ethiopia by Nuro Bezede ኑሮ በዘዴ 2 years ago 19 minutes 65,093 views",Nuro Bezede ኑሮ በዘዴ,65093,65102,9
7158,"ሰበር ዜና - የአ-ስከሬን ማውጫ የተፃፈላት ታዳጊ እናት መኖሪያ ቤት ተሰጣቸው!! | በተሻገር ጣሰው | Ethiopia by Nuro Bezede ኑሮ በዘዴ 2 years ago 20 minutes 11,664 views",Nuro Bezede ኑሮ በዘዴ,11664,11664,0
7159,"በአዲስ አበባ እየሆነ ያለው ምንድነው? ጃዋር ምን እያለ ነው?  | Nuro Bezede Ethiopian News by Nuro Bezede ኑሮ በዘዴ 2 years ago 14 minutes, 56 seconds 50,241 views",Nuro Bezede ኑሮ በዘዴ,50241,50241,0
7160,"ስለ ዶ/ር አብይ አዲሱ መፅሀፍ ያልተሰሙ እዉነታዎች ! | Ethiopia | Abiy Ahmed by Nuro Bezede ኑሮ በዘዴ 2 years ago 11 minutes, 15 seconds 2,409 views",Nuro Bezede ኑሮ በዘዴ,2409,2409,0
7161,"አስደሳች ዜና - ሞ-ታለች ተብላ የአ-ስከሬን ማውጫ የተፃፈላት ታዳጊ ህክምና ጀመረች!! | በተሻገር ጣሰው | Ethiopia by Nuro Bezede ኑሮ በዘዴ 2 years ago 16 minutes 32,980 views",Nuro Bezede ኑሮ በዘዴ,32980,32991,11
7162,"ታማኝ ዝምታውን ሰበረ! | ""ተበትኖ ያለው ኢትዮጵያዊ ኃይል እንዲደራጅ እፈልጋለሁ!” | Ethiopia | Tamagn Beyene by Nuro Bezede ኑሮ በዘዴ 2 years ago 16 minutes 5,751 views",Nuro Bezede ኑሮ በዘዴ,5751,5751,0
7163,"Lij  Michael ""Konjo"" | ልጅ ሚካኤል አሜሪካን ሃገር የሰራውን ክሊፕ ለቀቀ!! | ከተሻገር ጣሰው ጋር ያደረገው ልዩ ቆይታ by Nuro Bezede ኑሮ በዘዴ 2 years ago 11 minutes, 27 seconds 12,744 views",Nuro Bezede ኑሮ በዘዴ,12744,12754,10
7164,"Ethiopia: የሚያሳክመው ሰው አጥቶ ለ7 አመት ሙሉ ከቤት ያልወጣው ግለሰብ !! | በተሻገር ጣሰው | Nuro Bezede by Nuro Bezede ኑሮ በዘዴ 2 years ago 21 minutes 63,804 views",Nuro Bezede ኑሮ በዘዴ,63804,63809,5
7165,"የጠ/ሚሩ ቢሮ ለህወሀት ተቃዉሞ ያልተጠበቀ ምላሽ ሰጠ! | Nuro Bezede Ethiopian News by Nuro Bezede ኑሮ በዘዴ 2 years ago 9 minutes, 16 seconds 28,666 views",Nuro Bezede ኑሮ በዘዴ,28666,28666,0
7166,"የታከለ ድንገተኛ  ስንብት እና ውዝግብ ያስነሳው የቀጣዩ ከንቲባ ማንነት! | Nuro Bezede Ethiopian News by Nuro Bezede ኑሮ በዘዴ 2 years ago 12 minutes, 21 seconds 65,755 views",Nuro Bezede ኑሮ በዘዴ,65755,65757,2
7167,"Ethiopia: እነ ጄኔራል ተፈራ ማሞ ከእስር ሲፈቱ በባህርዳር የተደረገላቸው ደማቅ አቀባበል by Nuro Bezede ኑሮ በዘዴ 2 years ago 10 minutes, 5 seconds 73,305 views",Nuro Bezede ኑሮ በዘዴ,73305,73306,1
7168,"#Konta - The land of Elephants  | የዝሆኖች ምድር ኮንታ!  | Ethiopia by Nuro Bezede ኑሮ በዘዴ 2 years ago 11 minutes, 17 seconds 22,481 views",Nuro Bezede ኑሮ በዘዴ,22481,22497,16
7169,"Ethiopia: ሰበር አሳዛኝ ዜና በኮንታ በመሬት መንሸራተት አደጋ 20 ሰዎች ሞ-ቱ!! | በተሻገር ጣሰው!! by Nuro Bezede ኑሮ በዘዴ 2 years ago 10 minutes, 14 seconds 72,251 views",Nuro Bezede ኑሮ በዘዴ,72251,72251,0
7170,"Ethiopia: ከ20 ሺህ በላይ የአማራ ተወላጆች በደጀንና ባህርዳር ላይ እየተጉላሉ ነው!! | ከቦታው በተሻገር ጣሰው by Nuro Bezede ኑሮ በዘዴ 2 years ago 10 minutes, 38 seconds 95,329 views",Nuro Bezede ኑሮ በዘዴ,95329,95336,7
7171,"የባለ አደራው ምክር ቤት የጥቅምት 2ቱን ሰልፍ አስመልክቶ የሰጠው መግለጫ ክፍል 3 by Nuro Bezede ኑሮ በዘዴ 2 years ago 21 minutes 2,375 views",Nuro Bezede ኑሮ በዘዴ,2375,2375,0
7172,"Ethiopia: የባለ አደራው ምክር ቤት የጥቅምት 2ቱን ሰልፍ አስመልክቶ የሰጠው መግለጫ ክፍል 2 by Nuro Bezede ኑሮ በዘዴ 2 years ago 15 minutes 3,262 views",Nuro Bezede ኑሮ በዘዴ,3262,3262,0
7173,"ሰበር መግለጫ - ባለ አደራው ምክር ቤት የጥቅምት 2ቱን ሰልፍ አስመልክቶ የሰጠው መግለጫ by Nuro Bezede ኑሮ በዘዴ 2 years ago 20 minutes 23,776 views",Nuro Bezede ኑሮ በዘዴ,23776,23776,0
7174,"Ethiopia: ጠ/ሚ ዶ/ር አብይ አህመድ የአለማችን ግዙፉን የኖቤል ሎሬት ሽልማት አሸነፉ! by Nuro Bezede ኑሮ በዘዴ 2 years ago 10 minutes, 10 seconds 8,874 views",Nuro Bezede ኑሮ በዘዴ,8874,8874,0
7175,"Ethiopia: በአዳማ ልጆቻቸው የታረ-ዱባ-ቸው ቤተሰቦች ለኢትዮጲያዉያን የምንለዉ አለ ይላሉ! by Nuro Bezede ኑሮ በዘዴ 2 years ago 12 minutes, 6 seconds 130,903 views",Nuro Bezede ኑሮ በዘዴ,130903,130965,62
7176,"Ethiopia: ብቸኛዋ ምግብ የማትመገበው ኢትዮጵያዊት የምለው አለኝ ትላለች!! | በተሻገር ጣሰው by Nuro Bezede ኑሮ በዘዴ 2 years ago 50 minutes 208,080 views",Nuro Bezede ኑሮ በዘዴ,208080,208107,27
7177,"የድሬዳዋ የመንገድ ዳር ጣፋጭ ምግቦች | በተሻገር ጣሰው | Ethiopia | Dire Dawa | Nuro Bezede travel foods show by Nuro Bezede ኑሮ በዘዴ 2 years ago 18 minutes 38,385 views",Nuro Bezede ኑሮ በዘዴ,38385,38840,455
7178,"አዲስ አበባ በአሁኑ ሰዓት የእሬቻን በዓል ለማክበር በመጡ ሰዎች እንደዚህ ትመስላለች!! | በተሻገር ጣሰው | Addis Abeba by Nuro Bezede ኑሮ በዘዴ 2 years ago 18 minutes 17,945 views",Nuro Bezede ኑሮ በዘዴ,17945,17945,0
7179,"Ethiopia - አሳዛኝ ዜና - በአዳማ 2 እህትማማቾች በአጎታቸው ታርዳው ተገደ-ሉ ቤተሰቦቻቸው ምን ይላሉ? በተሻገር ጣሰው | Nuro Bezede by Nuro Bezede ኑሮ በዘዴ 2 years ago 26 minutes 423,972 views",Nuro Bezede ኑሮ በዘዴ,423972,424043,71
7180,"""የጭራቁን ወሬ ላይክና ሼር አታድርጉ!” የዲያቆን ዳንኤል ክብረት አስተማሪ ንግግር | Ethiopia by Nuro Bezede ኑሮ በዘዴ 2 years ago 24 minutes 3,952 views",Nuro Bezede ኑሮ በዘዴ,3952,3983,31
7181,"የዶ/ር ወዳጄነህ ህዝቡን ያስደነቀ ንግግር “አረንጓዴ ቢጫ ቀዩን ባንዲራ ለመለወጥ አይታሰብም ክንቱ ሙከራ ነው!!” | Ethiopia by Nuro Bezede ኑሮ በዘዴ 2 years ago 27 minutes 56,828 views",Nuro Bezede ኑሮ በዘዴ,56828,56838,10
7182,"[ሙሉ ቪዲዮ] የአየርመንገድ ሰራተኛዋ ገዳዮ-ች ተያዙ ባሏና ቤተሰቦች ምን ይላሉ? | Exclusive Interview Nuro Bezede by Nuro Bezede ኑሮ በዘዴ 2 years ago 34 minutes 72,058 views",Nuro Bezede ኑሮ በዘዴ,72058,72090,32
7183,"Ethiopia: የአየርመንገድ ሰራተኛዋ ገዳዮች ተያዙ ባሏና ቤተሰቦቾ ምን ይላሉ? | Exclusive Interview by Nuro Bezede ኑሮ በዘዴ 2 years ago 26 minutes 307,027 views",Nuro Bezede ኑሮ በዘዴ,307027,307032,5
7184,"የተዋህዶ ወጣቶች በመስቀል አደባባይ ያሳዩት ልዩ የወረብና የመዝሙር ስነ-ስርዓቶች | Ethiopia by Nuro Bezede ኑሮ በዘዴ 2 years ago 14 minutes, 26 seconds 65,760 views",Nuro Bezede ኑሮ በዘዴ,65760,65761,1
7185,"[አሁን የደረሰን ቪዲዮ] የአዲስ አበባው የመስቀል በዓል አስገራሚ ትዕይንቶች | Ethiopian Orthodox by Nuro Bezede ኑሮ በዘዴ 2 years ago 25 minutes 124,067 views",Nuro Bezede ኑሮ በዘዴ,124067,124072,5
7186,"ሙስሊሞች ኦርቶዶክስ ወገኖቻቸውን በመስቀል አደባባይ አስደነቁ! | Ethiopia by Nuro Bezede ኑሮ በዘዴ 2 years ago 23 minutes 31,755 views",Nuro Bezede ኑሮ በዘዴ,31755,31755,0
7187,"የመስቀል በዓል ድባብ በመስቀል አደባባባይና በኦሮሚያ ክልል | በተሻገር ጣሰው | Ethiopian Orthodox by Nuro Bezede ኑሮ በዘዴ 2 years ago 26 minutes 36,704 views",Nuro Bezede ኑሮ በዘዴ,36704,36704,0
7188,"በኩላሊት ህመም እየተሰቃየ ስለሚገኘው ድምፃዊ ሙሉዓለም አባቱ የተናገሩት ልብ የሚነካ ንግግር! | Ethiopia by Nuro Bezede ኑሮ በዘዴ 2 years ago 13 minutes, 8 seconds 59,695 views",Nuro Bezede ኑሮ በዘዴ,59695,59696,1
7189,"Ethiopia - በአሳዛኝ ሁኔታ የተገደለችው የኢትዮጵያ አየር መንገድ ሰራተኛ ቤተሰቦች ምን ይላሉ? | By Teshager Tassew by Nuro Bezede ኑሮ በዘዴ 2 years ago 18 minutes 357,660 views",Nuro Bezede ኑሮ በዘዴ,357660,357679,19
7190,"ሞታለች ተብላ የአስክሬን ማውጫ የወጣባት ታዳጊ እናት የምለው አለኝ ይላሉ!! በተሻገር ጣሰው | Ethiopia please let us help this Girl by Nuro Bezede ኑሮ በዘዴ 2 years ago 27 minutes 183,502 views",Nuro Bezede ኑሮ በዘዴ,183502,183530,28
7191,"ህዝቡን ያስደነቀዉ የአዳማዉ ልዩ ባህላዊ ጭፈራ ቤት ትዕይንቶች | በተሻገር ጣሰው by Nuro Bezede ኑሮ በዘዴ 2 years ago 32 minutes 9,383 views",Nuro Bezede ኑሮ በዘዴ,9383,9384,1
7192,"[ሚስጥራዊ መረጃ] - ሀይማኖታችሁን ተከላከሉ በተመስገን ደሳለኝ | Temesgen Desalegn Analysis | Ethiopian Orthodox by Nuro Bezede ኑሮ በዘዴ 2 years ago 26 minutes 12,131 views",Nuro Bezede ኑሮ በዘዴ,12131,12132,1
7193,"Ethiopia: ሰበር ዜና ለመስከረም 4 የተጠራው ሰልፍ እንደማይካሄድ ተገለፀ by Nuro Bezede ኑሮ በዘዴ 2 years ago 35 minutes 6,725 views",Nuro Bezede ኑሮ በዘዴ,6725,6725,0
7194,"የጎዳና ሴቶችና ወንዶችን ከመንገድ ላይ እያነሳ የሚያጥበው አነጋጋሪው ወጣት!! በተሻገር ጣሰው | Ethiopia by Nuro Bezede ኑሮ በዘዴ 2 years ago 35 minutes 65,364 views",Nuro Bezede ኑሮ በዘዴ,65364,65372,8
7195,"የአበባየሆሽ ጭፈራ ከቤቶች ድራማዋ ህፃን አሜን ጋር | Ethiopia by Nuro Bezede ኑሮ በዘዴ 2 years ago 14 minutes, 10 seconds 273,518 views",Nuro Bezede ኑሮ በዘዴ,273518,273533,15
7196,"የአዲስ አመት ልዩ ድባብ በአዲስ አበባ ከጋዜጠኛ ተሻገር ጣሰው ጋር | Ethiopia by Nuro Bezede ኑሮ በዘዴ 2 years ago 18 minutes 13,775 views",Nuro Bezede ኑሮ በዘዴ,13775,13775,0
7197,"በማዕከላዊ ጨለማ ክፍል ውስጥ የተሰቃየው መቶ አለቃ “ከፍያለው ተፈራ እግሮቹን ሲቆረጥ እኔ ክፍል ነበር” by Nuro Bezede ኑሮ በዘዴ 2 years ago 17 minutes 38,234 views",Nuro Bezede ኑሮ በዘዴ,38234,38235,1
7198,"የዕለቱ ዜና - በኦሮሚያ ሊመሰረት የነበረው የኦርቶዶክስ ቤ/ክ አደጋ እንደተጋረጠበት ተሰማ | Ethiopian Daily News by Nuro Bezede ኑሮ በዘዴ 2 years ago 10 minutes, 48 seconds 108,185 views",Nuro Bezede ኑሮ በዘዴ,108185,108201,16
7199,"Ethiopia: የእናቴን መታሰር ዶ/ር አብይም ቢሆኑ ያውቁታል የብ/ጀነራል አሳምነው ፅጌ ልጅ by Nuro Bezede ኑሮ በዘዴ 2 years ago 13 minutes, 18 seconds 6,285 views",Nuro Bezede ኑሮ በዘዴ,6285,6287,2
7200,"Ethiopia: የገዳሙን አስተዳዳሪ በመግደል የተጠረጠሩት በቁጥጥር ስር ዋሉ | የዕለቱ አጫጭር ዜናዎች | Ethiopian Daily News by Nuro Bezede ኑሮ በዘዴ 2 years ago 10 minutes, 22 seconds 64,567 views",Nuro Bezede ኑሮ በዘዴ,64567,64568,1
7201,"የገዳሙ አስተዳዳሪ ሞተው መገኘት አመፅ አስነሳ | የዕለቱ አጫጭር ዜናዎች | Ethiopian Daily News by Nuro Bezede ኑሮ በዘዴ 2 years ago 13 minutes, 13 seconds 17,040 views",Nuro Bezede ኑሮ በዘዴ,17040,17040,0
7202,"Ethiopia: የብ/ጀ አሳምነዉ ፅጌ እናት ዶ/ር አብይን ተማፀኗቸዉ! | “ጠቅላይ ሚኒስቴር እኔ ባልወልዶትም እናትዎ ነኝ፤ ልጄን ተዉልኝ!” by Nuro Bezede ኑሮ በዘዴ 2 years ago 17 minutes 20,691 views",Nuro Bezede ኑሮ በዘዴ,20691,20711,20
7203,"በአማራ 4 ሰዎች በጥይት ተገደሉ | የመከላከያ ሄሊኮፕተር ያልተጠበቀ አደጋ አጋጥሟት በረራዋን አቋረጠች | የዕለቱ አጫጭር ዜናዎች | Ethiopian News by Nuro Bezede ኑሮ በዘዴ 2 years ago 14 minutes, 37 seconds 36,961 views",Nuro Bezede ኑሮ በዘዴ,36961,36961,0
7204,"በስህተት ሊገደል የነበረው ሰው | በአዲስ አበባ ግዮን ሆቴል አካባቢ ምን ተከሰተ? እና ሀይሌ በኦስካር? | የዕለቱ አጫጭር ዜናዎች | Ethiopian News by Nuro Bezede ኑሮ በዘዴ 2 years ago 15 minutes 12,690 views",Nuro Bezede ኑሮ በዘዴ,12690,12690,0
7205,"Ethiopia - የጠ/ሚኒስትሩ ግልጽ ሥህተቶች | Temesgen Desalegn Analysis by Nuro Bezede ኑሮ በዘዴ 2 years ago 10 minutes, 22 seconds 28,074 views",Nuro Bezede ኑሮ በዘዴ,28074,28083,9
7206,"በአዲስ አበባ በግብረሰዶም ተግባር ላይ የተሰማራው ትምህርት ቤት | የዕለቱ አጫጭር መረጃዎች | Ethiopia by Nuro Bezede ኑሮ በዘዴ 2 years ago 11 minutes, 35 seconds 9,731 views",Nuro Bezede ኑሮ በዘዴ,9731,9733,2
7207,"12 ሰዎችን ከእሳት ያወጣው ቅን ሰው በከንቲባው ሰርፕራይዝ ተደረገ! | የዕለቱ አጫጭር መረጃዎች | Ethiopia by Nuro Bezede ኑሮ በዘዴ 2 years ago 9 minutes, 3 seconds 21,057 views",Nuro Bezede ኑሮ በዘዴ,21057,21057,0
7208,"ዘር የማይቆጥሩት የትናንት አባቶቻችን ደም በኛ ላይ አለ | መምህር ዘበነ ለማ by Nuro Bezede ኑሮ በዘዴ 2 years ago 11 minutes, 42 seconds 26,970 views",Nuro Bezede ኑሮ በዘዴ,26970,26976,6
7209,"ብዙዎችን ያስገረመው ህፃን ሮቤል በአምላክ የዛሬው ንግግር | Ethiopia by Nuro Bezede ኑሮ በዘዴ 2 years ago 14 minutes, 22 seconds 143,920 views",Nuro Bezede ኑሮ በዘዴ,143920,143953,33
7210,"አርቲስት ዮሴፍ ገብሬ ጆሲ በሽልማት ፕሮግራሙ ላይ ያደረገው ንግግር by Nuro Bezede ኑሮ በዘዴ 2 years ago 11 minutes, 43 seconds 60,792 views",Nuro Bezede ኑሮ በዘዴ,60792,60797,5
7211,"በሊቢያ ኢትዮጲያዊያን ስደተኞች ታገቱ | በቃሊቲ እስር ቤት የናይጄሪያዊው ህይወት አለፈ | የዕለቱ አጫጭር ዜናዎች by Nuro Bezede ኑሮ በዘዴ 2 years ago 10 minutes, 25 seconds 3,081 views",Nuro Bezede ኑሮ በዘዴ,3081,3081,0
7212,"ሰርጋቸውን በችግኝ ተከላ ያሳለፉት አስገራሚ ሙሽሮች | ኢትዮጲያ ታሪክ ሰራች | የዕለቱ አጫጭር መረጃዎች | Ethiopian News by Nuro Bezede ኑሮ በዘዴ 2 years ago 11 minutes, 14 seconds 17,374 views",Nuro Bezede ኑሮ በዘዴ,17374,17374,0
7213,"ኢንጂነር ስመኘው የሞቱ እለት በአዲስ አበባ | Ethiopian engineer Simegnew Bekele by Nuro Bezede ኑሮ በዘዴ 2 years ago 14 minutes, 47 seconds 8,233 views",Nuro Bezede ኑሮ በዘዴ,8233,8255,22
7214,"ጥብቅ መረጃ - ደቡብ ክልልን በኮማንድ ፖስት ስር ያዋለው የሲዳማ ዞን ጥቃት እና ጀርባው! | Ethiopia by Nuro Bezede ኑሮ በዘዴ 2 years ago 11 minutes, 17 seconds 37,194 views",Nuro Bezede ኑሮ በዘዴ,37194,37194,0
7215,"ናዝራዊት አበራ በቻይና የመጨረሻ የፍርድ ቀን እየተጠባበቀች ነው | የዕለቱ አጭር መረጃ | Ethiopian Daily News by Nuro Bezede ኑሮ በዘዴ 2 years ago 13 minutes, 50 seconds 30,599 views",Nuro Bezede ኑሮ በዘዴ,30599,30602,3
7216,"ኢንጂነሩ ከአሳምነው ፅጌ ጋር ምሽት ላይ አወራን ያሉት | ምሽት 1፡58 ላይ ደውዬለት ነበር… | Ethiopia by Nuro Bezede ኑሮ በዘዴ 2 years ago 17 minutes 48,597 views",Nuro Bezede ኑሮ በዘዴ,48597,48603,6
7217,"“አዴፓ በህውሀት ወጥመድ ግብቷል” አንዱ አለም አራጌ | Ethiopia by Nuro Bezede ኑሮ በዘዴ 2 years ago 18 minutes 28,268 views",Nuro Bezede ኑሮ በዘዴ,28268,28268,0
7218,"ቴዲ አፍሮ በልደቱ ማግስት ተሸለመ | ሀዋሳ ምን ተከስቶ ዋለ? የዕለቱ አነጋጋሪ መረጃዎች | Ethiopian Daily News by Nuro Bezede ኑሮ በዘዴ 2 years ago 10 minutes, 3 seconds 25,367 views",Nuro Bezede ኑሮ በዘዴ,25367,25373,6
7219,"ልዩ ትንታኔ - የጀነራሎቹና የጋዜጠኞቹ ፍጥጫ! | Ethiopia | Temesgen Desalegn | FDRE by Nuro Bezede ኑሮ በዘዴ 2 years ago 10 minutes, 20 seconds 10,837 views",Nuro Bezede ኑሮ በዘዴ,10837,10841,4
7220,"መታየት ያለበት ድንቅ ተውኔት ""ለኛም ብሔር እኮ ቀን ይመጣለታል"" | Ethiopia by Nuro Bezede ኑሮ በዘዴ 2 years ago 25 minutes 3,022 views",Nuro Bezede ኑሮ በዘዴ,3022,3022,0
7221,"አሁን የደረሰን ቪዲዮ - የባለአደራው መግለጫ ባልታውቁ ሰዎች ተበጥብጦ ተበተነ | Ethiopia by Nuro Bezede ኑሮ በዘዴ 2 years ago 16 minutes 33,542 views",Nuro Bezede ኑሮ በዘዴ,33542,33542,0
7222,"Ethiopia - ሰበር ዜና - የባለአደራው ምክር ቤት የህሊና እስረኞች  በአስቸኳይ እንዲፈቱ ጠየቀ by Nuro Bezede ኑሮ በዘዴ 2 years ago 18 minutes 81,408 views",Nuro Bezede ኑሮ በዘዴ,81408,81418,10
7223,"የጀነራል አሳምነው ፅጌ ወንድ ልጅ “ከዶ/ር አምባቸው ቤተሰቦች ጋር በፍቅር እንድንቀጥል ነው የምፈልገው” | Ethiopia by Nuro Bezede ኑሮ በዘዴ 2 years ago 10 minutes, 34 seconds 292,291 views",Nuro Bezede ኑሮ በዘዴ,292291,292345,54
7224,"የጀነራል አሳምነው ፅጌ ባለቤት መታሰሯን ልጃቸው ይፋ አደረገች by Nuro Bezede ኑሮ በዘዴ 2 years ago 3 minutes 117,066 views",Nuro Bezede ኑሮ በዘዴ,117066,117070,4
7225,"መረጃ - ጀነራል አሳምነው ፅጌ ለጋዜጠኛዋ በስልክ የነገሯትን መረጃ ይፋ አደረገች by Nuro Bezede ኑሮ በዘዴ 2 years ago 15 minutes 28,125 views",Nuro Bezede ኑሮ በዘዴ,28125,28127,2
7226,"ቃለ መጠይቅ - የዶ/ር አምባቸው ባለቤት ስለ አሳምነው ፅጌ እና ስለ ባለቤቷ ምን ትላለች? by Nuro Bezede ኑሮ በዘዴ 2 years ago 14 minutes, 22 seconds 425,771 views",Nuro Bezede ኑሮ በዘዴ,425771,425825,54
7227,"“ድንቄም መፈንቅለ መንግስት” በጋዜጠኛ ተመስገን ደሳለኝ | Temesgen Desalegn Analysis by Nuro Bezede ኑሮ በዘዴ 2 years ago 23 minutes 25,391 views",Nuro Bezede ኑሮ በዘዴ,25391,25410,19
7228,"አርቲስቶች ለኢትዮጲያ ህዝብ ያስተላለፉት ጥብቅ መልዕክት!! | ስለ ሰኔ 15 ጥቃት አርቲስቶች ምን አሉ? by Nuro Bezede ኑሮ በዘዴ 2 years ago 12 minutes, 49 seconds 28,453 views",Nuro Bezede ኑሮ በዘዴ,28453,28453,0
7229,"Ethiopia - ዶ/ር ደብረ ፂዮን በሰዓረ ቀብር ላይ ምን አሉ? | የጀነራል ሰዓረ ገዳይ የት እንዳለ ሲጠየቁ የአቶ ንጉሱ ምላሽ? by Nuro Bezede ኑሮ በዘዴ 2 years ago 11 minutes, 39 seconds 103,922 views",Nuro Bezede ኑሮ በዘዴ,103922,103922,0
7230,"“የተፈፀመው ጥቃት እንጂ መፈንቅለ መንግስት አይደለም” | የአዲስ አበባ ነዋሪዎች ያልተጠበቀ አስተያየት by Nuro Bezede ኑሮ በዘዴ 2 years ago 26 minutes 179,760 views",Nuro Bezede ኑሮ በዘዴ,179760,179766,6
7231,"Ethiopia - መረጃ - የጄነራሎቹና የአዴፓ አመራሮች ግድያ ሙሉ እውነቱን ማን ይንገረን? by Nuro Bezede ኑሮ በዘዴ 2 years ago 11 minutes, 59 seconds 10,739 views",Nuro Bezede ኑሮ በዘዴ,10739,10739,0
7232,"Ethiopia - አርቲስቶች በሰኔ 16 ጥቃት ዙሪያ የሰጡት መግለጫ by Nuro Bezede ኑሮ በዘዴ 2 years ago 13 minutes, 59 seconds 129,961 views",Nuro Bezede ኑሮ በዘዴ,129961,129961,0
7233,"Ethiopia - ሰበር መረጃ - የዶ/ር አምባቸው ሹፌር አየሁት ያለውን ነገር ይፋ አደረገ |  Dr Ambachew Mekonnen by Nuro Bezede ኑሮ በዘዴ 2 years ago 14 minutes, 13 seconds 181,443 views",Nuro Bezede ኑሮ በዘዴ,181443,181507,64
7234,"አሁን የደረሰን - በመጨረሻም ዶ/ር አብይ ዝምታውን ሰብረው ያወጡት መግለጫ by Nuro Bezede ኑሮ በዘዴ 2 years ago 10 minutes, 15 seconds 31,179 views",Nuro Bezede ኑሮ በዘዴ,31179,31180,1
7235,"Ethiopia - ስለ ዶ/ር አምባቸው ቤተሰቦቻቸውና አብሮ አደጎቻቸው ምን ይላሉ? by Nuro Bezede ኑሮ በዘዴ 2 years ago 14 minutes, 10 seconds 104,253 views",Nuro Bezede ኑሮ በዘዴ,104253,104256,3
7236,"Ethiopia - ዛሬ የደረሰን ቪዲዮ - በዶ/ር አምባቸው ቤት ያለው ልብ የሚነካ የሀዘን ድባብ by Nuro Bezede ኑሮ በዘዴ 2 years ago 11 minutes, 22 seconds 422,381 views",Nuro Bezede ኑሮ በዘዴ,422381,422477,96
7237,"ደብረ ህውሀት - ድብቁ የህውሀት ስብሰባ ላይ እነ ጌታቸው አሰፋ | አዜብ መስፍን ሚስጥራዊ ንግግሮችን ያጋለጠው የተመስገን ደሳለኝ ፅሁፍ by Nuro Bezede ኑሮ በዘዴ 2 years ago 25 minutes 248,287 views",Nuro Bezede ኑሮ በዘዴ,248287,248295,8
7238,"ዶ/ር ወዳጄነህ ዶ/ር አብይ ፊት የተናገረው ያልተጠበቀ ንግግር “አክሱም ፂዮን ከባለቤትዎ ጋር ሄደው ይባረኩ” by Nuro Bezede ኑሮ በዘዴ 2 years ago 10 minutes, 35 seconds 160,299 views",Nuro Bezede ኑሮ በዘዴ,160299,160334,35
7239,"የሰንሰለት ድራማው ቴዎድሮስ (ልኡል) አስደናቂ ንግግር “እኛ ታኪዮ ነን በፍቅር እናበራለን እንጂ በጥላቻ አንጨልምም” by Nuro Bezede ኑሮ በዘዴ 2 years ago 16 minutes 3,723 views",Nuro Bezede ኑሮ በዘዴ,3723,3723,0
7240,"የዶ/ር አብይ የዕለት ውሎ | በታንዛኒያ እስር ቤቶች ያሉ ኢትዮጲያዊያን ወደ ሀገራቸው ሊመለሱ መሆኑ እና የዕለቱ መረጃዎች by Nuro Bezede ኑሮ በዘዴ 2 years ago 12 minutes, 21 seconds 9,865 views",Nuro Bezede ኑሮ በዘዴ,9865,9865,0
7241,"Ethiopia - “ነፃነቴን የሰጠኝ ጠ/ሚ ዶ/ር አብይ ነው! ሌላ ማን ሰጠኝ?“ አርቲስት ደበበ እሸቱ by Nuro Bezede ኑሮ በዘዴ 2 years ago 13 minutes, 8 seconds 30,939 views",Nuro Bezede ኑሮ በዘዴ,30939,30939,0
7242,"Ethiopia - “ተዘርፈን ባዶ እጃችንን ቀርተናል! አገር እና ሕዝብ ይፍረደን” | 173 ሺህ የአሜሪካ ዶላር ዋጋ ነበረው by Nuro Bezede ኑሮ በዘዴ 2 years ago 10 minutes, 28 seconds 32,588 views",Nuro Bezede ኑሮ በዘዴ,32588,32588,0
7243,"የዶ/ር አብይ ውሎ | ታከለ ኡማ ያስተላለፈው ውሳኔ | እስክንድር ነጋ መግለጫ መስጠቱ እና የዕለቱ መረጃዎች by Nuro Bezede ኑሮ በዘዴ 2 years ago 14 minutes, 36 seconds 19,168 views",Nuro Bezede ኑሮ በዘዴ,19168,19169,1
7244,"በመጨረሻም ታማኝ በየነ እነ ኤርሚያስን ወደ ኢሳት ለመመለስና ለማስታረቅ ስላደረገው ጥረት ተናገረ | Ethiopia by Nuro Bezede ኑሮ በዘዴ 2 years ago 10 minutes, 16 seconds 31,921 views",Nuro Bezede ኑሮ በዘዴ,31921,31924,3
7245,"የደራሲ ዘነበ ወላ ትውልድ የሚቀይር አስደናቂ ንግግር | Ethiopia by Nuro Bezede ኑሮ በዘዴ 2 years ago 11 minutes, 13 seconds 2,229 views",Nuro Bezede ኑሮ በዘዴ,2229,2230,1
7246,"የዶ/ር አብይ አባት አህመድ አሊ ማን ነበሩ? | ስለ አብይ ምን በለው ነበር? | የእረፍታቸው ዜና ከተሰማ በኋላ ሚዲያዎች ምን አሉ? by Nuro Bezede ኑሮ በዘዴ 2 years ago 10 minutes, 9 seconds 79,539 views",Nuro Bezede ኑሮ በዘዴ,79539,79554,15
7247,"ኤርሚያስ በመጨረሻም ተናገረ “ሽጉጡን ደረቴ ላይ ካነጣጠረ በኋላ በአምላክ ፈቃድ ሳይተኩስ ቀርቷል” by Nuro Bezede ኑሮ በዘዴ 2 years ago 8 minutes, 35 seconds 102,093 views",Nuro Bezede ኑሮ በዘዴ,102093,102097,4
7248,"ዘራፊዎች አምባሳደር የሚሆኑባት አስገራሚ ሀገር | የእንዳልካቸው ዘነበ ህዝቡን ያስጨበጨበ ንግግር by Nuro Bezede ኑሮ በዘዴ 2 years ago 10 minutes, 40 seconds 1,773 views",Nuro Bezede ኑሮ በዘዴ,1773,1773,0
7249,"የይሁኔ በላይ ጥሪ ለድምፃዊ አበበ ተካ | ኢሳያስ አፈወርቂ የተቃውሞ ዘመቻ ተነሳባቸው | እና የዕለቱ ዜናዎች | Nuro Bezede Ethiopian News by Nuro Bezede ኑሮ በዘዴ 2 years ago 10 minutes, 30 seconds 25,721 views",Nuro Bezede ኑሮ በዘዴ,25721,25725,4
7250,"የዶ/ር ደብረ ፂዮን ያልተጠበቀ ንግግር | ስለ ትግራይ መገንጠል እና ጌታቸው አሰፋ የተናገሩት | Ethiopian Daily News by Nuro Bezede ኑሮ በዘዴ 2 years ago 13 minutes, 25 seconds 2,847 views",Nuro Bezede ኑሮ በዘዴ,2847,2848,1
7251,"ፖሊስ የጌታቸው አሰፋን አድራሻ ማግኘት አልቻልኩም አለ | አብን መንግስት ቃሉን እንዲጠብቅ ጠየቀ | እና ሌሎችም ዜናዎች  | Nuro Bezede News by Nuro Bezede ኑሮ በዘዴ 2 years ago 15 minutes 3,117 views",Nuro Bezede ኑሮ በዘዴ,3117,3117,0
7252,"ልዩ መረጃ - የሱዳን አለመረጋጋት በኢትዮጲያ ላይ የሚያመጣው ተፅዕኖ | ከዶ/ር አብይ ጉዞ በኋላስ ምን ተከሰተ? by Nuro Bezede ኑሮ በዘዴ 2 years ago 10 minutes, 57 seconds 4,411 views",Nuro Bezede ኑሮ በዘዴ,4411,4411,0
7253,"የዕለቱ ዜናዎች - እስክንድር | የዶ/ር አብይ አነጋጋሪው ጉዞ | ሰኔ 16 | አጣዬ | አንዳርጋቸውና ሌሎችም | Nuro Bezede Daily News by Nuro Bezede ኑሮ በዘዴ 2 years ago 14 minutes, 43 seconds 2,432 views",Nuro Bezede ኑሮ በዘዴ,2432,2432,0
7254,"የገዛ ፍቅረኛውን ገድሎ በጭካኔ የቆራረጠው ግለሰብ ተያዘ | ሼክ አላሙዲ ከሳውዲ መልካም ነገር አሰሙ | የዕለቱ ዜናዎች | Nuro Bezede Daily News by Nuro Bezede ኑሮ በዘዴ 2 years ago 11 minutes, 47 seconds 6,748 views",Nuro Bezede ኑሮ በዘዴ,6748,6748,0
7255,"የዶ/ር አብይ ብዙዎችን ያስደሰተው ድርጊት | ግብረሰዶማውያኑ ላይ ተቃውሞ መነሳቱ | እና የዕለቱ አነጋጋሪ ዜናዎች by Nuro Bezede ኑሮ በዘዴ 2 years ago 11 minutes, 30 seconds 4,334 views",Nuro Bezede ኑሮ በዘዴ,4334,4334,0
7256,"ኮለኔል መንግስቱ ሀ/ማርያም ድበዳቤ በጨረታ ተሸጠ | የመኪና ዋጋ በኢትዮጲያ | የዕለቱ ዋና ዋና ዜናዎች by Nuro Bezede ኑሮ በዘዴ 2 years ago 15 minutes 3,820 views",Nuro Bezede ኑሮ በዘዴ,3820,3821,1
7257,"የአዲስ አበባ ወጣቶች የፈፀሙት አስደናቂ ድርጊት | ሜቴክ ንብረቱን እየሸጠ መሆኑ እና የዕለቱ ዜናዎች by Nuro Bezede ኑሮ በዘዴ 2 years ago 15 minutes 4,967 views",Nuro Bezede ኑሮ በዘዴ,4967,4967,0
7258,"የኦነግና የኦዴፓ ያልተጠበቀው ስምምነት | የዶክተር አብይና ውሎ እና እነ በረከት በፍርድ ቤት | የዕለቱ ዜናዎች by Nuro Bezede ኑሮ በዘዴ 2 years ago 13 minutes, 10 seconds 1,996 views",Nuro Bezede ኑሮ በዘዴ,1996,1996,0
7259,"በክረምት ቤቶች መፍረስ የለባቸውም!! | የጋዜጠኛ እስክንድር ነጋ የዛሬው መግለጫ by Nuro Bezede ኑሮ በዘዴ 2 years ago 11 minutes, 26 seconds 1,957 views",Nuro Bezede ኑሮ በዘዴ,1957,1957,0
7260,"የደብረ ፂዮን አነጋጋሪ ድርጊት በአክሱም | ኦነግ በእኔ የሚተዳደር ወታደራዊ ሀይል የለም ማለቱና የዕለቱ አነጋጋሪ ዜናዎች by Nuro Bezede ኑሮ በዘዴ 2 years ago 15 minutes 2,535 views",Nuro Bezede ኑሮ በዘዴ,2535,2535,0
7261,"ኮለኔል መንግስቱ ሀ/ማርያም ከዙምባዌ የላኩት አስገራሚ ደብዳቤ እና ሃገራቸውን እንደሚናፍቁ መናገራቸው ተሰማ | የዕለቱ አጫጭር መረጃዎች by Nuro Bezede ኑሮ በዘዴ 2 years ago 12 minutes, 18 seconds 12,428 views",Nuro Bezede ኑሮ በዘዴ,12428,12428,0
7262,"ስለ ኮንዶሚኒየም የተሰማው ዜና | ደ/ብርሀን ምን ተፈጠረ? | የዕለቱ አነጋጋሪ ዜናዎች | Ethiopian Daily News by Nuro Bezede ኑሮ በዘዴ 2 years ago 14 minutes, 18 seconds 11,879 views",Nuro Bezede ኑሮ በዘዴ,11879,11879,0
7263,"ብዙዎችን ያስቆጣው የኢሳያስ አፈወርቂ የኤርትራው ንግግር “ለለውጥ አንቸኩልም” | የዕለቱ ዜናዎች by Nuro Bezede ኑሮ በዘዴ 2 years ago 12 minutes, 9 seconds 4,289 views",Nuro Bezede ኑሮ በዘዴ,4289,4289,0
7264,"ሰበር መረጃ - የኢሳቱ ጋዜጠኛ መሳይ መኮንን ኢሳት የግ7 ነው ስለሚባለው የሰጠው ምላሽ by Nuro Bezede ኑሮ በዘዴ 2 years ago 12 minutes, 34 seconds 2,935 views",Nuro Bezede ኑሮ በዘዴ,2935,2935,0
7265,"ታከለ ኡማ ማስጠንቀቂያ ሰጡ | የደብረ ብርሀኑ ሰላማዊ ሰልፍ | የዕለቱ አነጋጋሪ ዜናዎች | Ethiopian Daily News by Nuro Bezede ኑሮ በዘዴ 2 years ago 10 minutes, 24 seconds 3,293 views",Nuro Bezede ኑሮ በዘዴ,3293,3293,0
7266,"የእስክንድር ነጋ ባልደረባ በፖሊሶች ተደብድቦ መታሰሩ | ኢፍጣር በሚሊኒየም አዳራሽ | የዕለቱ ዜናዎች | Ethiopian Daily News by Nuro Bezede ኑሮ በዘዴ 2 years ago 14 minutes, 13 seconds 2,824 views",Nuro Bezede ኑሮ በዘዴ,2824,2824,0
7267,"የሰዓቱ መረጃ - ቁጣን የቀሰቀሰው በሳኡዲ የቤት ሰራተኛዋን ከዛፍ ጋር ያሰሯት አሰሪዎች | ታማኝ በየነ በጌዲዮ by Nuro Bezede ኑሮ በዘዴ 2 years ago 7 minutes, 36 seconds 8,462 views",Nuro Bezede ኑሮ በዘዴ,8462,8462,0
7268,"የ5 ሚሊዮን ብሩን እራት በነፃ የታደሙ እነማን ናቸው? | የዕለቱ አነጋጋሪ ዜናዎች | Ethiopian Daily News by Nuro Bezede ኑሮ በዘዴ 2 years ago 12 minutes, 3 seconds 26,078 views",Nuro Bezede ኑሮ በዘዴ,26078,26078,0
7269,"አስደንጋጩ የድሬዳዋ የአቧራ ማዕበል | ሀኪሙ የሚታገለው ለታካሚው ነው | የዕለቱ አነጋጋሪ ዜናዎች | Ethiopian Daily News by Nuro Bezede ኑሮ በዘዴ 2 years ago 14 minutes, 35 seconds 2,679 views",Nuro Bezede ኑሮ በዘዴ,2679,2679,0
7270,"የዛሬ ሰላማዊ ሰልፎች | ትራምፕ ስለ ስደተኞች የተናገሩት  | ታማኝ ከገዱ ምስጋና ተቀበለ | የዕለቱ አነጋጋሪ ዜናዎች | Ethiopian Daily News by Nuro Bezede ኑሮ በዘዴ 2 years ago 14 minutes, 33 seconds 11,671 views",Nuro Bezede ኑሮ በዘዴ,11671,11671,0
7271,"ስለ እነ ጌታቸው አሰፋ ዛሬ ፍርድ ቤቱ የተናገረው | 22 ዜጎቻችን በሰው ሀገር መታሰራቸውና የዕለቱ ዜናዎች | Ethiopian Daily News by Nuro Bezede ኑሮ በዘዴ 2 years ago 14 minutes, 40 seconds 5,990 views",Nuro Bezede ኑሮ በዘዴ,5990,5990,0
7272,"ታማኝ በየነ ቃሉን ፈፀመ | ከወደ ኤርትራ የተሰማው ዜና | እና የዕለቱ ዜናዎች | Ethiopian Daily News by Nuro Bezede ኑሮ በዘዴ 2 years ago 13 minutes, 17 seconds 13,885 views",Nuro Bezede ኑሮ በዘዴ,13885,13885,0
7273,"የታማኝ በየነ ድንቅ ንግግር ""እርዳታውን በብሄር ካሰብነው እንስሳ ነን"" ዛሬ በአዲስ አበባ ከተናገረው | Tamagne Beyene Amazing Speech by Nuro Bezede ኑሮ በዘዴ 2 years ago 23 minutes 2,400 views",Nuro Bezede ኑሮ በዘዴ,2400,2400,0
7274,"ታማኝ በየነ በአዲስ አበባ | በትግራይ ለጌታቸው አሰፋ ሰልፍ ተጠራ | የዕለቱ አነጋጋሪ ዜናዎች | Ethiopian Daily News by Nuro Bezede ኑሮ በዘዴ 2 years ago 11 minutes, 50 seconds 34,033 views",Nuro Bezede ኑሮ በዘዴ,34033,34033,0
7275,"የማህደር አሰፋ አነጋጋሪ ድርጊት | ደብረ ፂ በትግራይ ነዳጅ መኖሩን ይፋ አደረጉ | የዕለቱ አነጋጋሪ ዜናዎች by Nuro Bezede ኑሮ በዘዴ 2 years ago 12 minutes, 47 seconds 9,248 views",Nuro Bezede ኑሮ በዘዴ,9248,9248,0
7276,"ብዙዎችን ሲያነጋግር የቆየው የአርቲስት ፍቃዱ ተ/ማርያም ሀውልት በመጨረሻም ተመረቀ by Nuro Bezede ኑሮ በዘዴ 2 years ago 12 minutes, 3 seconds 9,165 views",Nuro Bezede ኑሮ በዘዴ,9165,9165,0
7277,"ቴዲ አፍሮ ታላቅ ምስጋናውን አቀረበ | የዶ/ር አብይ ውሎ | የዕለቱ አነጋጋሪ ዜናዎች | Ethiopian Daily News by Nuro Bezede ኑሮ በዘዴ 2 years ago 13 minutes, 18 seconds 15,934 views",Nuro Bezede ኑሮ በዘዴ,15934,15934,0
7278,"በባህርዳር ክርስቲያኖች በረመዳን ጾም አስደናቂ ድርጊት ፈፀሙ | አቶ በረከት የክህደት ቃላቸውን ሰጡ | የዕለቱ ዜናዎች by Nuro Bezede ኑሮ በዘዴ 2 years ago 14 minutes, 46 seconds 5,284 views",Nuro Bezede ኑሮ በዘዴ,5284,5284,0
7279,"የቴዲ አፍሮ አነጋጋሪ ድርጊት በእስራኤል | ስለ ጌታቸው አሰፋ እና የዕለቱ አነጋጋሪ ዜናዎች | Ethiopian Daily News by Nuro Bezede ኑሮ በዘዴ 2 years ago 11 minutes, 38 seconds 47,201 views",Nuro Bezede ኑሮ በዘዴ,47201,47201,0
7280,"አርቲስቶች ስለ ዶ/ር አብይ እራት ግብዣ ያስተላለፉት ድንቅ መልዕክት | የዕለቱ አነጋጋሪ ዜናዎች by Nuro Bezede ኑሮ በዘዴ 2 years ago 10 minutes, 52 seconds 13,009 views",Nuro Bezede ኑሮ በዘዴ,13009,13009,0
7281,"ሰበር ዜና -  በደህንነቱ ሰው ጌታቸው አሰፋ ላይ በከባድ ወንጀል ክስ ተመሰረተ by Nuro Bezede ኑሮ በዘዴ 2 years ago 13 minutes, 44 seconds 4,872 views",Nuro Bezede ኑሮ በዘዴ,4872,4872,0
7282,"የናዝራዊት ጓደኛ እንደታመመች ቤተሰቦቿ ተናገሩ | ዶክተሮችን ያስደሰተው የዶ/ር አብይ ውሳኔ | የዕለቱ ዜናዎች by Nuro Bezede ኑሮ በዘዴ 2 years ago 12 minutes, 23 seconds 8,856 views",Nuro Bezede ኑሮ በዘዴ,8856,8856,0
7283,"ጥብቅ መረጃ - የግጭቶቹ ጂኒ በተመስገን ደሳለኝ | Temesgen Desalegn | OLF | TPLF by Nuro Bezede ኑሮ በዘዴ 2 years ago 21 minutes 3,824 views",Nuro Bezede ኑሮ በዘዴ,3824,3825,1
7284,"በአሜሪካን 2 ኢትዮጲያዊያንን በመግደል የተጠረጠረው ተላልፎ ተሰጠ | አማራና ቅማንት | እና የዕለቱ ዜናዎች by Nuro Bezede ኑሮ በዘዴ 2 years ago 12 minutes, 21 seconds 10,179 views",Nuro Bezede ኑሮ በዘዴ,10179,10179,0
7285,"በቀስት ሰውን ሲገሉ የነበሩት እየተያዙ ነው | የዶ/ር አብይ ሽልማት | የደብረ ፂ ንግግር | እና የዕለቱ አነጋጋሪ ዜናዎች by Nuro Bezede ኑሮ በዘዴ 2 years ago 11 minutes, 41 seconds 27,746 views",Nuro Bezede ኑሮ በዘዴ,27746,27747,1
7286,"ሰበር መረጃ - የአማራ ወጣቶች በዛሬው ሰልፍ ለዶ/ር አብይ መንግስት ያስተላለፉት ጥብቅ መልዕክት by Nuro Bezede ኑሮ በዘዴ 2 years ago 11 minutes, 24 seconds 70,761 views",Nuro Bezede ኑሮ በዘዴ,70761,70763,2
7287,"የዕለቱ ዜናዎች - ብዙዎችን ያስቆጣው የአውሮፕላን አምራቹ ቦይንግ መግለጫ | የታከለ ኡማ ቢሮ የኮንዶሚኒየሙ እገዳ እንዲነሳ ጠየቀ by Nuro Bezede ኑሮ በዘዴ 2 years ago 11 minutes, 13 seconds 2,966 views",Nuro Bezede ኑሮ በዘዴ,2966,2966,0
7288,"የዕለቱ አስደሳች መረጃ - በመጨረሻም የዶ/ር አብይ ንግግር ለናዝራዊት ቤተሰቦች እፎይታን የሚሰጥ ሆኗል by Nuro Bezede ኑሮ በዘዴ 2 years ago 12 minutes, 35 seconds 32,467 views",Nuro Bezede ኑሮ በዘዴ,32467,32467,0
7289,"የምክትሉ ደመቀና የጀነራል ሰዓረ ውይይት | የዛሬው ቤኒሻንጉል ውሎ | እና የዕለቱ ዜናዎች | Ethiopian Daily News by Nuro Bezede ኑሮ በዘዴ 2 years ago 10 minutes, 14 seconds 2,895 views",Nuro Bezede ኑሮ በዘዴ,2895,2895,0
7290,"አርቲስቶቹን የፈተነውና ለአቅመ ደካሞች ያደረጉት እልህ አስጨራሹ የቤት መስራት ውድድር በፋሲካ በአል |  Fasika 2011 Special Show by Nuro Bezede ኑሮ በዘዴ 2 years ago 45 minutes 87,014 views",Nuro Bezede ኑሮ በዘዴ,87014,87015,1
7291,"የፋሲካ በዓል ዘመድ ጥየቃ ልዩ ዝግጅት በአርቲስት ንብረት ገላው | Fasika 2011 Special Show by Nuro Bezede ኑሮ በዘዴ 2 years ago 10 minutes, 19 seconds 44,723 views",Nuro Bezede ኑሮ በዘዴ,44723,44724,1
7292,"“ይቅርታ በፋሲካ” በፋሲካ የበዓል ሰርፕራይዝ ከተደረገው ወጣት ጋር by Nuro Bezede ኑሮ በዘዴ 2 years ago 15 minutes 77,982 views",Nuro Bezede ኑሮ በዘዴ,77982,77983,1
7293,"የዶ/ር አብይ ውሎ በቻይና | ፍትህ ፈላዎቹ የመአዛ ካሳ ቤተሰቦች | የዕለቱ አንኳር ዜናዎች | Ethiopian Daily News by Nuro Bezede ኑሮ በዘዴ 2 years ago 12 minutes, 57 seconds 7,108 views",Nuro Bezede ኑሮ በዘዴ,7108,7108,0
7294,"ከአትሌት ሀይሌ ገ/ስላሴና ሞፋራህ የቃላት ጦርነት ጀርባ ያሉ እውነታዎች | Mohamed Farah and Haile Gebrselassie by Nuro Bezede ኑሮ በዘዴ 2 years ago 11 minutes, 44 seconds 6,064 views",Nuro Bezede ኑሮ በዘዴ,6064,6064,0
7295,"የበረከት ስምዖን ባለቤት ከአብይ ጋር ያወሩትንና ስለ በረከት የእስር ቤት ህይወት ተናገረች | የዕለቱ ዜናዎች by Nuro Bezede ኑሮ በዘዴ 2 years ago 15 minutes 19,351 views",Nuro Bezede ኑሮ በዘዴ,19351,19354,3
7296,"በአዲስ አበባ ከፍተኛ ጥበቃ ከሚደረግለት እስር ቤት እስረኞች ማምለጣቸው ተሰማ | እና የዕለቱ አነጋጋሪ ዜናዎች by Nuro Bezede ኑሮ በዘዴ 2 years ago 14 minutes, 27 seconds 12,769 views",Nuro Bezede ኑሮ በዘዴ,12769,12770,1
7297,"ለ8 አመት በኳታር በህክምና ላይ የነበረችው ሜሮን ዛሬ እንደምትመለስ ተሰማ | እና የዕለቱ አነጋጋሪ ዜናዎች by Nuro Bezede ኑሮ በዘዴ 2 years ago 14 minutes, 35 seconds 4,051 views",Nuro Bezede ኑሮ በዘዴ,4051,4051,0
7298,"በቀይ ባህር ስለ ሞቱት 71 ኢትዮጲያዊያን የተሰማው | የዶላር እጥረት አሳሳቢ ሁኔታ በዝርዝር እና የዕለቱ ዜናዎች by Nuro Bezede ኑሮ በዘዴ 2 years ago 16 minutes 6,838 views",Nuro Bezede ኑሮ በዘዴ,6838,6838,0
7299,"የብዙዎችን ልብ የነካው የድምፃዊ አስጌ ዴንዳሾ ስለ ጌዴዎ ህዝብ ያቀረበው ግጥም | Asgegnew Ashko (Asge) Poem by Nuro Bezede ኑሮ በዘዴ 2 years ago 15 minutes 32,911 views",Nuro Bezede ኑሮ በዘዴ,32911,32917,6
7300,"በመቀሌ የአብይን ጥሪ የተቀበሉ ታሰሩ | የኦነግ ወታደሮች እንዴት በምግብ እንዴት ተመረዙ? እና የዕለቱ አነጋጋሪ ዜናዎች by Nuro Bezede ኑሮ በዘዴ 2 years ago 16 minutes 5,469 views",Nuro Bezede ኑሮ በዘዴ,5469,5469,0
7301,"አወዛጋቢው የኢቫንካ ትራምፕ የኢትዮጲያ ቆይታ | Ivanka Trump In Ethiopia | Dr Abiy by Nuro Bezede ኑሮ በዘዴ 2 years ago 16 minutes 63,933 views",Nuro Bezede ኑሮ በዘዴ,63933,63934,1
7302,"ሰበር መረጃ - ዛሬ በተያዙት 61 ባለ ስልጣናት ዙሪያ የአቃቤ ህጉ መግለጫ by Nuro Bezede ኑሮ በዘዴ 2 years ago 29 minutes 6,347 views",Nuro Bezede ኑሮ በዘዴ,6347,6347,0
7303,"የሰሜን ተራራን እሳት ለማጥፋት መልካም ዜና ተሰማ | የጌታቸው አሰፋን ሚስጥር ያወጣው አሜሪካዊ መታሰሩና የዕለቱ ዜናዎች by Nuro Bezede ኑሮ በዘዴ 2 years ago 11 minutes, 1 second 54,615 views",Nuro Bezede ኑሮ በዘዴ,54615,54615,0
7304,"አርቲስት ደሳለኝ በጌዴዎ ዞን ተገኝቶ ያየውን ከፍተኛ ችግር እያለቀሰ ተናገረ by Nuro Bezede ኑሮ በዘዴ 2 years ago 18 minutes 17,499 views",Nuro Bezede ኑሮ በዘዴ,17499,17499,0
7305,"“ለውጥማ አለ!” ተወዳጁ አርቲስት ደበበ እሸቱ በወቅታዊ የሀገራችን ሁኔታ ላይ ያቀረበው ድንቅ ንግግር by Nuro Bezede ኑሮ በዘዴ 2 years ago 10 minutes, 21 seconds 2,454 views",Nuro Bezede ኑሮ በዘዴ,2454,2454,0
7306,"መንግስት ብሄርተኞችን ካላፀዳ መንገጫገጩ ይቀጥላል | የኢሳቱ ጋዜጠኛ ሲሳይ አጌና ድንቅ ንግግር by Nuro Bezede ኑሮ በዘዴ 2 years ago 16 minutes 6,729 views",Nuro Bezede ኑሮ በዘዴ,6729,6729,0
7307,"ታማኝ በየነ ለአብይ መንግስት የላከው መልዕክት | የእስክንድርና የታከለ ውይይት | የዕለቱ ዜናዎች | Ethiopian Daily News by Nuro Bezede ኑሮ በዘዴ 2 years ago 12 minutes, 29 seconds 7,722 views",Nuro Bezede ኑሮ በዘዴ,7722,7722,0
7308,"የልማት ባንክ የአደባባይ ገመና ሲገለጥ | Bank of Ethiopia Analysis | Tarikua Getachew by Nuro Bezede ኑሮ በዘዴ 2 years ago 12 minutes, 56 seconds 4,472 views",Nuro Bezede ኑሮ በዘዴ,4472,4472,0
7309,"ስለ ናዝራዊት የተሰማው መልካም ዜና | ቦይን ይቅርታ መጠየቁና የዕለቱ ዜናዎች | Ethiopian Daily News by Nuro Bezede ኑሮ በዘዴ 2 years ago 10 minutes, 24 seconds 28,250 views",Nuro Bezede ኑሮ በዘዴ,28250,28252,2
7310,"የዕለቱ ዜናዎች - የኮንዶሚኒየም ነገር | አየር መንገዱን ይፋ ያደረገው መረጃና ከወደ ኬኒያ ደሞ ሊከሰስ መሆኑ | Ethiopian Daily News by Nuro Bezede ኑሮ በዘዴ 2 years ago 11 minutes, 55 seconds 8,143 views",Nuro Bezede ኑሮ በዘዴ,8143,8143,0
7311,"ጋዜጠኞች ለእስክንድር ነጋ ያቀረቧቸው ጥያቄዎችና የሰጠው ምላሽ by Nuro Bezede ኑሮ በዘዴ 2 years ago 20 minutes 3,599 views",Nuro Bezede ኑሮ በዘዴ,3599,3599,0
7312,"የዕለቱ ዜናዎች - ለግ7 የተላከው ማስጠንቀቂያ | ለማ መገርሳ ጀነራሉን ከስልጣናቸው አነሷቸው | Ethiopian Daily News by Nuro Bezede ኑሮ በዘዴ 2 years ago 15 minutes 12,222 views",Nuro Bezede ኑሮ በዘዴ,12222,12222,0
7313,"እስክንድር ነጋ ልዩ ጥቅም ለሚል ፓርቲ የአዲስ አበባ ህዝብ ድምፅ እንዳይሰጥ ሲል አሳሰበ by Nuro Bezede ኑሮ በዘዴ 2 years ago 10 minutes, 59 seconds 1,976 views",Nuro Bezede ኑሮ በዘዴ,1976,1976,0
7314,"ዶ/ር አብይ “ወደ ጦርነት እንገባለን” ሲሉ ለተናገሩት ባለ አደራ ምክር ቤት ምላሹን ሰጠ by Nuro Bezede ኑሮ በዘዴ 2 years ago 10 minutes, 42 seconds 8,281 views",Nuro Bezede ኑሮ በዘዴ,8281,8282,1
7315,"እስክንድር ነጋ መግለጫውን እንዳይሰጥ የከለከለው ማን እንደሆነ ሲጠየቅ የሰጠው ምላሽ by Nuro Bezede ኑሮ በዘዴ 2 years ago 19 minutes 3,974 views",Nuro Bezede ኑሮ በዘዴ,3974,3974,0
7316,"ከአዲስ አበባ ባለ አደራ ምክር ቤት የተሰጠ መግለጫ by Nuro Bezede ኑሮ በዘዴ 2 years ago 19 minutes 10,559 views",Nuro Bezede ኑሮ በዘዴ,10559,10565,6
7317,"አትሌት ደራርቱ በድል ለተመለሱት አትሌቶች የተደረገ አቀባበል ላይ ያደረገችው ንግግር by Nuro Bezede ኑሮ በዘዴ 2 years ago 12 minutes, 53 seconds 5,810 views",Nuro Bezede ኑሮ በዘዴ,5810,5814,4
7318,"ኢትዮጲያን በ 5 ወርቅ በውድድሩ ከዓለም 1ኛ ላደረጓት ጀግና አትሌቶች የተደረገ አቀባበል by Nuro Bezede ኑሮ በዘዴ 2 years ago 16 minutes 4,328 views",Nuro Bezede ኑሮ በዘዴ,4328,4328,0
7319,"ህፃን ሳዶርና ዘመን ድራማ ተዋናዮች ለኦቲዝም ተጠቂዎች ቀለም ሲቀቡላቸው by Nuro Bezede ኑሮ በዘዴ 2 years ago 11 minutes, 10 seconds 74,850 views",Nuro Bezede ኑሮ በዘዴ,74850,74853,3
7320,"ኢትዮጲያን በአለም ላይ ለማስጠራት የሚሰሩት ብሩህ አእምሮ ያላቸው ህፃናት ላይ የተሰጠ መግለጫ by Nuro Bezede ኑሮ በዘዴ 2 years ago 27 minutes 2,658 views",Nuro Bezede ኑሮ በዘዴ,2658,2658,0
7321,"የዕለቱ ዜናዎች | ዶ/ር አብይ ከናዝራዊት ቤተሰቦች ጋር አወሩ | ዶ/ር ብርሀኑ ነጋ የእስክንድርን ሀሳብ ተቃወሙ | Ethiopian Daily News by Nuro Bezede ኑሮ በዘዴ 2 years ago 11 minutes, 52 seconds 17,784 views",Nuro Bezede ኑሮ በዘዴ,17784,17784,0
7322,"ልዩ ቃለ ምልልስ - ከተወዳጇ ተዋናይት ፍቅርተ (ማሚ) እና ከአመቱ ምርጥ ተዋናይት አሸናፊ ሶንያ ጋር | Exclusive Interview by Nuro Bezede ኑሮ በዘዴ 2 years ago 14 minutes, 45 seconds 22,149 views",Nuro Bezede ኑሮ በዘዴ,22149,22149,0
7323,"ከተወዳጆቹ ተዋንያን ግሩም ኤርሚያስና አሌክስ ጋር የተደረገ ልዩ ቃለ ምልልስ | Exclusive Interview with Girum Ermias and Alex by Nuro Bezede ኑሮ በዘዴ 2 years ago 11 minutes, 17 seconds 25,507 views",Nuro Bezede ኑሮ በዘዴ,25507,25515,8
7324,"ተወዳጇ ተዋናይት ህፃን ማክቤል ሄኖክ በሞኙ የአራዳ ልጅ ፊልም አሸናፊ ሆነች by Nuro Bezede ኑሮ በዘዴ 2 years ago 10 minutes, 19 seconds 261,558 views",Nuro Bezede ኑሮ በዘዴ,261558,261571,13
7325,"በጉማ ሽልማት የአመቱ ምርጥ የፊልም ሙዚቃን እነ አህመድ ተሾመ (ዲንቢ) ሽልማቱን ሲቀበሉ by Nuro Bezede ኑሮ በዘዴ 2 years ago 11 minutes, 57 seconds 60,065 views",Nuro Bezede ኑሮ በዘዴ,60065,60074,9
7326,"በጉማ ሽልማት የአመቱ ምርጥ ወንድና ሴት ተዋናይ ዘርፍ አሸናፊዎች ይፋ ሲደረጉ by Nuro Bezede ኑሮ በዘዴ 2 years ago 14 minutes, 8 seconds 74,478 views",Nuro Bezede ኑሮ በዘዴ,74478,74479,1
7327,"ተዋናይ ካሳሁን ፍስሀ ማንዴላ የአመቱ ምርጥ ረዳት ተዋናይ ሽልማት ሲቀበል by Nuro Bezede ኑሮ በዘዴ 2 years ago 11 minutes, 51 seconds 138,929 views",Nuro Bezede ኑሮ በዘዴ,138929,139001,72
7328,"ቴዲ አፍሮ የተገኘበት ከ150 አመት በኋላ የተመለሰው የአፄ ቴዎድሮስ ቁንድላ አቀባበል ላይ የተላለፈ መልዕክት by Nuro Bezede ኑሮ በዘዴ 2 years ago 11 minutes, 37 seconds 56,653 views",Nuro Bezede ኑሮ በዘዴ,56653,56656,3
7329,"ተወዳጁ ቴዲ አፍሮ የተገኘበት የአፄ ቴዎድሮስ ፀጉር (ቁንድላ) የአቀባበል ዝግጅት በብሄራዊ ሙዚየም by Nuro Bezede ኑሮ በዘዴ 2 years ago 10 minutes, 33 seconds 79,417 views",Nuro Bezede ኑሮ በዘዴ,79417,79417,0
7330,"ሁሉም ኢትዮጲያዊ ሊመለከተው የሚገባ መልዕክት ከዲ/ን ዳንኤል ክብረት by Nuro Bezede ኑሮ በዘዴ 2 years ago 24 minutes 1,891 views",Nuro Bezede ኑሮ በዘዴ,1891,1891,0
7331,"[መታየት ያለበት] ዲ/ን ዳንኤል ክብረት ወቅታዊ የሀገራችን ችግሮች ብሎ ያነሳቸው ወሳኝ ምክሮች by Nuro Bezede ኑሮ በዘዴ 2 years ago 14 minutes, 58 seconds 7,846 views",Nuro Bezede ኑሮ በዘዴ,7846,7848,2
7332,"አውሮፕላኑ የተከሰከሰ እለት ተመሳሳዩ ውስጥ ነበርን ፕሌኑ መሬት ደርሶ ነው የተመለሰው ያሬድ ሹመቴ ተናገረ by Nuro Bezede ኑሮ በዘዴ 2 years ago 11 minutes, 37 seconds 30,272 views",Nuro Bezede ኑሮ በዘዴ,30272,30273,1
7333,"የዕለቱ ዜናዎች | ንግድ ባንክ 20 ሚሊዮን ድጋፍ አደረገ ስለተባለው እውነታው | ስለ ሜድሮክ ወርቅ የተሰማው | Ethiopian Daily News by Nuro Bezede ኑሮ በዘዴ 2 years ago 11 minutes, 1 second 2,788 views",Nuro Bezede ኑሮ በዘዴ,2788,2790,2
7334,"የዕለቱ ዜናዎች | በምዕራብ ወለጋ የተፈጠረው | ዶ/ር አብይ ስለ ፌስቡክ አክቲቪስቶች | አብን ጠየቀ | Ethiopian Daily News by Nuro Bezede ኑሮ በዘዴ 2 years ago 15 minutes 6,043 views",Nuro Bezede ኑሮ በዘዴ,6043,6043,0
7335,"ልጄ ሳትስመኝ መሄዷ ይቆጨኛል | የሆስተስ አያንቱ እናት ስለ ልጃቸው ሲናገሩ by Nuro Bezede ኑሮ በዘዴ 2 years ago 10 minutes, 33 seconds 121,024 views",Nuro Bezede ኑሮ በዘዴ,121024,121025,1
7336,"ቢሉኝ ሸገር ቢሉኝ ፊንፊኔ ፣ በረራ ስሜ ቢበዛ አንድ ነኝ እኔ | ተወዳጁ ገጣሚ በላይ በቀለ ወያ by Nuro Bezede ኑሮ በዘዴ 2 years ago 12 minutes, 7 seconds 76,077 views",Nuro Bezede ኑሮ በዘዴ,76077,76153,76
7337,"የመጋቢ ሀዲስ ንግግር | ጌታ ሆይ 107ቱ ፓርቲዎች 7 እንዲሆኑ እርዳን ወይ እንዲፈርሱ እርዳን by Nuro Bezede ኑሮ በዘዴ 2 years ago 10 minutes, 36 seconds 40,644 views",Nuro Bezede ኑሮ በዘዴ,40644,40647,3
7338,"Ethiopia - ""ሙያተኛ ሀገሬ"" የተወዳጇ ገጣሚ ህሊና ደሳለኝ ህዝቡን ያስደመመችበት ድንቅ ግጥም by Nuro Bezede ኑሮ በዘዴ 2 years ago 10 minutes, 52 seconds 31,166 views",Nuro Bezede ኑሮ በዘዴ,31166,31215,49
7339,"የዕለቱ ዜናዎች | በአውሮፕላን አደጋው ቦታ ሰዎች ከሟቾች ላይ ዘረፉ ስለተባለው እውነታው ይፋ ሆነ | Ethiopian Daily News by Nuro Bezede ኑሮ በዘዴ 2 years ago 12 minutes 20,054 views",Nuro Bezede ኑሮ በዘዴ,20054,20054,0
7340,"[ልብ የሚነካ ቪዲዮ] በአውሮፕላን አደጋው ህይወታቸውን ላጡ ወገኖች የተደረገ የቀብር ስነ ስርዓት by Nuro Bezede ኑሮ በዘዴ 2 years ago 16 minutes 22,623 views",Nuro Bezede ኑሮ በዘዴ,22623,22624,1
7341,"በአውሮፕላን አደጋው ለሞቱት የቀብር ስነ-ስርዓት ተፈፀመ by Nuro Bezede ኑሮ በዘዴ 2 years ago 15 minutes 112,963 views",Nuro Bezede ኑሮ በዘዴ,112963,112966,3
7342,"አብይና ትራምፕ ዛሬ በፕሌኑ ዙሪያ ተነጋገሩ | የሻሸመኔዎቹ ተፈረደባቸው እና ሌሎችም የዕለቱ ዜናዎች | Ethiopian Daily News by Nuro Bezede ኑሮ በዘዴ 2 years ago 13 minutes, 46 seconds 8,973 views",Nuro Bezede ኑሮ በዘዴ,8973,8973,0
7343,"የዕለቱ ዜናዎች | ሱሉልታን እንደ ለገጣፎ | በተከሰከሰው አውሮፕላን ዙሪያ በዛሬው እለት የተሰሙ ተጨማሪ መረጃዎች by Nuro Bezede ኑሮ በዘዴ 2 years ago 13 minutes, 43 seconds 10,530 views",Nuro Bezede ኑሮ በዘዴ,10530,10530,0
7344,"የዕለቱ ዜናዎች | የፓይለቱ ጓደኛ የተናገረው | ዶ/ር አብይ በላሊበላ | እና የዕለቱ በርካታ መረጃዎች | Ethiopian Daily News by Nuro Bezede ኑሮ በዘዴ 2 years ago 15 minutes 105,732 views",Nuro Bezede ኑሮ በዘዴ,105732,105732,0
7345,"በበረራው የሞቱ ግለሰቦች ማንነት ይፋ እየተደረገ ነው | በዛሬው እለት ከቦታው የተሰሙ አዳዲስ መረጃዎች by Nuro Bezede ኑሮ በዘዴ 2 years ago 11 minutes, 27 seconds 460,398 views",Nuro Bezede ኑሮ በዘዴ,460398,460414,16
7346,"በአዲስ አበባ ጉዳይ ድርድር የለንም ጋዜጠኛ እስክንድር ነጋ ከአዲስ አበባ ወጣቶች ጋር ባደረገው ውይይት by Nuro Bezede ኑሮ በዘዴ 2 years ago 15 minutes 31,402 views",Nuro Bezede ኑሮ በዘዴ,31402,31515,113
7347,"ጋዜጠኛ እስክንድር የአዲስ አበባን ጉዳይ አስመልክቶ ያወጣው የአቋም መግለጫ by Nuro Bezede ኑሮ በዘዴ 2 years ago 10 minutes, 28 seconds 5,229 views",Nuro Bezede ኑሮ በዘዴ,5229,5231,2
7348,"ስለተከሰከሰው አውሮፕላን ከቦታው እየወጡ ያሉ አዳዲስ መረጃዎች | Ethiopian Airlines ET302 Fatal Crash by Nuro Bezede ኑሮ በዘዴ 2 years ago 10 minutes, 3 seconds 164,810 views",Nuro Bezede ኑሮ በዘዴ,164810,164811,1
7349,"የአዲስ አበባ ወጣቶች ለዘር ፖለቲከኞች ያስተላለፉት ድንቅ መልዕክት by Nuro Bezede ኑሮ በዘዴ 2 years ago 15 minutes 65,331 views",Nuro Bezede ኑሮ በዘዴ,65331,65434,103
7350,"ቢመችሽም ባይመችሽም ሸገር ታከለ ኡማ አይሆንልሽም የአዲስ አበባ ወጣቶች by Nuro Bezede ኑሮ በዘዴ 2 years ago 10 minutes, 28 seconds 507,499 views",Nuro Bezede ኑሮ በዘዴ,507499,526327,18828
7351,"በተከሰከሰው የአውሮፕላን አደጋ ሁሉም ተሳፋሪዎች ህይወታቸው ማለፉ ታወቀ | ተጨማሪ ሰበር ዜና by Nuro Bezede ኑሮ በዘዴ 2 years ago 10 minutes, 20 seconds 74,191 views",Nuro Bezede ኑሮ በዘዴ,74191,74217,26
7352,"ተወዳጇ አርቲስት ሀረገ ወይን አሰፋ ስለ እንጀራ ክብነት ያቀረበችው አዝናኝ ወግ by Nuro Bezede ኑሮ በዘዴ 2 years ago 14 minutes, 15 seconds 2,376 views",Nuro Bezede ኑሮ በዘዴ,2376,2379,3
7353,"ልዩ ትንታኔ - የዶ/ር አብይ አስተዳደርና....... የእሽሩሩ ፖለቲካ | Dr Abiy | ODP | OLF Special Analysis by Nuro Bezede ኑሮ በዘዴ 2 years ago 15 minutes 22,819 views",Nuro Bezede ኑሮ በዘዴ,22819,22824,5
7354,"የዕለቱ ዜናዎች | ዶ/ር አብይ በገዱ ሽኝት ላይ | የነጃዋር ተቃውሞ ዛሬ | እስክንድር ነጋ | Ethiopian Daily News by Nuro Bezede ኑሮ በዘዴ 2 years ago 20 minutes 5,987 views",Nuro Bezede ኑሮ በዘዴ,5987,5987,0
7355,"የመጋቢ ሀዲስ እሸቱ አለማየሁ አስቂኝ አስተማሪ ንግግር | ከሮጡ አጨብጫቢ አይጠፋም | by Nuro Bezede ኑሮ በዘዴ 2 years ago 15 minutes 15,290 views",Nuro Bezede ኑሮ በዘዴ,15290,15299,9
7356,"የዕለቱ ዜናዎች | በኦሮሚያ በኮንዶሚኒየም ይገባኛል ስለተነሳው ከፍተኛ ተቃውሞ | እና ሌሎችም | Ethiopian Daily News by Nuro Bezede ኑሮ በዘዴ 2 years ago 13 minutes, 46 seconds 88,882 views",Nuro Bezede ኑሮ በዘዴ,88882,88882,0
7357,"የዕለቱ ዜናዎች | ለ20 አመታት በቤተ መንግስት በድብቅ ሲመዘበር የነበረው ሲጋለጥ | ዶ/ር አብይ የሱዳኑን ጉብኝት ለምን ሰረዙ? | Ethiopian News by Nuro Bezede ኑሮ በዘዴ 2 years ago 13 minutes, 24 seconds 9,403 views",Nuro Bezede ኑሮ በዘዴ,9403,9403,0
7358,"አስደሳች ዜና ኮንዶሚኒየም ቤት ዕጣ ዕረቡ ሊወጣ ነው | ዝርዝር መረጃዎች | የዕለቱ አንኳር ዜናዎች | Ethiopian Daily News by Nuro Bezede ኑሮ በዘዴ 2 years ago 13 minutes, 18 seconds 20,371 views",Nuro Bezede ኑሮ በዘዴ,20371,20382,11
7359,"“ውብ ሀገሬ ባንቺ እኮነው መከበሬ” የአዲስ አበባ ወጣቶች ዛሬ | Adwa by Nuro Bezede ኑሮ በዘዴ 3 years ago 15 minutes 29,572 views",Nuro Bezede ኑሮ በዘዴ,29572,29576,4
7360,"ኢንጂነር ታከለ ኡማ ሚሊኒክ አደባባይ ላይ አበባ ሲያስቀምጥና ሲዘምርና የሚያሳይ | Adwa by Nuro Bezede ኑሮ በዘዴ 3 years ago 11 minutes, 7 seconds 8,485 views",Nuro Bezede ኑሮ በዘዴ,8485,8484,-1
7361,"የአዲስ አበባ ወጣቶች አስገራሚ ትዕይንት በሚኒሊክ አደባባይ by Nuro Bezede ኑሮ በዘዴ 3 years ago 10 minutes, 31 seconds 7,886 views",Nuro Bezede ኑሮ በዘዴ,7886,7886,0
7362,"“ብሄር የሌለው የሸገር ልጅ ብቻ ነው” የአዲስ አበባ ወጣቶች ዛሬ በሚኒሊክ አደባባይ by Nuro Bezede ኑሮ በዘዴ 3 years ago 10 minutes, 48 seconds 165,415 views",Nuro Bezede ኑሮ በዘዴ,165415,165462,47
7363,"በዓድዋ ድል በዓል ላይ የታዩ አስገራሚ ሽለላዎች አዲስ አበባ ሚኒሊክ አደባባይ | Adwa by Nuro Bezede ኑሮ በዘዴ 3 years ago 10 minutes, 23 seconds 27,365 views",Nuro Bezede ኑሮ በዘዴ,27365,27396,31
7364,"የዕለቱ ዜናዎች | ዶ/ር አብይ ለአድዋ ያስተላለፉት መልዕክት | አወዛጋቢው የለማ ንግግር ምላሽ ተሰጠበት | Ethiopian Daily News by Nuro Bezede ኑሮ በዘዴ 3 years ago 18 minutes 11,150 views",Nuro Bezede ኑሮ በዘዴ,11150,11152,2
7365,"የዕለቱ ዜናዎች | ከእስር ቤት ያመለጡት እስረኞች | ወልቃይት ለትግራይ መንግስት ማስጠንቀቂያ መላኩ | Ethiopian Daily News by Nuro Bezede ኑሮ በዘዴ 3 years ago 12 minutes, 33 seconds 28,288 views",Nuro Bezede ኑሮ በዘዴ,28288,28288,0
7366,"የ5 ሚሊዮን ብር እራት ከዶ/ር ዐብይ ጋር | የትግራይ ክልል ተቃውሞ | እና  የዕለቱ አነጋጋሪ ዜናዎች | Ethiopian Daily News by Nuro Bezede ኑሮ በዘዴ 3 years ago 12 minutes, 36 seconds 18,419 views",Nuro Bezede ኑሮ በዘዴ,18419,18419,0
7367,"የተወዳጇን እጅጋየሁ ሽባባው (ጂጂ) ሙዚቃ ድንቅ አድርጋ የተጫወተችው ብላቴና by Nuro Bezede ኑሮ በዘዴ 3 years ago 14 minutes, 38 seconds 15,256 views",Nuro Bezede ኑሮ በዘዴ,15256,15261,5
7368,"“ዋ ያቺ አድዋ” ተወዳጁ ተዋናይ አለማየሁ ታደሰ ስለ አድዋ ድል የተቀኘው by Nuro Bezede ኑሮ በዘዴ 3 years ago 15 minutes 2,765 views",Nuro Bezede ኑሮ በዘዴ,2765,2772,7
7369,"ዛሬ ህወሀትን ስለ ለቀቁት ባለስልጣናት | እና የዕለቱ አነጋጋሪ ዜናዎች | Ethiopian Daily News by Nuro Bezede ኑሮ በዘዴ 3 years ago 13 minutes, 5 seconds 45,992 views",Nuro Bezede ኑሮ በዘዴ,45992,45992,0
7370,"የዶ/ር አብይ የ5 ሚሊዮን ብር እራት | ለበረከት ጥያቄ የፍርድ ቤቱ ውሳኔ | እና የእለቱ ዜናዎች | Ethiopian Daily News by Nuro Bezede ኑሮ በዘዴ 3 years ago 13 minutes, 41 seconds 12,526 views",Nuro Bezede ኑሮ በዘዴ,12526,12526,0
7371,"የለገጣፎ ነዋሪዎች ጩኸት በተፈናቀሉ ህፃናትና እናቶች አንደበት by Nuro Bezede ኑሮ በዘዴ 3 years ago 10 minutes, 50 seconds 36,057 views",Nuro Bezede ኑሮ በዘዴ,36057,36057,0
7372,"የሀዋሳው ህዝባዊ ሰልፍ | የለገጣፎ ጩኸት እና የዕለቱ አንኳር ዜናዎች | Ethiopian Daily News by Nuro Bezede ኑሮ በዘዴ 3 years ago 13 minutes, 34 seconds 24,531 views",Nuro Bezede ኑሮ በዘዴ,24531,24531,0
7373,"የዲጂታል ወያኔ ሴራ | ዛሬ ለገጣፎ | እና የዕለቱ አነጋጋሪ ዜናዎች | Ethiopian Daily News by Nuro Bezede ኑሮ በዘዴ 3 years ago 22 minutes 25,858 views",Nuro Bezede ኑሮ በዘዴ,25858,25858,0
7374,"አነጋጋሪው የኦዴፓ መግለጫ | የለገጣፎ አሳዛኝ ድርጊት | እና የዕለቱ አነጋጋሪ ዜናዎች | Ethiopian Daily News by Nuro Bezede ኑሮ በዘዴ 3 years ago 10 minutes, 5 seconds 27,834 views",Nuro Bezede ኑሮ በዘዴ,27834,27834,0
7375,"""እንደሚባለው ኢሳያስ አፈወርቂ ፀረ ኢትዮጲያ ሆነው አላገኘኋቸውም"" ተወዳጁ ጋዜጠኛ መሳይ መኮንን by Nuro Bezede ኑሮ በዘዴ 3 years ago 17 minutes 49,663 views",Nuro Bezede ኑሮ በዘዴ,49663,49665,2
7376,"ተወዳጁ ጋዜጠኛ አለምነህ ዋሴ ያቀረበው አዝናኝ ግጥም | Journalist Alemneh Wasse Amazing poem by Nuro Bezede ኑሮ በዘዴ 3 years ago 11 minutes, 14 seconds 7,225 views",Nuro Bezede ኑሮ በዘዴ,7225,7334,109
7377,"በኢትዮጲያ ሀገራችን ሙዚቃ በሚሊኒየም አዳራሽ ህዝቡ በስሜት ሲጨፍር by Nuro Bezede ኑሮ በዘዴ 3 years ago 12 minutes, 22 seconds 35,092 views",Nuro Bezede ኑሮ በዘዴ,35092,35093,1
7378,"ጋዜጠኛ ደረጄ ሀብተወልድ በኢሳት ቀን መድረክ ላይ ስለ ኢህአዴግ ፓርላማ የቀለደው | Dereje Habtewold by Nuro Bezede ኑሮ በዘዴ 3 years ago 11 minutes, 38 seconds 17,144 views",Nuro Bezede ኑሮ በዘዴ,17144,17153,9
7379,"ከአመታት በኋላ መላኩ ቢረዳ በኢሳት ቀን በቀጥታ ያቀረበው ሙዚቃ by Nuro Bezede ኑሮ በዘዴ 3 years ago 21 minutes 34,323 views",Nuro Bezede ኑሮ በዘዴ,34323,34328,5
7380,"መሳይ መኮንንና አፈወርቅ በሚሊኒየም አዳራሽ ያደረጉት ድንቅ ንግግር | Mesay Mekonnen by Nuro Bezede ኑሮ በዘዴ 3 years ago 12 minutes, 29 seconds 8,044 views",Nuro Bezede ኑሮ በዘዴ,8044,8052,8
7381,"እነ መሳይ መኮንን በጌትሽ ማሞ ሙዚቃ በስሜት ሲጨፍሩ | በሚሊኒየም አዳራሽ ታሪካዊ ቪዲዮ by Nuro Bezede ኑሮ በዘዴ 3 years ago 14 minutes, 14 seconds 129,133 views",Nuro Bezede ኑሮ በዘዴ,129133,129137,4
7382,"[ሙሉ ቪዲዮ] የአበበ ገላው ታሪካዊ ንግግር በሚሊኒየም አዳራሽ | Abebe Gellaw Speech by Nuro Bezede ኑሮ በዘዴ 3 years ago 19 minutes 49,245 views",Nuro Bezede ኑሮ በዘዴ,49245,49248,3
7383,"አበበ ገላው መለስ ዜናዊን ያስደነገጠበትን ንግግር ዛሬ ደገመው [ታሪካዊ ቪዲዮ ከሚሊኒየም አዳራሽ] by Nuro Bezede ኑሮ በዘዴ 3 years ago 11 minutes, 23 seconds 114,483 views",Nuro Bezede ኑሮ በዘዴ,114483,114493,10
7384,"ሀገሬ የምገባው በስጋት ሳይሆን በኩራት ነው ጋዜጠኛ አበበ ገላው | Journalist Abebe Gellaw by Nuro Bezede ኑሮ በዘዴ 3 years ago 10 minutes, 8 seconds 33,206 views",Nuro Bezede ኑሮ በዘዴ,33206,33208,2
7385,"አዲስ አበባ የገቡት የኢሳት ጋዜጠኞች ቃላት ያጡለትን ደስታ የገለፁበት ንግግር | Sisay Agena | MessayMekonnen by Nuro Bezede ኑሮ በዘዴ 3 years ago 10 minutes, 20 seconds 33,889 views",Nuro Bezede ኑሮ በዘዴ,33889,33892,3
7386,"ከትግራይ ክልል ጋር በተያያዘ ለተነሳባቸው ጥያቄ ሲሳይ አጌና እና አበበ ገላው ምላሽ ሰጡ | Sisay Agena | MessayMekonnen by Nuro Bezede ኑሮ በዘዴ 3 years ago 11 minutes, 47 seconds 151,052 views",Nuro Bezede ኑሮ በዘዴ,151052,151054,2
7387,"የኢሳቱ ጋዜጠኛ አበበ ገላው ለቀረቡለት ጥያቄዎች የሰጠው ምላሽ ክፍል 2 by Nuro Bezede ኑሮ በዘዴ 3 years ago 12 minutes, 53 seconds 61,614 views",Nuro Bezede ኑሮ በዘዴ,61614,61621,7
7388,"ለአበበ ገላው ፣ መሳይ መኮንንና ለኢሳት ባልደረቦች ከጋዜጠኞች ለቀረበላቸው ጥያቄዎች የሰጡት ምላሽ ክፍል 1 by Nuro Bezede ኑሮ በዘዴ 3 years ago 11 minutes, 28 seconds 27,808 views",Nuro Bezede ኑሮ በዘዴ,27808,27809,1
7389,"ጋዜጠኛ አበበ ገላው ከ20 አመት በኋላ በቦሌ ኤርፖርት ያደረገው ድንቅ ንግግር by Nuro Bezede ኑሮ በዘዴ 3 years ago 10 minutes, 43 seconds 30,928 views",Nuro Bezede ኑሮ በዘዴ,30928,30930,2
7390,"ጋዜጠኛ አበበ ገላው ከ 20 አመት በኋላ እናቱን ሲያገኝ [ልብ የሚነካ ትዕይንት] by Nuro Bezede ኑሮ በዘዴ 3 years ago 10 minutes, 50 seconds 235,494 views",Nuro Bezede ኑሮ በዘዴ,235494,235501,7
7391,"የኢሳት ጋዜጠኞች በቦሌ ኤርፖርት የተደረገላቸው ደማቅ አቀባበል by Nuro Bezede ኑሮ በዘዴ 3 years ago 10 minutes, 8 seconds 84,742 views",Nuro Bezede ኑሮ በዘዴ,84742,84747,5
7392,"ዶ/ር አብይ ዛሬ በአዳማ ካደረጉት ድንቅ ንግግር ላይ የተወሰደ | Dr Abiy Ahmed Speech by Nuro Bezede ኑሮ በዘዴ 3 years ago 11 minutes, 31 seconds 3,531 views",Nuro Bezede ኑሮ በዘዴ,3531,3532,1
7393,"ከ20 አመት በኋላ ከውቧ ባህር ዳር የተሰማው ድንቅ ዜና by Nuro Bezede ኑሮ በዘዴ 3 years ago 3 minutes, 22 seconds 10,485 views",Nuro Bezede ኑሮ በዘዴ,10485,10485,0
7394,"አብያችን መሸለሙ | የዶ/ር ደብረ ፂዮን ማስፈራሪያ ሲተረጎም | እለታዊ የፍ/ቤት ውሎ | የዕለቱ ዜናዎች | | Ethiopian Daily News by Nuro Bezede ኑሮ በዘዴ 3 years ago 15 minutes 17,845 views",Nuro Bezede ኑሮ በዘዴ,17845,17845,0
7395,"የየትነበርሽ ንጉሴ ሹመት | የዶ/ር አብይ መልዕክት | ጎንደርን በተመለከተ | የዕለቱ ዜናዎች | Ethiopian Daily News by Nuro Bezede ኑሮ በዘዴ 3 years ago 12 minutes, 28 seconds 14,111 views",Nuro Bezede ኑሮ በዘዴ,14111,14111,0
7396,"የፌደራል ዱላ ኮሜዲያን እሸቱ መለሰ አስቂኝ የመድረክ ኮሜዲ | Ethiopia Comedy by Nuro Bezede ኑሮ በዘዴ 3 years ago 14 minutes, 29 seconds 4,810 views",Nuro Bezede ኑሮ በዘዴ,4810,4815,5
7397,"Ethiopia - የዕለቱ ትኩስ ዜናዎች | Ethiopian Daily News by Nuro Bezede ኑሮ በዘዴ 3 years ago 18 minutes 4,171 views",Nuro Bezede ኑሮ በዘዴ,4171,4172,1
7398,"የ3 አመቷን ህፃን ህይወት የቀጠፈውና የ4 ኪሎ ተፈናቃዮች እሮሮ by Nuro Bezede ኑሮ በዘዴ 3 years ago 14 minutes, 8 seconds 7,756 views",Nuro Bezede ኑሮ በዘዴ,7756,7756,0
7399,"ጥብቅ መረጃ - የበረከት ልጆች እጣ ፈንታ | Bereket Simon | TPL by Nuro Bezede ኑሮ በዘዴ 3 years ago 14 minutes, 55 seconds 219,988 views",Nuro Bezede ኑሮ በዘዴ,219988,219996,8
7400,"የጎንደሩ አሳዛኝ ድርጊት | በረከት ስምኦን የፍርድ ቤት ውሎ | የዕለቱ ልዩ ዜናዎች | Ethiopian Daily News by Nuro Bezede ኑሮ በዘዴ 3 years ago 11 minutes, 1 second 15,147 views",Nuro Bezede ኑሮ በዘዴ,15147,15147,0
7401,"ጌታቸው ረዳ በዶ/ር አብይ ላይ ያለውን አቋም ይፋ አደረገ  “እኛ ችግር ሆነንበት አናውቅም” | Getachew Reda | PM Dr. Abiy Ahmed by Nuro Bezede ኑሮ በዘዴ 3 years ago 13 minutes, 36 seconds 16,370 views",Nuro Bezede ኑሮ በዘዴ,16370,16370,0
7402,"ዶ/ር አብይ ዛሬ | ከአብዲ ኢሌ አባሪዎች 6ቱ በቁጥጥር ስር ዋሉ | የጭልጋው ግጭት | የዕለቱ ዜናዎች |  Ethiopian Daily News by Nuro Bezede ኑሮ በዘዴ 3 years ago 10 minutes, 5 seconds 2,697 views",Nuro Bezede ኑሮ በዘዴ,2697,2697,0
7403,"ያልተጠበቀው የዶ/ር አብይ ድንገተኛ ጉብኝት | አብዲ ኢሌ ዛሬ በፍርድ ቤት | የዕለቱ ዜናዎች | Ethiopian Daily News by Nuro Bezede ኑሮ በዘዴ 3 years ago 14 minutes, 14 seconds 12,207 views",Nuro Bezede ኑሮ በዘዴ,12207,12208,1
7404,"ኮንዶሚኒየም ቤቶች የሚወጡበት ጊዜ ይፋ ተደረገ | አሳሳቢው መታወቂያ እደላ | የዕለቱ ዜናዎች | Ethiopian Daily News by Nuro Bezede ኑሮ በዘዴ 3 years ago 12 minutes, 4 seconds 65,681 views",Nuro Bezede ኑሮ በዘዴ,65681,65740,59
7405,"ዝናሽ ታያቸውና ዶ/ር አብይ የጉዲፈቻ ልጃቸውን ህጋዊ አደረጉ | የዶ/ር አብይ ውሎ ዜና | Ethiopian Daily News by Nuro Bezede ኑሮ በዘዴ 3 years ago 12 minutes, 15 seconds 11,840 views",Nuro Bezede ኑሮ በዘዴ,11840,11840,0
7406,"ጥብቅ መረጃ - ከአላሙዲንና ከነበረከት ስምኦን ግንኙነት ጀርባ ያሉ ልዩ ሚስጢሮች by Nuro Bezede ኑሮ በዘዴ 3 years ago 15 minutes 25,581 views",Nuro Bezede ኑሮ በዘዴ,25581,25581,0
7407,"ዶ/ር አብይ የኢሳቱን ጋዜጠኛ ሲሳይ አጌናን የገለፁበት አስገራሚ ንግግር by Nuro Bezede ኑሮ በዘዴ 3 years ago 12 minutes, 31 seconds 46,915 views",Nuro Bezede ኑሮ በዘዴ,46915,46917,2
7408,"ዶ/ር አብይ በዛሬው ፓርላማ ካነሷቸው አንኳር ሀሳቦች መካከል በአጭሩ by Nuro Bezede ኑሮ በዘዴ 3 years ago 13 minutes, 34 seconds 4,303 views",Nuro Bezede ኑሮ በዘዴ,4303,4307,4
7409,"ዶ/ር አብይ የነገው ፓርላማ | ቴዲ ማንጁስ በድጋሚ መታሰሩ ተሰማ | የዕለቱ ዜናዎች | Ethiopian Daily News by Nuro Bezede ኑሮ በዘዴ 3 years ago 11 minutes, 20 seconds 44,318 views",Nuro Bezede ኑሮ በዘዴ,44318,44318,0
7410,"በረከተ መለስ - የበረከት ስምኦን ያልተሰሙ አስገራሚ ጉዶች ሲጋለጡ | Bereket Simon | Meles Zenawi by Nuro Bezede ኑሮ በዘዴ 3 years ago 17 minutes 109,769 views",Nuro Bezede ኑሮ በዘዴ,109769,109779,10
7411,"በወቅታዊ የሀገራችን ጉዳይ ላይ የኡስታዝ አቡበከር ድንቅ መልዕክት ለኢትዮጲያዊያን by Nuro Bezede ኑሮ በዘዴ 3 years ago 13 minutes 3,352 views",Nuro Bezede ኑሮ በዘዴ,3352,3353,1
7412,"የበረከት ውሎ በእስር ቤት | ድሬዳዋ | ዶ/ር አብይ | ኦነግና ኦዴፓ | የዕለቱ ዜናዎች | Ethiopian Daily News by Nuro Bezede ኑሮ በዘዴ 3 years ago 16 minutes 40,872 views",Nuro Bezede ኑሮ በዘዴ,40872,40873,1
7413,"ልዩ ትንታኔ | ጋዜጠኛ መሳይ መኮንን ስለ በረከት መታሰር | Mesay mekonnen | Bereket Simon by Nuro Bezede ኑሮ በዘዴ 3 years ago 11 minutes, 37 seconds 49,259 views",Nuro Bezede ኑሮ በዘዴ,49259,49282,23
7414,"የእነ በረከት ስምኦን የሙስና ክስ ዝርዝር ይፋ ሆነ | ዶ/ር አብይ ዛሬ | የዕለቱ ልዩ ዜናዎች | Ethiopian Daily News by Nuro Bezede ኑሮ በዘዴ 3 years ago 13 minutes, 59 seconds 103,829 views",Nuro Bezede ኑሮ በዘዴ,103829,103834,5
7415,"ተወዳጇ ገጣሚ ሜሮን ጌትነት ከረጅም አመት በኋላ ድንቅ ግጥም “ተው እረፍ” by Nuro Bezede ኑሮ በዘዴ 3 years ago 16 minutes 17,229 views",Nuro Bezede ኑሮ በዘዴ,17229,17238,9
7416,"“ሀገሬን ለሰው አልሰጥም አለ” አዝናኝ ባህላዊ ዘፈንና ጭፈራ [ የጥምቀት ድባብ ] by Nuro Bezede ኑሮ በዘዴ 3 years ago 10 minutes, 50 seconds 47,902 views",Nuro Bezede ኑሮ በዘዴ,47902,47925,23
7417,"አስደናቂ የራያ ባህላዊ ጭፈራ በጥምቀት በዓል ላይ by Nuro Bezede ኑሮ በዘዴ 3 years ago 19 minutes 29,420 views",Nuro Bezede ኑሮ በዘዴ,29420,29430,10
7418,"Ethiopia: በጥምቀት በዓል የታዩ አስደናቂ ትዕይንቶች by Nuro Bezede ኑሮ በዘዴ 3 years ago 14 minutes, 47 seconds 12,019 views",Nuro Bezede ኑሮ በዘዴ,12019,12021,2
7419,"""ሚስቴን ያገኘኋት ጥምቀት ላይ ነው"" አዝናኝ የጥምቀት በዓል ጥያቄዎች by Nuro Bezede ኑሮ በዘዴ 3 years ago 10 minutes, 17 seconds 48,465 views",Nuro Bezede ኑሮ በዘዴ,48465,48465,0
7420,"የጥምቀት በዓል በአዲስ አበባና በጎንደር | የዕለቱ ዜናዎች | Ethiopian Daily News by Nuro Bezede ኑሮ በዘዴ 3 years ago 11 minutes, 3 seconds 23,630 views",Nuro Bezede ኑሮ በዘዴ,23630,23631,1
7421,"የጥምቀት ዋዜማ (ከተራ) በዓል አከባበር በአዲስ አበባ by Nuro Bezede ኑሮ በዘዴ 3 years ago 13 minutes, 11 seconds 47,862 views",Nuro Bezede ኑሮ በዘዴ,47862,47867,5
7422,"የከተራ በዓል ዋዜማ | ዝናሽ ታያቸው ዛሬ | የደራርቱ ቱሉ አስደናቂ ድርጊት | የዕለቱ ልዩ ዜናዎች | Ethiopian Daily News by Nuro Bezede ኑሮ በዘዴ 3 years ago 11 minutes, 3 seconds 32,454 views",Nuro Bezede ኑሮ በዘዴ,32454,32455,1
7423,"መንግስት የኦነግ አባላትን በቁጥጥር ስር ማዋል ጀመረ | የዶ/ር አብይ የዛሬ መልዕክት |  የዕለቱ ዜናዎች | Ethiopian Daily News by Nuro Bezede ኑሮ በዘዴ 3 years ago 15 minutes 32,939 views",Nuro Bezede ኑሮ በዘዴ,32939,32939,0
7424,"ኤርሚያስ አመልጋ ለፍርድ ቤቱ እያለቀሰ አስረዳ |  የአባገዳዎችን ጥሪ የተቀበለው ኦነግ | የዕለቱ ዜናዎች | Ethiopian Daily News by Nuro Bezede ኑሮ በዘዴ 3 years ago 12 minutes, 43 seconds 8,878 views",Nuro Bezede ኑሮ በዘዴ,8878,8878,0
7425,"[አዎ የቀን ጅብ ነኝ] የተወዳጁ በላይ በቀለ ወያ አስቂኝ ግጥም by Nuro Bezede ኑሮ በዘዴ 3 years ago 10 minutes, 18 seconds 10,868 views",Nuro Bezede ኑሮ በዘዴ,10868,10870,2
7426,"የአርቲስት አለማየሁ ታደሰ ምርጥ ግጥም [ ትግራይ ላከ ወሎ ጋር አበድረኝ ብሎ 1 ቁና ጤፍ ] by Nuro Bezede ኑሮ በዘዴ 3 years ago 13 minutes, 15 seconds 2,553 views",Nuro Bezede ኑሮ በዘዴ,2553,2553,0
7427,"ጥልቅ ትንታኔ - የዳውድ መንገድ እና የእነ አብይ ትዕግስት | OLF | PM Dr. Abiy Ahmed by Nuro Bezede ኑሮ በዘዴ 3 years ago 16 minutes 86,568 views",Nuro Bezede ኑሮ በዘዴ,86568,86571,3
7428,"Bezawit Fikadu - Yene Andegna | የኔ አንደኛ New Ethiopian Music 2019 (LIVE Performance) by Nuro Bezede ኑሮ በዘዴ 3 years ago 3 minutes, 43 seconds 121,135 views",Nuro Bezede ኑሮ በዘዴ,121135,121388,253
7429,"ህዝባዊ ተቃውሞ በጎንደር | የዶ/ር አብይ ውይይት | የዕለቱ ዜናዎች | Ethiopian Daily News by Nuro Bezede ኑሮ በዘዴ 3 years ago 12 minutes, 19 seconds 35,377 views",Nuro Bezede ኑሮ በዘዴ,35377,35377,0
7430,"የቤቶቹ ይበቃል ከአቢሲኒያ ቫይን ኮሜዲያን ጋር ያደረገው አዝናኝ ቆይታ by Nuro Bezede ኑሮ በዘዴ 3 years ago 11 minutes, 24 seconds 206,969 views",Nuro Bezede ኑሮ በዘዴ,206969,206976,7
7431,"አፋጣጭ ጥያቄ - ከትርሀስ ኮበለይና ከማህሌት ገ/ጊዮርጊስ ድምፃዊ ኤፍሬም አማረ ጋር አዝናኝ ጨዋታ ክፍል 2 | singer Ephrem Amare by Nuro Bezede ኑሮ በዘዴ 3 years ago 13 minutes, 44 seconds 258,719 views",Nuro Bezede ኑሮ በዘዴ,258719,258823,104
7432,"ልዩ የገና ፕሮግራም - ከተወዳጁ ድምፃዊ ኤፍሬም አማረ ጋር የተደረገ አዝናኝ ቆይታ ክፍል 1| singer Ephrem Amare by Nuro Bezede ኑሮ በዘዴ 3 years ago 15 minutes 55,066 views",Nuro Bezede ኑሮ በዘዴ,55066,55112,46
7433,"የአሸናፊ ማህሌት (የቤቶቹ ይበቃል) የሰራው አስተማሪ አጭር ፊልም "" እጆችን ለልመና"" by Nuro Bezede ኑሮ በዘዴ 3 years ago 12 minutes, 38 seconds 16,754 views",Nuro Bezede ኑሮ በዘዴ,16754,16754,0
7434,"አፋጣጭ ጥያቄ ከወንዲ ማክና ከያሬድ ነጉ ማነው ጎበዝ? አርቲስት አሸናፊ አቀናባሪ ታምሩን ሲያፋጥጠው አዝናኝ ጨዋታ ክፍል 2 by Nuro Bezede ኑሮ በዘዴ 3 years ago 10 minutes, 27 seconds 72,995 views",Nuro Bezede ኑሮ በዘዴ,72995,72999,4
7435,"ልዩ የገና ፕሮግራም የቤቶቹ ይበቃል ከታምሩ አማረ ጋር ያደረገው አዝናኝ ቆይታ ክፍል 1 by Nuro Bezede ኑሮ በዘዴ 3 years ago 14 minutes, 41 seconds 13,933 views",Nuro Bezede ኑሮ በዘዴ,13933,13935,2
7436,"ልዩ የገና በዓል አዝናኝ ፕሮግራሞች ከቤቶች ድራማው ይበቃል ጋር ይጠብቁን by Nuro Bezede ኑሮ በዘዴ 3 years ago 1 minute, 46 seconds 6,438 views",Nuro Bezede ኑሮ በዘዴ,6438,6438,0
7437,"በበዓል ሰሞን የወንድና የሴት አልባሳት ዋጋ በአዲስ አበባ ምን ያህል ነው? by Nuro Bezede ኑሮ በዘዴ 3 years ago 17 minutes 62,668 views",Nuro Bezede ኑሮ በዘዴ,62668,62679,11
7438,"ልዩ ሚስጢር -ጌታቸው አሰፋ ከመረመራቸውና ከሚያሰራቸው የወጣ ልዩ መረጃ | ጌታቸው አሰፋ ማን ነው? by Nuro Bezede ኑሮ በዘዴ 3 years ago 22 minutes 68,018 views",Nuro Bezede ኑሮ በዘዴ,68018,68021,3
7439,"የኢንጂነር ስመኘው አባት | አዲሱ የሜቴክ 8 ቢሊዮን ጉድ | የዕለቱ ልዩ ዜናዎች | Ethiopian Daily News by Nuro Bezede ኑሮ በዘዴ 3 years ago 11 minutes, 29 seconds 24,433 views",Nuro Bezede ኑሮ በዘዴ,24433,24433,0
7440,"ሰበር ዜና | አቃቤ ህግ ጌታቸው አሰፋን የትግራይ መንግስት አልሰጥም እንዳለው ይፋ አደረገ | Ethiopian Daily News by Nuro Bezede ኑሮ በዘዴ 3 years ago 10 minutes, 48 seconds 71,529 views",Nuro Bezede ኑሮ በዘዴ,71529,71530,1
7441,"የዘመን ድራማው አንጋፋ አርቲስት ስዩም ተፈራ የክብር ሽልማት ሲሸለሙ | Legend ARTIST SEYOUM TEFERA by Nuro Bezede ኑሮ በዘዴ 3 years ago 12 minutes, 39 seconds 11,897 views",Nuro Bezede ኑሮ በዘዴ,11897,11899,2
7442,"ልዩ መረጃ | የሪፐብሊካን ጋርዱ ምን ይሰራል? ከአሜሪካውና ከሌሎች ልዩ የሚያደርገውስ? by Nuro Bezede ኑሮ በዘዴ 3 years ago 10 minutes, 26 seconds 23,727 views",Nuro Bezede ኑሮ በዘዴ,23727,23737,10
7443,"የዶ/ር አብይ መልዕክት ለዲያስፖራው | የኦነጉ ጃን ማሮ ጉዳይ የዕለቱ ዜናዎች | Ethiopian Daily News by Nuro Bezede ኑሮ በዘዴ 3 years ago 11 minutes, 4 seconds 31,201 views",Nuro Bezede ኑሮ በዘዴ,31201,31201,0
7444,"ይቅናህ የኔ ጌታ | ማራኪ ግጥም በተወዳጇ ገጣሚ ህሊና by Nuro Bezede ኑሮ በዘዴ 3 years ago 16 minutes 48,061 views",Nuro Bezede ኑሮ በዘዴ,48061,48087,26
7445,"ተወዳጁ መሪያችን ዶ/ር አብይ ተወደሰ | ሚስጢራዊ እስር ቤቶች ተገኙ | የዕለቱ ዜናዎች | Ethiopian Daily News by Nuro Bezede ኑሮ በዘዴ 3 years ago 12 minutes 62,889 views",Nuro Bezede ኑሮ በዘዴ,62889,62889,0
7446,"ጥብቅ ሚስጢር | ከድንገተኛው የወጋገን ባንክ 1 ቢሊዮን ትርፍ ጀርባ ያለው ሚስጢር | Wegagen Bank | Ethiopia by Nuro Bezede ኑሮ በዘዴ 3 years ago 10 minutes, 26 seconds 19,428 views",Nuro Bezede ኑሮ በዘዴ,19428,19443,15
7447,"የሰላም ሚኒስትሯ ሙፈሪያት ዛሬ ህዝቡን አስደነቀችው | ህዝቡን በትህትና ስታስተናግድ የሚይሳይ ቪዲዮ by Nuro Bezede ኑሮ በዘዴ 3 years ago 11 minutes, 37 seconds 38,748 views",Nuro Bezede ኑሮ በዘዴ,38748,38751,3
7448,"ከላይ የእግዜር ፀሀይ መሀል ወያኔ ከታች የቻይና ጫማ | የበላይ በቀለ ወያ አስቂኝ ግጥሞች by Nuro Bezede ኑሮ በዘዴ 3 years ago 10 minutes, 32 seconds 15,807 views",Nuro Bezede ኑሮ በዘዴ,15807,15809,2
7449,"እባካችሁ የሰፈር አውራ ዶሮዎች አትረብሹን | የዲ/ን ዳንኤል ክብረት ቅኔያዊ ንግግር by Nuro Bezede ኑሮ በዘዴ 3 years ago 11 minutes, 23 seconds 203,485 views",Nuro Bezede ኑሮ በዘዴ,203485,203512,27
7450,"አነጋጋሪው የሻሸመኔው ጉድ እውነታ | የኦዴፓና ኦነግ ውዝግብ | የዕለቱ ዜናዎች | Ethiopian Daily News by Nuro Bezede ኑሮ በዘዴ 3 years ago 12 minutes, 24 seconds 35,929 views",Nuro Bezede ኑሮ በዘዴ,35929,35929,0
7451,"ዛሬ በሙስና የተያዙት ባለስልጣናት ስም ይፋ ሆነ | የክንፈ ዳኘው ወንድም ዛሬ በፍርድ ቤት | የዕለቱ ዜናዎች | Ethiopian Daily News by Nuro Bezede ኑሮ በዘዴ 3 years ago 13 minutes, 45 seconds 34,223 views",Nuro Bezede ኑሮ በዘዴ,34223,34223,0
7452,"ጥብቅ መረጃ | ጌታቸው አሰፋ የት እንደሚኖር | ፂሙን ለምን? እንዳሳደገውና ቻይና የሚመላለስበት ሚስጢር | Getachew Assefa by Nuro Bezede ኑሮ በዘዴ 3 years ago 16 minutes 257,552 views",Nuro Bezede ኑሮ በዘዴ,257552,257557,5
7453,"አዲሱ የሜቴክ ሰው በፍርድ ቤት | የዶ/ር አብይ ውሎ | እና የዕለቱ ዜናዎች by Nuro Bezede ኑሮ በዘዴ 3 years ago 12 minutes, 2 seconds 35,575 views",Nuro Bezede ኑሮ በዘዴ,35575,35576,1
7454,"በአንጋፋ አርቲስቶች የተሰራው በወቅታዊ የሀገራችን ጉዳይ ላይ ያተኮረ ድራማ | Ethiopia Drama by Nuro Bezede ኑሮ በዘዴ 3 years ago 23 minutes 6,598 views",Nuro Bezede ኑሮ በዘዴ,6598,6598,0
7455,"አምዶም ገ/ስላሴ ህውሀትን በድጋሚ አጋለጠ “ንግግሬ በጭብጨባ እንዲቋጥ ያስተባበረው ስብሀት ነጋ ነው” | Amdom Gebreslasie | TPLF by Nuro Bezede ኑሮ በዘዴ 3 years ago 14 minutes 125,967 views",Nuro Bezede ኑሮ በዘዴ,125967,125968,1
7456,"ልዩ ትንታኔ ያልተሳካው የኦንግና የህውሀት ጥምረት | TPLF Special Analysis by Nuro Bezede ኑሮ በዘዴ 3 years ago 12 minutes, 29 seconds 117,187 views",Nuro Bezede ኑሮ በዘዴ,117187,117189,2
7457,"የዶ/ር አብይ ጠንከር ያለ ማሳሰቢያ ከዕለቱ ልዩ ዜናዎች ጋር | Ethiopian Daily News by Nuro Bezede ኑሮ በዘዴ 3 years ago 11 minutes, 48 seconds 19,840 views",Nuro Bezede ኑሮ በዘዴ,19840,19840,0
7458,"አብዲ ዛሬ በፍርድ ቤት | ጌታቸው ረዳ አልፈተሽም ማለቱ | የዕለቱ ዋና ዋና ዜናዎች | Ethiopian Daily News by Nuro Bezede ኑሮ በዘዴ 3 years ago 12 minutes, 2 seconds 32,305 views",Nuro Bezede ኑሮ በዘዴ,32305,32306,1
7459,"የፕሬዘዳንት ግርማ  ወ/ጊዮርጊስ ልጅ ስለ አባቱ እያለቀሰ ያደረገው ልብ የሚነካ ንግግር by Nuro Bezede ኑሮ በዘዴ 3 years ago 14 minutes, 7 seconds 26,303 views",Nuro Bezede ኑሮ በዘዴ,26303,26304,1
7460,"ዶ/ር አብይ በቅድሞ ፕሬዘዳንት ግርማ ወ/ጊዮርጊስ የመጨረሻ ሽኝት ላይ by Nuro Bezede ኑሮ በዘዴ 3 years ago 10 minutes, 55 seconds 24,400 views",Nuro Bezede ኑሮ በዘዴ,24400,24401,1
7461,"ዶ/ር አብይ ከወ/ሮ ዝናሽ ታያችው ጋር የተገኙበት የቀብር ስነ-ስርዓት | President Girma Woldegiorgis death by Nuro Bezede ኑሮ በዘዴ 3 years ago 14 minutes, 39 seconds 182,499 views",Nuro Bezede ኑሮ በዘዴ,182499,182504,5
7462,"የዶ/ር አብይ አዲስ ሹመት | ስለ ሰኔ 16ቱ ጥቃት | የዕለቱ ዜናዎች | Ethiopian Daily News by Nuro Bezede ኑሮ በዘዴ 3 years ago 10 minutes, 7 seconds 12,649 views",Nuro Bezede ኑሮ በዘዴ,12649,12649,0
7463,"ጠቅላይ ሚንስትር ዐብይ በቅዳሜው ውይይት ላይ ምን አሉ? | What did Prime Minister Dr. Abiy say on Saturday? by Nuro Bezede ኑሮ በዘዴ 3 years ago 4 minutes, 57 seconds 4,060 views",Nuro Bezede ኑሮ በዘዴ,4060,4060,0
7464,"የዛሬው የእነ ፍፁም የሺጥላ የፍርድ ቤት ውሎ | የመላኩ ፈንታ ሹመት| የዕለቱ ዜናዎች | Ethiopian Daily News by Nuro Bezede ኑሮ በዘዴ 3 years ago 11 minutes, 12 seconds 52,461 views",Nuro Bezede ኑሮ በዘዴ,52461,52461,0
7465,"ጥብቅ መረጃ | ዶ/ር አረጋዊ የህወሀት አመራሮችን ሲያጋልጡ  | ጌታቸው አሰፋ ግፍ ሲፈፅም የኖረ ነው  | Dr. Aregawi Berhe | TPLF by Nuro Bezede ኑሮ በዘዴ 3 years ago 19 minutes 81,730 views",Nuro Bezede ኑሮ በዘዴ,81730,81730,0
7466,"ቆይታ ከአንዳርጋቸው ፅጌ ጋር ስለ ጌታቸው አሰፋና ሌሎችም | ""ለዘረፋ የሚደረግ ይቅርታ እኔ አላውቅም"" | Andargachew Tsege by Nuro Bezede ኑሮ በዘዴ 3 years ago 16 minutes 60,571 views",Nuro Bezede ኑሮ በዘዴ,60571,60571,0
7467,"አላሙዲን በድጋሚ ሊከሰሱ | የፍርድ ቤት ውሎ | የዕለቱ ልዩ ዜናዎች | Ethiopian Daily News by Nuro Bezede ኑሮ በዘዴ 3 years ago 12 minutes, 51 seconds 40,971 views",Nuro Bezede ኑሮ በዘዴ,40971,40971,0
7468,"የዶ/ር አብይ ውሎ | የሰብአዊ መብት ጥሰት የፈፀሙት ዛሬ በፍርድ ቤት | የዕለቱ ዜናዎች | Ethiopian Daily News by Nuro Bezede ኑሮ በዘዴ 3 years ago 12 minutes, 6 seconds 39,336 views",Nuro Bezede ኑሮ በዘዴ,39336,39336,0
7469,"ወንጀለኞቹ ማንም ይሁኑ ማን አድነን ለህግ ማቅረባችን አይቀሬ ነው | የዶ/ር አብይ መልዕክት by Nuro Bezede ኑሮ በዘዴ 3 years ago 12 minutes, 2 seconds 14,173 views",Nuro Bezede ኑሮ በዘዴ,14173,14173,0
7470,"አዲስ አበባዎች የሰቆቃውን ፊልም ሲመለከቱ ምን እንደተሰማቸው ተናገሩ by Nuro Bezede ኑሮ በዘዴ 3 years ago 13 minutes, 21 seconds 58,095 views",Nuro Bezede ኑሮ በዘዴ,58095,58096,1
7471,"አዲስ አበቤዎች ሲመለከቱት ምን አሉ? | የዕለቱ ልዩ ዜናዎች | Ethiopian Daily News by Nuro Bezede ኑሮ በዘዴ 3 years ago 16 minutes 58,030 views",Nuro Bezede ኑሮ በዘዴ,58030,58030,0
7472,"በአዲስ አበባ ሰላማዊ ሰልፍ ተጠራ | የዕለቱ አነጋጋሪ ዜናዎች | Ethiopian Daily News by Nuro Bezede ኑሮ በዘዴ 3 years ago 10 minutes, 58 seconds 102,304 views",Nuro Bezede ኑሮ በዘዴ,102304,102304,0
7473,"ሜቴክ ከአጋሮቹ ጋር የማያልቁት ወንጀሎችና የፍርድ ቤት ውሎ ሙሉ ዘገባ by Nuro Bezede ኑሮ በዘዴ 3 years ago 10 minutes, 12 seconds 22,957 views",Nuro Bezede ኑሮ በዘዴ,22957,22957,0
7474,"የሜቴክ ሰዎች ውሎ በፍርድ ቤት የዕለቱ ዜናዎች | Ethiopian Daily News by Nuro Bezede ኑሮ በዘዴ 3 years ago 11 minutes, 23 seconds 16,487 views",Nuro Bezede ኑሮ በዘዴ,16487,16487,0
7475,"በትናንትናው ዕለት ያልታየው አዝናኝ ትዕይንት by Nuro Bezede ኑሮ በዘዴ 3 years ago 11 minutes 10,375 views",Nuro Bezede ኑሮ በዘዴ,10375,10375,0
7476,"የዶ/ር አብይና የደፂ ውሎ የዕለቱ አነጋጋሪ ዜናዎች | Ethiopia Daily News by Nuro Bezede ኑሮ በዘዴ 3 years ago 19 minutes 65,884 views",Nuro Bezede ኑሮ በዘዴ,65884,65885,1
7477,"[የዘንድሮ ዘፈን ስራ ስራ] ሰርፀ ስለ ዘንድሮ ዘፋኞችና ስለ ነገስታቶቻችን የተናገረው by Nuro Bezede ኑሮ በዘዴ 3 years ago 12 minutes, 31 seconds 10,027 views",Nuro Bezede ኑሮ በዘዴ,10027,10048,21
7478,"ለራስ የተፃፈው አዝናኝ ደብዳቤ በጌትነት እንየው by Nuro Bezede ኑሮ በዘዴ 3 years ago 14 minutes, 35 seconds 3,036 views",Nuro Bezede ኑሮ በዘዴ,3036,3037,1
7479,"ዛሬ በአዲስ አበባ የታየው የተለያዩ አዝናኝ ባህላዊ ጭፈራዎች by Nuro Bezede ኑሮ በዘዴ 3 years ago 13 minutes, 25 seconds 46,398 views",Nuro Bezede ኑሮ በዘዴ,46398,46400,2
7480,"Ethiopia: በአብይ ጊዜ የለም ትካዜ የአዲስ አበባ ወጣቶች ዛሬ by Nuro Bezede ኑሮ በዘዴ 3 years ago 20 minutes 176,292 views",Nuro Bezede ኑሮ በዘዴ,176292,176305,13
7481,"አስገራሚው የዶ/ር አብይ ውሎና የዕለቱ ልዩ ዜናዎች | Ethiopian Daily News by Nuro Bezede ኑሮ በዘዴ 3 years ago 12 minutes, 30 seconds 38,790 views",Nuro Bezede ኑሮ በዘዴ,38790,38790,0
7482,"ዲ/ን ዳንኤል ክብረት በወቅታዊ ጉዳዮች ላይ የተናገረው ድንቅ ንግግር by Nuro Bezede ኑሮ በዘዴ 3 years ago 12 minutes, 40 seconds 38,993 views",Nuro Bezede ኑሮ በዘዴ,38993,39003,10
7483,"ተወዳጁ አርቲስት ደበበ እሸቱ ስለ ጌታቸው አሰፋ፤ ሜቴክና ደብረ ፂ አዝናኝ ንግግር | የተደማሪው የፍቅር ደብዳቤ | by Nuro Bezede ኑሮ በዘዴ 3 years ago 13 minutes, 27 seconds 107,105 views",Nuro Bezede ኑሮ በዘዴ,107105,107109,4
7484,"ጀነራል ክንፈ ዳኘው በፍርድ ቤት የዕለቱ አነጋጋሪ ዜናዎች | Ethiopian Daily News by Nuro Bezede ኑሮ በዘዴ 3 years ago 11 minutes 47,562 views",Nuro Bezede ኑሮ በዘዴ,47562,47564,2
7485,"ሎሬት የትነበርሽ ንጉሴ ስለ ሜቴክ የቀለደችው ቀልድ | ከምርጥ አነቃቂ ንግግር ጋር by Nuro Bezede ኑሮ በዘዴ 3 years ago 14 minutes, 3 seconds 95,397 views",Nuro Bezede ኑሮ በዘዴ,95397,95415,18
7486,"የክንፈ ዳኘው ወንድም በፍርድ ቤት የዕለቱ ዜናዎች | Ethiopian Daily News by Nuro Bezede ኑሮ በዘዴ 3 years ago 17 minutes 53,886 views",Nuro Bezede ኑሮ በዘዴ,53886,53886,0
7487,"በኦሮሚያና ቤኒሻንጉል ያለው የዛሬ ውሎ እና የዕለቱ ዜናዎች  | Ethiopian Daily News by Nuro Bezede ኑሮ በዘዴ 3 years ago 11 minutes, 51 seconds 19,423 views",Nuro Bezede ኑሮ በዘዴ,19423,19423,0
7488,"ለደብረ ፂዮን ንግግር የገዱ አስገራሚ ምላሽና የዕለቱ አነጋጋሪ ዜናዎች | Ethiopian Daily News by Nuro Bezede ኑሮ በዘዴ 3 years ago 12 minutes, 5 seconds 15,158 views",Nuro Bezede ኑሮ በዘዴ,15158,15160,2
7489,"ጥብቅ ሚስጢር | ጌታቸው አሰፋ በድብቅ ሲሰራቸው የነበሩ ጉዶች ሲጋለጡ | Getachew Assefa by Nuro Bezede ኑሮ በዘዴ 3 years ago 18 minutes 299,781 views",Nuro Bezede ኑሮ በዘዴ,299781,299794,13
7490,"ያኔ አይን አፋር እያለሽ ያኔ by Nuro Bezede ኑሮ በዘዴ 3 years ago 11 minutes, 5 seconds 759 views",Nuro Bezede ኑሮ በዘዴ,759,759,0
7491,"ዶ/ር አብይ ለትልቅ ሽልማት ታጩ | የዕለቱ አነጋጋሪ ዜናዎች | Ethiopian Daily News by Nuro Bezede ኑሮ በዘዴ 3 years ago 11 minutes, 5 seconds 26,944 views",Nuro Bezede ኑሮ በዘዴ,26944,26955,11
7492,"ኦብነግ አመራሮቼ ሲገቡ እንደ ግ7 አይነት አቀባበል ይደረግልኝ አለ | የዕለቱ ዜናዎች by Nuro Bezede ኑሮ በዘዴ 3 years ago 13 minutes, 48 seconds 3,020 views",Nuro Bezede ኑሮ በዘዴ,3020,3020,0
7493,"ከአይሱዙ ረዳትነት በቅፅበት ወደ ቢሊዬነርነት የተቀየሩት የአቶ ዓለም ፍፁም ጉድ ሲጋለጥ by Nuro Bezede ኑሮ በዘዴ 3 years ago 20 minutes 175,661 views",Nuro Bezede ኑሮ በዘዴ,175661,175668,7
7494,"የዶክተር አብይ የዛሬው ድንቅ ንግግርና ተጨማሪ የዕለቱ ዜናዎች | Ethiopian Daily News by Nuro Bezede ኑሮ በዘዴ 3 years ago 10 minutes, 24 seconds 32,790 views",Nuro Bezede ኑሮ በዘዴ,32790,32790,0
7495,"የዕለቱ ዋና ዋና ዜናዎች ከኑሮ በዘዴ | Ethiopian Daily News Nuro Bezede by Nuro Bezede ኑሮ በዘዴ 3 years ago 6 minutes, 40 seconds 12,960 views",Nuro Bezede ኑሮ በዘዴ,12960,12961,1
7496,"ከኢትዮጲያ ደራሲያን ማህበር የተሰጠ ይፋዊ ጋዜጣዊ መግለጫ by Nuro Bezede ኑሮ በዘዴ 3 years ago 15 minutes 1,668 views",Nuro Bezede ኑሮ በዘዴ,1668,1668,0
7497,"Ethiopia: የሜቴኩ ጀነራል ክንፈ ዳኘውና የፀሀፊያቸው ድራማ ሲጋለጥ |  METEC by Nuro Bezede ኑሮ በዘዴ 3 years ago 13 minutes, 34 seconds 143,592 views",Nuro Bezede ኑሮ በዘዴ,143592,143600,8
7498,"ወጣቶች በቴዲ አፍሮና በሮፍናን ሙዚቃ ሲጨፍሩ by Nuro Bezede ኑሮ በዘዴ 3 years ago 13 minutes, 31 seconds 68,960 views",Nuro Bezede ኑሮ በዘዴ,68960,68962,2
7499,"የአዲስ አበባ ወጣቶች አስቂኝ ድርጊት ሜቴክ ስለ ሰረቃት መርከብ | Funniest Science Great Ethiopian Run 2018 by Nuro Bezede ኑሮ በዘዴ 3 years ago 17 minutes 51,945 views",Nuro Bezede ኑሮ በዘዴ,51945,51947,2
7500,"ብዙ ህዝብ የታየበት የዘንድሮ ታላቁ ሩጫ ተሳታፊዎች ሲቀውጡት | Great Ethiopian Run 2018 by Nuro Bezede ኑሮ በዘዴ 3 years ago 10 minutes, 39 seconds 36,354 views",Nuro Bezede ኑሮ በዘዴ,36354,36355,1
7501,"የ37 ቢሊየን ብሩ መዳረሻና የሜቴክ የውስጥ መዝገብ [ልዩ ትንታኔ] by Nuro Bezede ኑሮ በዘዴ 3 years ago 5 minutes, 5 seconds 7,542 views",Nuro Bezede ኑሮ በዘዴ,7542,7542,0
7502,"የደብረ ፂዮን ያልተጠበቀ ድርጊት ፣ የባለ ስልጣኖቹ ፣የኢንጂነር ስመኘው እና የሜቴክ ነገር | Ethiopian Daily News by Nuro Bezede ኑሮ በዘዴ 3 years ago 14 minutes, 1 second 57,881 views",Nuro Bezede ኑሮ በዘዴ,57881,57881,0
7503,"Ethiopian Drama - አዝናኝ ድራማ by Nuro Bezede ኑሮ በዘዴ 3 years ago 17 minutes 3,028 views",Nuro Bezede ኑሮ በዘዴ,3028,3028,0
7504,"የጀግናው አርበኛ ህዝቡን ያስደመመ ሽለላ by Nuro Bezede ኑሮ በዘዴ 3 years ago 10 minutes, 47 seconds 4,278 views",Nuro Bezede ኑሮ በዘዴ,4278,4279,1
7505,"Ethiopia: ፋኖ ባህላዊ የሙዚቃ ባንድ በአስመራ ዝግጅቱን ሊያቀርብ ነው by Nuro Bezede ኑሮ በዘዴ 3 years ago 23 minutes 5,411 views",Nuro Bezede ኑሮ በዘዴ,5411,5411,0
7506,"ሰበር ዜና - ሰሞኑን በቁጥጥር ስር የዋሉት ሰዎችን በተመለከተ የጠቅላይ አቃቤ ሕግ መግለጫ by Nuro Bezede ኑሮ በዘዴ 3 years ago 19 minutes 5,129 views",Nuro Bezede ኑሮ በዘዴ,5129,5129,0
7507,"አዚዛ አህመድ ትህትና ፊልም በሴተኛ አዳሪነትና በHIV ዙሪያ | የሴተኛ አዳሪዎች ህይወት ለማሻሻል 72 ሚሊዮን ብር ሊሰበሰብ ነው by Nuro Bezede ኑሮ በዘዴ 3 years ago 13 minutes, 43 seconds 4,067 views",Nuro Bezede ኑሮ በዘዴ,4067,4069,2
7508,"አዚዛ የተሸለመችበትና በሴተኛ አዳሪነትና በHIV ላይ ያደረገው ትህትና ፊልም ገንዛቤ መፍጠሪያ መድረክ ተዘጋጀ by Nuro Bezede ኑሮ በዘዴ 3 years ago 44 minutes 1,238 views",Nuro Bezede ኑሮ በዘዴ,1238,1239,1
7509,"የኢትዮ-ኤርትራ የሰላም ሩጫ ፍቅር የዘነበበት ድባብ by Nuro Bezede ኑሮ በዘዴ 3 years ago 14 minutes, 15 seconds 7,604 views",Nuro Bezede ኑሮ በዘዴ,7604,7604,0
7510,"ቴዲ አፍሮ ኢትዮ-ኤርትራ የፍቅር ሩጫን ላሸነፉ ሽልማታቸውን ሲሰጥ by Nuro Bezede ኑሮ በዘዴ 3 years ago 15 minutes 99,181 views",Nuro Bezede ኑሮ በዘዴ,99181,99182,1
7511,"Teddy Afro - ቴዲ አፍሮ ታሪካዊውን የኢትዮ-ኤርትራ የፍቅር ሩጫ ሲያስጀምር | The First Ethio - Eritrea Great Run by Nuro Bezede ኑሮ በዘዴ 3 years ago 11 minutes, 11 seconds 183,983 views",Nuro Bezede ኑሮ በዘዴ,183983,184007,24
7512,"መምህር የሻው ተሰማ ተመልካቹን በሳቅ ያዝናናበት ምርጥ ወግ ""ከሰማይ የወረደች ሚስት"" by Nuro Bezede ኑሮ በዘዴ 3 years ago 12 minutes, 44 seconds 4,513 views",Nuro Bezede ኑሮ በዘዴ,4513,4515,2
7513,"ምርጥ ቅኔያዊ ግጥም በገጣሚ ያዴል “ከወዳደቁ ነገሮች የተሰራ ህይወት” by Nuro Bezede ኑሮ በዘዴ 3 years ago 12 minutes, 30 seconds 2,182 views",Nuro Bezede ኑሮ በዘዴ,2182,2182,0
7514,"""አለምህን ሙሉ የሚያደርጉት ሴቶች ናቸው"" ደራሲ ዘነበ ወላ ስለ ሴቶች የተናገረው ድንቅ ንግግር by Nuro Bezede ኑሮ በዘዴ 3 years ago 12 minutes, 46 seconds 10,527 views",Nuro Bezede ኑሮ በዘዴ,10527,10533,6
7515,"ሎሬት የትነበርሽ ንጉሴ ስለ አዲሷ ፕሬዘዳንት ሳህለ ወርቅ ዘውዴ የተናገረችው by Nuro Bezede ኑሮ በዘዴ 3 years ago 16 minutes 82,370 views",Nuro Bezede ኑሮ በዘዴ,82370,82377,7
7516,"[ክፍል 3 የመጨረሻው] የፍቄ ቤተሰቦች በገንዘብ ጉዳይ ተጣልተዋል ስለሚባለው እውነታውን ተናገሩ by Nuro Bezede ኑሮ በዘዴ 3 years ago 38 minutes 118,341 views",Nuro Bezede ኑሮ በዘዴ,118341,118343,2
7517,"ቴዲ ተሾመን ጋዜጠኞች በፍቄ ገንዘብ ዙሪያ በቀጥታ ሲያፋጥጡት | ክፍል 2 by Nuro Bezede ኑሮ በዘዴ 3 years ago 41 minutes 155,670 views",Nuro Bezede ኑሮ በዘዴ,155670,155674,4
7518,"አርቲስቶቹ ለፍቄ ስለተዋጣው ገንዘብ አርቲስት ቴዲ ተሾመ ገንዘቡን ለምን አልስጥም እንዳለ ሲያፋጥጡት የሰጠው ምላሽ by Nuro Bezede ኑሮ በዘዴ 3 years ago 23 minutes 120,098 views",Nuro Bezede ኑሮ በዘዴ,120098,120100,2
7519,"የአንጋፋው አርቲስት ፈለቀ ካሳ አባታዊ ምክር የታየበት ምርጥ ግጥም | Ethiopian poem by Nuro Bezede ኑሮ በዘዴ 3 years ago 7 minutes, 5 seconds 1,778 views",Nuro Bezede ኑሮ በዘዴ,1778,1778,0
7520,"በእብድ ገፀ ባህሪ በወቅታዊ የሀገራችን ሁኔታ ላይ የተሰራ ተውኔት by Nuro Bezede ኑሮ በዘዴ 3 years ago 11 minutes, 16 seconds 6,105 views",Nuro Bezede ኑሮ በዘዴ,6105,6109,4
7521,"ለዝነኛ አርቲስቶች የተደረገ የቀይ ምንጣፍ ስነ ስርዓት | Ethiopian Artist on Red carpet by Nuro Bezede ኑሮ በዘዴ 3 years ago 10 minutes, 36 seconds 78,402 views",Nuro Bezede ኑሮ በዘዴ,78402,78405,3
7522,"ተወዳጁ አርቲስት አለማየሁ ታደሰ የአመቱን ምርጥ ተዋናይ ዋንጫ ሲወስድ ያደረገው ድንቅ ንግግር by Nuro Bezede ኑሮ በዘዴ 3 years ago 10 minutes, 32 seconds 7,518 views",Nuro Bezede ኑሮ በዘዴ,7518,7518,0
7523,"Teddy Afro - ቴዲ አፍሮ የአመቱን ምርጥ አልበም ተሸላሚ ይፋ ሲያደርግ by Nuro Bezede ኑሮ በዘዴ 3 years ago 12 minutes, 27 seconds 245,687 views",Nuro Bezede ኑሮ በዘዴ,245687,245760,73
7524,"አምለሰት ሙጬ የአመቱን ምርጥ ተዋናይት ይፋ ስታደርግ by Nuro Bezede ኑሮ በዘዴ 3 years ago 13 minutes, 44 seconds 100,166 views",Nuro Bezede ኑሮ በዘዴ,100166,100173,7
7525,"ምን ልታዘዝ ድራማ አሸናፊ ሆነ | ጋሽ አያልቅበት ንግግር ሲያደርጉ by Nuro Bezede ኑሮ በዘዴ 3 years ago 10 minutes, 32 seconds 24,829 views",Nuro Bezede ኑሮ በዘዴ,24829,24834,5
7526,"ድምፃዊ ዘሩባቤልና ቤቲጂ ለዛ አዋርድ ላይ ያቀረቡት ድንቅ ዜማ by Nuro Bezede ኑሮ በዘዴ 3 years ago 10 minutes, 22 seconds 9,459 views",Nuro Bezede ኑሮ በዘዴ,9459,9460,1
7527,"በለዛ ሽልማት 3ዋንጫ የወሰደው ሮፍናን ከመረዋ ኳየር ጋር በጋራ ህዝቡን ያስደነቁብት ሙዚቃ by Nuro Bezede ኑሮ በዘዴ 3 years ago 16 minutes 62,060 views",Nuro Bezede ኑሮ በዘዴ,62060,62090,30
7528,"የዕለቱ ዋና ዋና ዜናዎች | Ethiopian Daily News by Nuro Bezede ኑሮ በዘዴ 3 years ago 14 minutes, 32 seconds 17,334 views",Nuro Bezede ኑሮ በዘዴ,17334,17334,0
7529,"የዕለቱ ዋና ዋና ዜናዎች | Ethiopian Daily News by Nuro Bezede ኑሮ በዘዴ 3 years ago 10 minutes, 43 seconds 52,685 views",Nuro Bezede ኑሮ በዘዴ,52685,52686,1
7530,"የዕለቱ ዋና ዋና ዜናዎች | Ethiopian Daily News by Nuro Bezede ኑሮ በዘዴ 3 years ago 10 minutes, 42 seconds 3,778 views",Nuro Bezede ኑሮ በዘዴ,3778,3778,0
7531,"አብዲ ኢሌ እስር ቤት ሰብሮ ሊያመልጥ ሲል ተያዘ | Ethiopian Daily News by Nuro Bezede ኑሮ በዘዴ 3 years ago 10 minutes, 37 seconds 13,447 views",Nuro Bezede ኑሮ በዘዴ,13447,13447,0
7532,"የዘመኑን ፍቅር በግጥም የገለፁበት አዝናኝ መንገድ by Nuro Bezede ኑሮ በዘዴ 3 years ago 10 minutes, 19 seconds 2,197 views",Nuro Bezede ኑሮ በዘዴ,2197,2197,0
7533,"በወቅታዊ የሀገራችን ጉዳይ ላይ የተገጠመ ግጥም [ወዴት ነው መንገዱ] by Nuro Bezede ኑሮ በዘዴ 3 years ago 10 minutes, 27 seconds 1,181 views",Nuro Bezede ኑሮ በዘዴ,1181,1181,0
7534,"ሴቶች ዶክተሮችን ቀርበው ለመጠየቅና ለማናገር የሚፈሩት ጥያቄዎች by Nuro Bezede ኑሮ በዘዴ 3 years ago 8 minutes, 25 seconds 3,174 views",Nuro Bezede ኑሮ በዘዴ,3174,3175,1
7535,"“ሀገሬን ፍቅር አስጠላት” በወቅታዊ ጉዳይ ላይ የተሰራ አስተማሪ ተውኔት by Nuro Bezede ኑሮ በዘዴ 3 years ago 11 minutes, 1 second 2,472 views",Nuro Bezede ኑሮ በዘዴ,2472,2472,0
7536,"Ethiopia: ለስኳር በሽታ አደገኛ የሆኑ 10 ምግቦች | | 10 Dangerous Foods for Diabetes by Nuro Bezede ኑሮ በዘዴ 3 years ago 3 minutes, 57 seconds 86,748 views",Nuro Bezede ኑሮ በዘዴ,86748,87412,664
7537,"ሙዝን ከተመገቡ በኋላ ልጣጩን ምን ያደርጉታል? መንገድ ላይ ይጥሉታል? by Nuro Bezede ኑሮ በዘዴ 3 years ago 5 minutes, 34 seconds 21,447 views",Nuro Bezede ኑሮ በዘዴ,21447,21453,6
7538,"Ethiopia: ህዝቡ ወ/ሮ ሙፈሪያት ምርጫው ላይ ስለፈፀሙት ያልተጠበቀ አነጋጋሪ ድርጊት ምን አለ? by Nuro Bezede ኑሮ በዘዴ 3 years ago 17 minutes 32,974 views",Nuro Bezede ኑሮ በዘዴ,32974,32977,3
7539,"Ethiopia: ሰዎች ዶ/ር አብይ በድጋሚ በመመረጣቸው ምን አሉ? | by Nuro Bezede ኑሮ በዘዴ 3 years ago 14 minutes, 35 seconds 15,529 views",Nuro Bezede ኑሮ በዘዴ,15529,15530,1
7540,"ሰበር ዜና ዶ/ር አብይ ምርጫውን በሙሉ ድምፅ አሸነፉ| የዕለቱ ዋና ዋና ዜናዎች by Nuro Bezede ኑሮ በዘዴ 3 years ago 13 minutes, 15 seconds 15,423 views",Nuro Bezede ኑሮ በዘዴ,15423,15429,6
7541,"Ethiopia: ኡስታዝ አብዱሰላም በፌስ ቡክ ስለሚታየው ዘረኝነት የሰጡት ወቅታዊ ምክር by Nuro Bezede ኑሮ በዘዴ 3 years ago 23 minutes 3,225 views",Nuro Bezede ኑሮ በዘዴ,3225,3226,1
7542,"Ethiopia: ዲ/ን ዳንኤል ክብረት በፌስ ቡክ ዘረኝነትን ስለሚሰብኩ ያስተላለፈው መልዕክት by Nuro Bezede ኑሮ በዘዴ 3 years ago 14 minutes, 3 seconds 18,387 views",Nuro Bezede ኑሮ በዘዴ,18387,18387,0
7543,"[አርባ ደቂቃ አየር ላይ] የፍቃዱ ከበደ ተመልካቹን በሳቅ ጦሽ ያደረገበት ወግ by Nuro Bezede ኑሮ በዘዴ 3 years ago 16 minutes 13,212 views",Nuro Bezede ኑሮ በዘዴ,13212,13218,6
7544,"ጤናማ ሰውነትን እንዲሁም ጥርት ያለ ቆዳ እንዲኖረን ምን እንመገብ? | Nuro Bezede Heath Tip by Nuro Bezede ኑሮ በዘዴ 3 years ago 8 minutes, 5 seconds 28,030 views",Nuro Bezede ኑሮ በዘዴ,28030,28052,22
7545,"የዕለቱ ዋና ዋና ዜናዎች | Ethiopian Daily News by Nuro Bezede ኑሮ በዘዴ 3 years ago 3 minutes, 13 seconds 10,181 views",Nuro Bezede ኑሮ በዘዴ,10181,10182,1
7546,"Ethiopia: የአማራ ፋኖ ለኦሮሚያ ቄሮ የላከው አስገራሚ ደብዳቤ by Nuro Bezede ኑሮ በዘዴ 3 years ago 10 minutes, 12 seconds 293,076 views",Nuro Bezede ኑሮ በዘዴ,293076,293678,602
7547,"ተወዳጁ ድምፃዊ ፀሃዬ ዮሃንስ ለአለም ፀሀይ ወዳጆ አታምርም ወይ ሙዚቃውን  ሲጫወትላት by Nuro Bezede ኑሮ በዘዴ 3 years ago 5 minutes, 41 seconds 2,681 views",Nuro Bezede ኑሮ በዘዴ,2681,2686,5
7548,"ተወዳጁ ድምፃዊ ጎሳዬ ተስፋዬ መድረክ ህዝቡን አሳበደው | Gossaye Tesfaye live performance by Nuro Bezede ኑሮ በዘዴ 3 years ago 6 minutes, 45 seconds 27,648 views",Nuro Bezede ኑሮ በዘዴ,27648,27739,91
7549,"Ethiopia: ታማኝ በየነ እምባ እየተናነቀው ስለተፈናቃይ ወገኖቻችን የተናገረው by Nuro Bezede ኑሮ በዘዴ 3 years ago 21 minutes 2,448 views",Nuro Bezede ኑሮ በዘዴ,2448,2448,0
7550,"Ethiopia: ታማኝ በየነ ለመላው ኢትዮጲያውያን ያስተላለፈው መልዕክት by Nuro Bezede ኑሮ በዘዴ 3 years ago 11 minutes, 28 seconds 5,206 views",Nuro Bezede ኑሮ በዘዴ,5206,5207,1
7551,"ታማኝን ባለ ኮከቡን ባንዲራ ይዘህ ታይሀል ብላ በድፍረት የጠየቀችው ጋዜጠኛ by Nuro Bezede ኑሮ በዘዴ 3 years ago 13 minutes, 6 seconds 110,117 views",Nuro Bezede ኑሮ በዘዴ,110117,110138,21
7552,"ታማኝ በየነ ከቡራዩ ለተፈናቀሉ ቤተሰቦች 13 ሚሊዮን ብር ሲሰጥ የተናገረው አስገራሚ ንግግር by Nuro Bezede ኑሮ በዘዴ 3 years ago 19 minutes 27,889 views",Nuro Bezede ኑሮ በዘዴ,27889,27891,2
7553,"ሰኔ 16 ቦምቡን ያፈነዱት የኦነግ ደጋፊዎች መሆናቸው ይፋ ሆነ  | Ethiopian Daily News by Nuro Bezede ኑሮ በዘዴ 3 years ago 10 minutes, 31 seconds 7,491 views",Nuro Bezede ኑሮ በዘዴ,7491,7497,6
7554,"የዕለቱ ዋና ዋና ዜናዎች | Ethiopian Daily News by Nuro Bezede ኑሮ በዘዴ 3 years ago 15 minutes 24,620 views",Nuro Bezede ኑሮ በዘዴ,24620,24624,4
7555,"ዶክተሩ ለኢንጂነር ስመኘው በቀለ አባት ያደረገው በጎ ተግባር | Ethiopian Daily News by Nuro Bezede ኑሮ በዘዴ 3 years ago 11 minutes, 23 seconds 156,202 views",Nuro Bezede ኑሮ በዘዴ,156202,156207,5
7556,"ከ20 አመት በኋላ የተሰማ አስገራሚ ዜና by Nuro Bezede ኑሮ በዘዴ 3 years ago 10 minutes, 21 seconds 38,193 views",Nuro Bezede ኑሮ በዘዴ,38193,38193,0
7557,"የዕለቱ ዋና ዋና ዜናዎች | Ethiopian Daily News by Nuro Bezede ኑሮ በዘዴ 3 years ago 12 minutes, 23 seconds 32,134 views",Nuro Bezede ኑሮ በዘዴ,32134,32136,2
7558,"የቴዲ አፍሮና መቅደስ ፀጋዬ በጎ ተግባር | የዕለቱ አስደሳች መረጃዎች by Nuro Bezede ኑሮ በዘዴ 3 years ago 15 minutes 204,628 views",Nuro Bezede ኑሮ በዘዴ,204628,204628,0
7559,"የዕለቱ ዋና ዋና ዜናዎች | Ethiopian Daily News by Nuro Bezede ኑሮ በዘዴ 3 years ago 11 minutes, 20 seconds 17,592 views",Nuro Bezede ኑሮ በዘዴ,17592,17592,0
7560,"የዕለቱ የዶ/ር አብይ ድንቅ ንግግርና ዋና ዋና ዜናዎች | Ethiopian Daily News by Nuro Bezede ኑሮ በዘዴ 3 years ago 12 minutes, 5 seconds 81,930 views",Nuro Bezede ኑሮ በዘዴ,81930,81930,0
7561,"ዶ/ር አብይ  ይቀጥሉ ይሆን? የእለቱ ተጨማሪ ዋና ዋና ዜናዎች | የዶ/ር አብይ ፈተናዎች by Nuro Bezede ኑሮ በዘዴ 3 years ago 10 minutes, 15 seconds 226,174 views",Nuro Bezede ኑሮ በዘዴ,226174,226185,11
7562,"የእለቱ ዋና ዋና ዜናዎች | Ethiopian Daily News by Nuro Bezede ኑሮ በዘዴ 3 years ago 10 minutes, 12 seconds 57,103 views",Nuro Bezede ኑሮ በዘዴ,57103,57103,0
7563,"[አሁን የደረሰን ቪዲዮ] በአዲስ አበባ በኮልፌና ሽሮ ሜዳ የተደረገ ሰልፍ by Nuro Bezede ኑሮ በዘዴ 3 years ago 2 minutes, 54 seconds 35,429 views",Nuro Bezede ኑሮ በዘዴ,35429,35430,1
7564,"Ethiopia: [ሙሉ ቪዲዮ] የቄሮ ወጣቶች በአዲስ አበባ by Nuro Bezede ኑሮ በዘዴ 3 years ago 44 minutes 24,828 views",Nuro Bezede ኑሮ በዘዴ,24828,24829,1
7565,"የኦነግ ደጋፊዎች መስቀል አደባባይ ሲደርሱ የተደረገላቸው ደማቅ አቀባበል by Nuro Bezede ኑሮ በዘዴ 3 years ago 17 minutes 35,884 views",Nuro Bezede ኑሮ በዘዴ,35884,35885,1
7566,"ቄሮ መስቀል አደባባይ ፈረስ ይዞ የገባበት አስገራሚ ትዕይንት by Nuro Bezede ኑሮ በዘዴ 3 years ago 13 minutes, 10 seconds 145,866 views",Nuro Bezede ኑሮ በዘዴ,145866,145868,2
7567,"የቄሮ ወጣቶች ከልደታ እስከ ሜክሲኮ የነበረው ትዕይንት by Nuro Bezede ኑሮ በዘዴ 3 years ago 11 minutes, 26 seconds 106,954 views",Nuro Bezede ኑሮ በዘዴ,106954,106960,6
7568,"የቄሮን ወጣቶች በዜማ ያስቀወጡት አባት by Nuro Bezede ኑሮ በዘዴ 3 years ago 10 minutes, 41 seconds 24,390 views",Nuro Bezede ኑሮ በዘዴ,24390,24390,0
7569,"አዲስ አበባ አሁን ያለችበት ሁኔታ ግጭቱ እንዴት ሊፈጠር ቻለ? | Ethiopian Daily News by Nuro Bezede ኑሮ በዘዴ 3 years ago 12 minutes, 31 seconds 168,084 views",Nuro Bezede ኑሮ በዘዴ,168084,168100,16
7570,"የእለቱ ዋና ዋና ዜናዎች | Ethiopian Daily News by Nuro Bezede ኑሮ በዘዴ 3 years ago 10 minutes, 53 seconds 53,587 views",Nuro Bezede ኑሮ በዘዴ,53587,53609,22
7571,"የአዲስ አበባን ህዝብ ያስቆጣው ቄሮ በአዲስ አበባ ጎዳናዎች ላይ by Nuro Bezede ኑሮ በዘዴ 3 years ago 19 minutes 310,661 views",Nuro Bezede ኑሮ በዘዴ,310661,311131,470
7572,"የዶ/ር አብይ መልዕክትና የአርበኞች ግንቦት 7 በወቅታዊ ጉዳዮች ላይ ያወጣው መግለጫ by Nuro Bezede ኑሮ በዘዴ 3 years ago 10 minutes, 25 seconds 11,315 views",Nuro Bezede ኑሮ በዘዴ,11315,11315,0
7573,"Ethiopia: የአዲስ አበባ ወጣቶች ከኑሮ በዘዴ ጋር ያደረጉት ቆይታ by Nuro Bezede ኑሮ በዘዴ 3 years ago 12 minutes, 58 seconds 11,231 views",Nuro Bezede ኑሮ በዘዴ,11231,11239,8
7574,"Ethiopia: የዛሬው የአዲስ አበባ ወጣቶች አዝናኝ የፖለቲካ ዘፈንና ትዕይንቶች by Nuro Bezede ኑሮ በዘዴ 3 years ago 15 minutes 57,857 views",Nuro Bezede ኑሮ በዘዴ,57857,57887,30
7575,"ለነ ፕሮፌሰር ብርሀኑ ነጋ አቀባበል የተደረገ ቀውጢ ጭፈራ by Nuro Bezede ኑሮ በዘዴ 3 years ago 11 minutes, 42 seconds 60,350 views",Nuro Bezede ኑሮ በዘዴ,60350,60360,10
7576,"ከ27 አመት በኋላ ባገኘው ነፃነት ህዝቡ ስሜቱን የገለፀበት አስገራሚ መንገድ by Nuro Bezede ኑሮ በዘዴ 3 years ago 14 minutes, 32 seconds 52,314 views",Nuro Bezede ኑሮ በዘዴ,52314,52317,3
7577,"በ97 በአጋዚ እናቱ የተገደለችበት ወጣት ዛሬ ያወጣው ሚስጢር by Nuro Bezede ኑሮ በዘዴ 3 years ago 10 minutes, 9 seconds 97,492 views",Nuro Bezede ኑሮ በዘዴ,97492,97495,3
7578,"Teddy Afro በቴዲ አፍሮ ጃ ያስተሰርያል ህዝቡን አሳበዱት by Nuro Bezede ኑሮ በዘዴ 3 years ago 17 minutes 17,369 views",Nuro Bezede ኑሮ በዘዴ,17369,17369,0
7579,"[ያልታየው ቪዲዮ] አርበኞች ግንቦት7 ኢትዮጲያ ሲገቡ የተደረገላቸው ደማቅ አቀባበል by Nuro Bezede ኑሮ በዘዴ 3 years ago 11 minutes, 50 seconds 70,959 views",Nuro Bezede ኑሮ በዘዴ,70959,70970,11
7580,"Ethiopia: የሶፋ ዋጋ በአዲስ አበባ በጥራትና በዋጋ የቱ የተሻለ ነው? by Nuro Bezede ኑሮ በዘዴ 3 years ago 11 minutes, 41 seconds 243,772 views",Nuro Bezede ኑሮ በዘዴ,243772,243932,160
7581,"የኢንጅነር ስመኘው ባለቤት ስለ ፖሊስ የምርመራ ውጤት ከካናዳ ያስተላለፉት መልዕክት by Nuro Bezede ኑሮ በዘዴ 3 years ago 11 minutes, 55 seconds 235,252 views",Nuro Bezede ኑሮ በዘዴ,235252,235259,7
7582,"የሀበሻ ቀሚስ ገበያና ዋጋ በሽሮ ሜዳ ምን ይመስላል? by Nuro Bezede ኑሮ በዘዴ 3 years ago 11 minutes, 12 seconds 212,846 views",Nuro Bezede ኑሮ በዘዴ,212846,212889,43
7583,"ኢንጂነር ስመኘው እራሳቸውን ያጠፋሉ ብዬ አላምንም የአዲስ አበባ ነዋሪዎች አስተያየት by Nuro Bezede ኑሮ በዘዴ 3 years ago 13 minutes, 40 seconds 4,194 views",Nuro Bezede ኑሮ በዘዴ,4194,4194,0
7584,"ይፋ የተደረገው የኢንጂነር ስመኘው ውጤት ውሸት እንደሚሆን የገለፁት ነዋሪዎች by Nuro Bezede ኑሮ በዘዴ 3 years ago 14 minutes, 31 seconds 96,948 views",Nuro Bezede ኑሮ በዘዴ,96948,96948,0
7585,"የአለም ፀሀይ ወዳጆ በሳቅ ጦሽ የሚያደርጉ የአሜሪካ ገጠመኞች by Nuro Bezede ኑሮ በዘዴ 3 years ago 16 minutes 18,745 views",Nuro Bezede ኑሮ በዘዴ,18745,18746,1
7586,"አስደንጋጩ የጫልቱ ሞት! በግፍ ተደፍራና አሲድ ተደፍቶባት የሞተችው 14 አመት ታዳጊ by Nuro Bezede ኑሮ በዘዴ 3 years ago 22 minutes 44,156 views",Nuro Bezede ኑሮ በዘዴ,44156,44159,3
7587,"Ethiopia: አሰሪዎቿ ተደፍራ ለሞት ለበቃችው ጫልቱ የተደረገ ሰላማዊ ሰልፍ by Nuro Bezede ኑሮ በዘዴ 3 years ago 14 minutes, 4 seconds 3,033 views",Nuro Bezede ኑሮ በዘዴ,3033,3033,0
7588,"ሰበር ዜና ጠቅላይ ሚኒስትር ዶክተር ዐቢይ አህመድ አሰብ ወደብን ጎበኙ by Nuro Bezede ኑሮ በዘዴ 3 years ago 3 minutes, 31 seconds 10,434 views",Nuro Bezede ኑሮ በዘዴ,10434,10438,4
7589,"ክቡር ለማ መገርሳ የበጎ ሰው ልዩ ሽልማት ከተቀበሉ በኋላ ያደረጉት ድንቅ ንግግር by Nuro Bezede ኑሮ በዘዴ 3 years ago 10 minutes, 14 seconds 2,401 views",Nuro Bezede ኑሮ በዘዴ,2401,2401,0
7590,"Ethiopia: [ሰበር ዜና] ክቡር ለማ መገርሳ የአመቱ የበጎ ሰው ልዩ ሽልማት አሸናፊ ሆኑ by Nuro Bezede ኑሮ በዘዴ 3 years ago 10 minutes, 14 seconds 3,471 views",Nuro Bezede ኑሮ በዘዴ,3471,3471,0
7591,"[ያልታየው ቪዲዮ] ለታማኝ በየነ አቀባበል የወጣው የህዝብ ጎርፍ by Nuro Bezede ኑሮ በዘዴ 3 years ago 10 minutes, 8 seconds 95,284 views",Nuro Bezede ኑሮ በዘዴ,95284,95313,29
7592,"Ethiopia: አለምፀሀይ ወዳጆ በዝነኛ አርቲስቶች አንደበት እንዴት ትገለፃለች? by Nuro Bezede ኑሮ በዘዴ 3 years ago 13 minutes, 37 seconds 10,386 views",Nuro Bezede ኑሮ በዘዴ,10386,10387,1
7593,"Ethiopia: አርቲስት አለምፀሀይ ወዳጆ ከ27 አመት በኋላ በሀገሯ የተናገርችው አስደናቂ ንግግር by Nuro Bezede ኑሮ በዘዴ 3 years ago 14 minutes, 57 seconds 2,830 views",Nuro Bezede ኑሮ በዘዴ,2830,2830,0
7594,"አርቲስት አለምፀሀይ ወዳጆ በብሄራዊ ቴአትር መድረኩን እያለቀሰች የሳመችበት ልብ የሚነካ ትዕይንት by Nuro Bezede ኑሮ በዘዴ 3 years ago 15 minutes 29,244 views",Nuro Bezede ኑሮ በዘዴ,29244,29247,3
7595,"አርቲስት አለምፀሀይ ወዳጆ የደስታ እምባዋን መቆጣጠር አቅቷት በብሄራዊ ቴአትር የተደረላት የጀግና አቀባበል by Nuro Bezede ኑሮ በዘዴ 3 years ago 10 minutes, 22 seconds 21,698 views",Nuro Bezede ኑሮ በዘዴ,21698,21709,11
7596,"ከ27 አመት በኋላ ሀገሯን ስትረግጥ ደማቅ አቀባበል የተደረገላት ተወዳጇ አርቲስት አለምፀሀይ ወዳጆ by Nuro Bezede ኑሮ በዘዴ 3 years ago 10 minutes, 34 seconds 12,143 views",Nuro Bezede ኑሮ በዘዴ,12143,12144,1
7597,"Ethiopia: መልካም ልደት ለጠቅላይ ሚኒስትር ዶ/ር አብይ አህመድ by Nuro Bezede ኑሮ በዘዴ 3 years ago 3 minutes, 28 seconds 39,008 views",Nuro Bezede ኑሮ በዘዴ,39008,39011,3
7598,"የኢንጅነር ስመኘው ቤተሰቦች ዛሬ ስለ አባታቸው መንግስትን የጠየቁት ጥያቄ | ቤተሰቡ ቅር ተሰኝቷል by Nuro Bezede ኑሮ በዘዴ 3 years ago 12 minutes, 45 seconds 102,584 views",Nuro Bezede ኑሮ በዘዴ,102584,102584,0
7599,"ሰዎች ባለማወቅ ስለ ፀጉራችን የሚመክሩን የተሳሳቱ ምክሮች by Nuro Bezede ኑሮ በዘዴ 3 years ago 7 minutes, 2 seconds 23,028 views",Nuro Bezede ኑሮ በዘዴ,23028,23028,0
7600,"የፀጉራችንን ፅዳትና ብዛት የምንጠብቅበት 9ኙ  የፀጉር ባለሙያዎች ምክር by Nuro Bezede ኑሮ በዘዴ 3 years ago 10 minutes, 8 seconds 37,764 views",Nuro Bezede ኑሮ በዘዴ,37764,37774,10
7601,"የእውነት! ከብደትዎን ቶሎ መቀነስ ከፈለጉ ከእነዚህ 11 ነገሮች ይራቁ by Nuro Bezede ኑሮ በዘዴ 3 years ago 11 minutes, 30 seconds 140,527 views",Nuro Bezede ኑሮ በዘዴ,140527,140737,210
7602,"[ያልታየው ቪዲዮ] የቤቶች ድራማው ባሻ የተናገረው ልብ የሚነካ ንግግር by Nuro Bezede ኑሮ በዘዴ 3 years ago 25 minutes 16,415 views",Nuro Bezede ኑሮ በዘዴ,16415,16420,5
7603,"[መታየት ያለበት ቪዲዮ] ጋሽ ፍቄ ከሚረዳቸው አረጋዊያን ማእከል የተላለፈ መልእክት by Nuro Bezede ኑሮ በዘዴ 3 years ago 10 minutes, 9 seconds 14,155 views",Nuro Bezede ኑሮ በዘዴ,14155,14155,0
7604,"Ethiopia: ቴዎድሮስ ተስፋዬ ስለ ጋሽ ፍቄ እያለቀሰ የተናገረው ልብ የሚነካ ንግግር by Nuro Bezede ኑሮ በዘዴ 3 years ago 12 minutes, 36 seconds 3,774 views",Nuro Bezede ኑሮ በዘዴ,3774,3775,1
7605,"የንጉሱ ወታደሮች ነን ከወሎ ስሪንቃ አርሴማ እስከ አዲስ አበባ by Nuro Bezede ኑሮ በዘዴ 3 years ago 11 minutes, 3 seconds 22,036 views",Nuro Bezede ኑሮ በዘዴ,22036,22036,0
7606,"ዝነኛ አርቲስቶች ስለ ጋሽ ፍቄ የተናገሩት / Ethiopian Famous Artists About Fikadu Tekle Mariam by Nuro Bezede ኑሮ በዘዴ 3 years ago 16 minutes 5,151 views",Nuro Bezede ኑሮ በዘዴ,5151,5153,2
7607,"አርቲስት ፓንዶራ አድነው ስለ ጋሽ ፍቄ የተናገረቻቸው አስገራሚ ነገሮች ""እንደልጁ ነበር የሚያየኝ"" / About Artist Fikadu Tekle mariam by Nuro Bezede ኑሮ በዘዴ 3 years ago 16 minutes 145,676 views",Nuro Bezede ኑሮ በዘዴ,145676,145678,2
7608,"Ethiopia: የጀግና ሽኝት የተደረገለት የአርቲስት ፍቃዱ ተ\ማርያም አስክሬን/Artist Fikadu Tekle mariam by Nuro Bezede ኑሮ በዘዴ 3 years ago 11 minutes, 28 seconds 199,372 views",Nuro Bezede ኑሮ በዘዴ,199372,199385,13
7609,"Ethiopia: አርቲስቶቹ ስለ ፍቄ እያለቀሱ የተናገሩት አንጀት የሚበላ ንግግር by Nuro Bezede ኑሮ በዘዴ 3 years ago 13 minutes, 16 seconds 105,367 views",Nuro Bezede ኑሮ በዘዴ,105367,105516,149
7610,"Ethiopia: የፍቃዱ አስክሬን ብሄራዊ ቴአትር ሲድርስ የተደረገለት አቀባበል by Nuro Bezede ኑሮ በዘዴ 3 years ago 12 minutes, 29 seconds 37,387 views",Nuro Bezede ኑሮ በዘዴ,37387,37391,4
7611,"Ethiopia: የሀይማኖት አባቶች በሲኖዶሶቹ አንድ መሆን የተሰማቸውን ደስታ ገለፁ by Nuro Bezede ኑሮ በዘዴ 3 years ago 16 minutes 1,769 views",Nuro Bezede ኑሮ በዘዴ,1769,1863,94
7612,"Ethiopia: ብፁዕ ወቅዱስ አቡነ መርቆሪዮስ 4ኪሎ ስላሴ ሲገቡ የተደረገላቸው ደማቅ አቀባበል by Nuro Bezede ኑሮ በዘዴ 3 years ago 10 minutes, 47 seconds 116,430 views",Nuro Bezede ኑሮ በዘዴ,116430,163860,47430
7613,"Ethiopia: አሳዛኝ ዜና! አርቲስት ፍቃዱ ተክለ ማርያም አረፈ by Nuro Bezede ኑሮ በዘዴ 3 years ago 54 seconds 9,626 views",Nuro Bezede ኑሮ በዘዴ,9626,9648,22
7614,"[ያልታየው ቪዲዮ] በአራት ኪሎ የነበረው ከፍተኛ ህዝባዊ ተቃውሞ/addis youths rally asking justice for Eng. simegnew bekele by Nuro Bezede ኑሮ በዘዴ 3 years ago 13 minutes, 43 seconds 229,943 views",Nuro Bezede ኑሮ በዘዴ,229943,229967,24
7615,"Ethiopia: ስመኘውን ለመግለፅ ቃላት ያጠራቸው ዘመድና ወዳጆቻቸው ጋር ቃለ መጠይቅ by Nuro Bezede ኑሮ በዘዴ 3 years ago 12 minutes, 24 seconds 19,018 views",Nuro Bezede ኑሮ በዘዴ,19018,19018,0
7616,"የስመኘው አባት በቀብር ላይ ያሉበት ብዙዎችን ያስለቀሰ አንጀት የሚበላ ሁኔታ by Nuro Bezede ኑሮ በዘዴ 3 years ago 10 minutes, 46 seconds 298,448 views",Nuro Bezede ኑሮ በዘዴ,298448,298476,28
7617,"Ethiopia: የስመኘው ዘመድ በቀብሩ ላይ የፈፀመችው አንጀት የሚበላ ድርጊት/ Engineer simegnew bekele wife by Nuro Bezede ኑሮ በዘዴ 3 years ago 10 minutes, 3 seconds 778,300 views",Nuro Bezede ኑሮ በዘዴ,778300,778934,634
7618,"Ethiopia: ለስመኘው በመስቀል አደባባይ የተደረገለት የጀግና አሸኛኘት by Nuro Bezede ኑሮ በዘዴ 3 years ago 11 minutes, 9 seconds 10,574 views",Nuro Bezede ኑሮ በዘዴ,10574,10575,1
7619,"ስመኘውን መቅበር ተከልክለው በአጋዚ ድብደባ የደረሰባቸው ወጣቶች ስለሁኔታው የተናገሩት by Nuro Bezede ኑሮ በዘዴ 3 years ago 11 minutes, 24 seconds 150,300 views",Nuro Bezede ኑሮ በዘዴ,150300,150300,0
7620,"Ethiopia: [አሁን የደረሰን ቪዲዮ] የኢንጅነር ስመኘው ቤተ ዘመዶች ስለሁኔታው የተናገሩት by Nuro Bezede ኑሮ በዘዴ 3 years ago 11 minutes, 25 seconds 107,301 views",Nuro Bezede ኑሮ በዘዴ,107301,107301,0
7621,"አባቱ ያሉበት ሁኔታ በጣም ያሳዝናል የስመኘው ቤተሰብ አሁን የተናገሩት እና ተጨማሪ አስተያየቶቸ by Nuro Bezede ኑሮ በዘዴ 3 years ago 11 minutes, 54 seconds 59,524 views",Nuro Bezede ኑሮ በዘዴ,59524,59525,1
7622,"Ethiopia: የሰውነታችንን ጤና ለማስጠበቅ የሚረዱ 7 ጠቃሚ ነጥቦች by Nuro Bezede ኑሮ በዘዴ 3 years ago 6 minutes, 30 seconds 11,524 views",Nuro Bezede ኑሮ በዘዴ,11524,11528,4
7623,"Ethiopia: ያለ ብዙ ልፋትና ወጪ ልብስን ነጭ የምናደርግበት አስገራሚ ዘዴ | Nuro Bezede by Nuro Bezede ኑሮ በዘዴ 3 years ago 10 minutes, 31 seconds 2,516 views",Nuro Bezede ኑሮ በዘዴ,2516,2518,2
7624,"Ethiopia: አይናችንን ጤንነት ለማስጠበቅ የሚረዳ የአይን ስፖርት | Nuro Bezede by Nuro Bezede ኑሮ በዘዴ 3 years ago 4 minutes, 56 seconds 12,452 views",Nuro Bezede ኑሮ በዘዴ,12452,12535,83
7625,"ET 7/24 የሰላማዊት ዮሀንስ አዲስ ሙዚቃ | የተወዳጁ ሙዚቀኛ የጋብቻ ጥያቄ እና የሳምንቱ የመዝናኛ መረጃዎች | Ethiopian Entertainment by Nuro Bezede ኑሮ በዘዴ 3 years ago 14 minutes, 29 seconds 116,951 views",Nuro Bezede ኑሮ በዘዴ,116951,116957,6
7626,"Ethiopia: የፀሀይ ብርሀን ለህይወታችን ያለው ከፍተኛ ጠቀሜታዎች | Nuro Bezede by Nuro Bezede ኑሮ በዘዴ 3 years ago 3 minutes, 38 seconds 924 views",Nuro Bezede ኑሮ በዘዴ,924,925,1
7627,"Ethiopia: ET 724 የሳምንቱን የመዝናኛ ጉዳዮችን በሀና ማርያም ክፍል 1 by Nuro Bezede ኑሮ በዘዴ 3 years ago 13 minutes, 5 seconds 1,853 views",Nuro Bezede ኑሮ በዘዴ,1853,1854,1
7628,"የጉማ ሽልማት ሙሉ ቪዲዮ ተጋብዛችኋል | Gumma Ethiopian Movie Award Full Video 2018 by Nuro Bezede ኑሮ በዘዴ 3 years ago 1 hour, 10 minutes 7,459 views",Nuro Bezede ኑሮ በዘዴ,7459,7480,21
7629,"Ethiopia: ታዛ የአመቱ ምርጥ ፊልም አሸናፊ | ጉማ አዋርድ ክፍል 4 | GUMMA AWARD Ethiopia 2018 by Nuro Bezede ኑሮ በዘዴ 3 years ago 17 minutes 22,663 views",Nuro Bezede ኑሮ በዘዴ,22663,22683,20
7630,"ጋሽ ውብሸት ወርቅ አለማሁ የህይወት ዘመን ተሸላሚ ሆኑ ጉማ አዋርድ ክፍል 3 by Nuro Bezede ኑሮ በዘዴ 3 years ago 4 minutes, 41 seconds 2,976 views",Nuro Bezede ኑሮ በዘዴ,2976,2976,0
7631,"Ethiopia: የአራዳ ልጅ 3 የአመቱ ምርጥ ፊልም ዘርፍ አሸናፊ ሆነ ጉማ አዋርድ ክፍል 2 | Gumma Award by Nuro Bezede ኑሮ በዘዴ 3 years ago 13 minutes, 59 seconds 15,876 views",Nuro Bezede ኑሮ በዘዴ,15876,15879,3
7632,"Ethiopia: ዘሪቱ ከበደ የአመቱ ምርጥ ተዋናይት ዘርፍ አሸናፊ ሆናለች | ጉማ አዋርድ ክፍል 1 by Nuro Bezede ኑሮ በዘዴ 3 years ago 12 minutes, 22 seconds 4,259 views",Nuro Bezede ኑሮ በዘዴ,4259,4259,0
7633,"Ethiopia: ቆዳን በተፈጥሮአዊ መንገድ ለማቅላት by Nuro Bezede ኑሮ በዘዴ 4 years ago 11 minutes, 20 seconds 129,615 views",Nuro Bezede ኑሮ በዘዴ,129615,130124,509
7634,"Ethiopia: የእንቅልፍ እጦት እንዳለብን የሚያረጋግጡ ምልክቶች by Nuro Bezede ኑሮ በዘዴ 4 years ago 8 minutes, 45 seconds 6,249 views",Nuro Bezede ኑሮ በዘዴ,6249,6251,2
7635,"የጤናማና ውብ ሴቶች ትናንሽ ሚስጥሮች by Nuro Bezede ኑሮ በዘዴ 4 years ago 15 minutes 14,500 views",Nuro Bezede ኑሮ በዘዴ,14500,14502,2
7636,"የቆዳ ሽፍታ የሚያስቸግሮ ከሆነ by Nuro Bezede ኑሮ በዘዴ 4 years ago 11 minutes, 6 seconds 27,763 views",Nuro Bezede ኑሮ በዘዴ,27763,28024,261
7637,"Ethiopia: ሴቶች ከወንዶች የሚፈልጉት 7 ነገሮች/7 Things Women Want from men by Nuro Bezede ኑሮ በዘዴ 4 years ago 10 minutes, 46 seconds 79,535 views",Nuro Bezede ኑሮ በዘዴ,79535,79553,18
7638,"የተልባ ዘይት ያልተሰሙ ድንቅ ጠቀሜታዎች by Nuro Bezede ኑሮ በዘዴ 4 years ago 11 minutes, 56 seconds 51,115 views",Nuro Bezede ኑሮ በዘዴ,51115,51152,37
7639,"ከንፈርን በተፈጥሮ ውብ የሚያደርጉ ሚስጥሮች by Nuro Bezede ኑሮ በዘዴ 4 years ago 11 minutes, 32 seconds 32,839 views",Nuro Bezede ኑሮ በዘዴ,32839,32871,32
7640,"በመጠነኛ ሰውነት ላይ ቦርጭ ካስቸገሮት by Nuro Bezede ኑሮ በዘዴ 4 years ago 10 minutes, 2 seconds 58,254 views",Nuro Bezede ኑሮ በዘዴ,58254,58261,7
7641,"Ethiopia: የፀጉርን እድገት የሚያፋጥኑ ቀላል ብልሀቶች by Nuro Bezede ኑሮ በዘዴ 4 years ago 10 minutes, 4 seconds 148,629 views",Nuro Bezede ኑሮ በዘዴ,148629,148667,38
7642,"Ethiopia: የእጅ መዳፍ ስለ ህይወቶ ምን ይናገራል? by Nuro Bezede ኑሮ በዘዴ 4 years ago 7 minutes, 32 seconds 319,399 views",Nuro Bezede ኑሮ በዘዴ,319399,320045,646
7643,"የጠቆረ ብብትን ለማንጣት ፍቱን መፍትሄዎች by Nuro Bezede ኑሮ በዘዴ 4 years ago 7 minutes, 45 seconds 177,798 views",Nuro Bezede ኑሮ በዘዴ,177798,177925,127
7644,"Ethiopia: በጨጓራ ህመም ለምትሰቃዩ መፍትሄ by Nuro Bezede ኑሮ በዘዴ 4 years ago 5 minutes, 31 seconds 301,146 views",Nuro Bezede ኑሮ በዘዴ,301146,302787,1641
7645,"ኑሮ በዘዴ: ጭንቀት የወለደው አካላዊ ህመም by Nuro Bezede ኑሮ በዘዴ 4 years ago 5 minutes, 54 seconds 17,215 views",Nuro Bezede ኑሮ በዘዴ,17215,17230,15
7646,"የጥርስ ሳሙና ስንመርጥ የምንሰራቸው አደገኛ ስህተቶች | dangerous mistakes we make when we pick toothpastes by Nuro Bezede ኑሮ በዘዴ 4 years ago 10 minutes, 7 seconds 79,345 views",Nuro Bezede ኑሮ በዘዴ,79345,79474,129
7647,"Ethiopia: መሀንነት በሴቶች ላይ እንዴት ይፈጠራል? by Nuro Bezede ኑሮ በዘዴ 4 years ago 11 minutes, 3 seconds 107,703 views",Nuro Bezede ኑሮ በዘዴ,107703,107740,37
7648,"ወንዶች እዛም እዛም የሚሉበት ምክንያት ይፋ ተደረገ | Ethiopia: Reasons Why Men Cheat by Nuro Bezede ኑሮ በዘዴ 4 years ago 10 minutes, 10 seconds 28,753 views",Nuro Bezede ኑሮ በዘዴ,28753,28756,3
7649,"የሀገራችን ጤና ነክ እምነቶችና ሳይንስ ( ምች, መጋኛ, ወደ ጨረቃ ዞሮ መሽናት ) by Nuro Bezede ኑሮ በዘዴ 4 years ago 10 minutes, 24 seconds 2,517 views",Nuro Bezede ኑሮ በዘዴ,2517,2522,5
7650,"ከመርፌና ክኒን የቱ ይመረጣል? | are needles more effective than pills? by Nuro Bezede ኑሮ በዘዴ 4 years ago 10 minutes, 52 seconds 13,288 views",Nuro Bezede ኑሮ በዘዴ,13288,13426,138
7651,"ኑሮ በዘዴ፡ ማለዳ ላይ ሲነሱ ሊፈትሿቸው የሚገቡ ምልክቶች | important health signs to check for every morning by Nuro Bezede ኑሮ በዘዴ 4 years ago 5 minutes, 39 seconds 18,820 views",Nuro Bezede ኑሮ በዘዴ,18820,18830,10
7652,"Ethiopia: አፋችን ለምን ይደርቃል? መፍትሄውስ? | Dry mouth  Symptoms and Causes by Nuro Bezede ኑሮ በዘዴ 4 years ago 4 minutes, 43 seconds 8,289 views",Nuro Bezede ኑሮ በዘዴ,8289,8294,5
7653,"የኮስሞቲክስ አጠቃቀምና በየጊዜው የምንሰራቸው ስህተቶች | dangers caused by cosmetics products by Nuro Bezede ኑሮ በዘዴ 4 years ago 10 minutes, 10 seconds 6,180 views",Nuro Bezede ኑሮ በዘዴ,6180,6181,1
7654,"የሳይነስ በሽታ ምንድን ነው? | what is sinus? by Nuro Bezede ኑሮ በዘዴ 4 years ago 10 minutes, 21 seconds 21,743 views",Nuro Bezede ኑሮ በዘዴ,21743,21897,154
7655,"Ethiopia: የጆሮ ኢንፌክሽን በአዋቂዎችና በህፃናት | Ear Infections on adult and kids by Nuro Bezede ኑሮ በዘዴ 4 years ago 4 minutes, 22 seconds 10,523 views",Nuro Bezede ኑሮ በዘዴ,10523,10574,51
7656,"ከቅባታማ ምግቦች ምግቦች ይልቅ መቀነስ ያለብን ነገሮች | it turns out fat is not what you should avoid by Nuro Bezede ኑሮ በዘዴ 4 years ago 10 minutes, 14 seconds 12,243 views",Nuro Bezede ኑሮ በዘዴ,12243,12247,4
7657,"ከከባድ እስከ ቀላል የራስ ምታትን ለማስታገስ አስገራሚ መላዎች | Ethiopia: How to Get Rid of a Headache by Nuro Bezede ኑሮ በዘዴ 4 years ago 10 minutes, 20 seconds 22,348 views",Nuro Bezede ኑሮ በዘዴ,22348,22476,128
7658,"Ethiopia: ወንዶች አልጋ ላይ የሚሰሩት 6 ስህተቶች by Nuro Bezede ኑሮ በዘዴ 4 years ago 7 minutes, 39 seconds 141,540 views",Nuro Bezede ኑሮ በዘዴ,141540,141550,10
7659,"አዲስ ነገር፡ በወንዶች ፂም መድሀኒት ሊሰራ ነው ተባለ | Ethiopia: a medicine is made from a beard by Nuro Bezede ኑሮ በዘዴ 4 years ago 4 minutes, 10 seconds 5,533 views",Nuro Bezede ኑሮ በዘዴ,5533,5553,20
7660,"ኑሮ በዘዴ፡ ለፍቺ የሚዳርጉ 10 ምክንያቶች | Ethiopia: Top 10 Reasons for Divorce by Nuro Bezede ኑሮ በዘዴ 4 years ago 7 minutes, 20 seconds 42,903 views",Nuro Bezede ኑሮ በዘዴ,42903,42920,17
7661,"Ethiopia: ልጆች ሊከተሏቸው የሚገቡ የምግብ ልማዶች by Nuro Bezede ኑሮ በዘዴ 4 years ago 7 minutes, 35 seconds 31,240 views",Nuro Bezede ኑሮ በዘዴ,31240,31276,36
7662,"እንዴት በቀላሉ ለፀጉራችን ትሪትመንት መስራት እንችላለን? | Amazing Benefits Of Mayonnaise Hair Treatment by Nuro Bezede ኑሮ በዘዴ 4 years ago 12 minutes, 52 seconds 85,119 views",Nuro Bezede ኑሮ በዘዴ,85119,85184,65
7663,"ኑሮ በዘዴ: Alcohol and Its Impact on Your Skin by Nuro Bezede ኑሮ በዘዴ 4 years ago 6 minutes, 18 seconds 2,324 views",Nuro Bezede ኑሮ በዘዴ,2324,2334,10
7664,"Ethiopia: ብዙዎች የሚያነሷቸው ውበት ነክ ጥያቄዎች መልስ | about beauty people usually ask by Nuro Bezede ኑሮ በዘዴ 4 years ago 10 minutes, 22 seconds 32,113 views",Nuro Bezede ኑሮ በዘዴ,32113,32116,3
7665,"what to know about newborn | Ethiopia: አዲስ ስለ ተወለደ ህፃን ማወቅ ያለብን by Nuro Bezede ኑሮ በዘዴ 4 years ago 10 minutes, 19 seconds 38,821 views",Nuro Bezede ኑሮ በዘዴ,38821,39277,456
7666,"በየአመቱ 6000 ኢትዮጲያዊ ሴቶችን እየገደለብን ስላለው አሳሳቢ በሽታ ማወቅ ያለብዎ | what is cervical cancer? by Nuro Bezede ኑሮ በዘዴ 4 years ago 7 minutes, 55 seconds 52,449 views",Nuro Bezede ኑሮ በዘዴ,52449,52461,12
7667,"ክብደትዎን በትክክለኛ መንገድ ለመጨመር ማድረግ ያለብዎ | How to Gain Weight Fast and Safely by Nuro Bezede ኑሮ በዘዴ 4 years ago 11 minutes, 10 seconds 18,957 views",Nuro Bezede ኑሮ በዘዴ,18957,18967,10
7668,"Ethiopia: የስኳር በሽታና የጉበት በሽታ እንዴት ይያያዛሉ? by Nuro Bezede ኑሮ በዘዴ 4 years ago 4 minutes, 41 seconds 10,741 views",Nuro Bezede ኑሮ በዘዴ,10741,10742,1
7669,"ወንዶች የማይናገሩት ነገር ግን የሚመቻቸው የሴት ባህሪያት | top 5 qualities men want in a woman by Nuro Bezede ኑሮ በዘዴ 4 years ago 7 minutes, 36 seconds 182,559 views",Nuro Bezede ኑሮ በዘዴ,182559,182563,4
7670,"ቆዳችን ያለ ጊዜው እንዳያረጅ ማድረግ ያለብዎ 10 ወሳኝ ነገሮች | Ethiopia: Nuro Bezede explains by Nuro Bezede ኑሮ በዘዴ 4 years ago 13 minutes, 1 second 10,618 views",Nuro Bezede ኑሮ በዘዴ,10618,10620,2
7671,"Ethiopia: body parts you're not washing enough | ሁልጊዜ ገላችንን ስንታጠብ መዘንጋት የሌለብን ቦታወች by Nuro Bezede ኑሮ በዘዴ 4 years ago 5 minutes, 18 seconds 27,642 views",Nuro Bezede ኑሮ በዘዴ,27642,27654,12
7672,"ስንፈተ ወሲብ በሴቶችና በወንዶች መንስኤና መፍትሄ Ethiopia Nuro Bezede explains by Nuro Bezede ኑሮ በዘዴ 4 years ago 11 minutes, 6 seconds 52,701 views",Nuro Bezede ኑሮ በዘዴ,52701,52719,18
7673,"ክብደታችንን እንዳንቀንስ የሚያደርጉ መጥፎ ልማዶች Ethiopia: Everymorning things we do that gain us weight by Nuro Bezede ኑሮ በዘዴ 4 years ago 4 minutes, 54 seconds 59,317 views",Nuro Bezede ኑሮ በዘዴ,59317,59367,50
7674,"ከአይን ስር የሚፈጠርን ጥቁረት ለማጠፋት የሚረዳ | Ethiopia: How to Get Rid of Dark Under-Eye Circles by Nuro Bezede ኑሮ በዘዴ 4 years ago 5 minutes, 55 seconds 59,517 views",Nuro Bezede ኑሮ በዘዴ,59517,59687,170
7675,"ልብስ በማሽን ስናጥብ የምንፈፅማቸው 5 ከባድ ስህተቶች | Ethiopia: laundry mistakes you're making by Nuro Bezede ኑሮ በዘዴ 4 years ago 5 minutes, 6 seconds 28,369 views",Nuro Bezede ኑሮ በዘዴ,28369,28523,154
7676,"የብዙ ሴቶች የውበት ሚስጢር የሆነው የሬት አስደናቂ በረከቶች || Ethiopia Special benefits of aloe vera by Nuro Bezede ኑሮ በዘዴ 4 years ago 12 minutes, 7 seconds 50,608 views",Nuro Bezede ኑሮ በዘዴ,50608,50790,182
7677,"Ethiopia ቀላል መስለው ከባድ ዋጋ የሚያስከፍሉ ህመሞች by Nuro Bezede ኑሮ በዘዴ 4 years ago 10 minutes, 3 seconds 20,175 views",Nuro Bezede ኑሮ በዘዴ,20175,20326,151
7678,"Ethiopia: ስለ ፀጉርዎ ሊያውቋቸው የሚገቡ ወሳኝ ነገሮች || The most important Hair Rule by Nuro Bezede ኑሮ በዘዴ 4 years ago 7 minutes, 5 seconds 58,667 views",Nuro Bezede ኑሮ በዘዴ,58667,58690,23
7679,"ቁርስ በመዝለላችን የሚገጥሙን አስደንጋጭ የጤና እክሎች why we shouldn't skip breakfast by Nuro Bezede ኑሮ በዘዴ 4 years ago 4 minutes, 47 seconds 26,264 views",Nuro Bezede ኑሮ በዘዴ,26264,26275,11
7680,"Ethiopia ቢራ ባለመጠጣታችን ምን የቀሩብን ነገሮች ይኖሩ ይሆን? the benefits of beer by Nuro Bezede ኑሮ በዘዴ 4 years ago 6 minutes, 31 seconds 4,468 views",Nuro Bezede ኑሮ በዘዴ,4468,4475,7
7681,"Ethiopia የጦስኝ 8ቱ አስደናቂ የጤና በረከቶች Benefits of thyme Nuro Bezede by Nuro Bezede ኑሮ በዘዴ 4 years ago 7 minutes, 39 seconds 36,080 views",Nuro Bezede ኑሮ በዘዴ,36080,36209,129
7682,"በስራ ቦታ ክብደት እንዳንቀንስ የሚያደርጉን የሁልጊዜ ስህተቶቻችን || mistakes we do at work to lose weight Ethiopia by Nuro Bezede ኑሮ በዘዴ 4 years ago 5 minutes, 11 seconds 4,968 views",Nuro Bezede ኑሮ በዘዴ,4968,4968,0
7683,"ማድያትን በቀላሉ ለማጥፋት የሚረዱን በቤት ውስጥ የሚዘጋጁ መላዎች Ethiopia How to prevent melasma by Nuro Bezede ኑሮ በዘዴ 4 years ago 8 minutes, 54 seconds 172,138 views",Nuro Bezede ኑሮ በዘዴ,172138,172221,83
7684,"Ethiopia ህልም ስለራስ ማንነት ምን ይናገራል ??? by Nuro Bezede ኑሮ በዘዴ 4 years ago 3 minutes, 25 seconds 49,358 views",Nuro Bezede ኑሮ በዘዴ,49358,49442,84
7685,"የወር አበባን ለማዘግየት የሚረዱ ተፈጥሯዊ ዘዴዎች by Nuro Bezede ኑሮ በዘዴ 4 years ago 11 minutes, 5 seconds 14,468 views",Nuro Bezede ኑሮ በዘዴ,14468,14473,5
7686,"የእንጉዳይ የማታውቋቸው ግን ልታውቋቸው የሚገቡ 7 ድንቅ በረከቶች by Nuro Bezede ኑሮ በዘዴ 4 years ago 10 minutes, 8 seconds 11,634 views",Nuro Bezede ኑሮ በዘዴ,11634,11665,31
7687,"Ethiopia:  በኢትዮጲያ እጅግ አሳሳቢ 10 ገዳይ በሽታዎች by Nuro Bezede ኑሮ በዘዴ 4 years ago 12 minutes, 40 seconds 9,110 views",Nuro Bezede ኑሮ በዘዴ,9110,9111,1
7688,"Ethiopia ብጉርን በቀላሉ ለማጥፋት የቲማቲም ተአምራዊ መፍተሄ by Nuro Bezede ኑሮ በዘዴ 4 years ago 13 minutes, 39 seconds 25,583 views",Nuro Bezede ኑሮ በዘዴ,25583,25593,10
7689,"Ethiopia: አዲሱ የስኳር በሽታ ዶክተሮችን ግራ አጋባ by Nuro Bezede ኑሮ በዘዴ 4 years ago 4 minutes, 57 seconds 25,555 views",Nuro Bezede ኑሮ በዘዴ,25555,25673,118
7690,"Ethiopia የተወለዱበት ወር ስለ ጤናዎ ምን ይናገራል | A link Between Birth month And Diseases by Nuro Bezede ኑሮ በዘዴ 4 years ago 5 minutes, 7 seconds 51,720 views",Nuro Bezede ኑሮ በዘዴ,51720,51756,36
7691,"Ethiopia አስምን በተፈጥሮአዊ መንገድ ማከም ይቻላል ወይ? Nuro Bezede by Nuro Bezede ኑሮ በዘዴ 4 years ago 5 minutes, 24 seconds 9,000 views",Nuro Bezede ኑሮ በዘዴ,9000,9024,24
7692,"Ethiopia: ቡና ለኤች አይቪ ህሙማን የሚሰጠው ከፍተኛ ጥቅም | Nuro Bezede by Nuro Bezede ኑሮ በዘዴ 4 years ago 4 minutes, 19 seconds 50,264 views",Nuro Bezede ኑሮ በዘዴ,50264,50286,22
7693,"ስለራሳችን ያለን ግምትና ፍቅር እንዴት ይያያዛል? Ethiopia by Nuro Bezede ኑሮ በዘዴ 4 years ago 4 minutes, 3 seconds 9,439 views",Nuro Bezede ኑሮ በዘዴ,9439,9439,0
7694,"የነጭ ሽንኩርት መጥፎ የአፍ ጠረንን ለማስወገድ የሚረዱ ቀላል ብልሀቶች Ethiopia Nuro Bezede by Nuro Bezede ኑሮ በዘዴ 4 years ago 7 minutes, 9 seconds 88,635 views",Nuro Bezede ኑሮ በዘዴ,88635,88708,73
7695,"ለሴቶች እጅግ አሳሳቢ የሆነው የጡት ካንሰር ህክምና ምን ላይ ደርሷል Ethiopia by Nuro Bezede ኑሮ በዘዴ 4 years ago 13 minutes, 18 seconds 4,845 views",Nuro Bezede ኑሮ በዘዴ,4845,4849,4
7696,"የሚያምር የፊት ቆዳ እንዲኖረን የሚረዳ ከቡና የሚዘጋጅ ስክራብ  Ethiopia Nuro Bezede by Nuro Bezede ኑሮ በዘዴ 4 years ago 7 minutes, 5 seconds 249,983 views",Nuro Bezede ኑሮ በዘዴ,249983,250072,89
7697,"የፀጉር መነቃቀልን ለማስቆም የሚረዱ ቀላል ዘዴዎች Ethiopia Nuro Bezede by Nuro Bezede ኑሮ በዘዴ 4 years ago 6 minutes, 2 seconds 57,170 views",Nuro Bezede ኑሮ በዘዴ,57170,57188,18
7698,"የማር ጥቅም ከውበት መጠበቂያ እስከ ቁስል ማከሚያ Ethiopia Nuro Bezede by Nuro Bezede ኑሮ በዘዴ 4 years ago 5 minutes, 6 seconds 47,774 views",Nuro Bezede ኑሮ በዘዴ,47774,47803,29
7699,"መሀንነትን የሚያመጡ መጥፎ ልማዶች ለሌሎች ሼር ያድርጉ Ethiopia by Nuro Bezede ኑሮ በዘዴ 4 years ago 3 minutes, 26 seconds 43,254 views",Nuro Bezede ኑሮ በዘዴ,43254,43255,1
7700,"ለፊታችን ቆዳ እጅግ አደገኛ የሆኑ የሆኑ የቆዳ ሀኪሞች የሚመክሩት Ethiopia NuroBezede by Nuro Bezede ኑሮ በዘዴ 4 years ago 4 minutes, 23 seconds 23,760 views",Nuro Bezede ኑሮ በዘዴ,23760,23762,2
7701,"ከወንድና ከሴት ማን ይበልጥ ይዋሻልና ብዙ ጊዜ የሚዋሹ ውሸቶች Ethiopia Nuro Bezede by Nuro Bezede ኑሮ በዘዴ 4 years ago 3 minutes, 25 seconds 4,335 views",Nuro Bezede ኑሮ በዘዴ,4335,4335,0
7702,"Ethiopia፡ የመቀመጫ ቅርፅ ለማሳመር የሚሰሩ ስፖርቶች by Nuro Bezede ኑሮ በዘዴ 4 years ago 5 minutes, 9 seconds 123,506 views",Nuro Bezede ኑሮ በዘዴ,123506,123803,297
7703,"""ዓሳን መብላት በብልሀት"" እንደሆነ የሚያሳምኑ 6ቱ ወሳኝ ነገሮች Ethiopia: Nuro Bezede by Nuro Bezede ኑሮ በዘዴ 4 years ago 6 minutes, 47 seconds 5,213 views",Nuro Bezede ኑሮ በዘዴ,5213,5215,2
7704,"ነጭ ሽንኩርትን ባለመጠቀማችን የቀሩብን አስገራሚ ጥቅሞች Ethiopia by Nuro Bezede ኑሮ በዘዴ 4 years ago 5 minutes, 37 seconds 115,420 views",Nuro Bezede ኑሮ በዘዴ,115420,115470,50
7705,"ሴቶች አባታቸውን የሚመስል ወንድ ይወዳሉ ወይ? by Nuro Bezede ኑሮ በዘዴ 4 years ago 5 minutes, 7 seconds 4,844 views",Nuro Bezede ኑሮ በዘዴ,4844,4847,3
7706,"ጉንፋንን ለማዳን የሚረዱ በቤት ውስጥ በቀላሉ የሚዘጋጁ መፍሄዎች || Nuro Bezede by Nuro Bezede ኑሮ በዘዴ 4 years ago 3 minutes, 55 seconds 4,848 views",Nuro Bezede ኑሮ በዘዴ,4848,4863,15
7707,"Ethiopia፡ የለስላሳ መጠጦችን እንዳንጠጣ የሚያደርጉ አስገራሚ ምክንያቶች by Nuro Bezede ኑሮ በዘዴ 4 years ago 5 minutes, 12 seconds 81,232 views",Nuro Bezede ኑሮ በዘዴ,81232,81260,28
7708,"Ethiopia፡ ቤኪንግ ሶዳ ምንድን ነው? ያልተሰሙ አስገራሚ ጥቅሞች by Nuro Bezede ኑሮ በዘዴ 4 years ago 11 minutes, 15 seconds 50,242 views",Nuro Bezede ኑሮ በዘዴ,50242,50292,50
7709,"Ethiopia፡ ፆም እና ጤና ምን አገናኛቸው? ጠቃሚ ምክር || Nuro BeZede by Nuro Bezede ኑሮ በዘዴ 4 years ago 4 minutes, 56 seconds 6,570 views",Nuro Bezede ኑሮ በዘዴ,6570,6570,0
7710,"Ethiopia፡ ስለ ፍቅር የተለመዱ ግን የተሳሳቱ 10 አመለካከቶች by Nuro Bezede ኑሮ በዘዴ 4 years ago 6 minutes, 40 seconds 27,365 views",Nuro Bezede ኑሮ በዘዴ,27365,27369,4
7711,"Ethiopia: ከእርግዝና በኋላ የሚከሰትን ትርፍ ቆዳ ወደ ቦታው ለመመለስ የሚረዱን ዘዴዎች by Nuro Bezede ኑሮ በዘዴ 4 years ago 4 minutes, 59 seconds 29,177 views",Nuro Bezede ኑሮ በዘዴ,29177,29178,1
7712,"Ethiopia፡ መጥፎ የአፍ ጠረንን ለማስወገድ የሚረዱ ቀላል ብልሀቶች by Nuro Bezede ኑሮ በዘዴ 4 years ago 5 minutes, 7 seconds 124,994 views",Nuro Bezede ኑሮ በዘዴ,124994,125040,46
7713,"Ethiopia፡ እንዳያልበን የሚያደርጉ ተፈጥሮአዊ ብልሀቶች by Nuro Bezede ኑሮ በዘዴ 4 years ago 4 minutes, 39 seconds 3,502 views",Nuro Bezede ኑሮ በዘዴ,3502,3508,6
7714,"Ethiopia፡ ቁመት ለመጨመር የሚረዱ ተፈጥሮአዊ ቀላል ብልሀቶች || Nuro Bezede by Nuro Bezede ኑሮ በዘዴ 4 years ago 7 minutes, 49 seconds 77,981 views",Nuro Bezede ኑሮ በዘዴ,77981,78294,313
7715,"Ethiopia፡ የወይን ጠጅ ባለ መጠጣትዎ ያጡት የጤና በረከቶች || Nuro Bezede by Nuro Bezede ኑሮ በዘዴ 4 years ago 4 minutes, 50 seconds 5,902 views",Nuro Bezede ኑሮ በዘዴ,5902,5912,10
7716,"Ethiopia፡ ወንዶች ሲስሙ የሚሰሯቸው 6 ስህተቶች || Nuro Bezede by Nuro Bezede ኑሮ በዘዴ 4 years ago 3 minutes, 36 seconds 515,752 views",Nuro Bezede ኑሮ በዘዴ,515752,515922,170
7717,"Ethiopia፡ በ20 ዕድሜ ክልል ውስጥ ላሉ ሴቶች ክብደት ለመቀነስ የሚረዱ ዘዴዎች || Nuro Bezede by Nuro Bezede ኑሮ በዘዴ 4 years ago 6 minutes, 38 seconds 19,225 views",Nuro Bezede ኑሮ በዘዴ,19225,19231,6
7718,"Ethiopia፡ በፍቅር ግንኙነት ውስጥ መሰለቻቸት እንዳይመጣ ማድረግ ያለባችሁ || Nuro Bezede by Nuro Bezede ኑሮ በዘዴ 4 years ago 4 minutes, 48 seconds 54,528 views",Nuro Bezede ኑሮ በዘዴ,54528,54535,7
7719,"Ethiopia፡ ምርቃናን ፈረንጆች እንዴት ያዩታል እስቲ ለየት ያለውን ይመልከቱ || Nuro Bezede by Nuro Bezede ኑሮ በዘዴ 4 years ago 4 minutes, 46 seconds 15,864 views",Nuro Bezede ኑሮ በዘዴ,15864,15868,4
7720,"Ethiopia፡ የብጉር ጠበሳን ለማጥፋት የሚረዱን በቤት ውስጥ የሚዘጋጁ መፍትሄዎች || Nuro Bezede by Nuro Bezede ኑሮ በዘዴ 4 years ago 5 minutes, 51 seconds 39,929 views",Nuro Bezede ኑሮ በዘዴ,39929,39944,15
7721,"Ethiopia፡ ለውዝ እንድንበላ የሚያደርጉ 11 አስገራሚ ምክንያቶች || Nuro Bezede by Nuro Bezede ኑሮ በዘዴ 4 years ago 6 minutes, 47 seconds 52,173 views",Nuro Bezede ኑሮ በዘዴ,52173,52232,59
7722,"Ethiopia፡ ሴቶችን ከገንዘብ በላይ የሚማርካቸው 7 የማትጠብቋቸው ነገሮች || Nuro Bezede by Nuro Bezede ኑሮ በዘዴ 4 years ago 5 minutes, 40 seconds 329,187 views",Nuro Bezede ኑሮ በዘዴ,329187,329259,72
7723,"Ethiopia፡ ፎሮፎርን ለማስወገድ የሚረዱ ቀላል በቤት ውስጥ የሚዘጋጁ መፍትሄዎች || Nuro Bezede by Nuro Bezede ኑሮ በዘዴ 4 years ago 5 minutes, 33 seconds 45,498 views",Nuro Bezede ኑሮ በዘዴ,45498,45726,228
7724,"Ethiopia፡ ስኬታማ እንዳንሆን የሚያደርጉ ምክንያቶች || Nuro Bezede by Nuro Bezede ኑሮ በዘዴ 4 years ago 6 minutes, 38 seconds 33,948 views",Nuro Bezede ኑሮ በዘዴ,33948,33956,8
7725,"Ethiopia፡ ትዳር ለመመስረት ትክክለኛው ዕድሜ ስንት ነው?? || Nuro Bezede by Nuro Bezede ኑሮ በዘዴ 4 years ago 3 minutes, 47 seconds 49,126 views",Nuro Bezede ኑሮ በዘዴ,49126,49128,2
7726,"Ethiopia፡ የቆዳ ሸንተረር እንዴት ይፈጠራል? እና ለማጥፋት የሚረዱ መፍሄዎች || Nuro Bezede by Nuro Bezede ኑሮ በዘዴ 4 years ago 5 minutes, 19 seconds 263,012 views",Nuro Bezede ኑሮ በዘዴ,263012,263059,47
7727,"Ethiopia: የቀላ አይንን ወደ ነበረበት የምንመልስበት ፈጣን ዘዴዎች || Nuro Bezede by Nuro Bezede ኑሮ በዘዴ 4 years ago 4 minutes, 15 seconds 27,371 views",Nuro Bezede ኑሮ በዘዴ,27371,27541,170
7728,"Ethiopia፡ ጥርስን ፅድት የሚያደርጉ 7ቱ ምግቦች || Nuro Bezede by Nuro Bezede ኑሮ በዘዴ 4 years ago 3 minutes, 46 seconds 27,077 views",Nuro Bezede ኑሮ በዘዴ,27077,27100,23
7729,"Ethiopia የልብ ህመም ከመከሰቱ ከ1 ወር በፊት የሚታዩ ወሳኝ ምልክቶች by Nuro Bezede ኑሮ በዘዴ 4 years ago 4 minutes, 50 seconds 71,605 views",Nuro Bezede ኑሮ በዘዴ,71605,71976,371
7730,"Ethiopia የውሀ ሽንት ስለ ሰውነትዎ ጤንነት ምን ይናገራል by Nuro Bezede ኑሮ በዘዴ 4 years ago 8 minutes, 51 seconds 90,823 views",Nuro Bezede ኑሮ በዘዴ,90823,90851,28
7731,"Ethiopia ከውሀ ጥቅም ለማግኘት አወሳሰዳችን ምን መምሰል አለበት?? || Nuro Bezede by Nuro Bezede ኑሮ በዘዴ 4 years ago 4 minutes, 51 seconds 10,740 views",Nuro Bezede ኑሮ በዘዴ,10740,10742,2
7732,"Ethiopia፡ የሸሸ ፀጉርን መልሰው የሚያበቅሉ ምትሀተኛ መድሀኒቶች by Nuro Bezede ኑሮ በዘዴ 4 years ago 4 minutes, 8 seconds 75,084 views",Nuro Bezede ኑሮ በዘዴ,75084,75467,383
7733,"Ethiopia መጥፎ የእግር ጠረንን ለማስወገድ እነዚህን መላዎች ይሞክሩ || Nuro Bezede by Nuro Bezede ኑሮ በዘዴ 4 years ago 3 minutes, 17 seconds 13,039 views",Nuro Bezede ኑሮ በዘዴ,13039,13097,58
7734,"Ethiopia: ክብደት ለመቀነስ የሚረዱን በቤት ውስጥ የሚዘጋጁ ተፈጥሮአዊ መጠጦች ለእርስዎ || Nuro Bezede by Nuro Bezede ኑሮ በዘዴ 4 years ago 4 minutes, 2 seconds 71,552 views",Nuro Bezede ኑሮ በዘዴ,71552,71583,31
7735,"Ethiopia: የአቮካዶ ለየት ያሉ አስገራሚ የጤና በረከቶች  || Nuro Bezede by Nuro Bezede ኑሮ በዘዴ 4 years ago 6 minutes, 23 seconds 57,524 views",Nuro Bezede ኑሮ በዘዴ,57524,57592,68
7736,"Ethiopia፡ እርጎ ባለመጠጣታችን የቀሩብን አስደናቂ የጤና በረከቶች || Nuro Bezede by Nuro Bezede ኑሮ በዘዴ 4 years ago 4 minutes, 34 seconds 61,628 views",Nuro Bezede ኑሮ በዘዴ,61628,61690,62
7737,"Ethiopia: የኩላሊት ጠጠር በሽታ እንዳይከሰት የሚደረጉ ጥንቃቄዎች || Nuro Bezede by Nuro Bezede ኑሮ በዘዴ 4 years ago 5 minutes, 24 seconds 17,100 views",Nuro Bezede ኑሮ በዘዴ,17100,17111,11
7738,"Ethiopia: ሙዚቃ ማዳመጥ ከጤናዎ ጋር እንዴት ይያያዛል || Nuro Bezede by Nuro Bezede ኑሮ በዘዴ 4 years ago 6 minutes, 43 seconds 10,753 views",Nuro Bezede ኑሮ በዘዴ,10753,10759,6
7739,"Ethiopia: የሀንጎቨር ስሜትን ለማስወገድ የሚረዱ ቀላል ብልሀቶች || Nuro Bezede by Nuro Bezede ኑሮ በዘዴ 4 years ago 4 minutes, 9 seconds 729 views",Nuro Bezede ኑሮ በዘዴ,729,731,2
7740,"Ethiopia፡ በኩሽና ውስጥ ስራን በጣም የሚያቀሉ ብልሀቶች || Nuro Bezede by Nuro Bezede ኑሮ በዘዴ 4 years ago 5 minutes, 26 seconds 5,989 views",Nuro Bezede ኑሮ በዘዴ,5989,5990,1
7741,"Ethiopia፡ ያልታወቁ ግን ሊታወቁ የሚገቡ የወሲብ እውነታዎች || Nuro Bezede by Nuro Bezede ኑሮ በዘዴ 4 years ago 7 minutes, 35 seconds 155,849 views",Nuro Bezede ኑሮ በዘዴ,155849,155902,53
7742,"Ethiopia: የዝንጅብል ሊታወቁ የሚገባቸው 5 ትላልቅ ጠቀሜታዎች | 5 Things You Should Know about Ginger by Nuro Bezede ኑሮ በዘዴ 4 years ago 3 minutes, 26 seconds 147,020 views",Nuro Bezede ኑሮ በዘዴ,147020,147050,30
7743,"Ethiopia: የጥፍር ጨረቃ ምንድን ነው? ስለ ጤናዎስ ምን ይናገራል? || Nuro Bezede by Nuro Bezede ኑሮ በዘዴ 4 years ago 3 minutes, 47 seconds 143,062 views",Nuro Bezede ኑሮ በዘዴ,143062,143215,153
7744,"Ethiopia: 10 ያልተለመዱ ግን በጣም ውጤታማ የጤና ብልሀቶች | 10 strange but true health tips by Nuro Bezede ኑሮ በዘዴ 4 years ago 4 minutes, 37 seconds 3,053 views",Nuro Bezede ኑሮ በዘዴ,3053,3054,1
7745,"Ethiopia: ከቀናችሁ 22 ሰዓታትን የሚያገኙባቸው 6 የእንቅልፍ ዘዴዎች | 6 Sleep techniques for up to 22 hours in Amharic by Nuro Bezede ኑሮ በዘዴ 4 years ago 4 minutes, 15 seconds 7,249 views",Nuro Bezede ኑሮ በዘዴ,7249,7250,1
7746,"ETHIOPIA፡ እንደ ታዋቂ ሰዎች ዘናጭ እና ውብ ለመሆን የሚረዱሽ የተደበቁ ሚስጥሮች by Nuro Bezede ኑሮ በዘዴ 4 years ago 4 minutes, 41 seconds 9,729 views",Nuro Bezede ኑሮ በዘዴ,9729,9744,15
7747,"ETHIOPIA:  8  ሳናውቅ በየጊዜው የምንሰራቸው የጀርባ አጥንታችንን የሚጎዱ ስራዎች by Nuro Bezede ኑሮ በዘዴ 4 years ago 3 minutes, 22 seconds 43,071 views",Nuro Bezede ኑሮ በዘዴ,43071,43081,10
